"","player_id","Name","DoB","Position","Club","Division","Nationality","EU National","Contract Start","Contract End","Transfer Value","Pref. Foot","Left Foot","Right Foot","Height","Weight","All-time Apps","All-time Gls","Current Ability","Potential Ability","Corners","Crossing","Dribbling","Finishing","First Touch","Free Kicks","Heading","Long Shots","Long Throws","Marking","Passing","Penalties","Tackling","Technique","Aggression","Anticipation","Bravery","Composure","Concentration","Decisions","Determination","Flair","Leadership","Off the Ball","Positioning","Teamwork","Vision","Work Rate","Acceleration","Agility","Balance","Jumping Reach","Natural Fitness","Pace","Stamina","Strength","Versatility","Temperament","Sportsmanship","Professionalism","Pressure","Loyalty","Injury Proneness","Important Matches","Dirtiness","Controversy","Consistency","Ambition","Adaptability","Throwing","Rushing out Tendency","Reflexes","Punching Tendency","One on Ones","Kicking","Handling","Eccentricity","Communication","Command of Area","Aerial Reach"
"1",7458500,"Lionel Messi","6/24/1987 (35 years old)","AM (RC), ST (C)","Paris SG","Ligue 1 Uber Eats","ARG","Yes","8/10/2021","6/30/2024","$24M - $37M","Left","Very Strong","Fairly Strong","5'7""","147 lbs","610","507",185,200,15,15,20,17,19,18,10,16,4,4,19,17,7,20,7,16,10,16,13,18,20,20,14,14,5,14,20,9,16,15,18,6,14,15,13,9,12,14,15,17,19,17,6,18,9,5,16,18,17,2,3,1,2,1,3,3,3,3,3,3
"2",14157184,"Alexis Mac Allister","12/24/1998 (24 years old)","DM, M/AM (C)","Brighton","English Premier Division","ARG","No","10/22/2022","6/30/2025","$29M - $44M","Right","Weak","Very Strong","5'9""","156 lbs","176","27",158,165,14,14,13,14,16,16,10,15,9,7,16,16,14,16,15,15,14,16,15,16,14,14,11,14,14,15,16,15,13,12,12,9,14,13,14,12,14,10,15,16,14,12,6,17,8,3,14,12,9,3,4,2,1,1,3,1,2,2,1,1
"3",48037335,"Marcus Thuram","8/6/1997 (25 years old)","AM (L), ST (C)","Borussia M'gladbach","Bundesliga","FRA","Yes","6/14/2021","6/30/2027","$61M - $76M","Right","Fairly Strong","Very Strong","6'4""","198 lbs","212","47",155,160,4,10,16,14,15,6,14,14,4,5,12,13,7,16,13,14,12,13,10,12,13,16,8,15,7,13,13,12,16,14,16,15,12,17,13,16,11,8,7,13,11,10,9,14,12,15,12,16,15,1,3,3,3,1,3,2,1,2,1,1
"4",735216,"Cristiano Ronaldo","2/5/1985 (38 years old)","ST (C)","Al-Nassr (KSA)","Saudi Professional League","POR","Yes","12/31/2022","6/30/2025","Not for Sale","Right","Fairly Strong","Very Strong","6'2""","185 lbs","669","512",160,196,10,11,13,18,15,11,18,15,5,3,13,20,5,17,6,17,13,15,12,13,20,17,18,19,3,5,12,7,12,11,13,16,20,13,13,15,9,7,5,20,17,5,7,17,12,16,14,20,17,1,2,2,2,2,1,1,2,1,4,3
"5",55041632,"Bernardo Silva","8/10/1994 (28 years old)","M/AM (RC)","Man City","English Premier Division","POR","Yes","6/14/2021","6/30/2025","Not for Sale","Left","Very Strong","Weak","5'8""","141 lbs","340","64",178,180,14,15,17,15,17,13,10,13,2,12,17,13,8,18,13,16,15,16,15,15,16,17,12,17,13,17,17,20,15,19,16,7,17,14,17,9,20,8,12,17,13,11,6,16,10,14,16,17,15,3,2,2,1,2,3,2,2,1,3,2
"6",83261910,"Nuno Mendes","6/19/2002 (20 years old)","D/WB (L)","Paris SG","Ligue 1 Uber Eats","POR","Yes","6/30/2022","6/30/2026","$131M - $198M","Left","Very Strong","Fairly Strong","5'9""","154 lbs","90","2",152,177,13,14,14,10,14,7,9,10,11,11,13,9,14,14,13,14,12,13,13,13,14,12,8,11,11,12,13,13,17,14,13,10,16,17,14,13,14,15,14,14,17,15,11,10,6,6,13,15,16,3,3,3,1,3,2,2,3,2,1,4
"7",55070299,"Rúben Dias","5/14/1997 (26 years old)","D (C)","Man City","English Premier Division","POR","Yes","8/30/2021","6/30/2027","$335M - $368M","Right","Fairly Strong","Very Strong","6'1""","182 lbs","233","12",174,177,4,11,12,6,13,5,15,4,5,17,14,8,18,13,16,17,18,15,16,15,18,8,17,8,17,16,13,17,13,13,12,16,18,13,18,16,8,16,14,18,16,16,4,16,13,8,18,18,18,1,1,1,1,3,2,3,1,4,1,4
"8",83169822,"João Félix","11/10/1999 (23 years old)","AM (RLC), ST (C)","Chelsea","English Premier Division","POR","Yes","6/14/2021","6/30/2026","$42M - $63M","Right","Fairly Strong","Very Strong","5'10""","163 lbs","167","51",153,177,11,12,17,13,17,12,12,13,4,4,16,14,7,18,14,15,11,15,13,15,13,19,7,18,6,9,16,9,13,16,13,9,14,12,12,9,8,10,10,15,15,8,9,15,14,13,11,18,14,2,3,3,1,3,2,2,2,3,3,3
"9",83111483,"Rafael Leão","6/10/1999 (24 years old)","AM (L), ST (C)","AC Milan","Italian Serie A","POR","Yes","6/2/2023","6/30/2028","$149M - $187M","Right","Strong","Very Strong","6'2""","178 lbs","169","54",167,176,8,14,17,14,16,7,11,13,7,5,14,12,6,15,9,15,8,13,11,13,14,18,9,15,6,13,14,11,17,18,16,14,16,17,12,14,12,12,9,14,13,11,8,14,7,6,13,16,12,2,1,3,3,3,1,1,3,1,2,2
"10",43124203,"Bruno Fernandes","9/8/1994 (28 years old)","M (C), AM (RC)","Man UFC","English Premier Division","POR","Yes","4/1/2022","6/30/2026","$246M - $270M","Right","Fairly Strong","Very Strong","5'10""","152 lbs","344","103",172,174,16,16,11,15,17,16,10,16,4,3,18,19,8,17,18,17,17,14,14,13,17,17,17,17,8,15,18,17,13,15,13,9,20,13,19,11,15,7,6,17,14,13,1,13,14,5,14,15,18,3,1,3,1,2,2,2,1,1,1,1
"11",83169226,"Diogo Costa","9/19/1999 (23 years old)","GK","FC Porto","Portuguese Premier League","POR","Yes","11/3/2022","6/30/2027","$47M - $72M","Right","Fairly Strong","Very Strong","6'1""","176 lbs","121","-",155,174,3,3,1,2,11,4,5,3,2,3,14,6,3,13,14,13,14,16,14,14,14,11,10,2,14,14,14,13,11,15,12,13,14,11,11,13,14,16,15,17,18,14,9,14,6,6,15,13,9,12,13,16,8,16,17,14,7,14,14,13
"12",83174762,"Vitinha","2/13/2000 (23 years old)","DM, M (C)","Paris SG","Ligue 1 Uber Eats","POR","Yes","7/1/2022","6/30/2027","$51M - $78M","Right","Reasonable","Very Strong","5'8""","145 lbs","107","12",154,168,12,11,15,9,15,10,6,13,9,13,16,10,12,16,12,15,15,15,13,15,14,13,12,15,14,16,16,15,13,16,14,6,14,13,15,11,13,14,14,16,16,16,5,13,5,5,15,14,15,2,2,2,2,3,1,3,2,3,2,3
"13",2000238881,"Thomi Montefiori","2/6/2003 (20 years old)","AM (C)","JUV","Brazilian National Second Division","ARG","No","8/11/2022","12/31/2023","$0","Right","Reasonable","Very Strong","5'9""","154 lbs","7","-",82,165,3,6,8,13,13,3,1,8,5,6,10,4,8,13,9,8,5,7,7,12,16,13,9,8,8,7,12,8,13,13,7,4,13,13,11,5,11,20,12,13,13,9,10,9,5,4,10,9,10,2,3,2,3,3,1,3,1,3,4,1
"14",2000131486,"João Veloso","6/26/2005 (17 years old)","M/AM (C)","Benfica","Portuguese Premier League","POR","Yes","6/18/2022","6/30/2025","$8.8M - $13.5M","Right","Weak","Very Strong","6'1""","160 lbs","-","-",102,168,8,9,11,10,12,8,6,12,3,8,13,8,9,13,10,11,10,11,10,12,15,15,8,12,9,11,14,11,12,12,12,7,14,13,11,11,14,18,17,18,16,14,5,12,7,8,14,15,13,2,2,2,2,4,1,1,2,3,3,3
"15",55041623,"João Cancelo","5/27/1994 (29 years old)","D/WB (RL)","FC Bayern","Bundesliga","POR","Yes","2/1/2022","6/30/2027","$53M - $67M","Right","Fairly Strong","Very Strong","6'0""","163 lbs","290","12",158,167,13,16,16,9,16,13,10,13,14,9,16,11,13,17,15,13,12,14,10,13,13,17,7,14,11,12,16,12,15,15,14,12,14,15,14,12,17,7,9,7,10,6,9,13,13,15,12,19,16,3,1,2,2,1,3,1,1,3,2,2
"16",55083779,"Diogo Jota","12/4/1996 (26 years old)","AM (RL), ST (C)","Liverpool","English Premier Division","POR","Yes","8/2/2022","6/30/2027","$84M - $105M","Right","Fairly Strong","Very Strong","5'10""","160 lbs","255","86",155,166,7,12,15,15,14,9,15,11,5,8,13,11,9,15,13,14,12,14,13,14,17,15,5,15,9,14,13,14,16,15,13,11,14,15,13,11,12,12,11,15,15,12,9,14,12,8,12,16,14,4,2,3,1,2,3,1,1,2,4,1
"17",83209468,"Gonçalo Ramos","6/20/2001 (21 years old)","ST (C)","Benfica","Portuguese Premier League","POR","Yes","10/7/2020","6/30/2025","$53M - $80M","Right","Fairly Strong","Very Strong","6'1""","176 lbs","100","45",150,166,10,10,13,15,13,8,15,11,8,7,13,11,8,14,13,14,15,13,15,15,16,13,10,16,8,16,13,15,13,14,14,13,15,14,15,12,13,16,15,16,14,16,5,13,7,5,14,13,10,1,1,1,1,4,2,1,3,1,2,1
"18",2000104450,"Rodrigo Ribeiro","4/28/2005 (18 years old)","AM (R), ST (C)","Sporting CP","Portuguese Premier League","POR","Yes","12/27/2022","6/30/2025","$11.5M - $17M","Right","Reasonable","Very Strong","6'1""","174 lbs","38","10",96,166,5,8,13,11,12,6,9,7,4,4,11,9,4,14,12,11,9,11,10,9,13,14,5,12,6,9,10,11,13,13,9,11,14,13,12,10,10,16,10,12,14,12,10,13,7,5,11,12,11,4,2,2,2,2,3,2,1,2,1,1
"19",55062009,"Ricardo Pereira","10/6/1993 (29 years old)","D (RL), WB (R)","Leicester","Sky Bet Championship","POR","Yes","2/18/2022","6/30/2026","$24M - $29M","Right","Reasonable","Very Strong","5'9""","154 lbs","244","14",137,165,9,13,13,11,12,8,9,12,7,12,13,12,15,15,11,14,13,13,12,14,14,13,12,14,14,15,14,16,13,12,13,9,10,13,13,10,16,12,15,15,14,13,14,12,9,6,14,15,12,3,4,2,1,1,3,3,1,1,1,2
"20",309147,"Pepe","2/26/1983 (40 years old)","D (C)","FC Porto","Portuguese Premier League","POR","Yes","4/23/2023","6/30/2024","$400K - $3.9M","Right","Reasonable","Very Strong","6'2""","174 lbs","513","34",154,165,6,8,10,8,11,8,15,8,8,18,12,8,16,11,17,15,18,10,14,15,18,8,20,12,15,15,10,13,11,12,12,16,13,13,14,14,8,7,3,20,17,13,14,18,19,6,16,18,16,1,3,1,2,2,2,2,3,1,2,2
"21",28122195,"Fábio Carvalho","8/30/2002 (20 years old)","M (LC), AM (RLC)","Liverpool","English Premier Division","POR","Yes","7/1/2022","6/30/2027","$22M - $28M","Right","Reasonable","Very Strong","5'7""","136 lbs","53","13",132,165,12,10,15,12,14,12,7,11,5,7,14,12,9,15,12,13,11,13,11,12,13,15,7,13,8,12,14,13,15,16,12,7,13,14,12,7,12,12,12,13,11,10,8,10,9,5,12,15,12,3,1,2,4,3,3,2,2,2,3,1
"22",55070307,"Rúben Neves","3/13/1997 (26 years old)","DM, M (C)","Wolves","English Premier Division","POR","Yes","6/14/2021","6/30/2027","$44M - $55M","Right","Reasonable","Very Strong","5'11""","176 lbs","278","30",150,165,14,13,12,11,14,14,9,15,7,11,17,16,13,16,13,15,12,15,13,14,16,11,14,11,14,16,17,15,12,13,14,11,14,11,14,12,11,12,14,19,16,16,8,13,13,6,14,14,12,3,3,3,3,2,1,3,2,1,1,2
"23",2000199219,"Gonçalo Moreira","1/3/2006 (17 years old)","AM (RL)","Benfica","Portuguese Premier League","POR","Yes","7/1/2022","6/30/2025","$3K - $30K","Right","Weak","Very Strong","5'7""","134 lbs","-","-",89,165,6,10,12,11,12,6,5,8,4,5,11,5,5,13,12,10,12,10,11,9,16,15,7,12,6,11,11,12,13,13,8,5,12,12,9,8,14,19,18,18,14,11,8,12,5,8,12,14,12,2,2,1,3,1,1,2,1,2,1,2
"24",14167329,"Lisandro Martínez","1/18/1998 (25 years old)","D (LC)","Man UFC","English Premier Division","ARG","No","7/27/2022","6/30/2027","$135M - $163M","Left","Very Strong","Reasonable","5'9""","169 lbs","148","10",155,165,6,9,11,7,14,8,14,6,12,15,15,10,16,15,17,16,17,16,14,14,17,10,13,10,16,14,14,15,13,13,14,12,15,13,15,15,13,12,8,14,14,12,7,11,14,6,15,13,14,1,2,3,4,3,1,1,1,3,3,2
"25",2000265865,"Rodrigo Mora","5/5/2007 (16 years old)","AM (LC)","FC Porto B","Portuguese Second League","POR","Yes","6/1/2023","6/30/2026","$3.6M - $7.2M","Right Only","Weak","Very Strong","5'9""","154 lbs","1","-",85,165,8,9,13,10,12,7,5,10,5,6,11,10,6,13,10,12,9,10,9,11,5,15,8,12,7,10,13,10,12,12,9,6,11,12,9,7,12,18,12,10,11,10,9,15,7,8,12,12,19,2,3,3,2,3,2,3,2,2,4,1
"26",55061470,"Nélson Semedo","11/16/1993 (29 years old)","D/WB (R)","Wolves","English Premier Division","POR","Yes","5/19/2023","6/30/2025","$49M - $75M","Right","Reasonable","Very Strong","5'10""","152 lbs","338","15",144,164,8,12,14,9,15,8,7,10,11,11,12,8,14,15,13,14,13,9,10,11,15,14,6,15,12,14,12,15,16,16,14,8,15,16,15,13,15,10,13,15,15,14,7,15,11,10,13,13,16,2,2,1,1,2,2,2,3,2,3,3
"27",55070285,"João Palhinha","7/9/1995 (27 years old)","DM, M (C)","Fulham","English Premier Division","POR","Yes","7/3/2022","6/30/2027","$98M - $118M","Right","Fairly Strong","Very Strong","6'3""","185 lbs","220","12",155,164,5,11,12,9,13,4,15,13,10,14,14,10,18,14,14,16,17,15,16,15,15,6,14,13,17,15,13,15,11,10,14,15,15,12,15,16,13,12,15,19,14,16,10,14,13,5,16,12,11,2,1,2,1,3,2,1,3,1,3,1
"28",29179717,"Pedro Neto","3/9/2000 (23 years old)","AM (RLC), ST (C)","Wolves","English Premier Division","POR","Yes","11/3/2020","6/30/2025","$86M - $103M","Left","Very Strong","Reasonable","5'8""","136 lbs","99","10",137,163,13,13,16,13,13,11,7,13,3,5,13,10,5,15,9,9,9,11,10,11,15,16,7,13,6,11,11,13,16,13,11,7,14,16,12,7,17,15,16,15,14,13,10,12,11,8,14,15,13,3,2,3,3,1,2,2,3,4,2,1
"29",83297596,"Rafael Luís","2/18/2005 (18 years old)","DM, M (C)","Benfica","Portuguese Premier League","POR","Yes","6/17/2022","6/30/2025","$6.4M - $9.8M","Left","Very Strong","Reasonable","6'2""","176 lbs","-","-",102,163,8,8,11,7,13,6,8,10,6,10,13,8,10,13,10,11,10,13,12,11,16,14,7,8,9,11,13,10,12,12,13,10,16,13,11,12,12,18,19,18,14,17,7,12,5,6,16,18,14,1,3,2,2,2,3,3,3,1,3,1
"30",2000131484,"João Rêgo","6/20/2005 (17 years old)","AM (RLC)","Benfica","Portuguese Premier League","POR","Yes","9/18/2021","6/30/2024","$5M - $7.6M","Right","Weak","Very Strong","6'0""","141 lbs","-","-",100,162,11,10,13,10,13,9,5,10,4,7,13,8,4,13,10,10,12,12,13,12,16,16,6,12,7,9,14,9,13,13,10,7,14,12,10,8,18,16,15,16,14,12,5,10,8,10,14,15,16,2,1,4,2,2,2,1,1,1,3,3
"31",83228731,"Gonçalo Inácio","8/25/2001 (21 years old)","D (C)","Sporting CP","Portuguese Premier League","POR","Yes","4/1/2022","6/30/2026","$38M - $48M","Left","Very Strong","Weak","6'2""","176 lbs","81","6",142,162,7,11,12,11,13,7,16,9,9,15,15,7,12,14,15,13,14,14,16,13,15,4,12,13,14,14,14,13,12,12,13,16,15,13,14,14,10,13,14,17,16,16,9,11,7,6,14,14,8,3,2,2,3,3,4,2,2,3,2,3
"32",83188780,"Matheus Nunes","8/27/1998 (24 years old)","M (C), AM (RC)","Wolves","English Premier Division","POR","Yes","8/17/2022","6/30/2027","$44M - $67M","Right","Fairly Strong","Very Strong","6'0""","171 lbs","129","10",149,161,13,13,15,12,14,11,10,14,8,9,13,11,11,15,15,13,16,13,17,13,15,15,8,14,14,16,14,16,14,13,13,12,17,14,16,14,14,15,13,18,17,13,3,17,13,5,15,16,14,4,3,1,2,4,1,3,1,1,1,1
"33",55027994,"André Gomes","7/30/1993 (29 years old)","M (C)","Everton","English Premier Division","POR","Yes","6/15/2020","6/30/2024","$11.5M","Right","Fairly Strong","Very Strong","6'2""","185 lbs","254","24",130,161,11,12,11,11,16,13,10,9,9,8,15,14,12,17,10,13,9,16,11,15,12,13,9,12,11,14,13,14,8,10,13,12,13,11,12,14,13,12,14,15,11,13,10,14,12,5,13,12,13,1,3,1,1,3,2,2,1,3,3,2
"34",83174759,"Fábio Vieira","5/30/2000 (23 years old)","M (C), AM (RLC)","Arsenal","English Premier Division","POR","Yes","7/1/2022","6/30/2027","$95M - $119M","Left","Very Strong","Reasonable","5'8""","141 lbs","104","18",148,160,14,14,15,12,16,14,8,13,5,6,16,13,8,17,12,14,12,15,12,15,13,15,10,14,9,13,16,14,14,15,15,6,13,14,14,9,13,12,12,15,16,16,6,15,6,5,14,12,12,3,2,1,2,1,2,1,3,4,3,2
"35",14130029,"Cristian Romero","4/27/1998 (25 years old)","D (C)","Tottenham","English Premier Division","ARG","No","8/30/2022","6/30/2027","$65M - $78M","Right","Reasonable","Very Strong","6'1""","174 lbs","156","6",148,164,5,6,9,8,13,4,16,5,4,16,12,8,18,12,18,18,15,16,12,12,16,8,12,6,13,14,11,17,13,14,14,14,15,13,14,15,8,10,9,14,14,12,8,15,15,4,15,15,16,1,2,2,2,1,2,3,3,1,1,2
"36",2000030130,"João Neves","9/27/2004 (18 years old)","DM, M/AM (C)","Benfica","Portuguese Premier League","POR","Yes","6/13/2022","6/30/2026","$46M - $69M","Right","Weak","Very Strong","5'9""","147 lbs","28","1",139,160,12,12,14,11,14,10,12,11,12,10,14,10,11,14,17,13,16,14,16,13,17,14,12,13,12,14,14,17,13,14,14,10,17,13,16,12,12,11,17,16,14,19,8,12,10,6,15,15,12,3,1,2,2,1,2,1,3,1,3,3
"37",85045409,"Raphaël Guerreiro","12/22/1993 (29 years old)","D/WB (L), DM, M (C)","Borussia Dortmund","Bundesliga","POR","Yes","6/14/2021","6/30/2026","$35M - $42M","Left","Very Strong","Weak","5'7""","156 lbs","296","41",147,159,15,15,15,11,17,16,7,14,14,9,16,12,11,17,9,15,10,16,10,13,11,16,5,16,10,12,16,10,14,15,12,6,10,12,15,9,17,16,16,10,13,12,14,15,6,8,12,10,10,3,3,3,2,3,2,3,1,2,3,1
"38",83297509,"Vasco Sousa","4/3/2003 (20 years old)","M/AM (C)","FC Porto","Portuguese Premier League","POR","Yes","8/10/2021","6/30/2025","$16.5M - $20M","Right Only","Weak","Very Strong","5'5""","123 lbs","58","2",110,159,8,11,14,11,14,6,4,9,5,8,15,10,7,14,11,12,14,13,11,13,13,16,7,12,8,12,15,12,12,12,13,6,13,12,13,8,6,18,9,10,13,10,7,10,2,6,10,10,13,1,1,1,1,2,3,3,1,3,4,3
"39",83261140,"Francisco Conceição","12/14/2002 (20 years old)","AM (R)","Ajax","Keuken Kampioen Divisie","POR","Yes","7/21/2022","6/30/2027","$7M - $11M","Left","Very Strong","Weak","5'7""","141 lbs","85","11",128,159,12,12,16,11,14,11,6,11,3,4,13,11,5,15,13,12,15,13,11,11,9,19,8,14,5,8,12,13,15,16,13,7,13,14,13,8,6,7,5,14,11,3,3,13,14,16,11,10,5,2,2,3,1,3,1,1,1,2,1,1
"40",55063493,"Rafa","5/17/1993 (30 years old)","AM (RLC)","Benfica","Portuguese Premier League","POR","Yes","6/14/2021","6/30/2024","$33M - $39M","Right","Reasonable","Very Strong","5'8""","136 lbs","312","74",156,158,11,11,16,12,15,11,5,12,5,6,14,12,9,15,13,13,11,10,11,12,13,19,10,17,7,9,15,11,18,18,15,5,16,17,13,6,10,14,10,14,12,18,7,15,6,6,12,4,8,3,3,3,1,1,1,3,4,3,3,1
"41",28127132,"Wanya Marçal-Madivádua","10/19/2002 (20 years old)","M/AM (RLC)","Leicester","Sky Bet Championship","POR","Yes","6/12/2023","6/30/2025","$18.5M - $28M","Right","Fairly Strong","Very Strong","5'11""","160 lbs","-","-",118,158,11,11,12,11,12,11,8,11,7,6,12,6,8,12,7,10,5,11,12,10,10,11,13,10,9,12,11,13,13,10,12,12,15,14,13,9,16,8,11,7,9,10,11,12,4,11,12,10,16,3,3,2,4,4,2,2,3,3,3,4
"42",2000047625,"Luís Gomes","4/24/2004 (19 years old)","AM (RL)","Sporting CP","Portuguese Premier League","POR","Yes","10/14/2020","6/30/2025","$2.9M - $5.8M","Right","Weak","Very Strong","5'8""","141 lbs","-","-",82,157,9,13,12,9,12,8,5,8,4,4,11,4,5,13,10,11,8,11,9,10,12,10,6,12,6,13,12,8,11,12,10,5,11,11,9,6,8,19,9,13,11,10,5,10,6,6,10,10,8,2,3,2,3,1,2,3,1,3,4,3
"43",744536,"Miguel Veloso","5/11/1986 (37 years old)","DM, M (C)","Hellas Verona","Italian Serie A","POR","Yes","6/14/2021","6/30/2024","$70K - $700K","Left Only","Very Strong","Weak","5'11""","174 lbs","417","25",125,157,15,11,12,7,14,16,9,14,4,12,15,13,14,15,15,15,10,14,13,14,17,11,15,9,14,14,15,12,11,11,13,10,14,10,12,10,12,12,14,19,17,12,8,13,14,8,15,16,14,3,2,3,1,2,3,3,3,3,3,1
"44",29192705,"Pedro Gonçalves","6/28/1998 (24 years old)","M (C), AM (RLC)","Sporting CP","Portuguese Premier League","POR","Yes","10/29/2021","6/30/2026","$37M - $45M","Right","Fairly Strong","Very Strong","5'9""","147 lbs","125","51",150,157,12,13,15,16,15,14,8,14,10,6,14,8,9,16,11,16,8,14,12,14,14,14,12,15,10,11,15,13,14,15,14,8,16,14,14,9,10,13,14,15,16,13,8,12,12,6,14,12,17,1,2,1,2,2,3,1,3,2,3,1
"45",83174775,"João Mário","1/3/2000 (23 years old)","D/WB/M (R)","FC Porto","Portuguese Premier League","POR","Yes","10/7/2022","6/30/2027","$30M - $38M","Right","Strong","Very Strong","5'10""","149 lbs","102","8",142,157,11,15,16,10,14,7,6,9,11,8,13,8,11,15,11,11,12,13,11,12,13,15,9,13,11,12,13,13,15,15,13,8,14,16,14,8,16,15,8,14,12,15,5,10,8,2,13,13,7,2,2,2,3,1,3,3,3,1,4,3
"46",14183207,"Julián Álvarez","1/31/2000 (23 years old)","AM (RLC), ST (C)","Man City","English Premier Division","ARG","No","3/16/2023","6/30/2028","$47M - $59M","Right","Fairly Strong","Very Strong","5'7""","154 lbs","105","42",151,162,14,11,13,15,16,13,10,14,6,5,13,13,8,15,11,13,12,14,12,14,14,17,7,15,8,16,13,16,15,14,13,7,15,13,16,13,13,8,17,14,14,12,6,14,8,5,13,14,16,1,2,2,1,1,1,2,1,2,2,3
"47",55041710,"Gonçalo Guedes","11/29/1996 (26 years old)","M (RL), AM (RLC), ST (C)","Benfica","Portuguese Premier League","POR","Yes","8/8/2022","6/30/2027","$58M - $88M","Right","Reasonable","Very Strong","5'10""","158 lbs","255","45",144,156,10,13,14,13,12,12,8,15,12,7,13,13,7,14,12,13,13,10,11,10,13,15,7,14,7,12,12,14,16,13,12,10,15,15,13,12,11,13,17,13,9,15,15,10,8,7,12,13,13,1,2,2,1,1,1,2,3,1,2,2
"48",55013032,"Danilo Pereira","9/9/1991 (31 years old)","D (C), DM, M (C)","Paris SG","Ligue 1 Uber Eats","POR","Yes","7/1/2021","6/30/2025","Not for Sale","Right","Fairly Strong","Very Strong","6'2""","182 lbs","320","31",154,156,6,8,11,8,11,7,15,12,8,14,13,12,15,12,13,14,15,14,15,13,14,9,15,13,15,15,12,14,13,12,14,15,17,13,16,17,11,18,17,18,14,14,6,13,9,9,15,15,14,3,1,3,4,2,1,1,3,3,1,3
"49",83111501,"Thierry Rendall Correia","3/9/1999 (24 years old)","D (RL), WB (R)","Valencia","Spanish First Division","POR","Yes","10/5/2021","6/30/2026","$15M - $18M","Right","Reasonable","Very Strong","5'10""","158 lbs","83","1",138,156,8,12,12,6,12,5,8,8,12,10,11,10,11,13,13,13,13,11,11,10,13,14,7,12,10,12,11,14,15,16,15,14,15,16,16,17,13,9,7,13,12,13,5,11,12,10,12,11,19,2,3,2,3,3,3,1,1,3,4,1
"50",55012106,"William Carvalho","4/7/1992 (31 years old)","DM, M (C)","Real Hispalis","Spanish First Division","POR","Yes","9/1/2022","6/30/2026","Not for Sale","Right","Fairly Strong","Very Strong","6'2""","182 lbs","333","23",150,156,8,9,14,9,15,10,11,9,7,11,15,9,16,16,12,13,13,17,18,15,12,14,15,12,17,17,17,11,10,10,18,13,13,10,15,19,9,15,16,19,15,10,9,14,8,10,10,10,14,3,1,1,3,3,3,2,2,3,1,1
"51",83320124,"Mateus Fernandes","7/10/2004 (18 years old)","M/AM (C)","Sporting CP","Portuguese Premier League","POR","Yes","10/8/2022","6/30/2027","$120K - $1.2M","Right","Reasonable","Very Strong","5'10""","158 lbs","39","2",114,156,10,12,14,10,14,8,9,10,6,8,13,8,13,14,13,8,9,12,12,12,14,12,8,12,11,13,14,13,12,13,12,8,14,12,14,7,14,12,11,12,13,11,5,12,12,7,13,12,14,3,1,1,3,1,2,3,3,2,3,2
"52",55070298,"Renato Sanches","8/18/1997 (25 years old)","DM, M (C), AM (RC)","Paris SG","Ligue 1 Uber Eats","POR","Yes","8/4/2022","6/30/2027","$9.8M - $15M","Right","Reasonable","Very Strong","5'9""","154 lbs","194","14",142,156,9,12,15,11,14,9,9,15,10,10,14,11,11,16,17,11,16,14,12,11,18,14,8,13,9,11,13,16,14,14,18,10,17,13,16,14,13,10,10,11,9,13,13,14,13,13,12,15,6,2,1,2,3,2,2,2,3,2,1,2
"53",2000009057,"Carlos Borges","3/19/2004 (19 years old)","AM (RL)","Man City","English Premier Division","POR","Yes","6/13/2022","6/30/2027","$18M - $22M","Left","Very Strong","Weak","5'7""","127 lbs","-","-",125,156,9,13,15,12,13,10,6,12,6,3,12,8,4,12,8,10,14,10,9,7,12,13,4,12,5,9,12,14,17,15,8,7,13,18,11,8,16,18,14,10,12,10,6,13,9,3,12,11,9,2,3,2,3,2,2,3,1,2,2,1
"54",55069796,"Ricardo Horta","9/15/1994 (28 years old)","AM (RLC), ST (C)","BRG","Portuguese Premier League","POR","Yes","4/5/2023","6/30/2028","$29M - $43M","Right","Reasonable","Very Strong","5'8""","138 lbs","305","88",153,155,13,13,16,15,15,13,7,14,6,5,13,14,8,16,8,12,8,14,11,13,13,17,13,17,8,11,15,12,16,15,13,7,16,15,13,7,12,14,11,15,15,16,7,14,6,6,15,14,10,2,2,3,3,1,2,2,1,1,3,2
"55",83111598,"David Carmo","7/17/1999 (23 years old)","D (C), DM","FC Porto","Portuguese Premier League","POR","Yes","7/5/2022","6/30/2027","$25M - $38M","Left","Very Strong","Reasonable","6'5""","187 lbs","95","2",138,155,6,10,10,8,12,7,13,9,11,16,13,8,12,13,13,11,16,13,12,12,14,7,13,8,14,15,13,14,10,9,14,17,15,14,14,17,8,8,13,15,8,16,12,6,15,11,12,13,10,1,1,2,3,2,1,3,3,1,2,1
"56",83152910,"Galeno","10/21/1997 (25 years old)","M/AM (RL)","FC Porto","Portuguese Premier League","POR","Yes","10/11/2022","6/30/2027","$25M - $38M","Right","Reasonable","Very Strong","5'10""","158 lbs","217","46",148,155,11,11,16,12,12,13,6,12,13,6,11,14,7,14,13,11,12,10,8,9,14,17,7,14,8,10,11,14,18,16,14,11,18,18,16,10,4,13,11,15,13,12,6,14,5,6,12,14,16,1,1,2,3,2,1,2,3,3,2,3
"57",14043349,"Ángel Correa","3/9/1995 (28 years old)","M (R), AM (RLC), ST (C)","A. Madrid","Spanish First Division","ARG","Yes","1/4/2022","6/30/2026","$40M - $48M","Right","Fairly Strong","Very Strong","5'8""","147 lbs","320","65",150,162,13,11,16,13,15,9,8,11,10,5,14,11,6,16,11,14,11,14,13,14,13,17,10,16,8,12,14,14,14,16,14,6,16,14,12,11,12,11,14,15,14,15,8,13,13,10,14,14,13,1,1,1,1,3,1,1,2,3,2,3
"58",83227945,"Vitinha","3/15/2000 (23 years old)","ST (C)","OM","Ligue 1 Uber Eats","POR","Yes","1/31/2023","6/30/2027","$57M - $68M","Right","Fairly Strong","Very Strong","6'0""","163 lbs","70","29",140,155,6,10,13,15,12,7,13,13,5,6,11,13,8,12,17,16,18,12,14,12,18,12,7,14,7,15,11,16,14,12,14,12,16,15,17,13,10,7,17,15,16,11,5,12,16,6,14,15,11,1,3,4,4,2,2,3,1,1,3,1
"59",29179241,"Erling Haaland","7/21/2000 (22 years old)","ST (C)","Man City","English Premier Division","NOR","Yes","7/1/2022","6/30/2027","Not for Sale","Left","Very Strong","Reasonable","6'5""","207 lbs","187","147",188,195,7,10,14,18,16,13,15,13,5,6,13,17,7,15,15,19,15,18,15,15,20,16,13,18,7,14,14,13,17,16,17,18,19,19,14,17,10,12,10,17,18,15,10,14,9,11,16,20,16,1,2,1,3,1,2,3,3,3,3,2
"60",53095137,"Martin Ødegaard","12/17/1998 (24 years old)","M/AM (C)","Arsenal","English Premier Division","NOR","Yes","8/20/2021","6/30/2025","$351M - $382M","Left","Very Strong","Reasonable","5'10""","149 lbs","276","47",173,180,16,15,16,13,18,14,8,17,4,10,17,14,9,18,8,18,10,16,15,17,16,16,14,17,9,18,19,15,13,16,15,9,13,13,15,11,13,18,17,19,14,14,7,13,4,6,15,16,16,3,1,3,3,3,3,3,3,3,3,3
"61",53101282,"Sander Berge","2/18/1998 (25 years old)","DM, M/AM (C)","Sheff Utd","English Premier Division","NOR","Yes","6/15/2020","6/30/2024","$12.5M - $18.5M","Right","Reasonable","Very Strong","6'5""","194 lbs","222","17",129,165,9,11,12,10,12,9,9,10,6,11,13,12,12,14,12,14,10,13,14,13,14,11,11,13,12,13,13,12,13,13,14,12,14,13,14,13,12,16,14,14,12,15,9,12,7,5,12,16,15,1,3,1,3,1,2,2,1,1,2,2
"62",2000254793,"Sverre Halseth Nypan","12/19/2006 (16 years old)","M (C), AM (RLC)","Rosenborg","Norwegian Premier Division","NOR","Yes","12/15/2022","12/31/2025","$3.3M - $6.6M","Either","Very Strong","Very Strong","5'10""","154 lbs","13","2",115,162,9,11,13,9,13,9,7,10,6,9,13,8,9,13,12,12,10,10,9,9,14,16,7,12,10,11,13,12,13,13,11,8,10,12,11,9,12,11,10,15,14,13,13,13,9,9,12,14,12,2,1,1,4,2,2,3,3,1,2,3
"63",2000020287,"Andreas Schjelderup","6/1/2004 (19 years old)","AM (L), ST (C)","Benfica","Portuguese Premier League","NOR","Yes","1/12/2023","6/30/2028","$7.4M - $9.2M","Right","Fairly Strong","Very Strong","5'9""","160 lbs","61","18",129,160,12,12,15,13,16,12,6,14,3,4,14,14,4,15,9,14,10,14,13,13,12,15,7,14,6,13,15,13,14,14,8,8,13,14,9,7,12,13,13,16,12,8,8,9,8,5,11,15,7,4,2,3,2,1,3,4,2,1,1,2
"64",2000170102,"Daniel Bassi","10/31/2004 (18 years old)","M (L), AM (RL)","Tromsø","Norwegian Premier Division","NOR","Yes","6/13/2022","12/31/2025","$70K - $700K","Right","Reasonable","Very Strong","5'10""","141 lbs","39","8",104,158,7,11,15,9,12,4,5,8,2,3,10,5,7,13,7,9,5,9,9,8,17,13,3,9,5,10,10,11,15,14,11,7,11,14,11,10,11,11,6,14,9,7,8,12,4,10,11,17,15,3,2,3,2,1,2,4,3,1,1,2
"65",2000090211,"Antonio Nusa","4/17/2005 (18 years old)","M/AM (RL)","Club Brugge","Jupiler Pro League","NOR","Yes","4/27/2023","6/30/2027","$16.5M - $21M","Right","Fairly Strong","Very Strong","5'11""","143 lbs","42","5",113,157,9,13,14,12,14,10,8,10,4,6,12,10,7,13,9,10,13,11,11,9,11,15,6,11,10,11,12,10,14,14,11,8,12,12,11,10,13,11,11,13,12,10,7,13,11,10,14,15,13,2,3,3,3,1,3,1,3,3,3,1
"66",53159880,"Sivert Mannsverk","5/8/2002 (21 years old)","DM, M (C)","Molde","Norwegian Premier Division","NOR","Yes","8/1/2021","12/31/2025","$5M - $7.6M","Right","Reasonable","Very Strong","6'1""","169 lbs","138","12",135,155,13,13,10,8,13,10,11,11,8,14,14,12,13,12,14,15,14,12,14,14,14,10,13,13,15,12,14,14,11,11,13,13,13,13,16,12,13,14,13,18,16,12,6,13,16,10,14,17,16,1,2,3,1,3,3,2,1,3,4,3
"67",53086846,"Fredrik Aursnes","12/10/1995 (27 years old)","DM, M (C)","Benfica","Portuguese Premier League","NOR","Yes","8/24/2022","6/30/2027","$19M - $29M","Right","Weak","Very Strong","5'10""","156 lbs","357","47",151,154,14,14,13,9,14,8,11,10,6,11,16,10,13,14,15,14,16,15,16,16,16,11,14,12,16,18,13,17,13,12,17,11,20,14,17,12,20,14,19,18,18,15,3,15,14,6,18,14,12,2,4,1,1,3,2,2,3,1,2,1
"68",14043255,"Guido Rodríguez","4/12/1994 (29 years old)","DM, M (C)","Real Hispalis","Spanish First Division","ARG","Yes","6/14/2021","6/30/2024","$54M - $68M","Right","Fairly Strong","Very Strong","6'1""","176 lbs","288","22",155,162,10,11,12,8,15,8,11,10,8,14,14,8,18,12,12,16,12,14,14,15,16,12,12,13,18,17,13,16,12,13,15,12,13,12,13,12,12,12,14,15,13,10,7,10,10,5,16,13,13,1,1,3,1,1,3,2,4,3,3,3
"69",2000072641,"Jakob Napoleon Romsaas","5/16/2004 (19 years old)","M (C), AM (RLC), ST (C)","Tromsø","Norwegian Premier Division","NOR","Yes","2/15/2023","6/30/2026","$2.6M - $5.4M","Right","Fairly Strong","Very Strong","5'11""","160 lbs","49","12",112,153,12,12,14,11,12,11,7,12,4,7,12,11,7,14,10,11,10,11,7,8,15,16,8,10,8,13,13,9,12,14,13,10,11,11,12,9,12,13,14,14,18,14,12,17,7,9,15,16,13,1,3,1,2,1,2,1,1,3,3,3
"70",53122155,"Leo Østigård","11/28/1999 (23 years old)","D (C)","Parthenope","Italian Serie A","NOR","Yes","7/18/2022","6/30/2026","$17.5M - $22M","Right","Weak","Very Strong","6'0""","176 lbs","143","8",140,153,6,8,7,6,11,6,18,6,12,15,11,8,15,10,17,13,17,13,12,13,16,10,11,7,14,13,10,17,13,11,14,13,15,14,15,16,10,18,12,14,12,6,5,13,17,16,16,18,14,2,3,2,2,1,1,2,3,3,1,3
"71",53110135,"Kristoffer Ajer","4/17/1998 (25 years old)","D (C), DM, M (C)","Brentford","English Premier Division","NOR","Yes","7/21/2021","6/30/2026","$33M - $41M","Right","Weak","Very Strong","6'5""","202 lbs","219","16",139,151,6,8,12,10,12,7,15,9,10,14,13,11,14,13,16,14,16,14,13,12,18,7,15,11,13,14,13,15,13,11,13,16,15,14,14,14,15,13,14,16,16,15,10,14,10,8,14,16,16,3,3,1,4,1,3,2,2,1,3,2
"72",53140581,"Markus Solbakken","7/25/2000 (22 years old)","DM, M (C)","Viking","Norwegian Premier Division","NOR","Yes","2/7/2022","12/31/2025","$3.2M - $6.4M","Right","Reasonable","Very Strong","6'0""","154 lbs","168","5",128,150,13,12,13,7,14,11,9,13,6,10,14,9,11,14,12,13,11,15,13,13,16,14,10,13,13,14,13,15,13,12,12,11,12,12,13,11,14,12,8,16,16,11,7,11,12,10,13,16,13,3,2,3,4,1,1,2,1,2,2,2
"73",2000264066,"Isak Jønvik Holmen","6/9/2007 (16 years old)","M (C)","Rosenborg","Norwegian Premier Division","NOR","Yes","7/7/2022","6/30/2025","$275K - $2.7M","Either","Very Strong","Very Strong","5'11""","145 lbs","2","-",77,150,5,3,7,7,9,6,6,8,2,13,12,2,12,9,7,6,4,9,7,13,12,10,10,9,4,7,13,12,11,9,7,5,10,9,7,5,15,13,11,11,13,11,8,4,10,3,16,11,9,3,1,3,3,3,1,3,2,3,3,1
"74",53143395,"Jørgen Strand Larsen","2/6/2000 (23 years old)","ST (C)","Vigo","Spanish First Division","NOR","Yes","9/1/2022","6/30/2028","$20M - $26M","Right","Weak","Very Strong","6'4""","174 lbs","157","43",134,150,5,6,13,13,14,6,14,12,6,8,13,12,9,14,10,14,14,13,14,13,12,14,8,15,8,13,13,14,12,14,15,14,13,15,13,16,7,13,11,11,6,4,6,11,8,6,12,17,14,3,3,1,1,2,2,3,4,3,1,3
"75",751770,"Morten Gamst Pedersen","9/8/1981 (41 years old)","M (RLC), AM (C)","Ranheim","Norwegian First Division","NOR","Yes","4/19/2023","12/31/2023","$0 - $50K","Left","Very Strong","Strong","6'0""","163 lbs","635","115",94,150,18,16,7,11,12,16,11,13,13,5,15,14,5,12,11,14,8,14,14,14,17,15,14,8,10,16,16,7,5,8,10,9,15,4,6,10,12,13,10,18,10,15,11,13,11,5,17,12,14,2,1,1,1,3,1,2,3,2,2,3
"76",53113114,"Julian Ryerson","11/17/1997 (25 years old)","D/WB (RL)","Borussia Dortmund","Bundesliga","NOR","Yes","1/17/2023","6/30/2026","$19.5M - $29M","Right","Fairly Strong","Very Strong","6'0""","189 lbs","202","14",143,148,8,12,13,8,12,8,8,9,13,13,12,8,14,13,16,12,16,12,14,12,16,12,12,12,13,17,11,16,13,13,15,10,15,13,16,13,18,12,14,15,14,10,8,13,8,8,14,14,15,3,3,3,1,2,1,1,3,3,2,2
"77",2000257869,"Filip Erik Thorvaldsen","4/15/2006 (17 years old)","AM (RL)","Vålerenga","Norwegian Premier Division","NOR","Yes","2/27/2023","12/31/2025","$1.7M - $3.5M","Right","Reasonable","Very Strong","5'9""","138 lbs","2","-",88,148,5,7,12,10,11,7,6,9,3,3,7,8,3,11,7,8,7,12,11,11,13,14,4,12,7,9,8,9,14,14,12,7,5,13,8,7,10,15,11,14,8,12,13,3,11,5,11,12,12,1,3,2,2,2,2,3,1,4,3,3
"78",53063430,"Alexander Sørloth","12/5/1995 (27 years old)","ST (C)","RB Leipzig","Bundesliga","NOR","Yes","9/22/2020","6/30/2026","$8.6M - $13M","Left","Very Strong","Fairly Strong","6'4""","198 lbs","258","76",142,148,7,7,13,15,13,10,15,12,6,6,11,13,5,13,13,13,14,14,13,13,13,10,9,12,5,15,13,13,13,13,16,16,14,15,14,16,10,7,10,14,12,14,4,14,11,5,13,13,12,2,2,1,4,2,2,2,2,4,3,2
"79",955978,"Alejandro Gómez","2/15/1988 (35 years old)","AM (LC)","Sevilla","Spanish First Division","ARG","Yes","1/26/2021","6/30/2024","$210K - $2.1M","Right","Fairly Strong","Very Strong","5'6""","149 lbs","528","97",136,161,14,15,17,12,17,13,5,16,4,4,16,14,5,17,12,14,13,12,11,14,15,17,15,14,4,13,17,11,12,15,14,5,12,10,10,7,15,14,15,14,14,9,12,14,6,12,11,15,16,1,1,1,2,3,1,1,3,1,2,3
"80",2000186500,"Elias Haug","2/18/2006 (17 years old)","D (C)","Sarpsborg","Norwegian Premier Division","NOR","Yes","1/1/2022","12/31/2024","$180K - $1.8M","Right","Reasonable","Very Strong","6'1""","165 lbs","-","-",75,147,3,4,2,7,7,1,9,6,7,12,10,2,8,9,8,10,9,8,8,14,17,5,9,3,8,7,8,8,12,10,8,10,15,12,5,8,8,10,9,12,11,11,13,7,5,6,8,10,15,1,1,2,3,4,1,3,1,2,1,3
"81",53167502,"August Mikkelsen","10/24/2000 (22 years old)","AM (RLC)","Hammarby IF","Swedish Premier Division","NOR","Yes","1/25/2023","12/31/2027","$24K - $5.8M","Right","Fairly Strong","Very Strong","5'6""","136 lbs","102","19",104,146,12,12,13,10,13,12,4,10,4,5,12,10,4,13,6,12,8,12,12,12,11,13,4,12,8,9,12,9,13,13,7,5,13,12,13,6,12,12,15,13,11,12,9,8,3,6,11,12,9,2,3,2,1,3,2,1,1,4,2,2
"82",29240362,"Daniel Karlsbakk","4/7/2003 (20 years old)","M (L), AM (RL), ST (C)","sc Heerenveen","Eredivisie","NOR","Yes","1/31/2023","6/30/2026","$4.8M - $7.2M","Right","Reasonable","Very Strong","6'4""","176 lbs","61","7",103,146,8,11,12,12,12,10,9,11,5,6,8,11,6,11,11,11,11,12,9,9,15,14,7,11,7,12,8,12,11,8,13,15,10,12,12,13,14,12,12,15,13,13,9,10,11,9,15,15,11,4,1,4,3,1,1,2,3,3,1,1
"83",2000010819,"Isak Hansen-Aarøen","8/22/2004 (18 years old)","M/AM (C)","Man UFC","English Premier Division","NOR","Yes","8/22/2021","6/30/2024","$19M - $24M","Right","Reasonable","Very Strong","5'9""","132 lbs","18","1",112,146,9,10,15,11,14,9,3,8,2,4,14,8,5,15,12,12,7,13,9,10,18,10,4,14,4,14,13,13,13,15,14,6,11,13,12,6,11,6,15,15,12,10,4,13,7,4,12,16,15,2,2,2,3,3,2,3,3,2,2,4
"84",53146811,"Hugo Vetlesen","2/29/2000 (23 years old)","M/AM (C)","Bodø/Glimt","Norwegian Premier Division","NOR","Yes","10/5/2020","12/31/2026","$130K - $1.3M","Right","Fairly Strong","Very Strong","5'9""","158 lbs","175","31",131,145,8,13,14,13,13,10,6,12,4,8,13,8,10,13,12,14,8,15,16,13,15,14,9,14,12,15,13,15,13,14,11,7,14,13,15,9,10,12,11,16,13,17,6,15,11,5,14,15,12,1,1,3,1,1,3,3,3,3,2,2
"85",53138465,"Emil Breivik","6/11/2000 (23 years old)","D (R), DM, M (C)","Molde","Norwegian Premier Division","NOR","Yes","10/22/2021","12/31/2025","$2.8M - $5.6M","Right","Reasonable","Very Strong","5'11""","180 lbs","158","15",131,145,14,13,10,10,12,14,10,14,11,13,14,12,12,12,14,14,13,14,11,12,13,11,12,13,14,12,13,14,10,10,14,12,15,12,15,13,13,10,10,14,15,14,10,10,14,11,13,12,16,1,1,2,1,3,1,1,1,4,1,3
"86",53161610,"Marcus Holmgren Pedersen","5/21/2000 (23 years old)","D/WB (RL)","Feyenoord","Eredivisie","NOR","Yes","7/1/2021","6/30/2026","$550K - $9.4M","Right Only","Weak","Very Strong","6'0""","167 lbs","142","12",128,145,8,13,12,7,11,9,7,8,10,11,13,8,13,13,14,10,14,9,10,10,13,12,7,10,11,15,10,15,16,14,8,10,16,17,15,8,12,12,11,13,12,10,6,13,12,6,11,16,15,1,1,2,1,4,3,3,3,1,2,3
"87",53052372,"Mohamed Elyounoussi","8/4/1994 (28 years old)","M (RL), AM (RLC)","Southampton","Sky Bet Championship","NOR","Yes","6/15/2020","6/30/2025","$12M - $18.5M","Right","Fairly Strong","Very Strong","5'10""","154 lbs","327","88",133,145,11,12,15,12,15,15,10,12,5,6,13,9,6,14,12,14,11,13,8,10,14,13,11,15,5,16,14,17,13,15,11,8,13,11,14,8,16,13,8,14,12,10,10,13,10,8,11,17,13,3,1,1,1,1,3,2,3,1,1,3
"88",2000221711,"Sean Nilsen-Modebe","7/21/2007 (15 years old)","ST (C)","Ull/Kisa","Norwegian Second Division Group 2","NOR","Yes","1/1/2022","12/31/2024","$500 - $7K","Left Only","Very Strong","Weak","6'0""","171 lbs","27","11",82,145,7,7,9,12,10,10,12,11,5,6,9,11,6,10,10,10,8,10,9,9,15,11,6,11,5,11,8,10,12,12,12,11,13,12,12,11,5,16,16,15,14,12,6,13,8,7,15,16,14,1,3,1,1,3,1,4,4,3,3,3
"89",53170349,"Odin Thiago Holm","1/18/2003 (20 years old)","M/AM (C)","Vålerenga","Norwegian Premier Division","NOR","Yes","6/13/2022","12/31/2025","$3.3M - $6.6M","Right","Reasonable","Very Strong","5'11""","154 lbs","90","14",116,145,9,7,14,8,13,12,9,8,5,7,13,9,8,14,9,10,9,12,10,12,18,16,9,11,9,11,13,11,14,16,14,13,12,12,12,9,9,11,8,14,12,12,13,11,5,4,13,18,8,3,3,3,4,3,1,1,1,3,2,2
"90",14048343,"Rodrigo De Paul","5/24/1994 (29 years old)","M/AM (RC)","A. Madrid","Spanish First Division","ARG","Yes","7/12/2021","6/30/2026","$57M - $72M","Right","Reasonable","Very Strong","5'11""","154 lbs","348","45",153,160,15,15,15,13,15,14,8,15,3,10,15,15,12,15,13,15,14,14,13,14,15,15,15,13,10,15,15,14,14,14,14,9,15,14,14,12,15,12,12,13,14,13,8,15,15,12,12,16,13,2,3,1,3,1,2,1,4,1,3,3
"91",28126241,"Oscar Bobb","7/12/2003 (19 years old)","M (RC), AM (RLC)","Man City","English Premier Division","NOR","Yes","2/3/2022","6/30/2026","$3.1M - $6.2M","Left","Very Strong","Reasonable","5'6""","141 lbs","-","-",115,145,12,12,14,11,13,10,4,12,5,8,13,7,8,14,10,8,9,10,10,12,13,13,12,15,12,11,13,14,15,14,12,1,5,14,8,6,15,14,10,7,12,14,15,11,11,1,13,13,15,3,2,1,1,1,3,1,1,2,2,2
"92",53116125,"Ola Solbakken","9/7/1998 (24 years old)","AM (RLC)","AS Roma","Italian Serie A","NOR","Yes","1/1/2023","6/30/2027","$1M - $2.2M","Left","Very Strong","Reasonable","6'1""","171 lbs","149","32",135,145,11,12,14,12,14,11,11,12,8,9,11,13,8,14,10,13,8,13,13,12,12,13,10,15,7,15,12,13,14,13,14,13,12,15,14,12,12,13,14,13,10,9,9,16,5,10,13,15,9,3,1,2,3,3,3,2,3,2,3,1
"93",53166991,"Emil Ceïde","9/3/2001 (21 years old)","AM (RL)","Sassuolo","Italian Serie A","NOR","Yes","7/1/2022","6/30/2026","$350K - $3.5M","Right","Reasonable","Very Strong","6'0""","154 lbs","126","15",118,145,6,10,15,7,14,7,5,10,3,4,13,7,4,16,6,7,6,12,7,9,11,17,3,15,5,7,12,7,16,16,12,5,13,15,13,8,6,12,12,14,12,9,3,8,6,4,7,12,13,2,2,3,1,3,1,2,3,2,1,3
"94",53020695,"Joshua King","1/15/1992 (31 years old)","AM (L), ST (C)","Fenerbahçe","Turkish Super League","NOR","Yes","7/13/2022","6/30/2024","$5.6M - $7.2M","Right Only","Weak","Very Strong","5'11""","163 lbs","328","65",130,145,6,7,14,13,12,10,9,13,8,4,12,12,4,14,14,13,15,15,6,13,15,15,12,15,6,12,7,14,17,14,14,10,14,17,10,14,12,14,6,15,10,8,18,12,4,7,14,13,12,2,3,1,1,3,2,4,4,2,2,1
"95",53159473,"Kristoffer Askildsen","1/9/2001 (22 years old)","DM, M (C)","Sampdoria","Italian Serie B","NOR","Yes","9/1/2020","6/30/2024","$2.1M - $4.3M","Right","Fairly Strong","Very Strong","6'3""","174 lbs","65","3",116,144,4,4,10,10,11,6,11,12,4,13,13,10,13,10,13,13,13,11,13,13,11,13,12,13,13,13,11,15,12,10,12,15,11,11,13,13,12,8,13,12,13,13,4,12,12,5,13,13,12,1,2,3,3,3,3,2,3,2,3,2
"96",53180825,"Christos Zafeiris","2/23/2003 (20 years old)","DM, M/AM (C)","Slavia Prague","Czech Third Division CFL A","NOR","Yes","1/30/2023","6/30/2027","$5M - $9.6M","Right","Fairly Strong","Very Strong","5'8""","145 lbs","94","6",117,144,13,12,10,8,13,13,7,11,7,8,14,10,9,12,12,12,7,12,10,11,15,13,9,13,10,13,13,14,13,14,9,7,12,11,14,7,14,11,11,13,15,12,6,12,11,6,13,15,12,3,3,2,3,3,4,3,3,1,1,3
"97",2000258843,"Markus Seim-Monsen","1/9/2007 (16 years old)","AM (RL), ST (C)","Stabæk","Norwegian Premier Division","NOR","Yes","6/13/2022","12/31/2025","$40K - $425K","Right","Reasonable","Very Strong","6'1""","158 lbs","12","7",85,144,8,7,13,11,11,8,12,9,5,3,9,8,2,11,7,9,8,7,9,5,8,13,8,9,4,12,8,12,14,12,10,12,14,14,6,10,9,16,10,10,12,9,10,15,14,2,18,10,20,3,3,2,4,2,3,3,3,1,2,3
"98",53049614,"Fredrik Midtsjø","8/11/1993 (29 years old)","DM, M (C)","Galatasaray","Turkish Super League","NOR","Yes","8/1/2022","6/30/2025","$700K - $7M","Right","Reasonable","Very Strong","5'9""","152 lbs","296","23",125,143,10,10,14,9,12,12,10,14,5,9,13,8,11,13,12,14,14,13,12,13,16,12,14,12,10,15,13,14,13,13,14,9,15,10,15,12,14,5,15,15,12,16,5,12,6,3,14,15,10,2,1,2,2,2,1,2,2,1,1,1
"99",53099570,"Patrick Berg","11/24/1997 (25 years old)","DM, M (C)","Bodø/Glimt","Norwegian Premier Division","NOR","Yes","8/29/2022","7/31/2027","$1.1M - $11M","Right","Weak","Very Strong","5'10""","158 lbs","214","21",139,142,13,12,10,9,13,10,9,13,7,14,14,10,13,14,15,17,11,15,14,13,16,10,15,11,17,17,14,16,11,13,14,7,18,10,15,12,11,16,16,18,15,15,6,12,9,3,16,14,12,1,2,2,3,3,2,3,1,3,3,3
"100",53139180,"Johan Hove","9/7/2000 (22 years old)","M/AM (C)","FC Groningen","Keuken Kampioen Divisie","NOR","Yes","1/17/2023","6/30/2026","$4.3M - $6.6M","Right","Reasonable","Very Strong","5'10""","158 lbs","164","31",121,141,12,12,12,11,14,12,5,12,5,12,14,10,11,13,13,13,9,11,10,11,13,13,8,14,11,12,14,14,12,12,12,10,11,12,15,10,10,8,12,13,15,12,6,5,5,4,13,13,11,3,1,2,2,3,2,4,1,1,3,3
"101",14001284,"Éver Banega","6/29/1988 (34 years old)","DM, M/AM (C)","Al-Shabab","Saudi Professional League","ARG","Yes","6/1/2023","6/30/2024","$150K - $6.8M","Right","Reasonable","Very Strong","5'9""","156 lbs","463","50",140,160,13,15,16,12,17,14,6,13,4,9,16,14,12,17,15,15,11,17,12,13,13,17,14,13,11,16,17,12,10,11,13,7,12,10,11,10,11,12,13,15,14,10,12,13,16,13,15,11,8,2,3,2,2,3,1,4,1,4,2,2
"102",53170352,"Osame Sahraoui","6/11/2001 (22 years old)","AM (LC)","sc Heerenveen","Eredivisie","NOR","Yes","1/31/2023","6/30/2026","$5.6M - $8.6M","Right","Fairly Strong","Very Strong","5'7""","143 lbs","128","17",123,141,6,10,16,9,13,9,4,11,4,6,14,5,5,14,8,8,7,13,12,14,15,18,5,12,5,12,15,13,14,18,16,4,9,12,12,7,12,13,12,12,13,12,6,10,2,4,13,15,12,1,1,1,1,2,4,1,1,4,1,2
"103",2000163579,"Aleksander Hammer Kjelsen","1/3/2006 (17 years old)","D (C)","Vålerenga","Norwegian Premier Division","NOR","Yes","10/17/2022","12/31/2025","$240K - $2.4M","Right","Reasonable","Very Strong","6'1""","165 lbs","44","-",95,141,3,5,8,4,10,3,11,4,7,13,11,5,13,11,11,8,12,10,8,11,14,7,4,6,10,8,8,12,13,12,11,14,12,13,10,12,9,14,15,13,11,12,6,16,6,3,13,14,10,1,3,2,1,1,1,3,3,3,1,1
"104",53151876,"Joshua Kitolano","8/3/2001 (21 years old)","DM, M (C)","Sparta Rotterdam","Eredivisie","NOR","Yes","8/1/2022","6/30/2026","$6.4M - $9.8M","Right","Reasonable","Very Strong","5'5""","138 lbs","149","12",120,140,10,10,13,8,13,10,6,8,8,11,13,14,10,13,15,11,12,12,12,12,14,13,8,13,11,16,11,16,13,14,10,7,15,13,16,9,16,18,13,13,13,9,5,12,8,6,12,10,14,1,2,2,3,3,2,2,3,2,1,3
"105",2000178594,"Gustav Kjølstad Nyheim","2/13/2006 (17 years old)","M (C), AM (LC), ST (C)","Molde","Norwegian Premier Division","NOR","Yes","8/1/2021","6/30/2024","$300K - $3M","Right","Reasonable","Very Strong","6'1""","171 lbs","10","4",88,140,10,10,11,10,12,11,7,10,4,5,10,10,5,12,7,11,8,12,8,9,16,14,9,11,6,11,11,9,11,11,12,13,14,11,11,10,10,12,11,14,14,14,5,6,10,6,16,19,12,1,3,3,3,3,1,2,1,1,2,1
"106",53167331,"Tobias Gulliksen","7/9/2003 (19 years old)","M (C), AM (RLC)","Strømsgodset","Norwegian Premier Division","NOR","Yes","6/13/2022","12/31/2025","$250K - $2.5M","Right","Fairly Strong","Very Strong","5'10""","154 lbs","90","13",120,140,11,11,13,9,13,11,5,12,2,9,12,9,11,13,12,12,11,12,12,12,15,12,7,12,11,10,13,15,13,14,12,7,9,12,14,8,7,10,12,17,15,10,5,11,11,7,14,16,12,2,1,2,3,3,2,1,2,3,3,1
"107",91176250,"Noah Jean Holm","5/23/2001 (22 years old)","AM (RL), ST (C)","Rosenborg","Norwegian Premier Division","NOR","Yes","8/1/2021","12/31/2024","$425K - $4.3M","Right","Reasonable","Very Strong","6'1""","191 lbs","54","7",117,140,5,7,11,12,11,7,13,12,9,8,10,11,7,11,14,11,12,13,10,9,16,10,7,11,8,11,9,11,13,12,14,15,13,14,13,16,10,13,11,13,12,11,7,13,12,6,12,14,12,2,1,2,3,3,1,3,1,1,2,2
"108",53145323,"Håkon Evjen","2/14/2000 (23 years old)","M (RC), AM (RLC)","Brøndby IF","3F Superliga","NOR","Yes","1/17/2023","6/30/2027","$180K - $1.8M","Left","Very Strong","Weak","5'10""","145 lbs","143","24",122,140,7,11,15,12,14,7,9,12,7,9,13,8,12,14,12,12,7,12,11,9,14,14,5,13,9,12,13,14,15,14,10,5,12,14,12,6,13,12,9,15,10,12,5,7,3,4,10,13,9,2,2,3,2,2,2,1,2,1,2,1
"109",53126110,"Kristian Thorstvedt","3/13/1999 (24 years old)","M/AM (C)","Sassuolo","Italian Serie A","NOR","Yes","7/8/2022","6/30/2027","$600K - $6.2M","Left","Very Strong","Fairly Strong","6'2""","185 lbs","175","40",126,140,7,7,11,12,12,12,13,12,5,8,13,12,9,14,13,14,15,14,13,14,12,13,12,13,9,15,14,13,11,11,14,14,14,11,14,14,12,12,12,13,13,14,11,12,9,4,11,12,12,1,3,3,3,3,3,3,1,3,3,1
"110",53126104,"Emil Bohinen","3/12/1999 (24 years old)","DM, M (C)","Salernitana","Italian Serie A","NOR","Yes","7/1/2022","6/30/2026","$210K - $7.2M","Left","Very Strong","Reasonable","6'2""","178 lbs","163","14",126,140,13,13,14,8,15,11,14,12,4,6,15,12,13,14,10,12,8,12,12,12,12,14,6,12,13,14,14,10,12,13,15,14,10,12,12,15,10,9,14,15,13,14,10,12,10,7,11,15,9,2,3,2,1,2,2,4,2,1,3,1
"111",766626,"Tarik","2/23/1988 (35 years old)","M (LC), AM (RLC), ST (C)","Shonan","J1 League","NOR","Yes","1/1/2022","1/31/2024","$22K - $230K","Right","Reasonable","Very Strong","5'8""","145 lbs","401","89",114,140,10,9,9,8,14,10,9,6,10,7,11,15,9,13,14,13,14,13,13,14,15,13,11,12,8,14,11,8,12,13,11,8,12,13,8,11,12,10,13,16,11,11,11,13,6,8,11,10,14,3,2,1,3,2,1,2,3,1,3,3
"112",14044150,"Paulo Dybala","11/15/1993 (29 years old)","AM (RC), ST (C)","AS Roma","Italian Serie A","ARG","Yes","7/20/2022","6/30/2025","$10M - $15.5M","Left","Very Strong","Reasonable","5'10""","174 lbs","364","132",157,177,15,15,17,16,17,17,11,17,4,4,17,16,3,19,9,16,9,12,11,14,14,18,11,14,4,14,17,12,14,18,18,7,10,13,11,11,13,14,13,15,12,12,17,11,5,12,13,13,14,3,1,2,2,2,1,2,2,4,3,2
"113",14030119,"Gerónimo Rulli","5/20/1992 (31 years old)","GK","Ajax","Eredivisie","ARG","Yes","1/6/2023","6/30/2026","Not for Sale","Right Only","Weak","Very Strong","6'2""","185 lbs","294","-",141,159,2,1,3,2,9,7,5,1,1,3,12,1,2,13,8,13,15,12,13,11,11,2,11,2,13,14,10,11,11,15,7,14,15,10,13,12,15,8,13,20,10,18,5,13,8,5,13,15,14,13,14,18,14,18,15,13,10,12,14,13
"114",2000015844,"Filip Rønningen Jørgensen","5/27/2002 (21 years old)","DM, M (C)","Odd","Norwegian Premier Division","NOR","Yes","8/1/2020","12/31/2024","$400K - $3.9M","Right","Weak","Very Strong","5'10""","163 lbs","111","10",112,140,13,11,12,9,13,10,8,10,7,10,13,10,11,13,12,13,11,13,12,13,15,9,10,13,11,13,13,13,11,13,13,9,13,11,12,11,12,12,11,15,14,12,5,12,10,10,15,16,12,3,2,2,1,2,3,1,4,3,3,2
"115",8718372,"Manuel Neuer","3/27/1986 (37 years old)","GK","FC Bayern","Bundesliga","GER","Yes","5/23/2022","6/30/2024","$12M - $18M","Right","Fairly Strong","Very Strong","6'4""","205 lbs","501","-",162,193,2,6,12,7,13,8,10,7,12,9,16,13,11,13,12,13,14,18,13,14,18,12,17,13,16,12,16,12,9,14,14,18,19,10,12,16,5,18,12,15,20,18,12,17,4,13,16,16,8,17,20,15,8,15,18,14,18,14,15,15
"116",28124579,"Jamal Musiala","2/26/2003 (20 years old)","M (C), AM (RLC)","FC Bayern","Bundesliga","GER","Yes","3/5/2021","6/30/2026","$111M - $139M","Right","Fairly Strong","Very Strong","6'0""","158 lbs","100","25",157,185,7,8,19,13,16,7,8,13,5,9,15,11,11,18,12,14,12,14,12,14,16,18,6,14,10,15,15,15,14,17,16,10,14,16,12,9,16,18,16,17,13,14,7,16,6,4,13,19,18,2,3,1,2,4,3,1,1,2,1,3
"117",92039023,"Joshua Kimmich","2/8/1995 (28 years old)","D/WB (R), DM, M (C)","FC Bayern","Bundesliga","GER","Yes","8/23/2021","6/30/2025","$230M - $253M","Right","Fairly Strong","Very Strong","5'10""","165 lbs","286","28",176,183,15,16,12,10,16,15,10,15,14,12,18,14,13,16,15,15,14,17,13,14,20,13,17,12,12,18,18,20,12,12,15,10,20,12,20,11,19,10,12,20,15,16,4,15,12,8,16,20,12,3,2,3,3,3,3,1,3,3,2,1
"118",35017428,"Marc-André ter Stegen","4/30/1992 (31 years old)","GK","Barcelona","Spanish First Division","GER","Yes","6/14/2021","6/30/2025","Not for Sale","Right","Strong","Very Strong","6'2""","187 lbs","381","-",175,183,7,3,2,3,13,9,7,1,2,2,17,7,1,14,11,17,15,18,15,13,18,5,14,1,12,14,9,10,14,14,16,16,15,11,13,15,16,11,14,18,17,14,8,15,6,5,17,18,16,17,18,18,10,15,19,14,12,15,15,13
"119",91151081,"Kai Havertz","6/11/1999 (24 years old)","M/AM (C), ST (C)","Chelsea","English Premier Division","GER","Yes","9/3/2020","6/30/2028","$75M - $90M","Left","Very Strong","Reasonable","6'3""","185 lbs","209","55",155,180,10,10,14,11,18,11,14,11,8,8,16,12,10,17,11,15,11,12,10,14,10,15,7,15,11,15,17,13,14,13,13,14,16,15,15,14,16,17,15,15,14,12,4,13,8,5,10,14,12,1,3,2,2,3,3,1,3,1,2,1
"120",35007944,"Mats Hummels","12/16/1988 (34 years old)","D (C)","Borussia Dortmund","Bundesliga","GER","Yes","5/24/2023","6/30/2024","$950K - $9.6M","Right","Fairly Strong","Very Strong","6'3""","207 lbs","459","35",152,177,4,11,11,8,14,7,16,9,8,15,16,12,17,15,13,16,16,17,15,14,16,13,16,9,16,15,16,12,9,9,16,16,15,12,11,16,7,16,18,18,14,16,13,17,8,10,16,13,6,1,2,1,1,3,2,3,3,3,2,3
"121",156772,"Toni Kroos","1/4/1990 (33 years old)","DM, M (C)","R. Madrid","Spanish First Division","GER","Yes","6/14/2021","6/30/2025","$13.5M - $21M","Right","Strong","Very Strong","6'0""","167 lbs","459","48",160,176,19,18,13,13,18,14,7,17,8,8,20,13,9,16,9,16,9,18,14,17,10,11,12,15,13,16,18,10,10,10,12,10,12,11,11,13,13,17,18,17,14,10,7,14,10,7,13,14,8,3,2,3,4,1,2,1,3,1,1,1
"122",35002579,"Jérôme Boateng","9/3/1988 (34 years old)","D (C)","OL","Ligue 1 Uber Eats","GER","Yes","9/1/2021","6/30/2025","$28K - $275K","Right","Fairly Strong","Very Strong","6'4""","207 lbs","386","6",126,175,3,8,9,6,13,5,13,6,12,14,16,6,13,13,14,15,13,16,13,12,11,10,14,7,14,12,15,10,9,8,14,16,10,12,8,16,10,8,12,10,12,14,14,16,9,18,10,10,7,2,2,2,1,3,1,4,1,2,2,3
"123",35011448,"Thomas Müller","9/13/1989 (33 years old)","M/AM (RC), ST (C)","FC Bayern","Bundesliga","GER","Yes","5/3/2022","6/30/2024","$24M - $37M","Right","Fairly Strong","Very Strong","6'1""","167 lbs","477","160",157,174,11,16,11,12,14,8,14,11,7,9,15,13,11,13,15,18,14,16,15,14,18,12,17,18,11,19,16,17,12,12,16,13,18,13,16,11,16,10,10,16,19,20,8,14,11,10,13,17,7,1,2,1,1,3,2,3,3,3,2,3
"124",2000025301,"Marco Pellegrino","7/18/2002 (20 years old)","D (C)","Platense","Argentine Premier Division","ARG","Yes","5/4/2023","12/31/2025","$4.4M - $8.6M","Left Only","Very Strong","Weak","6'1""","174 lbs","19","1",123,159,4,11,12,8,11,7,13,4,9,15,13,6,14,12,11,13,13,12,13,12,12,7,9,11,14,13,12,12,13,12,11,13,12,12,12,14,11,13,12,12,11,10,5,10,9,8,10,10,18,2,1,2,1,3,1,2,3,2,3,1
"125",91138280,"Leroy Sané","1/11/1996 (27 years old)","M (RL), AM (RLC)","FC Bayern","Bundesliga","GER","Yes","6/14/2021","6/30/2025","$124M - $189M","Left","Very Strong","Reasonable","6'0""","176 lbs","233","57",167,172,14,12,18,13,15,16,8,17,7,7,15,11,8,17,13,15,11,15,12,14,12,16,7,14,8,12,15,11,17,16,15,10,14,18,13,11,13,7,9,12,12,10,7,12,7,13,13,16,11,1,2,1,1,4,3,2,2,3,2,3
"126",35017438,"Mario Götze","6/3/1992 (31 years old)","M (C), AM (RLC)","Eintracht Frankfurt","Bundesliga","GER","Yes","6/2/2023","6/30/2026","Not for Sale","Right","Reasonable","Very Strong","5'9""","165 lbs","310","69",145,171,14,12,13,11,18,13,8,11,6,9,16,12,10,17,13,15,10,17,14,14,12,14,13,12,10,15,16,16,12,13,15,7,15,11,16,9,15,10,10,15,11,12,12,16,5,13,13,12,7,2,2,1,2,2,1,4,1,1,2,2
"127",91013383,"Marco Reus","5/31/1989 (34 years old)","M (C), AM (RLC)","Borussia Dortmund","Bundesliga","GER","Yes","4/27/2023","6/30/2024","$8.4M - $10.5M","Right","Fairly Strong","Very Strong","5'11""","156 lbs","414","158",150,170,14,13,13,14,16,16,8,15,7,8,15,13,9,16,14,16,12,16,14,13,16,15,13,16,10,15,15,15,13,14,15,8,14,12,12,9,16,10,10,18,15,20,15,14,7,12,12,16,9,3,2,1,4,1,3,2,2,3,2,3
"128",91104807,"Leon Goretzka","2/6/1995 (28 years old)","DM, M/AM (C)","FC Bayern","Bundesliga","GER","Yes","9/16/2021","6/30/2026","$87M - $109M","Right","Reasonable","Very Strong","6'2""","180 lbs","273","43",158,170,8,10,12,11,15,10,16,14,8,12,15,11,15,15,14,16,16,14,14,14,18,12,14,17,13,16,14,17,12,11,15,16,12,15,17,17,19,8,14,16,15,15,13,14,9,11,13,16,12,1,2,2,1,2,2,3,3,2,1,2
"129",2000175080,"Dennis Seimen","12/1/2005 (17 years old)","GK","VfB Stuttgart","Bundesliga","GER","Yes","10/13/2021","6/30/2027","$55K - $550K","Left Only","Very Strong","Weak","6'4""","180 lbs","4","-",103,169,1,2,2,3,11,4,5,1,2,1,11,11,3,11,15,10,12,11,10,10,18,8,13,2,12,11,11,14,9,12,12,16,15,9,10,11,12,10,12,17,17,16,5,15,11,3,16,17,7,11,16,14,7,13,10,12,12,11,11,13
"130",92088306,"Nico Schlotterbeck","12/1/1999 (23 years old)","D (LC)","Borussia Dortmund","Bundesliga","GER","Yes","7/1/2022","6/30/2027","$51M - $78M","Left","Very Strong","Weak","6'3""","189 lbs","116","11",147,167,3,10,13,8,12,6,15,12,14,14,15,9,16,13,16,13,17,15,12,13,18,13,12,10,14,15,14,17,13,12,15,16,13,14,13,16,14,10,9,13,12,12,7,13,10,8,14,17,9,2,1,4,1,3,3,1,1,1,3,1
"131",91003875,"İlkay Gündoğan","10/24/1990 (32 years old)","DM, M/AM (C)","Man City","English Premier Division","GER","Yes","6/14/2021","6/30/2025","Not for Sale","Right","Fairly Strong","Very Strong","5'11""","176 lbs","344","61",167,167,10,11,14,13,17,15,7,12,6,11,16,14,13,16,15,17,13,16,14,14,15,13,14,16,13,16,16,15,14,16,14,10,13,13,16,13,14,14,16,18,16,7,9,16,8,6,17,17,13,1,1,1,1,2,2,1,3,4,2,2
"132",92023410,"Antonio Rüdiger","3/3/1993 (30 years old)","D (C)","R. Madrid","Spanish First Division","GER","Yes","6/2/2022","6/30/2026","$89M - $135M","Right","Reasonable","Very Strong","6'3""","187 lbs","310","14",163,166,5,10,10,7,10,9,15,8,14,15,12,7,17,11,18,15,18,13,14,16,17,9,18,8,14,13,10,15,17,9,17,15,15,16,16,18,13,11,9,15,13,9,14,12,14,15,16,17,15,1,2,1,3,3,1,3,1,2,2,1
"133",16279486,"Karim Adeyemi","1/18/2002 (21 years old)","AM (RL), ST (C)","Borussia Dortmund","Bundesliga","GER","Yes","7/1/2022","6/30/2027","$84M - $127M","Left","Very Strong","Fairly Strong","5'11""","165 lbs","126","47",143,165,11,9,15,12,12,9,8,8,6,6,10,13,7,13,16,10,12,10,8,9,16,14,4,12,6,10,10,15,19,16,8,10,12,19,11,9,10,7,8,12,10,12,12,14,12,13,10,16,9,2,3,3,1,3,1,3,2,2,2,2
"134",28066083,"Serge Gnabry","7/14/1995 (27 years old)","M/AM (RL), ST (C)","FC Bayern","Bundesliga","GER","Yes","7/16/2022","6/30/2026","$92M - $115M","Right","Strong","Very Strong","5'9""","169 lbs","217","82",158,165,12,11,15,15,14,12,11,15,6,8,13,13,9,15,11,16,12,14,11,13,12,15,6,17,8,12,14,12,15,15,15,8,12,15,12,12,16,13,14,11,10,14,12,14,6,13,12,15,12,3,2,1,3,3,3,2,2,3,3,1
"135",14004589,"Nicolás Otamendi","2/12/1988 (35 years old)","D (C)","Benfica","Portuguese Premier League","ARG","No","6/9/2023","6/30/2025","Not for Sale","Right","Fairly Strong","Very Strong","6'0""","178 lbs","377","25",158,159,5,9,11,10,13,6,15,6,11,18,13,10,16,12,17,18,20,14,15,13,18,6,20,13,14,18,13,18,9,13,16,13,18,10,16,15,9,12,14,15,19,7,3,14,16,12,15,18,16,1,2,2,1,1,2,2,4,2,1,2
"136",2000188173,"Assan Ouédraogo","5/9/2006 (17 years old)","M (C), AM (LC)","Schalke 04","Bundesliga 2","GER","Yes","11/9/2022","6/30/2027","$11M - $13.5M","Right","Reasonable","Very Strong","6'3""","185 lbs","-","-",103,165,3,8,14,11,13,7,11,13,6,8,13,10,9,14,10,9,10,9,10,8,16,15,8,11,8,11,12,12,12,14,12,13,14,12,12,10,16,16,14,15,13,18,6,13,4,4,14,15,8,1,3,3,2,1,2,4,2,1,2,2
"137",91193048,"Florian Wirtz","5/3/2003 (20 years old)","M (C), AM (RLC)","Bayer 04","Bundesliga","GER","Yes","6/23/2022","6/30/2027","$75M - $114M","Right","Fairly Strong","Very Strong","5'10""","156 lbs","77","14",148,164,14,12,16,12,16,12,7,12,4,8,16,11,10,17,12,13,13,15,12,13,16,17,8,13,8,13,16,14,14,16,12,7,12,15,13,8,14,12,12,16,18,12,9,16,7,4,14,16,14,3,1,3,2,2,3,3,2,3,2,1
"138",91206164,"Malick Thiaw","8/8/2001 (21 years old)","D (C)","AC Milan","Italian Serie A","GER","Yes","8/29/2022","6/30/2027","$58M - $88M","Right","Fairly Strong","Very Strong","6'4""","196 lbs","80","3",145,163,5,8,11,7,12,6,14,7,12,14,13,10,16,12,14,14,15,14,14,13,16,7,13,8,14,12,12,13,13,11,15,16,15,14,14,14,10,14,17,16,15,15,6,14,11,5,14,15,16,2,1,1,2,3,2,3,2,1,3,1
"139",92012109,"Bernd Leno","3/4/1992 (31 years old)","GK","Fulham","English Premier Division","GER","Yes","8/2/2022","6/30/2025","Not for Sale","Right","Weak","Very Strong","6'3""","182 lbs","427","-",145,163,3,2,1,2,10,5,6,1,1,1,10,4,3,9,8,14,14,12,14,10,12,4,9,6,13,16,7,12,13,16,14,14,14,10,12,12,1,15,14,15,12,14,8,14,4,8,13,12,12,12,16,17,12,17,15,15,13,13,14,14
"140",2000074825,"Youssoufa Moukoko","11/20/2004 (18 years old)","ST (C)","Borussia Dortmund","Bundesliga","GER","Yes","1/1/2023","6/30/2026","$92M - $111M","Left","Very Strong","Fairly Strong","5'10""","158 lbs","58","13",125,163,7,8,13,15,15,11,10,11,4,5,11,13,5,15,11,12,10,12,9,9,13,15,7,15,5,10,11,12,15,15,12,8,12,15,11,11,13,14,12,12,12,12,11,10,6,13,10,18,12,3,2,3,1,2,1,3,3,1,1,1
"141",92051583,"Timo Werner","3/6/1996 (27 years old)","AM (L), ST (C)","RB Leipzig","Bundesliga","GER","Yes","8/9/2022","6/30/2026","$30M - $38M","Right","Fairly Strong","Very Strong","5'11""","165 lbs","310","111",147,161,5,9,13,12,12,8,13,12,6,6,11,16,7,12,14,16,11,11,9,11,12,12,8,16,6,14,11,16,18,14,12,11,14,17,15,11,12,14,10,12,7,13,10,11,5,8,10,16,8,3,3,2,3,3,1,1,1,2,1,3
"142",2000138516,"Paul Wanner","12/23/2005 (17 years old)","M/AM (RC)","FC Bayern","Bundesliga","GER","Yes","1/31/2022","6/30/2024","$130K - $1.3M","Left","Very Strong","Reasonable","6'1""","158 lbs","11","-",106,161,12,9,13,10,14,12,7,10,6,7,13,12,7,15,8,9,7,12,10,9,12,16,4,10,7,10,13,9,13,14,10,10,13,14,10,7,16,17,14,12,11,12,6,13,4,7,12,14,8,1,1,1,3,2,1,1,2,3,2,1
"143",91013409,"Shkodran Mustafi","4/17/1992 (31 years old)","D (C)","Levante","Spanish Second Division","GER","Yes","6/30/2021","6/30/2023","$16K - $50K","Right","Weak","Very Strong","6'0""","180 lbs","243","17",123,161,5,8,10,6,12,4,15,6,11,14,11,6,13,12,16,14,16,10,10,11,13,6,10,8,14,15,10,16,12,11,13,15,8,12,11,15,11,10,14,12,7,12,15,8,12,8,10,8,13,3,1,3,3,3,2,1,3,3,3,2
"144",2000257651,"Noah Darvich","9/25/2006 (16 years old)","M (C), AM (RLC)","SC Freiburg","Bundesliga","GER","Yes","6/13/2022","6/30/2025","$400K - $3.9M","Left","Very Strong","Weak","6'0""","154 lbs","-","-",100,160,12,9,14,10,13,12,8,10,4,6,13,12,7,15,8,9,8,11,10,11,14,17,12,12,7,11,12,10,12,13,12,10,14,12,10,9,12,12,13,16,13,10,6,14,4,5,14,17,10,2,2,2,2,2,1,1,1,1,2,2
"145",2000071246,"Linus Gechter","2/27/2004 (19 years old)","D (C), DM","Braunschweig","Bundesliga 2","GER","Yes","3/17/2022","6/30/2025","$8.2M - $12.5M","Right","Reasonable","Very Strong","6'3""","182 lbs","22","1",108,160,3,7,11,6,12,3,12,6,6,12,13,5,12,13,11,11,12,13,12,10,13,10,11,9,13,14,12,12,12,12,13,13,10,13,12,12,12,16,15,14,11,15,10,11,4,6,12,13,7,2,2,2,3,1,1,2,2,1,1,1
"146",14241914,"Alan Varela","7/4/2001 (21 years old)","DM, M (C)","Boca","Argentine Premier Division","ARG","No","8/4/2022","12/31/2026","$8.6M - $13M","Right","Reasonable","Very Strong","5'9""","158 lbs","79","-",141,158,4,8,12,7,14,8,8,12,3,14,14,13,14,14,12,14,14,13,13,14,14,14,12,13,14,16,14,15,14,14,14,7,16,13,15,12,10,14,14,12,14,16,6,14,10,6,14,12,15,3,2,1,1,3,1,4,2,4,2,1
"147",28113827,"Felix Nmecha","10/10/2000 (22 years old)","DM, M/AM (C)","VfL Wolfsburg","Bundesliga","GER","Yes","7/1/2021","6/30/2027","$26M - $33M","Right","Reasonable","Very Strong","6'2""","160 lbs","46","3",140,160,12,11,15,11,15,12,13,12,6,10,15,12,12,16,13,12,12,14,12,13,13,16,5,13,11,12,15,13,13,13,15,14,13,15,14,13,13,9,11,8,11,8,8,12,8,16,13,16,12,2,3,3,2,2,3,2,1,3,2,1
"148",91107360,"Niklas Süle","9/3/1995 (27 years old)","D (RC)","Borussia Dortmund","Bundesliga","GER","Yes","7/1/2022","6/30/2026","$39M - $59M","Right","Fairly Strong","Very Strong","6'5""","218 lbs","257","15",154,159,3,12,12,8,12,5,15,12,11,15,14,8,15,13,11,14,15,15,14,13,14,12,12,11,15,12,13,12,12,10,17,17,12,16,13,18,12,12,10,9,12,9,9,16,8,13,14,12,6,1,3,3,1,1,2,3,2,3,2,1
"149",91119265,"Julian Brandt","5/2/1996 (27 years old)","M/AM (RLC)","Borussia Dortmund","Bundesliga","GER","Yes","4/11/2023","6/30/2026","$66M - $79M","Right","Fairly Strong","Very Strong","6'1""","182 lbs","293","59",154,158,14,13,15,12,17,14,7,14,6,8,16,11,8,17,8,13,10,15,12,13,11,16,7,13,8,12,16,12,13,15,12,10,12,14,15,10,15,20,17,14,12,12,9,13,4,4,13,11,6,3,1,3,1,2,2,1,1,2,1,3
"150",91208050,"Kevin Schade","11/27/2001 (21 years old)","AM (RLC), ST (C)","Brentford","English Premier Division","GER","Yes","6/13/2022","6/30/2027","$20M - $30M","Right","Fairly Strong","Very Strong","6'0""","160 lbs","77","16",137,157,9,12,14,12,13,6,13,9,3,5,13,11,5,14,12,12,11,10,10,11,13,14,4,13,4,11,11,12,16,13,11,12,12,16,13,9,12,17,9,12,13,10,8,12,5,4,12,15,12,2,2,2,2,4,2,1,3,3,2,3
"151",8708271,"Lukas Podolski","6/4/1985 (38 years old)","AM (C), ST (C)","Górnik","PKO Bank Polski Ekstraklasa","GER","Yes","5/19/2023","6/30/2025","Not for Sale","Left","Very Strong","Reasonable","6'0""","194 lbs","525","170",109,156,10,13,11,15,14,14,8,14,9,5,16,17,5,15,8,14,11,18,7,14,14,9,8,10,6,15,14,6,8,10,14,10,9,10,8,13,14,10,4,12,18,17,11,18,14,17,12,12,16,2,1,1,2,2,1,3,1,3,3,3
"152",92021718,"Emre Can","1/12/1994 (29 years old)","D (C), DM, M (C)","Borussia Dortmund","Bundesliga","GER","Yes","7/1/2020","6/30/2026","$36M - $55M","Right","Reasonable","Very Strong","6'1""","189 lbs","306","30",147,155,8,8,12,10,14,10,14,14,11,13,15,16,16,15,17,13,16,15,12,12,17,13,14,11,13,13,13,16,12,10,16,13,14,16,15,16,17,9,8,12,10,10,12,10,13,12,13,13,12,1,1,1,2,3,1,2,1,3,3,2
"153",37041773,"Robin Gosens","7/5/1994 (28 years old)","D/WB/M (L)","Inter","Italian Serie A","GER","Yes","8/5/2022","6/30/2026","$12.5M - $15M","Left","Very Strong","Reasonable","6'0""","167 lbs","267","35",142,154,8,13,11,13,12,6,16,12,14,11,12,11,14,12,16,15,16,12,12,13,17,10,13,17,11,15,12,17,13,12,15,14,14,15,16,13,12,12,14,17,15,12,10,15,12,5,14,15,12,3,2,2,2,2,1,1,3,3,3,3
"154",91175868,"Yann Aurel Bisseck","11/29/2000 (22 years old)","D (C)","AGF","3F Superliga","GER","Yes","7/1/2022","12/31/2024","$5.8M - $8.6M","Right Only","Weak","Very Strong","6'5""","191 lbs","107","9",132,154,4,9,10,7,10,4,14,13,11,13,11,5,15,12,10,13,15,13,10,13,14,11,10,12,15,13,9,13,11,11,14,17,15,14,12,16,11,16,14,10,15,13,6,16,8,5,13,13,7,3,1,1,1,2,2,3,3,3,3,3
"155",91195878,"Luca Netz","5/15/2003 (20 years old)","D/WB (L)","Borussia M'gladbach","Bundesliga","GER","Yes","7/1/2021","6/30/2026","$12.5M - $19M","Left","Very Strong","Reasonable","6'0""","182 lbs","60","2",123,154,14,13,12,8,12,12,8,9,12,10,12,8,11,13,8,12,12,12,10,11,15,13,7,13,11,13,12,13,14,13,12,11,14,15,14,12,14,17,15,15,12,14,8,12,3,6,12,15,8,1,3,2,2,3,1,2,3,3,1,2
"156",91188349,"Noah Atubolu","5/25/2002 (21 years old)","GK","SC Freiburg","Bundesliga","GER","Yes","6/13/2022","6/30/2027","$11M - $13.5M","Right Only","Weak","Very Strong","6'3""","211 lbs","81","-",120,154,2,1,2,2,11,7,7,2,9,2,12,3,1,11,13,11,13,12,12,12,16,8,12,4,13,12,11,12,8,13,13,17,13,9,10,14,1,15,10,16,12,18,5,12,4,7,16,16,7,12,15,15,8,13,13,12,12,12,11,13
"157",2000051578,"Facundo Buonanotte","12/23/2004 (18 years old)","M (R), AM (RLC)","Brighton","English Premier Division","ARG","Yes","1/1/2023","6/30/2026","$101M - $153M","Left","Very Strong","Reasonable","5'9""","145 lbs","45","5",131,158,11,11,14,13,14,11,9,14,8,9,13,13,11,14,12,11,12,14,13,11,14,14,10,14,8,13,13,14,14,14,14,7,13,12,14,10,9,13,10,11,12,11,8,13,7,7,14,9,12,1,2,1,2,3,4,3,3,2,3,1
"158",2000171001,"Tarek Buchmann","2/28/2005 (18 years old)","D (C)","FC Bayern II","German Regional Division Bavaria","GER","Yes","6/13/2022","6/30/2025","$4.4M - $8.4M","Right","Reasonable","Very Strong","6'2""","171 lbs","-","-",99,154,2,7,10,6,11,2,13,6,3,12,12,6,12,12,12,10,12,13,11,9,15,10,12,8,12,12,11,12,12,11,12,14,10,13,10,12,8,16,16,15,12,12,10,12,3,4,13,15,12,2,2,1,2,3,3,1,1,1,1,3
"159",5127684,"Ron-Robert Zieler","2/12/1989 (34 years old)","GK","Hannover","Bundesliga 2","GER","Yes","4/5/2023","6/30/2024","$190K - $1.9M","Right Only","Weak","Very Strong","6'2""","180 lbs","370","-",127,153,4,3,2,2,9,7,6,3,1,2,10,2,3,9,13,13,13,13,12,12,13,6,15,2,16,11,9,9,9,15,12,15,17,9,11,12,13,15,12,15,12,16,5,16,5,4,17,12,7,11,15,16,12,15,12,13,10,12,12,11
"160",91205203,"Eric Martel","4/29/2002 (21 years old)","D (C), DM, M (C)","1. FC Köln","Bundesliga","GER","Yes","7/1/2022","6/30/2026","$11.5M - $14.5M","Right","Reasonable","Very Strong","6'2""","178 lbs","77","4",128,152,4,8,11,7,12,6,14,10,12,13,13,8,15,12,16,12,16,12,12,12,17,10,12,11,14,16,12,16,11,11,13,14,15,12,16,13,12,14,14,14,12,10,4,13,8,7,13,15,14,1,1,1,3,3,3,3,2,1,2,4
"161",2000180822,"Brajan Gruda","5/31/2004 (19 years old)","M (R), AM (RLC)","Mainz 05","Bundesliga","GER","Yes","11/18/2022","6/30/2026","$5M - $7.6M","Left","Very Strong","Weak","5'10""","154 lbs","2","-",112,152,12,9,14,11,13,13,11,12,16,6,12,13,6,14,12,9,8,11,10,9,14,16,8,11,6,10,12,10,14,15,9,9,14,14,11,8,13,7,8,13,12,13,4,12,6,7,14,14,11,1,3,3,3,3,2,3,1,1,2,1
"162",92027981,"Jonas Hofmann","7/14/1992 (30 years old)","M/AM (RC)","Borussia M'gladbach","Bundesliga","GER","Yes","6/14/2021","6/30/2025","$10.5M - $13M","Right","Reasonable","Very Strong","5'9""","158 lbs","308","63",150,152,17,14,12,13,14,14,7,11,12,9,15,13,10,14,12,16,13,14,12,13,17,13,14,16,9,16,16,17,14,13,12,7,15,14,16,11,18,16,15,18,16,16,10,14,6,6,16,13,8,2,1,2,3,1,3,1,2,1,2,3
"163",91014650,"Kevin Volland","7/30/1992 (30 years old)","AM (RLC), ST (C)","AS Monaco","Ligue 1 Uber Eats","GER","Yes","9/2/2020","6/30/2024","$600K - $9.6M","Left","Very Strong","Fairly Strong","5'10""","182 lbs","395","128",135,151,8,10,12,12,12,12,12,12,8,8,12,13,11,12,17,13,16,12,12,12,17,13,13,16,9,16,13,17,12,12,16,11,14,13,15,14,15,9,11,17,12,14,12,13,12,6,13,13,9,1,3,3,1,3,3,3,3,3,1,3
"164",91184445,"Josha Vagnoman","12/11/2000 (22 years old)","D/WB (RL)","VfB Stuttgart","Bundesliga","GER","Yes","7/9/2022","6/30/2026","$49M - $59M","Right","Fairly Strong","Very Strong","6'3""","198 lbs","94","8",133,151,4,11,13,8,12,4,12,9,15,10,11,8,12,12,12,12,14,12,11,11,13,12,9,14,11,14,11,14,14,11,14,14,12,15,14,14,14,15,12,14,13,14,13,13,6,6,12,14,12,3,1,2,2,3,1,1,3,4,1,2
"165",92017768,"Karim Bellarabi","4/8/1990 (33 years old)","M/AM (RL)","Bayer 04","Bundesliga","GER","Yes","6/14/2021","6/30/2024","$130K - $1.3M","Right","Reasonable","Very Strong","6'0""","174 lbs","313","58",125,151,11,12,15,10,12,12,7,11,13,8,12,9,11,13,15,12,13,12,10,10,10,14,10,12,8,12,12,16,14,14,11,9,10,15,11,11,13,8,8,12,12,18,15,12,11,10,11,8,5,3,1,1,1,1,3,3,2,2,1,3
"166",91175517,"David Raum","4/22/1998 (25 years old)","D/WB/M (L)","RB Leipzig","Bundesliga","GER","Yes","7/31/2022","6/30/2027","$36M - $43M","Left","Very Strong","Weak","5'11""","165 lbs","171","9",143,150,15,17,12,9,12,13,8,10,15,10,12,8,12,12,16,13,14,12,10,12,17,13,7,16,10,16,13,17,15,13,12,10,17,16,17,12,12,10,8,14,11,8,4,12,12,8,12,14,12,1,2,2,3,1,1,3,2,2,1,2
"167",91132680,"Benjamin Henrichs","2/23/1997 (26 years old)","D/WB (RL)","RB Leipzig","Bundesliga","GER","Yes","6/30/2021","6/30/2026","$18M - $27M","Right","Fairly Strong","Very Strong","6'0""","174 lbs","162","6",144,150,8,12,12,8,13,8,11,8,13,12,14,11,15,13,15,13,16,13,12,12,15,12,11,15,13,15,13,15,13,13,12,12,12,14,15,13,18,10,11,13,12,14,9,14,8,8,13,14,12,1,2,1,3,1,1,2,1,3,1,3
"168",14181375,"Nicolás González","4/6/1998 (25 years old)","AM (RL), ST (C)","Fiorentina","Italian Serie A","ARG","Yes","7/1/2021","6/30/2026","$30M - $37M","Left","Very Strong","Weak","5'11""","165 lbs","173","46",151,158,9,14,16,14,15,7,16,13,4,4,14,16,6,15,16,13,16,14,10,14,17,15,7,16,6,13,13,14,16,15,13,16,14,16,12,11,12,7,10,14,14,12,10,13,9,12,14,15,16,1,1,4,3,3,3,2,1,2,1,2
"169",91119700,"Jonathan Tah","2/11/1996 (27 years old)","D (RC)","Bayer 04","Bundesliga","GER","Yes","9/28/2021","6/30/2025","$21M - $32M","Right","Reasonable","Very Strong","6'5""","207 lbs","274","8",145,150,3,7,10,6,12,4,14,6,10,14,14,6,13,12,15,15,14,16,13,13,13,8,14,8,15,15,12,13,12,10,17,17,13,15,12,18,8,15,13,14,11,13,9,13,7,8,14,14,8,1,1,2,3,3,1,3,1,2,2,3
"170",719601,"Robert Lewandowski","8/21/1988 (34 years old)","ST (C)","Barcelona","Spanish First Division","POL","Yes","7/17/2022","6/30/2025","Not for Sale","Right","Fairly Strong","Very Strong","6'1""","178 lbs","535","403",182,190,3,8,13,19,18,15,17,12,3,7,13,19,7,16,14,18,15,17,17,17,20,14,15,18,7,15,14,15,13,13,19,15,19,14,17,16,8,11,10,18,16,10,2,15,8,12,17,20,15,2,1,2,1,2,2,2,3,4,1,3
"171",28009478,"Wojciech Szczęsny","4/18/1990 (33 years old)","GK","Juventus","Italian Serie A","POL","Yes","4/28/2023","6/30/2025","Not for Sale","Right","Reasonable","Very Strong","6'5""","198 lbs","397","-",152,169,2,3,3,1,10,1,5,3,1,1,11,3,3,8,12,13,14,17,12,12,15,7,11,4,14,9,10,11,10,15,11,17,12,12,11,15,2,14,9,16,14,12,8,14,5,12,15,13,17,13,16,17,7,16,16,17,13,14,14,15
"172",43093171,"Piotr Zieliński","5/20/1994 (29 years old)","M/AM (C)","Parthenope","Italian Serie A","POL","Yes","8/31/2020","6/30/2024","$45M - $56M","Right","Strong","Very Strong","5'11""","152 lbs","333","40",158,160,14,15,12,14,17,12,7,15,4,8,17,14,8,17,10,15,11,13,10,14,11,15,10,15,11,15,16,12,13,14,12,9,16,14,13,11,14,12,14,15,14,14,6,11,7,13,13,13,13,3,3,1,1,1,3,1,1,2,2,3
"173",96102946,"Jakub Kiwior","2/15/2000 (23 years old)","D (LC), DM","Arsenal","English Premier Division","POL","Yes","1/23/2023","6/30/2027","$70M - $106M","Left","Very Strong","Weak","6'2""","171 lbs","98","5",143,158,7,11,12,7,12,12,14,8,7,14,13,8,13,13,13,15,13,13,13,13,14,9,11,7,14,15,12,13,16,14,12,16,15,14,13,13,12,13,12,15,13,12,5,12,11,4,14,14,15,1,4,2,2,1,2,2,1,2,3,3
"174",719130,"Łukasz Piszczek","6/3/1985 (38 years old)","D (RC), WB (R)","LKS Goczałkowice","Polish Third Division Group 3","POL","Yes","3/3/2023","6/30/2024","$0 - $45K","Right","Reasonable","Very Strong","6'0""","174 lbs","431","39",125,158,8,13,10,10,12,8,11,11,15,11,11,9,13,12,10,14,13,12,15,15,15,10,15,12,13,15,11,13,11,10,12,12,16,11,11,12,18,18,16,18,15,18,10,17,8,4,16,12,15,4,4,1,2,3,1,1,3,3,1,1
"175",43426126,"Nicola Zalewski","1/23/2002 (21 years old)","WB (RL), M/AM (L)","AS Roma","Italian Serie A","POL","Yes","12/29/2021","6/30/2025","$57M - $86M","Right","Strong","Very Strong","5'9""","138 lbs","50","2",139,156,10,11,15,8,16,9,5,9,4,10,14,9,12,15,12,11,13,11,10,11,14,14,4,13,10,12,14,12,15,14,12,7,13,15,12,8,18,12,13,12,13,13,4,15,9,7,13,14,13,3,1,3,3,3,4,1,3,3,3,3
"176",96086697,"Jakub Moder","4/7/1999 (24 years old)","DM, M/AM (C)","Brighton","English Premier Division","POL","Yes","10/5/2020","6/30/2025","$24M - $29M","Right","Fairly Strong","Very Strong","6'2""","171 lbs","173","20",135,155,13,10,11,11,13,13,11,14,7,10,13,12,12,13,9,13,12,13,13,13,14,13,11,14,13,14,13,14,12,11,11,13,13,12,14,13,15,12,14,14,10,14,6,13,7,5,14,14,13,2,3,1,1,2,1,4,2,1,3,2
"177",96075512,"Krystian Bielik","1/4/1998 (25 years old)","DM, M (C)","Derby","Sky Bet League One","POL","Yes","8/2/2019","6/30/2025","$275K - $2.8M","Right","Reasonable","Very Strong","6'2""","171 lbs","135","9",120,155,4,6,12,5,13,7,14,7,6,14,15,7,14,15,15,13,13,14,13,14,14,8,11,7,14,14,13,14,9,9,13,16,15,10,14,14,13,13,10,13,12,9,14,5,14,7,12,13,12,2,2,3,3,2,3,3,3,2,2,2
"178",34012402,"Grzegorz Krychowiak","1/29/1990 (33 years old)","DM, M (C)","Krasnodar","Russian Premier League","POL","Yes","8/2/2021","6/30/2025","Not for Sale","Right","Reasonable","Very Strong","6'2""","191 lbs","401","46",140,155,6,7,11,10,12,7,12,13,5,14,13,12,14,12,15,16,16,13,15,15,14,8,15,14,14,15,12,15,11,12,15,13,16,12,15,15,11,13,12,14,14,13,5,14,12,7,14,13,18,1,3,3,2,1,3,3,3,2,2,4
"179",6300468,"Mario Santana","12/23/1981 (41 years old)","M (R), AM (RC)","Palermo","Italian Serie B","ARG","Yes","8/10/2022","6/30/2024","$0","Right Only","Very Weak","Very Strong","5'9""","165 lbs","468","69",60,158,11,12,11,8,11,8,6,5,8,6,11,9,9,12,9,10,13,10,12,10,8,17,11,12,11,10,10,8,8,9,9,5,11,9,7,7,12,12,8,11,11,15,10,14,8,14,9,14,20,2,2,3,3,1,4,1,1,1,2,2
"180",96026541,"Arkadiusz Milik","2/28/1994 (29 years old)","ST (C)","OM","Ligue 1 Uber Eats","POL","Yes","7/1/2022","6/30/2027","$7.2M - $8.6M","Left","Very Strong","Reasonable","6'1""","176 lbs","285","111",146,155,5,9,10,16,15,14,15,13,4,4,13,15,6,14,10,16,14,15,14,15,13,14,10,15,4,15,12,14,14,14,16,14,13,13,13,15,9,14,12,10,12,9,11,13,10,9,13,16,11,3,2,2,3,2,3,1,3,3,4,2
"181",718272,"Łukasz Fabiański","4/18/1985 (38 years old)","GK","West Ham","English Premier Division","POL","Yes","7/6/2022","6/30/2023","$50K - $500K","Right Only","Weak","Very Strong","6'3""","182 lbs","423","-",138,154,3,1,3,2,8,6,11,2,3,7,11,1,13,7,10,13,12,16,17,12,15,5,8,4,15,14,10,13,9,15,12,14,13,8,10,13,12,19,18,18,10,13,10,15,3,6,15,14,16,14,14,16,12,15,12,15,7,14,13,13
"182",67030699,"Kamil Glik","2/3/1988 (35 years old)","D (C)","Benevento","Italian Serie C/C","POL","Yes","9/1/2020","6/30/2024","$5K - $55K","Right Only","Weak","Very Strong","6'3""","176 lbs","447","27",111,152,4,9,7,7,10,6,14,9,6,12,11,9,13,9,18,11,17,12,10,13,18,8,16,9,14,14,11,13,9,8,15,14,17,9,10,16,6,12,12,19,17,16,7,11,14,6,10,17,14,1,3,1,1,2,3,2,3,1,3,3
"183",96085886,"Kamil Grabara","1/8/1999 (24 years old)","GK","FC København","3F Superliga","POL","Yes","7/1/2021","6/30/2026","$10.5M - $16M","Right Only","Weak","Very Strong","6'5""","205 lbs","128","-",139,150,3,1,4,2,5,7,7,3,1,1,10,5,3,7,17,13,17,15,13,13,18,2,7,1,14,13,9,10,11,13,13,16,12,10,11,14,8,5,5,13,16,15,5,15,10,15,14,20,16,15,14,16,13,15,10,12,13,13,14,16
"184",2000255483,"Adrian Przyborek","1/1/2007 (16 years old)","M/AM (L)","Pogoń","PKO Bank Polski Ekstraklasa","POL","Yes","1/16/2023","6/30/2026","$90K - $900K","Right","Reasonable","Very Strong","5'10""","132 lbs","8","1",75,149,5,8,13,12,11,4,6,5,6,4,9,2,7,13,5,7,8,8,7,9,8,13,10,7,6,7,8,8,13,11,7,3,11,9,13,5,8,18,11,12,10,10,11,5,8,8,11,11,13,4,2,3,3,2,3,3,3,1,2,1
"185",96121228,"Jakub Kamiński","6/5/2002 (21 years old)","M/AM (RL)","VfL Wolfsburg","Bundesliga","POL","Yes","7/1/2022","6/30/2027","$9.6M - $14.5M","Right","Reasonable","Very Strong","5'10""","149 lbs","133","23",128,148,12,10,14,10,12,11,8,10,8,8,12,8,11,13,11,11,15,10,11,10,16,14,11,12,9,15,12,16,15,15,9,8,16,15,14,8,18,13,13,15,12,12,5,12,8,5,12,15,12,3,3,3,2,1,3,2,3,3,2,4
"186",29147447,"Matty Cash","8/7/1997 (25 years old)","D/WB/M (R)","Aston Villa","English Premier Division","POL","Yes","4/4/2022","6/30/2027","$35M - $44M","Right","Fairly Strong","Very Strong","6'1""","174 lbs","233","18",140,148,10,11,13,11,14,10,12,12,17,9,13,8,13,12,15,15,13,10,11,12,15,11,9,14,12,16,11,16,14,14,13,10,15,14,15,12,13,13,12,13,12,13,12,10,13,2,13,13,13,2,3,1,2,1,3,2,2,3,2,4
"187",96088503,"Sebastian Szymański","5/10/1999 (24 years old)","M (C), AM (RLC)","Dinamo Moscow","Russian Premier League","POL","Yes","6/14/2021","6/30/2027","$8.4M - $10.5M","Left","Very Strong","Weak","5'9""","132 lbs","194","29",137,147,15,12,13,12,14,13,8,15,6,5,13,12,8,16,13,16,14,13,11,13,17,14,13,16,10,16,12,16,15,14,12,7,11,13,16,8,18,14,11,16,13,15,2,14,6,4,12,15,13,1,1,2,2,1,3,1,2,1,1,3
"188",96145145,"Kacper Kozłowski","10/16/2003 (19 years old)","M/AM (C)","Brighton","English Premier Division","POL","Yes","1/5/2022","6/30/2026","$750K - $1.6M","Right","Fairly Strong","Very Strong","5'10""","165 lbs","103","11",110,147,7,9,11,10,13,10,7,13,4,7,14,10,9,13,7,12,14,13,12,12,16,10,12,12,3,9,13,12,11,13,12,10,7,11,11,11,11,10,13,15,17,10,5,11,6,12,13,18,16,3,1,2,2,1,1,1,1,3,1,1
"189",96047750,"Jan Bednarek","4/12/1996 (27 years old)","D (C)","Southampton","Sky Bet Championship","POL","Yes","12/3/2020","6/30/2025","$16M - $24M","Right","Reasonable","Very Strong","6'2""","169 lbs","221","10",138,145,2,7,9,7,11,3,14,5,5,14,12,5,14,13,12,14,17,12,14,14,13,8,13,5,14,14,9,15,13,12,13,14,17,13,17,15,9,10,12,12,13,14,9,13,5,4,13,13,12,1,2,1,3,2,3,1,1,3,3,4
"190",2000204278,"Luka Andrade","1/3/2007 (16 years old)","M (R), AM (RLC), ST (C)","Boca","Argentine Premier Division","ARG","No","1/1/2023","12/31/2027","$1.2M - $12.5M","Right","Reasonable","Very Strong","5'6""","123 lbs","-","-",86,158,7,8,14,14,13,6,8,13,7,6,10,2,7,12,15,7,8,7,4,6,13,11,9,9,4,8,9,12,14,10,14,3,9,12,7,2,8,18,11,11,11,11,12,3,5,5,16,8,11,2,1,1,2,1,2,2,3,1,1,3
"191",54005896,"Mateusz Klich","6/13/1990 (32 years old)","M/AM (C)","D.C. United","Major League Soccer","POL","Yes","1/11/2023","12/31/2024","Not for Sale","Right","Reasonable","Very Strong","6'0""","185 lbs","385","50",126,145,10,10,9,12,13,11,7,13,4,10,14,16,11,13,15,13,15,13,12,12,17,12,13,13,11,16,14,18,10,10,12,11,18,11,16,11,10,8,3,13,14,17,4,14,10,17,13,11,14,2,3,3,2,3,1,2,2,3,3,2
"192",96054420,"Krzysztof Piątek","7/1/1995 (27 years old)","ST (C)","Hertha","Bundesliga 2","POL","Yes","6/14/2021","6/30/2026","$170K - $1.7M","Right","Reasonable","Very Strong","6'0""","169 lbs","328","111",130,145,6,7,11,14,13,8,14,10,6,6,12,16,7,12,13,15,15,13,14,12,12,10,12,15,6,12,11,14,12,12,16,14,14,13,15,14,7,14,10,15,10,8,6,10,11,9,12,13,12,3,2,2,3,3,1,4,3,1,1,3
"193",96105337,"Sebastian Walukiewicz","5/4/2000 (23 years old)","D (C)","Cagliari","Italian Serie A","POL","Yes","6/15/2020","6/30/2027","$2.4M - $5M","Right","Weak","Very Strong","6'2""","187 lbs","96","1",121,145,4,7,10,7,10,4,14,6,10,12,11,8,13,10,13,13,14,13,13,12,15,10,6,11,13,14,10,15,12,11,15,14,15,13,15,15,2,11,12,12,13,9,10,12,13,2,13,12,8,3,3,2,2,2,3,1,2,3,2,3
"194",96093498,"Radosław Majecki","11/16/1999 (23 years old)","GK","AS Monaco","Ligue 1 Uber Eats","POL","Yes","1/29/2020","6/30/2024","$500K - $5.2M","Right","Weak","Very Strong","6'4""","171 lbs","144","-",110,145,4,2,1,3,11,5,8,1,2,1,10,6,2,9,4,12,12,14,13,10,14,6,8,8,12,11,7,13,6,12,13,15,14,7,11,13,8,13,12,15,17,11,2,12,3,8,14,15,15,11,12,11,13,12,11,13,7,12,11,14
"195",96122121,"Patryk Peda","4/16/2002 (21 years old)","D (C)","SPAL","Italian Serie C/B","POL","Yes","9/23/2021","6/30/2024","$0","Right Only","Weak","Very Strong","6'3""","167 lbs","34","1",110,144,6,9,8,6,9,11,12,8,10,12,10,10,12,8,13,12,14,12,11,13,16,7,12,8,14,14,6,13,10,11,12,16,12,11,15,11,7,15,15,15,14,13,5,10,10,4,10,13,8,3,3,3,1,3,3,1,1,1,1,1
"196",721326,"Kamil Grosicki","6/8/1988 (35 years old)","AM (RL)","Pogoń","PKO Bank Polski Ekstraklasa","POL","Yes","7/21/2021","6/30/2024","$14K - $140K","Right","Reasonable","Very Strong","5'11""","171 lbs","476","97",122,143,11,14,15,11,14,14,7,13,5,7,13,13,7,13,8,13,7,13,12,10,14,15,8,14,10,8,10,12,14,14,12,9,11,14,10,9,12,11,10,12,13,7,7,12,8,12,8,13,12,2,4,1,1,3,1,2,1,1,3,1
"197",28111106,"Marcin Bułka","10/4/1999 (23 years old)","GK","OGC Nice","Ligue 1 Uber Eats","POL","Yes","7/1/2022","6/30/2026","$600K - $5.8M","Right","Reasonable","Very Strong","6'6""","218 lbs","18","-",126,142,5,1,1,3,9,10,2,1,3,3,11,3,2,8,9,12,13,11,11,11,15,3,14,3,13,12,13,9,12,12,16,18,9,11,5,14,11,13,13,15,16,17,8,15,9,6,12,14,13,12,11,12,15,14,13,12,11,12,12,16
"198",2000178898,"Karol Borys","9/28/2006 (16 years old)","M/AM (C)","Śląsk","PKO Bank Polski Ekstraklasa","POL","Yes","6/13/2022","6/30/2026","$275K - $2.8M","Right","Fairly Strong","Very Strong","5'9""","147 lbs","17","-",83,141,6,7,8,13,14,7,2,5,6,6,14,5,6,14,10,11,5,7,4,7,5,13,6,11,9,8,12,13,9,10,8,5,15,11,13,5,12,18,11,11,10,11,10,10,12,8,7,12,17,2,2,4,3,1,2,2,3,2,2,2
"199",96131647,"Kamil Piątkowski","6/21/2000 (22 years old)","D (C), WB/M (R)","AA Gent","Jupiler Pro League","POL","Yes","7/1/2021","6/30/2026","$350K - $3.6M","Right","Reasonable","Very Strong","6'3""","182 lbs","105","4",112,141,5,9,9,6,11,5,11,9,9,12,11,7,13,10,16,11,13,12,11,11,14,5,9,9,11,13,10,13,12,12,13,15,15,13,14,14,7,13,13,13,12,13,6,9,7,5,10,15,11,2,2,3,1,3,2,3,3,3,2,1
"200",2000096695,"Bartosz Żelazowski","4/25/2005 (18 years old)","GK","OGC Nice","Ligue 1 Uber Eats","POL","Yes","1/20/2022","6/30/2024","$75K - $750K","Right","Reasonable","Very Strong","6'4""","167 lbs","-","-",70,141,4,2,2,3,8,7,1,2,2,1,7,1,2,3,14,11,7,6,9,5,10,2,9,3,9,7,6,6,8,15,7,13,12,8,6,4,9,19,10,11,12,10,7,17,8,4,6,10,20,7,7,10,14,10,13,13,5,8,9,12
"201",2000166219,"Jerónimo Domina","10/17/2005 (17 years old)","ST (C)","Unión (SF)","Argentine Premier Division","ARG","No","6/13/2022","12/31/2026","$1.1M - $6M","Right","Weak","Very Strong","5'9""","156 lbs","43","8",113,157,7,11,12,12,12,11,9,8,1,7,12,5,6,13,10,13,10,11,11,11,5,15,10,13,11,13,12,15,13,13,9,9,14,14,15,9,9,10,11,10,11,11,11,16,7,8,10,9,20,3,1,2,1,2,3,1,3,1,3,2
"202",96131663,"Bartosz Białek","11/11/2001 (21 years old)","AM (C), ST (C)","VfL Wolfsburg","Bundesliga","POL","Yes","8/19/2020","6/30/2024","$110K - $1.1M","Right","Fairly Strong","Very Strong","6'3""","185 lbs","93","22",115,140,5,7,11,14,11,6,13,10,6,4,10,13,6,11,11,13,14,13,12,12,13,12,6,14,6,12,10,12,12,11,14,14,12,12,11,14,10,14,14,14,14,13,8,11,7,6,12,13,12,2,2,2,3,3,3,1,3,1,3,1
"203",96122114,"Michał Karbownik","3/13/2001 (22 years old)","D/WB (RL), DM, M (C)","Brighton","English Premier Division","POL","Yes","10/5/2020","6/30/2024","$550K - $5.2M","Right","Reasonable","Very Strong","5'9""","141 lbs","126","1",120,140,10,12,13,7,13,8,7,6,12,10,13,6,11,13,13,11,12,12,10,11,13,13,8,12,11,16,13,12,14,14,10,7,13,14,14,9,19,14,13,15,10,9,8,12,11,3,12,13,12,1,4,1,2,2,1,3,1,3,3,2
"204",96129140,"Mateusz Bogusz","8/22/2001 (21 years old)","M/AM (C)","LAFC","Major League Soccer","POL","Yes","3/31/2023","12/31/2026","$5.4M - $8.2M","Right","Reasonable","Very Strong","5'9""","149 lbs","116","16",118,140,10,13,14,11,12,11,7,12,6,9,13,10,10,13,14,12,14,13,11,12,13,14,7,13,9,13,13,13,12,11,13,8,15,12,14,13,11,8,10,13,12,10,4,10,4,3,12,14,16,3,2,2,3,1,3,1,1,3,1,1
"205",96088106,"Przemysław Płacheta","3/23/1998 (25 years old)","D/M/AM (L)","Norwich","Sky Bet Championship","POL","Yes","7/22/2020","6/30/2024","$2.5M","Left Only","Very Strong","Very Weak","5'10""","156 lbs","121","19",117,140,11,10,12,10,10,12,7,10,5,9,11,9,9,11,12,7,7,10,9,9,14,14,4,11,10,11,11,12,17,15,12,10,11,18,12,8,13,10,14,15,13,10,8,11,6,5,11,14,11,1,3,3,1,2,2,3,3,3,2,3
"206",96111188,"Bartosz Slisz","3/29/1999 (24 years old)","DM, M (C)","Legia","PKO Bank Polski Ekstraklasa","POL","Yes","2/28/2020","12/31/2024","$230K - $2.3M","Right Only","Weak","Very Strong","5'10""","154 lbs","189","9",116,140,10,10,10,6,11,10,11,12,8,10,13,11,14,11,13,15,11,12,12,12,13,10,10,8,15,14,10,15,12,12,12,11,16,12,17,12,11,12,14,14,14,13,3,10,8,4,12,13,11,2,2,1,3,2,2,2,3,3,1,2
"207",96116988,"Filip Marchwiński","1/10/2002 (21 years old)","AM (RLC)","Lech","PKO Bank Polski Ekstraklasa","POL","Yes","6/13/2022","6/30/2026","$425K - $4.2M","Right","Fairly Strong","Very Strong","6'1""","158 lbs","131","19",116,140,8,10,11,12,12,11,11,9,3,4,13,10,4,13,13,13,14,13,11,13,9,15,7,13,10,13,13,14,13,13,12,12,7,12,12,9,13,13,13,9,4,12,6,12,10,5,11,11,12,3,1,1,2,2,2,4,2,1,2,2
"208",96075397,"Kamil Jóźwiak","4/22/1998 (25 years old)","WB/M (R), AM (RL)","Charlotte FC","Major League Soccer","POL","Yes","3/10/2022","12/31/2025","$2.5M - $5.2M","Right Only","Weak","Very Strong","5'9""","154 lbs","241","25",114,140,9,13,14,10,13,9,7,7,4,4,13,8,4,13,7,11,14,11,11,9,17,14,8,10,6,11,12,11,15,12,10,7,9,15,13,6,10,16,11,15,8,13,12,11,10,5,11,15,13,3,2,1,2,1,3,1,3,3,2,3
"209",96128951,"Łukasz Łakomy","1/18/2001 (22 years old)","DM, M/AM (C)","KGHM Zagłębie","PKO Bank Polski Ekstraklasa","POL","Yes","1/26/2021","6/30/2026","$210K - $2.1M","Left","Very Strong","Strong","5'11""","158 lbs","106","13",116,139,11,14,12,5,13,11,8,12,5,9,14,8,9,12,12,11,13,11,12,13,10,8,7,12,9,15,13,13,12,12,13,10,10,12,12,8,7,7,12,14,6,7,7,5,10,12,13,12,8,1,2,2,2,4,2,1,1,2,1,2
"210",96123943,"Mikołaj Biegański","4/5/2002 (21 years old)","GK","Wisła Kraków","Polish First Division","POL","Yes","7/1/2021","6/30/2025","$75K - $750K","Right Only","Weak","Very Strong","6'3""","185 lbs","117","-",105,139,3,1,2,2,6,3,5,1,3,3,8,1,2,8,8,11,13,12,12,12,16,8,9,6,12,9,8,13,12,13,11,16,16,12,11,10,7,15,13,15,16,14,5,15,5,5,13,15,15,10,11,14,12,11,8,12,7,10,12,12
"211",2000035772,"Antoni Mikułko","2/11/2005 (18 years old)","GK","Wieczysta Kraków","Polish Third Division Group 4","POL","Yes","6/27/2022","6/30/2025","$150K - $1.5M","Right","Reasonable","Very Strong","6'2""","169 lbs","34","-",79,139,3,2,1,2,4,5,1,1,3,3,10,4,1,3,8,10,12,7,10,13,5,3,10,1,4,7,6,6,11,12,2,11,16,11,4,6,11,18,12,13,13,11,12,3,8,2,18,11,20,7,12,13,13,6,8,9,7,7,11,13
"212",14186894,"Juan Foyth","1/12/1998 (25 years old)","D (RC), DM","Villarreal","Spanish First Division","ARG","Yes","6/11/2021","6/30/2026","$32M - $48M","Right","Reasonable","Very Strong","6'2""","152 lbs","88","3",145,157,7,11,13,8,15,11,15,7,8,14,14,8,16,15,14,13,16,16,12,11,12,12,10,13,14,15,13,16,13,14,14,13,13,14,15,13,12,14,10,13,12,10,6,13,13,7,11,11,15,2,1,1,2,1,4,3,2,1,2,2
"213",2000038815,"Tomasz Pieńko","1/5/2004 (19 years old)","M/AM (RLC)","KGHM Zagłębie","PKO Bank Polski Ekstraklasa","POL","Yes","8/11/2022","6/30/2024","$200K - $2M","Left","Very Strong","Reasonable","6'1""","169 lbs","73","12",107,139,8,11,12,13,11,6,7,7,6,5,11,8,5,12,12,11,11,11,12,12,14,13,10,12,6,12,11,15,12,12,13,11,13,12,12,12,12,16,12,13,15,14,6,11,9,5,11,14,12,3,1,3,3,3,1,1,3,3,3,2
"214",96129436,"Maik Nawrocki","2/7/2001 (22 years old)","D (C)","Legia","PKO Bank Polski Ekstraklasa","POL","Yes","5/28/2022","6/30/2026","$1M - $12M","Right","Reasonable","Very Strong","6'1""","163 lbs","56","7",113,138,7,9,11,7,10,6,13,9,12,13,14,10,13,12,14,12,10,13,12,9,13,8,11,10,13,11,8,12,13,11,12,14,14,13,13,12,5,8,13,18,14,10,2,12,11,7,13,13,12,3,2,1,2,3,2,2,2,1,1,2
"215",96011201,"Bartosz Bereszyński","7/12/1992 (30 years old)","D/WB (R)","Parthenope","Italian Serie A","POL","Yes","2/5/2022","6/30/2025","$1.6M - $3.5M","Right","Reasonable","Very Strong","6'0""","169 lbs","300","4",126,138,9,13,11,4,11,6,13,4,16,12,13,8,15,12,16,12,16,11,10,11,15,10,5,13,12,15,11,16,13,12,12,10,14,13,15,16,13,9,12,15,13,5,10,12,10,10,13,15,15,1,4,1,3,1,2,3,1,3,2,1
"216",2000280600,"Kacper Szymczyk","2/11/2007 (16 years old)","GK","Escola Varsovia","-","POL","Yes","1/1/2022","6/30/2026","$0","Right","Fairly Strong","Very Strong","6'0""","152 lbs","-","-",70,138,3,2,3,1,8,7,1,1,3,3,9,1,3,4,7,12,9,3,12,6,13,3,10,2,13,8,7,7,6,13,8,11,10,7,7,4,13,17,10,13,11,10,8,8,7,8,18,9,19,9,5,12,14,11,12,14,5,11,7,8
"217",96110489,"Szymon Żurkowski","9/25/1997 (25 years old)","DM, M/AM (C)","Spezia","Italian Serie B","POL","Yes","6/15/2020","6/30/2026","$3.6M - $7.2M","Right","Fairly Strong","Very Strong","6'1""","169 lbs","170","15",122,138,10,10,11,10,12,9,8,13,10,9,12,10,11,13,14,12,13,10,12,11,15,12,9,14,12,13,12,16,12,13,13,12,14,12,14,14,12,11,12,12,12,12,5,13,9,2,13,9,12,2,1,2,2,1,4,3,3,2,1,3
"218",96032464,"Karol Linetty","2/2/1995 (28 years old)","DM, M (C)","Torino","Italian Serie A","POL","Yes","9/1/2020","6/30/2024","$700K - $9M","Right","Strong","Very Strong","5'9""","160 lbs","292","19",132,138,10,11,12,11,13,9,10,11,8,10,14,10,14,13,13,13,14,12,13,13,15,12,13,13,11,14,12,14,12,12,15,9,16,13,14,12,14,11,12,13,10,15,10,14,13,8,13,13,14,1,1,1,2,1,3,3,2,1,1,1
"219",2000303458,"Szymon Łyczko","2/10/2006 (17 years old)","M/AM (R)","Stal Rzeszów","Polish First Division","POL","Yes","7/1/2022","6/30/2024","$30K - $300K","Right","Reasonable","Very Strong","5'10""","149 lbs","14","1",76,138,8,11,13,10,13,6,1,6,6,3,8,5,6,13,13,6,1,8,7,12,6,13,3,10,5,7,11,11,13,12,3,3,12,13,6,4,10,11,9,11,12,12,14,17,15,5,8,12,7,1,1,3,2,1,3,3,3,2,3,4
"220",2000116388,"Mateusz Kowalczyk","4/16/2004 (19 years old)","DM, M (C)","ŁKS Łódź","PKO Bank Polski Ekstraklasa","POL","Yes","7/1/2021","6/30/2026","$275K - $2.7M","Right","Weak","Very Strong","5'11""","160 lbs","53","8",91,137,8,8,9,10,10,5,9,10,13,10,10,8,11,10,12,10,13,13,10,10,14,12,8,12,8,13,10,13,12,13,13,7,15,11,11,11,13,20,15,15,17,11,12,8,11,1,18,15,8,2,3,1,2,3,3,1,3,2,2,3
"221",54009099,"Łukasz Skorupski","5/5/1991 (32 years old)","GK","Bologna","Italian Serie A","POL","Yes","8/8/2022","6/30/2025","Not for Sale","Right","Weak","Very Strong","6'2""","185 lbs","318","-",135,137,5,2,1,1,9,7,4,3,2,3,10,4,1,7,13,13,14,12,12,13,13,10,11,9,14,17,8,16,12,15,15,14,14,12,15,15,14,14,17,17,11,14,4,12,8,5,14,13,12,9,10,16,16,17,9,12,3,11,12,13
"222",96150948,"Fryderyk Gerbowski","1/17/2003 (20 years old)","DM, M (RC)","Wisła Płock","Polish First Division","POL","Yes","11/30/2021","6/30/2024","$240K - $2.4M","Right","Reasonable","Very Strong","5'11""","169 lbs","40","2",97,137,10,10,10,8,12,11,9,12,8,10,11,8,10,12,8,9,12,12,11,11,14,8,9,10,10,12,13,12,11,11,9,10,7,11,12,9,14,11,14,14,11,11,6,10,9,1,11,13,11,3,2,1,3,1,2,3,1,1,2,1
"223",14110660,"Lautaro Martínez","8/22/1997 (25 years old)","ST (C)","Inter","Italian Serie A","ARG","No","10/28/2021","6/30/2026","$167M - $224M","Right","Fairly Strong","Very Strong","5'9""","158 lbs","221","101",172,177,4,8,14,17,16,8,16,15,4,5,12,15,8,16,18,15,18,15,12,13,19,17,16,17,7,15,12,18,16,16,14,11,20,16,19,13,11,11,12,19,15,16,6,15,14,4,16,18,16,3,1,1,2,3,3,2,1,1,3,1
"224",14020367,"Emiliano Martínez","9/2/1992 (30 years old)","GK","Aston Villa","English Premier Division","ARG","No","1/21/2022","6/30/2027","$49M - $62M","Right","Reasonable","Very Strong","6'4""","187 lbs","181","-",156,156,2,1,1,2,11,1,5,1,1,3,12,3,1,11,7,15,15,12,14,14,15,8,13,11,13,14,7,13,10,16,13,15,13,10,12,12,2,11,3,15,18,15,5,15,10,15,14,16,14,11,14,18,7,16,14,16,11,12,14,16
"225",96052559,"Bartłomiej Drągowski","8/19/1997 (25 years old)","GK","Spezia","Italian Serie B","POL","Yes","8/10/2022","6/30/2025","$300K - $2.9M","Right","Reasonable","Very Strong","6'3""","163 lbs","209","-",127,137,3,2,3,2,9,7,10,2,1,2,10,3,2,9,12,13,14,10,10,13,15,2,12,2,13,8,8,11,12,12,14,17,13,11,14,13,10,8,11,15,12,12,11,8,6,12,11,13,11,12,8,16,13,12,10,14,12,12,13,13
"226",19024412,"Neymar","2/5/1992 (31 years old)","AM (LC), ST (C)","Paris SG","Ligue 1 Uber Eats","BRA","No","6/14/2021","6/30/2027","Not for Sale","Right","Fairly Strong","Very Strong","5'9""","149 lbs","338","204",175,190,16,16,20,16,18,17,8,15,4,4,17,19,5,20,10,15,14,17,10,14,16,20,14,16,4,8,17,9,15,15,14,6,14,15,13,11,12,8,6,13,14,11,13,15,12,12,12,19,16,2,2,2,3,1,1,1,1,3,3,2
"227",2000220941,"Endrick","7/21/2006 (16 years old)","AM (R), ST (C)","SEP","Brazilian National First Division","BRA","No","7/21/2022","6/30/2025","$24M - $29M","Left","Very Strong","Fairly Strong","5'8""","145 lbs","18","6",114,187,7,10,14,13,13,11,9,10,4,4,10,11,5,13,12,12,12,12,10,11,13,18,3,12,6,8,11,11,14,13,13,6,14,13,10,15,10,10,12,15,11,12,12,13,12,7,8,16,16,2,1,1,2,2,2,1,2,3,1,1
"228",19302146,"Vinícius Júnior","7/12/2000 (22 years old)","AM (RL)","R. Madrid","Spanish First Division","BRA","Yes","6/14/2021","6/30/2024","$104M - $156M","Right","Fairly Strong","Very Strong","5'10""","160 lbs","192","45",181,184,7,13,19,16,14,8,12,12,4,3,15,12,6,15,17,16,17,15,12,16,20,16,13,17,9,13,14,14,19,16,16,8,15,18,16,12,10,4,8,14,12,12,5,13,11,16,13,17,15,1,3,1,3,1,1,1,2,3,2,3
"229",19351309,"Gabriel Martinelli","6/18/2001 (21 years old)","AM (RL), ST (C)","Arsenal","English Premier Division","BRA","Yes","2/3/2023","6/30/2027","$304M - $331M","Right","Reasonable","Very Strong","5'11""","158 lbs","110","32",160,180,14,12,15,14,15,10,13,8,3,5,12,11,5,16,14,13,14,13,12,13,17,15,6,16,7,16,13,17,17,16,14,11,13,16,16,11,12,14,14,17,15,12,10,14,10,5,15,17,16,1,3,3,1,3,3,3,3,2,2,1
"230",8832853,"Marcelo","5/12/1988 (35 years old)","D/WB/M/AM (L)","FLU","Brazilian National First Division","BRA","Yes","3/9/2023","12/31/2024","$600K - $1.8M","Left","Very Strong","Strong","5'9""","176 lbs","431","29",125,180,13,16,16,13,17,12,10,13,13,7,15,12,10,18,13,13,12,14,8,10,13,17,13,14,9,13,14,8,9,10,15,6,9,10,8,10,10,15,12,12,15,16,13,14,13,12,12,15,12,1,1,2,4,3,3,3,3,1,1,3
"231",55057659,"Ederson","8/17/1993 (29 years old)","GK","Man City","English Premier Division","BRA","Yes","9/1/2021","6/30/2026","$294M - $323M","Left","Very Strong","Fairly Strong","6'2""","189 lbs","324","-",180,180,3,2,11,1,14,8,9,12,2,1,18,12,3,17,12,17,18,20,16,15,16,3,7,15,16,14,17,13,14,13,13,13,15,13,14,13,1,19,10,16,20,12,5,16,5,4,16,14,16,17,16,15,6,14,20,16,15,13,16,13
"232",19058734,"Alisson","10/2/1992 (30 years old)","GK","Liverpool","English Premier Division","BRA","No","8/4/2021","6/30/2027","$283M - $340M","Right","Reasonable","Very Strong","6'3""","200 lbs","254","1",176,180,3,3,10,1,15,2,7,2,3,2,14,5,3,14,12,17,14,15,15,16,19,13,11,11,18,11,11,17,13,16,16,14,17,13,12,15,1,17,15,18,17,14,8,16,5,6,17,17,16,14,16,17,14,18,15,16,12,14,13,15
"233",19306929,"Rodrygo","1/9/2001 (22 years old)","AM (RL), ST (C)","R. Madrid","Spanish First Division","BRA","Yes","6/14/2021","6/30/2025","$141M - $170M","Right","Reasonable","Very Strong","5'9""","141 lbs","155","27",164,178,11,12,16,17,15,14,12,14,8,5,14,12,6,15,11,14,14,15,14,14,14,15,11,17,9,12,13,15,15,17,16,9,12,16,14,13,11,15,15,15,13,14,9,13,7,5,13,13,12,4,3,1,2,2,4,3,2,1,2,3
"234",19220266,"Gabriel Jesus","4/3/1997 (26 years old)","AM (RL), ST (C)","Arsenal","English Premier Division","BRA","No","6/28/2022","6/30/2027","$275M - $330M","Right","Fairly Strong","Very Strong","5'9""","160 lbs","232","85",165,175,8,12,16,14,15,11,15,12,4,7,14,13,8,16,14,16,14,14,14,15,15,16,12,16,10,18,14,18,15,16,15,10,15,15,15,14,12,15,14,14,14,12,9,14,12,8,13,13,15,3,1,1,3,1,2,1,2,1,3,3
"235",2000163799,"Nico Paz","9/8/2004 (18 years old)","M/AM (RL)","R. Madrid C","Spanish Federation Third Group 7","ARG","Yes","7/1/2020","6/30/2025","$140K - $1.4M","Left","Very Strong","Fairly Strong","5'11""","141 lbs","20","1",106,156,8,13,14,14,13,8,8,10,5,8,14,5,10,12,7,12,9,8,9,14,9,14,9,12,7,10,13,10,13,15,8,8,13,12,10,8,15,16,11,12,13,10,15,9,5,4,9,11,9,3,1,2,1,2,1,2,3,2,1,2
"236",19047778,"Oscar","9/9/1991 (31 years old)","M (C), AM (RC)","SH Port","Chinese Super League","BRA","No","6/14/2021","12/31/2024","Not for Sale","Right","Fairly Strong","Very Strong","5'11""","156 lbs","312","68",144,175,10,14,14,12,14,13,8,13,9,10,15,12,13,16,12,14,12,14,12,12,12,16,8,17,14,15,16,11,13,15,11,9,18,14,12,9,13,14,12,11,8,7,7,12,6,10,12,12,11,1,2,2,3,1,4,3,1,4,3,3
"237",19068857,"Roberto Firmino","10/2/1991 (31 years old)","AM (RC), ST (C)","Liverpool","English Premier Division","BRA","No","6/14/2021","6/30/2025","$20M - $24M","Right","Reasonable","Very Strong","5'11""","167 lbs","434","128",145,175,8,12,14,13,17,8,12,10,7,11,13,12,12,17,13,15,10,16,12,13,13,16,10,14,12,18,15,15,13,14,16,10,17,12,15,13,11,16,13,15,15,14,8,14,7,6,12,14,13,1,1,3,1,1,2,1,1,1,1,3
"238",8833628,"Thiago Silva","9/22/1984 (38 years old)","D (C)","Chelsea","English Premier Division","BRA","Yes","2/10/2023","6/30/2024","$11M - $16M","Right","Weak","Very Strong","5'11""","178 lbs","502","28",156,174,4,5,9,7,14,8,17,7,7,17,13,13,16,13,17,16,15,20,17,16,15,8,19,8,19,15,13,14,10,10,16,13,14,8,14,13,8,15,18,20,11,15,11,13,7,6,15,17,13,2,3,2,2,1,1,2,1,3,1,1
"239",19044710,"Douglas Costa","9/14/1990 (32 years old)","AM (RLC)","LA Galaxy","Major League Soccer","BRA","No","7/1/2022","12/31/2023","$325K - $3.3M","Left","Very Strong","Reasonable","5'8""","165 lbs","370","53",132,172,12,14,17,9,17,13,4,15,4,3,14,12,4,18,12,13,9,12,9,11,10,18,6,13,5,7,14,9,15,16,14,6,8,15,10,8,12,7,7,9,12,12,19,12,11,14,10,10,12,1,1,1,1,1,1,1,1,1,1,1
"240",19183676,"Fabinho","10/23/1993 (29 years old)","D (RC), DM, M (C)","Liverpool","English Premier Division","BRA","No","8/3/2021","6/30/2026","$41M - $62M","Right","Reasonable","Very Strong","6'2""","171 lbs","349","33",155,170,7,11,13,9,16,8,14,12,9,15,15,15,16,15,16,14,15,16,14,14,15,11,10,12,16,17,12,15,12,12,14,15,16,13,16,15,15,14,14,16,15,13,7,15,11,6,15,16,16,2,3,3,3,2,2,1,1,1,2,3
"241",19297055,"Bruno Guimarães","11/16/1997 (25 years old)","DM, M (C)","Newcastle","English Premier Division","BRA","Yes","1/30/2022","6/30/2026","$221M - $243M","Right","Weak","Very Strong","6'0""","163 lbs","167","15",165,170,11,12,16,13,18,12,11,12,5,13,18,11,14,18,16,16,15,18,15,15,14,14,12,14,16,15,17,16,12,13,12,12,14,13,14,13,17,11,9,14,14,12,7,13,15,6,15,13,15,3,3,4,1,1,2,3,2,2,3,3
"242",19061518,"Casemiro","2/23/1992 (31 years old)","DM, M (C)","Man UFC","English Premier Division","BRA","Yes","8/22/2022","6/30/2026","Not for Sale","Right","Fairly Strong","Very Strong","6'1""","185 lbs","354","38",159,170,10,11,11,11,14,10,16,14,10,14,14,13,16,14,18,17,17,12,15,13,18,12,17,13,17,17,13,16,11,11,15,14,12,12,15,17,12,11,10,16,15,10,5,15,17,14,15,15,16,1,3,3,2,1,3,2,2,3,1,1
"243",19046041,"Philippe Coutinho","6/12/1992 (30 years old)","M/AM (LC)","Aston Villa","English Premier Division","BRA","Yes","5/12/2022","6/30/2026","Not for Sale","Right","Strong","Very Strong","5'8""","156 lbs","348","81",144,170,13,14,18,12,17,16,9,14,4,5,14,13,6,18,10,13,9,14,11,10,10,18,10,14,7,10,17,10,14,15,12,7,10,11,13,9,15,12,14,15,11,10,15,14,7,9,10,13,14,1,2,2,2,2,1,2,3,2,2,2
"244",2000221458,"Luís Guilherme","2/9/2006 (17 years old)","AM (RC)","SEP","Brazilian National First Division","BRA","No","6/15/2022","6/14/2025","$11M - $17M","Left","Very Strong","Weak","5'10""","163 lbs","8","-",108,169,8,11,13,10,11,11,7,10,1,5,14,12,6,14,8,10,3,13,5,7,2,11,7,11,5,9,13,10,15,18,13,7,9,15,12,10,12,16,13,10,10,12,5,11,8,2,8,11,12,3,2,1,2,2,3,1,2,3,2,2
"245",19338230,"Antony","2/24/2000 (23 years old)","M/AM (R)","Man UFC","English Premier Division","BRA","No","8/31/2022","6/30/2027","$93M - $140M","Left Only","Very Strong","Weak","5'9""","138 lbs","114","26",146,168,12,14,16,12,16,13,6,15,6,6,14,13,8,16,15,13,15,13,13,10,14,17,8,14,11,14,13,17,13,17,14,7,15,15,17,8,10,6,5,12,13,12,8,12,15,13,11,15,8,1,2,2,2,3,3,3,1,3,3,1
"246",14004181,"Pablo Piatti","3/31/1989 (34 years old)","M (L), AM (RLC)","Estudiantes (LP)","Argentine Premier Division","ARG","Yes","7/1/2022","6/30/2024","$325K - $1M","Left Only","Very Strong","Weak","5'5""","138 lbs","401","67",124,155,16,14,14,13,14,13,5,14,5,4,14,14,10,15,9,12,11,13,12,14,18,14,11,15,9,12,13,14,12,14,15,6,13,12,12,9,11,14,14,16,14,14,14,15,9,9,12,11,10,1,2,3,2,4,1,3,3,1,1,2
"247",19273276,"Éder Militão","1/18/1998 (25 years old)","D (C)","R. Madrid","Spanish First Division","BRA","Yes","6/14/2021","6/30/2025","$136M - $206M","Right","Weak","Very Strong","6'1""","174 lbs","160","13",166,168,9,10,12,8,12,10,15,11,11,15,14,13,16,12,15,16,16,13,13,14,15,10,16,12,16,14,12,16,16,15,15,15,18,16,16,16,12,12,12,14,15,12,4,13,12,6,13,12,15,1,2,2,3,3,2,1,3,3,2,1
"248",19384379,"Patryck Lanza","1/18/2003 (20 years old)","D/WB (L)","SPO","Brazilian National First Division","BRA","No","10/24/2022","4/30/2027","$6.8M - $8.4M","Left Only","Very Strong","Weak","6'0""","149 lbs","1","-",105,167,10,11,13,6,13,11,7,10,10,7,13,10,7,14,12,11,9,11,11,12,10,14,11,12,8,11,13,11,14,12,10,10,9,13,9,10,18,11,11,11,11,11,12,8,6,6,12,11,19,1,2,2,1,1,4,3,3,1,2,3
"249",19371902,"Danilo","4/29/2001 (22 years old)","DM, M (C)","Nottm Forest","English Premier Division","BRA","No","1/16/2023","6/30/2029","$33M - $50M","Left","Very Strong","Reasonable","5'9""","152 lbs","87","6",134,166,10,11,13,9,13,12,11,11,6,13,13,9,13,14,13,15,12,13,13,13,13,12,8,12,13,15,13,14,13,14,13,8,13,12,13,11,12,11,12,12,13,12,8,12,13,5,13,11,13,2,2,1,4,1,2,2,2,2,1,3
"250",19265858,"Richarlison","5/10/1997 (26 years old)","AM (RL), ST (C)","Tottenham","English Premier Division","BRA","No","7/1/2022","6/30/2027","$67M - $101M","Right","Fairly Strong","Very Strong","5'11""","156 lbs","266","67",145,166,10,11,13,13,12,9,14,11,8,6,12,12,12,15,15,12,13,11,12,10,14,14,9,12,10,13,10,16,15,14,12,11,15,15,17,13,12,11,5,12,13,14,8,11,6,8,11,13,15,1,2,3,1,3,2,3,2,3,1,2
"251",19163495,"Marquinhos","5/14/1994 (29 years old)","D (C), DM","Paris SG","Ligue 1 Uber Eats","BRA","Yes","5/19/2023","6/30/2028","$110M - $138M","Right","Reasonable","Very Strong","6'0""","165 lbs","299","24",164,165,4,11,10,8,14,4,15,10,7,16,14,8,16,14,14,17,15,17,17,16,17,10,15,8,16,17,13,15,13,13,16,13,15,14,16,14,15,16,15,18,14,15,8,15,8,7,15,16,15,2,3,2,3,2,3,2,2,3,3,1
"252",8825061,"Fernandinho","5/4/1985 (38 years old)","DM, M (C)","ATP","Brazilian National First Division","BRA","No","7/1/2022","12/31/2024","Not for Sale","Right","Reasonable","Very Strong","5'10""","147 lbs","545","66",147,165,10,9,13,11,15,10,14,12,6,13,15,13,15,16,15,14,16,16,18,16,16,10,15,15,13,17,12,17,11,11,14,11,14,11,11,13,20,17,20,18,15,18,7,15,16,5,18,13,19,2,3,2,1,1,3,4,1,1,2,2
"253",19108573,"Ismaily","1/11/1990 (33 years old)","D/WB (L)","LOSC","Ligue 1 Uber Eats","BRA","No","6/9/2023","6/30/2024","$4.4M - $8.4M","Left Only","Very Strong","Weak","5'10""","189 lbs","255","18",130,165,11,16,17,9,14,13,11,14,10,11,13,12,13,14,11,13,11,13,12,13,15,13,9,15,11,15,12,17,13,13,14,8,15,14,12,12,11,13,13,15,12,13,7,13,9,6,18,11,9,1,2,3,3,2,2,3,3,3,2,1
"254",19242277,"Raphinha","12/14/1996 (26 years old)","M (R), AM (RL)","Barcelona","Spanish First Division","BRA","Yes","7/15/2022","6/30/2027","$32M - $38M","Left","Very Strong","Reasonable","5'9""","149 lbs","222","55",155,163,15,14,16,13,16,14,8,14,11,8,14,14,11,16,14,14,14,14,12,14,15,17,8,16,8,12,14,15,16,16,14,7,11,15,14,9,7,8,12,14,15,10,6,13,11,9,12,14,14,1,2,3,2,3,1,2,3,4,2,1
"255",19375640,"André","7/16/2001 (21 years old)","DM, M (C)","FLU","Brazilian National First Division","BRA","No","1/6/2023","12/31/2026","$11.5M - $18M","Right","Reasonable","Very Strong","5'10""","169 lbs","71","3",140,163,8,9,13,10,14,9,11,11,9,14,14,10,14,13,13,14,13,13,13,14,13,12,13,13,15,14,14,14,13,13,14,8,13,13,14,13,12,12,11,13,12,10,4,14,14,6,13,13,20,1,2,2,1,1,1,3,2,1,1,1
"256",2000263996,"Riquelme Fillipi","9/15/2006 (16 years old)","AM (RL), ST (C)","SEP","Brazilian National First Division","BRA","No","10/6/2022","10/5/2025","$180K - $1.8M","Right","Reasonable","Very Strong","5'9""","145 lbs","3","-",73,163,6,8,11,13,13,6,8,13,6,4,12,3,7,9,14,7,8,5,6,8,13,9,11,6,3,7,8,6,13,13,11,6,11,13,11,7,9,10,9,12,13,9,10,11,9,8,9,14,15,1,4,3,3,4,2,3,3,2,1,3
"257",67201783,"Emiliano Buendía","12/25/1996 (26 years old)","AM (RC)","Aston Villa","English Premier Division","ARG","Yes","6/10/2021","6/30/2026","$27M - $33M","Right","Reasonable","Very Strong","5'7""","143 lbs","295","49",143,155,14,15,16,13,15,13,5,11,4,4,15,9,8,16,15,15,12,15,11,11,16,18,5,15,9,13,16,14,14,16,15,8,14,14,13,10,14,3,5,13,13,14,6,14,14,12,12,16,15,3,1,4,3,1,1,1,3,1,3,1
"258",2000263999,"Estêvão","4/24/2007 (16 years old)","AM (RC), ST (C)","SEP","Brazilian National First Division","BRA","No","4/24/2023","4/23/2026","$150K - $1.5M","Left","Very Strong","Reasonable","5'9""","136 lbs","5","1",75,162,6,7,10,13,13,5,6,7,1,5,13,2,3,12,5,4,8,5,5,12,4,14,11,11,1,6,10,7,11,12,7,5,9,12,12,4,11,10,12,11,11,9,5,11,7,2,10,11,19,2,3,3,3,3,1,4,2,1,2,1
"259",19380666,"Marcos Leonardo","5/2/2003 (20 years old)","AM (L), ST (C)","SAN","Brazilian National First Division","BRA","No","1/20/2022","12/31/2026","$5.6M - $8.6M","Right","Reasonable","Very Strong","5'10""","154 lbs","83","27",130,162,4,8,11,15,13,5,11,10,8,5,11,10,4,14,12,14,12,15,13,12,13,13,11,15,5,12,10,14,15,14,12,11,14,13,14,13,10,10,7,12,11,10,5,12,10,7,13,13,12,1,1,3,3,1,1,1,1,3,3,4
"260",19067093,"Alex Sandro","1/26/1991 (32 years old)","D (LC), WB (L)","Juventus","Italian Serie A","BRA","No","6/1/2023","6/30/2024","$3.1M - $6.2M","Left","Very Strong","Reasonable","5'11""","176 lbs","346","17",136,162,11,14,13,9,14,8,14,11,13,13,14,9,15,14,11,15,14,14,10,13,13,14,12,10,16,14,12,15,12,12,13,12,16,13,13,13,12,17,15,15,12,14,10,11,14,6,13,9,13,1,3,1,1,2,3,4,3,2,1,3
"261",19342183,"Evanilson","10/6/1999 (23 years old)","ST (C)","FC Porto","Portuguese Premier League","BRA","No","10/7/2022","6/30/2027","$23M - $29M","Right","Fairly Strong","Very Strong","6'0""","176 lbs","88","37",140,162,6,8,12,15,14,8,12,10,7,8,14,13,9,14,11,13,12,15,11,12,13,14,10,14,5,10,14,12,14,13,16,13,11,14,14,15,12,13,10,13,14,12,16,15,12,6,13,13,13,2,2,3,3,1,1,1,3,3,3,1
"262",19334410,"Matheus Cunha","5/27/1999 (24 years old)","AM (RLC), ST (C)","Wolves","English Premier Division","BRA","No","7/1/2021","6/30/2027","$41M - $62M","Right","Fairly Strong","Very Strong","6'0""","167 lbs","160","32",143,162,12,12,17,15,15,13,11,14,5,4,14,13,6,16,16,11,15,12,6,8,16,17,10,12,5,7,11,13,15,15,14,12,12,15,13,12,14,7,7,11,12,10,6,14,14,13,10,17,14,3,3,3,3,2,1,1,3,3,2,1
"263",2111393,"Alexandre Pato","9/2/1989 (33 years old)","AM (L), ST (C)","SPO","Brazilian National First Division","BRA","No","5/25/2023","12/31/2023","$700K - $1.5M","Right","Fairly Strong","Very Strong","5'11""","158 lbs","331","126",121,162,5,10,15,13,15,12,11,14,6,5,12,14,5,16,13,11,8,12,9,11,9,16,10,13,5,9,12,9,14,12,12,10,13,13,10,11,13,14,12,10,8,15,18,13,7,6,10,9,18,2,3,3,2,1,3,1,2,3,4,3
"264",2105510,"Hulk","7/25/1986 (36 years old)","AM (R), ST (C)","ATM","Brazilian National First Division","BRA","No","3/16/2022","12/31/2024","Not for Sale","Left","Very Strong","Reasonable","5'10""","209 lbs","469","264",143,161,16,15,14,15,14,16,8,16,11,5,15,16,8,15,12,14,15,12,12,12,17,17,14,16,9,8,14,11,15,13,17,9,18,14,15,18,11,8,8,13,13,14,7,13,12,13,15,17,16,2,3,3,2,2,3,1,2,3,3,1
"265",19371031,"João Gomes","2/12/2001 (22 years old)","DM, M (C)","Wolves","English Premier Division","BRA","No","1/30/2023","6/30/2028","$44M - $55M","Right Only","Weak","Very Strong","5'8""","163 lbs","70","1",130,161,10,10,13,10,13,7,10,12,11,14,13,10,15,13,16,13,16,14,13,12,16,12,8,14,14,16,12,16,13,13,12,11,15,13,13,13,14,12,12,14,15,14,5,1,13,5,14,14,16,1,1,2,3,1,1,3,3,1,2,1
"266",19226741,"Lucas Paquetá","8/27/1997 (25 years old)","DM, M (C), AM (LC)","West Ham","English Premier Division","BRA","Yes","8/29/2022","6/30/2027","$78M - $94M","Left","Very Strong","Reasonable","5'11""","158 lbs","181","34",150,161,12,12,15,12,16,12,12,13,6,10,14,15,12,17,13,13,16,14,12,12,13,17,11,14,10,12,15,14,13,16,14,11,13,13,13,14,14,10,8,14,9,9,8,14,11,9,11,14,11,3,2,1,2,2,3,2,1,3,1,3
"267",319221,"Filipe Luís","8/9/1985 (37 years old)","D (LC), WB (L)","FLA","Brazilian National First Division","BRA","Yes","1/1/2023","12/31/2023","$300K - $900K","Left","Very Strong","Weak","5'11""","169 lbs","520","17",131,160,12,15,15,12,15,12,5,11,12,13,15,13,13,15,13,15,13,15,14,13,16,13,18,15,15,16,15,16,10,12,12,11,10,10,12,11,13,7,11,18,12,20,12,15,12,12,13,13,10,1,2,3,3,1,2,1,3,2,1,1
"268",14024702,"Leandro Paredes","6/29/1994 (28 years old)","DM, M (C)","Paris SG","Ligue 1 Uber Eats","ARG","No","6/14/2021","6/30/2024","$500K - $5.2M","Right","Reasonable","Very Strong","5'11""","165 lbs","236","22",143,155,15,12,12,10,14,15,12,14,7,12,15,13,15,16,14,13,12,13,13,14,11,11,9,12,14,13,13,12,13,14,13,10,14,13,15,13,10,9,8,9,10,10,10,12,16,14,13,8,12,3,3,3,3,1,2,4,2,2,1,3
"269",19242094,"Gabriel","12/19/1997 (25 years old)","D (C)","Arsenal","English Premier Division","BRA","No","10/21/2022","6/30/2027","$213M - $256M","Left","Very Strong","Reasonable","6'3""","171 lbs","167","15",156,160,4,7,10,6,12,4,17,6,7,15,13,7,16,13,16,14,16,12,13,14,13,8,11,9,15,16,13,14,13,13,14,17,13,15,16,17,4,7,8,14,12,15,8,12,15,8,15,14,15,3,2,1,3,1,1,4,3,2,3,4
"270",316742,"Dante","10/18/1983 (39 years old)","D (C)","OGC Nice","Ligue 1 Uber Eats","BRA","Yes","5/5/2023","6/30/2024","$230K - $2.3M","Left","Very Strong","Reasonable","6'2""","196 lbs","526","23",137,160,4,5,13,8,15,4,16,5,8,15,16,5,16,14,15,17,18,16,15,15,19,17,18,13,15,16,17,17,4,6,17,16,15,5,14,17,10,15,15,18,18,18,7,18,12,8,15,15,16,2,2,3,3,1,2,1,2,3,1,2
"271",19371552,"João Pedro","9/26/2001 (21 years old)","AM (RLC), ST (C)","Watford","Sky Bet Championship","BRA","No","9/23/2022","6/30/2028","$29M - $44M","Right","Weak","Very Strong","6'0""","158 lbs","129","27",140,160,11,11,14,12,15,11,10,12,6,6,13,16,7,14,15,12,11,13,11,13,15,15,11,15,7,14,14,16,14,14,15,10,14,14,14,13,11,10,11,14,14,12,5,12,6,6,14,13,13,3,2,3,3,3,2,3,4,4,3,1
"272",2107500,"Rafael","7/9/1990 (32 years old)","D/WB (R)","BOT","Brazilian National First Division","BRA","Yes","9/8/2021","12/31/2023","$130K - $1.3M","Right","Reasonable","Very Strong","5'8""","171 lbs","243","7",125,160,7,13,12,7,13,7,10,7,12,11,13,7,12,14,18,15,17,8,9,11,17,13,13,14,10,15,11,16,14,13,12,8,12,14,13,12,13,8,9,16,12,16,14,14,16,5,11,14,17,1,3,2,2,3,1,1,2,3,2,3
"273",19010481,"Taison","1/13/1988 (35 years old)","AM (LC)","PAOK","Greek Super League 1","BRA","No","1/14/2023","6/30/2024","$750K - $1.6M","Right","Reasonable","Very Strong","5'8""","165 lbs","361","65",130,160,9,12,16,12,15,11,7,14,4,7,13,12,8,16,12,12,12,11,11,14,16,16,14,15,4,12,15,12,14,13,14,5,13,13,12,9,13,7,12,13,11,7,9,12,9,15,14,12,15,3,3,3,2,1,1,1,4,3,1,2
"274",2000095783,"Vitor Roque","2/28/2005 (18 years old)","AM (RL), ST (C)","ATP","Brazilian National First Division","BRA","No","4/12/2022","5/31/2027","$26M - $32M","Right","Reasonable","Very Strong","5'8""","167 lbs","44","7",132,160,11,12,14,14,13,8,12,13,8,7,11,14,8,14,11,13,11,14,13,13,13,13,10,14,8,13,12,13,15,14,11,8,11,13,13,13,13,15,11,9,10,11,10,13,9,6,13,10,14,2,4,2,2,1,2,3,2,3,3,2
"275",19101228,"Allan","1/8/1991 (32 years old)","DM, M (C)","Al-Wahda (UAE)","UAE Professional League","BRA","Yes","9/26/2022","5/31/2024","$900K - $10M","Right","Weak","Very Strong","5'9""","163 lbs","398","16",145,160,3,9,13,10,13,6,10,12,6,14,15,10,18,14,16,14,16,13,14,13,17,13,12,14,16,16,12,17,10,13,18,7,14,12,15,15,11,13,12,8,15,11,12,13,12,9,12,14,13,3,3,1,4,1,1,3,1,1,2,1
"276",2000015032,"Kaiky","1/12/2004 (19 years old)","D (C)","Almería","Spanish First Division","BRA","No","7/21/2022","6/30/2028","$19M - $29M","Right","Fairly Strong","Very Strong","6'1""","167 lbs","28","-",125,160,4,6,9,9,13,7,13,7,7,14,13,9,14,13,13,13,11,11,13,12,12,9,8,13,13,13,14,13,12,12,11,14,13,12,13,13,9,20,13,12,10,11,4,11,9,6,11,12,9,2,1,2,1,2,3,3,1,2,1,3
"277",19337893,"Roger Ibañez","11/23/1998 (24 years old)","D (C)","AS Roma","Italian Serie A","BRA","Yes","3/4/2021","6/30/2028","$35M - $42M","Right","Fairly Strong","Very Strong","6'2""","176 lbs","121","6",145,160,5,8,11,9,12,4,16,9,10,15,14,6,17,12,16,17,17,10,9,11,11,8,7,8,14,12,10,12,14,13,12,16,17,16,15,15,12,14,10,14,9,13,5,9,12,6,14,14,15,3,1,2,4,3,2,3,3,4,1,2
"278",2000206497,"Deivid Washington","6/5/2005 (18 years old)","ST (C)","SAN","Brazilian National First Division","BRA","No","4/18/2023","4/16/2026","$18.5M - $22M","Right","Fairly Strong","Very Strong","6'0""","171 lbs","9","2",118,159,5,9,11,14,11,7,14,10,6,7,12,12,5,14,7,12,7,14,12,11,13,11,9,13,10,12,12,11,13,12,12,13,12,13,10,11,13,13,10,12,13,12,5,8,12,2,13,10,20,2,1,3,3,2,2,4,2,3,3,3
"279",14005628,"Erik Lamela","3/4/1992 (31 years old)","AM (RLC)","Sevilla","Spanish First Division","ARG","Yes","7/26/2021","6/30/2024","$45M - $68M","Left","Very Strong","Reasonable","5'11""","176 lbs","325","51",148,155,13,14,15,11,14,14,9,14,4,9,15,14,13,16,16,14,12,17,12,12,17,17,5,14,9,16,16,19,13,16,13,9,10,13,14,12,15,9,8,14,11,11,16,12,12,7,8,12,4,1,3,2,4,1,1,2,3,1,3,3
"280",2000090823,"Matheus França","4/1/2004 (19 years old)","M/AM (C)","FLA","Brazilian National First Division","BRA","No","6/13/2022","12/31/2026","$18.5M - $23M","Right","Reasonable","Very Strong","6'0""","147 lbs","32","5",123,159,8,10,14,10,15,8,10,11,3,12,14,6,12,15,15,13,12,12,12,12,15,15,8,13,13,13,13,13,14,14,13,11,15,14,12,13,16,11,13,15,10,13,8,19,9,4,12,10,16,3,3,2,3,2,1,1,1,1,3,1
"281",18004457,"Kevin De Bruyne","6/28/1991 (31 years old)","M (RLC), AM (C)","Man City","English Premier Division","BEL","Yes","6/14/2021","6/30/2025","Not for Sale","Right","Strong","Very Strong","5'11""","149 lbs","424","103",190,190,14,19,16,16,16,17,6,17,7,9,18,15,9,18,12,14,13,14,15,18,17,16,13,15,10,14,20,15,16,13,14,10,16,14,16,13,14,13,16,18,11,14,7,15,6,13,15,17,13,3,3,2,4,1,1,3,2,1,2,3
"282",18026122,"Thibaut Courtois","5/11/1992 (31 years old)","GK","R. Madrid","Spanish First Division","BEL","Yes","8/16/2021","6/30/2026","Not for Sale","Left","Very Strong","Reasonable","6'6""","211 lbs","444","-",181,181,6,3,10,2,10,10,10,2,3,2,13,3,1,12,8,15,15,12,16,16,16,14,13,2,16,14,9,11,12,13,14,18,12,11,8,14,13,14,14,15,16,15,5,18,5,10,16,14,14,15,12,19,6,18,16,16,5,14,16,20
"283",8169242,"Toby Alderweireld","3/2/1989 (34 years old)","D (RC)","Antwerp","Jupiler Pro League","BEL","Yes","7/15/2022","6/30/2025","Not for Sale","Right","Fairly Strong","Very Strong","6'2""","200 lbs","395","24",142,170,7,10,10,10,14,10,15,9,12,13,15,8,15,13,13,15,14,15,13,15,14,10,14,10,15,14,13,13,9,10,12,14,15,9,12,17,13,15,15,18,15,13,10,13,5,9,15,13,11,1,2,2,1,3,1,3,2,2,1,1
"284",18007344,"Romelu Lukaku","5/13/1993 (30 years old)","ST (C)","Chelsea","English Premier Division","BEL","Yes","8/12/2021","6/30/2026","$37M - $55M","Left","Very Strong","Fairly Strong","6'3""","205 lbs","448","210",159,170,4,9,13,18,13,11,15,14,4,5,13,20,9,13,16,14,15,13,13,13,18,13,16,15,5,17,11,12,15,9,20,16,13,16,14,20,6,12,15,17,17,11,12,12,10,8,14,18,19,2,1,1,3,1,3,3,1,3,2,2
"285",2000127875,"Ethan Butera","4/16/2006 (17 years old)","D (C), DM","RSC Anderlecht","Jupiler Pro League","BEL","Yes","6/13/2022","6/30/2024","$160K - $1.6M","Left","Very Strong","Reasonable","6'0""","163 lbs","13","-",99,169,5,9,11,5,13,8,12,10,5,12,13,3,12,13,8,13,11,11,11,12,11,5,12,10,12,10,10,10,9,9,10,11,10,10,9,12,14,19,13,11,12,10,8,10,10,4,11,10,12,1,3,2,1,4,3,3,2,2,2,2
"286",18106083,"Jérémy Doku","5/27/2002 (21 years old)","AM (RL), ST (C)","Rennes","Ligue 1 Uber Eats","BEL","Yes","10/5/2020","6/30/2025","$54M - $67M","Right","Fairly Strong","Very Strong","5'7""","147 lbs","109","14",145,168,11,11,15,11,14,8,5,8,5,5,13,14,7,15,14,11,15,11,10,9,12,16,6,12,7,12,10,13,18,16,11,8,16,17,12,11,11,10,13,11,13,12,9,12,7,12,10,15,12,1,3,2,3,1,1,1,3,2,2,2
"287",8169425,"Dries Mertens","5/6/1987 (36 years old)","AM (C), ST (C)","Galatasaray","Turkish Super League","BEL","Yes","8/8/2022","6/30/2024","$1.8M - $3.9M","Right","Fairly Strong","Very Strong","5'7""","134 lbs","574","206",135,166,12,13,13,12,17,13,7,13,3,4,14,16,6,17,14,17,13,15,13,16,17,15,16,15,9,16,15,14,13,15,8,6,15,8,10,7,13,12,6,18,15,18,11,15,10,10,14,16,17,1,2,1,1,3,2,1,1,2,1,1
"288",8150316,"Jan Vertonghen","4/24/1987 (36 years old)","D (LC)","RSC Anderlecht","Jupiler Pro League","BEL","Yes","9/1/2022","6/30/2024","$160K - $1.6M","Left Only","Very Strong","Weak","6'2""","174 lbs","480","33",132,165,7,11,10,8,14,11,14,10,12,15,14,10,16,14,14,14,14,14,14,12,12,12,18,10,16,15,11,11,7,9,11,14,15,10,11,15,12,11,10,14,17,16,11,13,13,9,16,14,14,3,2,3,3,2,2,3,1,3,1,2
"289",8169332,"Radja Nainggolan","5/4/1988 (35 years old)","DM, M/AM (C)","SPAL","Italian Serie C/B","BEL","Yes","1/30/2023","6/30/2024","$50K - $500K","Right","Reasonable","Very Strong","5'9""","158 lbs","492","56",114,165,5,10,11,12,14,11,6,16,3,8,12,10,13,14,18,14,18,13,12,12,20,12,16,14,11,14,14,16,8,11,13,9,10,9,8,14,11,6,7,4,17,13,12,15,13,18,12,18,16,3,1,1,3,3,3,1,4,1,2,2
"290",14217414,"Lucas Beltrán","3/29/2001 (22 years old)","ST (C)","River","Argentine Premier Division","ARG","Yes","10/4/2022","12/31/2025","$24M - $36M","Right","Reasonable","Very Strong","5'9""","165 lbs","88","24",135,155,7,7,14,15,13,7,13,13,6,5,12,10,9,15,15,13,12,13,13,12,13,14,13,14,12,13,10,17,13,13,14,10,14,13,14,15,9,11,15,14,13,12,7,11,8,5,13,14,8,1,3,4,3,3,3,3,3,1,2,1
"291",18027198,"Yannick Carrasco","9/4/1993 (29 years old)","WB/M (L), AM (RL)","A. Madrid","Spanish First Division","BEL","Yes","9/8/2020","6/30/2024","$15M - $22M","Right","Fairly Strong","Very Strong","5'11""","156 lbs","326","76",155,165,14,13,17,13,14,15,8,13,6,4,13,15,4,17,11,12,10,14,12,13,15,16,9,16,7,10,15,12,15,14,14,10,12,16,13,11,12,8,12,12,13,9,11,13,10,14,11,16,10,3,4,1,2,3,3,2,2,1,3,2
"292",18105815,"Arthur Theate","5/25/2000 (23 years old)","D (C)","Rennes","Ligue 1 Uber Eats","BEL","Yes","7/29/2022","6/30/2026","$40M - $51M","Left","Very Strong","Weak","6'1""","167 lbs","102","11",136,162,5,9,11,9,11,6,16,9,8,14,12,7,14,12,15,16,15,12,12,11,17,13,13,11,14,14,11,14,14,14,13,14,13,13,15,14,11,10,10,15,12,11,5,14,13,12,14,16,15,3,1,3,3,1,1,3,2,2,4,3
"293",18110528,"Charles De Ketelaere","3/10/2001 (22 years old)","AM (C), ST (C)","AC Milan","Italian Serie A","BEL","Yes","8/2/2022","6/30/2027","$30M - $45M","Left","Very Strong","Reasonable","6'4""","174 lbs","122","18",144,161,8,14,14,13,15,9,13,12,9,7,14,13,11,16,8,12,9,11,13,12,13,14,8,14,10,14,15,13,14,15,15,16,13,14,14,14,18,7,15,15,8,13,6,10,8,10,12,14,11,2,1,1,3,1,2,2,1,1,2,2
"294",2000155483,"Julien Duranville","5/5/2006 (17 years old)","M/AM (RL)","Borussia Dortmund","Bundesliga","BEL","Yes","1/27/2023","6/30/2026","$22M - $27M","Right","Fairly Strong","Very Strong","5'7""","147 lbs","12","2",113,161,10,11,15,11,13,10,5,10,3,6,11,10,6,14,7,8,9,8,9,8,15,17,3,11,7,9,10,9,17,14,9,4,11,16,8,7,12,15,13,13,10,12,13,12,3,6,11,18,12,3,1,3,2,2,1,4,3,3,1,2
"295",8169215,"Axel Witsel","1/12/1989 (34 years old)","D (C), DM, M (C)","A. Madrid","Spanish First Division","BEL","Yes","4/17/2023","6/30/2024","$750K - $5.4M","Right","Fairly Strong","Very Strong","6'1""","178 lbs","474","64",147,160,8,10,13,10,15,8,13,11,9,12,16,14,12,15,11,18,13,18,19,14,13,8,13,12,12,18,13,13,10,11,18,14,18,10,14,14,10,14,10,15,18,6,10,18,13,11,16,8,17,2,2,2,2,1,2,3,1,1,1,1
"296",18077264,"Youri Tielemans","5/7/1997 (26 years old)","DM, M (C)","Leicester","Sky Bet Championship","BEL","Yes","6/14/2021","6/30/2026","$29M - $43M","Right","Fairly Strong","Very Strong","5'9""","158 lbs","337","52",149,160,11,13,13,12,16,12,9,14,3,11,18,14,12,17,13,15,12,14,12,15,13,15,14,14,12,14,17,13,11,12,12,8,15,10,12,10,15,15,15,14,13,13,5,12,8,7,13,17,13,3,1,2,2,3,3,3,2,2,3,2
"297",18053710,"Michy Batshuayi","10/2/1993 (29 years old)","ST (C)","Fenerbahçe","Turkish Super League","BEL","Yes","9/2/2022","6/30/2024","$12.5M - $19M","Right","Strong","Very Strong","6'1""","171 lbs","307","113",135,160,5,7,13,15,16,9,11,12,8,3,11,14,3,14,15,13,13,15,9,9,12,14,10,14,5,11,9,11,13,15,16,11,16,11,14,14,5,8,8,9,11,7,9,10,9,8,16,15,13,3,1,1,2,2,1,3,3,3,3,4
"298",18009139,"Christian Benteke","12/3/1990 (32 years old)","ST (C)","D.C. United","Major League Soccer","BEL","Yes","8/5/2022","12/31/2024","Not for Sale","Right","Reasonable","Very Strong","6'3""","189 lbs","424","140",121,160,7,7,10,11,8,9,18,10,7,9,9,10,4,13,15,12,14,9,12,10,16,12,10,12,8,11,11,9,12,13,17,18,14,12,14,19,1,10,12,14,16,10,12,10,12,8,10,16,18,3,2,1,3,2,3,2,4,1,1,4
"299",91207274,"Amadou Onana","8/16/2001 (21 years old)","DM, M (C)","Everton","English Premier Division","BEL","Yes","8/9/2022","6/30/2027","$104M - $157M","Right","Fairly Strong","Very Strong","6'4""","167 lbs","90","4",136,160,7,9,14,10,13,9,11,9,8,12,13,9,15,14,15,11,14,13,12,12,14,14,12,11,14,10,14,14,12,13,15,15,13,17,14,14,11,10,12,9,13,6,10,15,10,15,10,17,13,1,2,3,2,2,2,2,1,3,1,3
"300",18107187,"Maarten Vandevoordt","2/26/2002 (21 years old)","GK","KRC Genk","Jupiler Pro League","BEL","Yes","6/13/2022","6/30/2026","$700K - $5.4M","Right Only","Weak","Very Strong","6'4""","167 lbs","98","-",121,157,5,1,2,2,9,8,1,1,1,2,14,2,2,14,14,10,12,10,14,11,14,14,10,1,11,10,8,14,13,14,12,14,15,14,10,10,11,18,10,14,10,10,5,12,9,12,12,11,7,11,12,14,6,15,14,12,13,12,12,12
"301",14008030,"Nicolás Tagliafico","8/31/1992 (30 years old)","D/WB/M (L)","OL","Ligue 1 Uber Eats","ARG","Yes","7/21/2022","6/30/2025","$10.5M - $15.5M","Left","Very Strong","Weak","5'8""","147 lbs","342","14",138,155,8,12,12,7,13,11,15,9,13,15,13,4,16,12,19,14,17,12,13,12,15,12,16,13,14,15,12,17,11,13,14,13,13,11,16,13,12,5,10,18,15,16,5,18,16,3,15,16,16,1,2,4,1,2,1,2,1,3,2,1
"302",18054004,"Leandro Trossard","12/4/1994 (28 years old)","WB/M (L), AM (LC), ST (C)","Arsenal","English Premier Division","BEL","Yes","1/20/2023","6/30/2026","$81M - $123M","Right","Strong","Very Strong","5'8""","147 lbs","310","89",155,157,14,12,15,14,14,12,6,13,4,6,14,13,4,16,13,12,13,13,14,13,13,15,8,15,9,12,15,12,16,15,13,6,12,15,13,9,15,12,12,11,12,8,8,15,8,9,14,15,12,1,1,1,3,3,2,3,2,2,2,1
"303",2000127879,"Rayane Bounida","3/3/2006 (17 years old)","AM (RLC)","Ajax","Eredivisie","BEL","Yes","7/1/2022","6/30/2025","$8.8M - $11M","Right","Fairly Strong","Very Strong","5'4""","121 lbs","-","-",95,157,8,8,16,10,16,6,2,8,1,2,10,14,2,16,7,6,14,8,6,10,13,17,2,8,2,4,12,10,15,16,5,3,8,13,6,3,12,13,9,11,10,10,12,7,9,2,6,9,19,1,3,3,1,1,1,1,4,2,1,2
"304",2000016527,"Stanis Idumbo Muzambo","6/29/2005 (17 years old)","M (C), AM (LC)","Ajax","Eredivisie","BEL","Yes","6/13/2022","6/30/2024","$19.5M - $25M","Right","Weak","Very Strong","5'7""","141 lbs","12","-",106,157,8,8,16,7,15,7,4,7,5,5,13,5,5,16,6,7,16,10,10,11,16,14,7,9,7,7,12,10,13,15,11,8,7,14,11,8,9,14,11,15,14,12,11,8,6,5,14,10,15,1,1,3,3,2,2,2,2,2,1,1
"305",28116558,"Largie Ramazani","2/27/2001 (22 years old)","AM (RL), ST (C)","Almería","Spanish First Division","BEL","Yes","6/30/2020","6/30/2025","$40M - $60M","Right","Strong","Very Strong","5'6""","149 lbs","86","15",133,155,4,11,15,14,13,8,4,6,4,4,12,13,4,14,9,8,8,11,9,11,14,14,3,13,4,10,9,12,18,14,8,3,13,17,12,6,6,19,10,11,13,10,10,12,3,1,11,15,15,4,2,1,2,1,1,3,1,1,2,3
"306",18101745,"Lois Openda","2/16/2000 (23 years old)","ST (C)","RC Lens","Ligue 1 Uber Eats","BEL","Yes","7/5/2022","6/30/2028","$50M - $61M","Right","Fairly Strong","Very Strong","5'10""","165 lbs","139","53",143,155,7,8,14,15,14,7,13,10,6,6,11,16,6,14,15,13,13,12,12,13,15,14,6,15,6,12,11,13,17,15,12,11,14,16,12,13,10,12,10,12,12,6,6,12,12,15,13,18,16,1,1,3,2,1,3,2,1,3,2,3
"307",18054092,"Adnan Januzaj","2/5/1995 (28 years old)","M/AM (RL)","Sevilla","Spanish First Division","BEL","Yes","9/1/2022","6/30/2026","$8.8M","Left","Very Strong","Reasonable","5'11""","165 lbs","226","22",135,155,16,13,17,13,15,15,5,15,3,6,15,13,6,17,10,11,8,13,11,13,10,17,11,13,8,8,16,11,14,16,15,9,11,12,11,9,15,13,7,11,12,10,12,14,5,11,7,15,18,2,2,1,1,2,3,1,4,1,2,2
"308",18045347,"Divock Origi","4/18/1995 (28 years old)","ST (C)","AC Milan","Italian Serie A","BEL","Yes","7/5/2022","6/30/2026","$140K - $1.4M","Right","Fairly Strong","Very Strong","6'2""","165 lbs","236","44",137,154,6,11,14,13,14,9,12,14,8,7,13,13,7,14,10,12,11,13,12,12,8,13,8,13,7,13,13,12,13,14,15,13,11,15,14,14,12,16,12,15,11,18,15,15,6,5,11,10,13,1,1,3,2,3,1,2,3,1,2,1
"309",18097160,"Albert Sambi Lokonga","10/22/1999 (23 years old)","DM, M (C)","Arsenal","English Premier Division","BEL","Yes","7/19/2021","6/30/2026","$33M - $51M","Right","Fairly Strong","Very Strong","6'0""","163 lbs","103","3",137,154,10,10,13,8,15,10,10,12,10,11,14,11,13,14,12,14,12,14,14,12,15,13,12,13,11,16,13,15,13,13,11,10,14,14,14,12,12,14,12,14,12,14,14,14,12,6,12,14,14,1,1,1,3,4,2,1,4,3,3,2
"310",85023676,"Thorgan Hazard","3/29/1993 (30 years old)","M (RL), AM (RLC)","PSV","Eredivisie","BEL","Yes","6/14/2021","6/30/2024","$700K - $7.2M","Right","Fairly Strong","Very Strong","5'9""","156 lbs","329","62",138,153,15,13,14,12,14,13,7,13,7,8,13,13,8,14,13,12,10,11,13,13,13,13,10,13,8,15,13,14,14,13,10,8,11,14,13,9,18,14,14,16,14,10,13,12,6,8,13,12,11,1,1,3,1,2,2,1,3,1,3,1
"311",18074558,"Timothy Castagne","12/5/1995 (27 years old)","D/WB/M (RL)","Leicester","Sky Bet Championship","BEL","Yes","9/3/2020","6/30/2025","$15M - $23M","Right","Reasonable","Very Strong","6'1""","176 lbs","246","10",139,152,8,14,12,10,12,6,9,8,8,11,13,5,12,13,12,12,11,12,12,12,14,11,9,13,12,15,11,16,14,13,13,12,12,14,15,11,16,13,13,13,12,14,10,14,13,12,15,13,14,2,1,3,1,3,2,1,3,3,2,2
"312",14031132,"Lucas Ocampos","7/11/1994 (28 years old)","M/AM (RL)","Sevilla","Spanish First Division","ARG","Yes","6/14/2021","6/30/2024","$35M - $52M","Right","Fairly Strong","Very Strong","6'2""","185 lbs","361","65",147,155,11,12,15,14,14,9,13,13,12,4,13,15,7,14,14,13,15,13,12,12,16,15,8,16,7,15,11,16,15,14,13,13,14,15,14,14,14,11,7,13,14,13,5,13,8,6,13,15,10,2,1,4,1,1,3,2,2,2,4,2
"313",8167246,"Simon Mignolet","3/6/1988 (35 years old)","GK","Club Brugge","Jupiler Pro League","BEL","Yes","9/29/2022","6/30/2026","Not for Sale","Right Only","Weak","Very Strong","6'4""","194 lbs","488","1",135,152,3,1,2,2,11,8,4,3,3,2,11,3,3,8,10,15,14,14,14,13,15,1,13,3,15,11,8,10,9,15,13,14,14,11,12,13,13,16,16,18,13,15,4,13,1,5,13,15,16,12,12,17,14,15,12,13,7,12,11,13
"314",18010782,"Koen Casteels","6/25/1992 (30 years old)","GK","VfL Wolfsburg","Bundesliga","BEL","Yes","6/14/2021","6/30/2024","$5.8M - $8.6M","Left Only","Very Strong","Weak","6'6""","189 lbs","290","-",140,152,3,2,1,1,9,5,7,3,3,3,12,3,2,11,14,13,13,13,13,13,15,6,15,1,14,13,11,12,10,15,12,18,14,11,12,12,11,18,16,18,14,14,8,14,5,6,13,15,12,13,16,16,8,14,12,13,12,12,14,16
"315",18113140,"Aster Vranckx","10/4/2002 (20 years old)","DM, M/AM (C)","VfL Wolfsburg","Bundesliga","BEL","Yes","7/1/2021","6/30/2025","$8.4M - $12.5M","Right","Reasonable","Very Strong","6'0""","171 lbs","77","7",122,152,11,10,13,9,13,11,10,11,7,12,13,10,13,13,13,12,14,12,12,11,15,10,13,13,12,15,12,14,12,13,12,11,13,12,14,12,14,9,12,11,13,11,6,12,12,10,12,15,13,2,2,3,2,1,3,1,2,1,4,3
"316",18115012,"Roméo Lavia","1/6/2004 (19 years old)","DM, M (C)","Southampton","Sky Bet Championship","BEL","Yes","7/7/2022","6/30/2027","$66M","Right","Reasonable","Very Strong","5'11""","165 lbs","29","1",134,151,5,7,13,8,14,11,7,11,5,10,14,5,14,14,15,14,12,13,12,13,16,14,12,13,14,16,14,16,14,14,12,9,14,14,14,13,11,15,14,14,13,8,7,13,6,7,12,18,14,3,1,1,1,3,4,3,2,2,1,3
"317",2000127465,"Arthur Vermeeren","2/7/2005 (18 years old)","DM, M (C)","Antwerp","Jupiler Pro League","BEL","Yes","2/8/2023","6/30/2026","$22M - $26M","Right","Reasonable","Very Strong","5'11""","152 lbs","32","2",110,151,8,8,11,8,12,8,7,9,8,8,14,9,10,12,11,13,12,15,13,14,10,11,9,12,10,14,14,14,13,12,6,8,11,13,10,6,12,13,14,14,11,17,12,11,5,6,12,14,12,3,1,1,2,3,1,3,2,1,3,2
"318",18097159,"Alexis Saelemaekers","6/27/1999 (23 years old)","WB/M/AM (R)","AC Milan","Italian Serie A","BEL","Yes","10/15/2021","6/30/2026","$7.2M - $9.2M","Right","Fairly Strong","Very Strong","5'11""","158 lbs","168","8",138,151,6,13,14,8,14,8,11,12,9,10,13,7,12,14,14,13,14,11,13,12,16,13,10,13,13,16,12,15,14,14,12,10,15,14,14,10,17,9,9,15,13,11,7,12,12,4,13,14,15,1,1,3,3,2,3,1,3,3,4,2
"319",18115016,"Zeno Debast","10/24/2003 (19 years old)","D (C)","RSC Anderlecht","Jupiler Pro League","BEL","Yes","5/8/2022","6/30/2025","$20M - $31M","Right","Fairly Strong","Very Strong","6'3""","160 lbs","41","-",119,151,6,11,8,7,13,8,13,8,8,14,15,9,14,13,8,12,8,14,14,10,14,13,7,10,12,12,13,12,12,12,12,14,10,12,10,11,10,8,10,14,8,14,14,12,8,10,11,14,7,3,1,3,3,3,2,3,2,3,2,3
"320",18101760,"Cyril Ngongé","5/26/2000 (23 years old)","M (R), AM (RC), ST (C)","Hellas Verona","Italian Serie A","BEL","Yes","1/19/2023","6/30/2027","$4.2M - $6.4M","Left","Very Strong","Reasonable","5'10""","160 lbs","103","25",133,150,12,12,14,13,13,9,13,13,7,5,11,14,5,14,13,12,14,11,11,10,8,14,8,13,4,12,10,11,16,14,12,9,10,15,12,9,12,11,7,11,11,10,5,11,9,15,12,15,12,2,4,1,4,2,1,2,3,1,2,1
"321",18083577,"Wout Faes","4/3/1998 (25 years old)","D (C)","Leicester","Sky Bet Championship","BEL","Yes","9/1/2022","6/30/2027","$19.5M","Right","Reasonable","Very Strong","6'2""","185 lbs","193","6",130,150,8,10,11,6,12,8,14,8,5,15,12,5,16,12,13,16,13,13,12,11,14,8,14,8,12,13,14,14,12,11,13,14,12,11,13,15,10,12,14,11,12,12,6,12,15,8,10,15,14,1,2,1,1,3,1,1,2,2,3,3
"322",8170873,"Marouane Fellaini","11/22/1987 (35 years old)","DM, M/AM (C), ST (C)","Shandong","Chinese Super League","BEL","Yes","6/1/2021","12/31/2025","Not for Sale","Right","Fairly Strong","Very Strong","6'4""","187 lbs","412","76",131,150,8,8,7,12,13,8,16,10,13,14,12,14,15,13,17,14,17,13,14,14,15,12,8,15,14,18,8,12,9,11,18,17,16,12,12,17,12,8,6,14,12,11,5,12,19,8,15,11,14,3,3,3,2,1,3,1,3,3,3,2
"323",961299,"Sergio Romero","2/22/1987 (36 years old)","GK","Boca","Argentine Premier Division","ARG","Yes","8/8/2022","12/31/2024","Not for Sale","Right Only","Weak","Very Strong","6'4""","191 lbs","242","-",133,155,4,3,3,3,10,7,4,2,3,2,9,2,6,10,10,10,14,12,10,11,9,8,11,3,14,12,11,8,11,13,15,14,10,14,10,16,1,12,11,15,15,9,4,13,9,9,12,9,12,12,14,15,14,14,16,14,8,13,13,15
"324",18111484,"Johan Bakayoko","4/20/2003 (20 years old)","AM (RL)","PSV","Eredivisie","BEL","Yes","2/27/2023","6/30/2026","$10.5M - $16M","Left","Very Strong","Fairly Strong","5'10""","158 lbs","84","25",129,149,12,12,14,8,12,14,9,11,11,4,12,9,5,14,12,11,12,9,9,11,12,15,4,12,5,9,8,11,16,14,12,10,13,16,13,9,14,16,11,10,11,13,11,4,5,2,11,12,15,3,1,1,1,1,3,3,2,1,1,2
"325",18116036,"Mandela Keita","5/10/2002 (21 years old)","DM, M (C)","Antwerp","Jupiler Pro League","BEL","Yes","7/18/2022","6/30/2025","$800K - $11M","Right","Weak","Very Strong","5'11""","171 lbs","50","-",117,149,8,9,12,8,11,10,12,11,8,12,12,5,12,12,12,13,14,13,12,12,14,13,10,13,14,12,13,13,13,12,12,13,8,13,12,13,11,12,12,12,11,12,15,9,13,1,12,14,10,2,3,2,3,2,1,3,3,3,2,2
"326",2000116924,"Ayanda Sishuba","2/2/2005 (18 years old)","AM (C)","RC Lens","Ligue 1 Uber Eats","BEL","Yes","4/18/2023","6/30/2026","$500K - $8.4M","Left","Very Strong","Reasonable","5'8""","147 lbs","-","-",100,149,10,10,13,12,13,11,10,10,4,6,12,8,6,12,6,10,9,12,11,11,15,13,12,11,6,12,11,10,12,12,11,8,14,13,12,8,16,13,14,13,12,12,10,14,5,6,17,14,12,2,3,2,1,2,1,2,2,1,1,1
"327",18045342,"Dennis Praet","5/14/1994 (29 years old)","M (C), AM (RC)","Leicester","Sky Bet Championship","BEL","Yes","8/8/2019","6/30/2024","$4.9M","Right","Fairly Strong","Very Strong","5'11""","171 lbs","324","30",127,148,12,13,13,11,14,12,8,12,12,8,15,10,12,14,12,12,13,14,15,14,13,15,9,13,11,15,13,13,12,10,10,9,14,11,13,12,14,17,10,13,12,11,13,12,8,10,12,13,12,1,3,3,4,2,4,2,3,1,2,1
"328",2000107079,"Malick Fofana","3/31/2005 (18 years old)","AM (RL)","AA Gent","Jupiler Pro League","BEL","Yes","6/13/2022","6/30/2026","$7.4M - $9.2M","Left","Very Strong","Fairly Strong","5'7""","136 lbs","35","4",98,148,6,9,13,9,14,7,8,8,5,5,8,8,6,13,7,8,10,9,10,10,12,13,6,10,8,12,11,9,14,10,8,8,13,13,10,9,11,13,12,10,10,12,11,9,7,6,9,11,20,4,2,2,1,3,3,3,1,1,1,1
"329",18114980,"Hugo Siquet","7/9/2002 (20 years old)","D/WB (R)","Cercle Brugge","Jupiler Pro League","BEL","Yes","1/1/2022","6/30/2026","$5.8M - $8.8M","Right","Weak","Very Strong","5'11""","145 lbs","62","2",122,147,13,14,11,8,10,11,9,10,12,11,11,10,12,12,15,12,14,11,12,11,12,13,12,13,10,14,12,11,15,10,9,9,15,15,15,10,13,12,11,11,13,9,5,14,12,3,13,10,11,3,3,1,1,1,4,1,3,3,2,2
"330",2000254671,"Noah Makembo-Ntemo","3/14/2007 (16 years old)","M/AM (C)","Standard","Jupiler Pro League","BEL","Yes","6/1/2023","6/30/2025","$475K - $4.7M","Right","Weak","Very Strong","5'9""","147 lbs","-","-",86,147,8,8,11,8,10,9,9,11,5,5,9,3,10,10,12,7,11,8,9,11,8,15,11,10,9,11,11,11,13,11,11,10,11,12,10,11,9,14,12,12,12,15,2,12,8,5,9,11,15,2,3,2,3,3,1,1,1,2,2,3
"331",2000254418,"Robin Mirisola","12/8/2006 (16 years old)","ST (C)","KRC Genk","Jupiler Pro League","BEL","Yes","4/6/2022","6/30/2025","$30K - $7.8M","Right","Weak","Very Strong","6'1""","156 lbs","-","-",84,146,7,8,13,12,11,4,9,6,4,6,8,7,6,12,5,11,8,13,6,8,7,11,4,14,4,4,8,8,13,10,8,9,6,11,10,5,8,19,12,12,11,11,10,11,11,8,8,12,14,3,3,1,2,1,3,4,1,1,4,1
"332",18057380,"Leander Dendoncker","4/15/1995 (28 years old)","DM, M (C)","Aston Villa","English Premier Division","BEL","Yes","9/1/2022","6/30/2027","$10.5M - $16M","Right","Reasonable","Very Strong","6'2""","167 lbs","264","17",133,145,9,9,11,8,11,10,15,11,10,13,14,8,14,11,14,15,14,13,15,14,12,10,12,13,14,15,11,15,12,13,14,15,12,13,14,12,13,11,11,14,11,10,8,14,13,12,13,14,8,1,2,2,2,2,2,1,3,1,3,2
"333",18023431,"Christian Kabasele","2/24/1991 (32 years old)","D (C)","Watford","Sky Bet Championship","BEL","Yes","6/14/2021","6/30/2025","Not for Sale","Right","Reasonable","Very Strong","6'2""","189 lbs","307","22",120,145,6,9,9,10,12,8,14,12,10,11,10,10,12,11,12,13,14,12,9,10,13,8,10,12,13,12,9,14,14,12,15,15,12,14,12,14,14,14,12,14,8,13,9,12,8,14,12,15,13,2,3,4,1,2,3,3,2,1,3,1
"334",2000035036,"Alejandro Garnacho","7/1/2004 (18 years old)","AM (RL), ST (C)","Man UFC","English Premier Division","ARG","Yes","4/28/2023","6/30/2028","$176M - $255M","Right","Fairly Strong","Very Strong","5'11""","141 lbs","21","3",142,175,5,8,15,13,14,10,5,10,2,2,12,14,2,14,13,10,12,13,10,10,14,16,4,13,2,10,11,12,18,15,12,9,14,18,12,8,10,15,10,11,14,10,4,5,7,5,11,12,15,3,2,3,3,1,2,1,3,1,1,1
"335",955277,"Lisandro López","3/2/1983 (40 years old)","ST (C)","Sarmiento (Junín)","Argentine Premier Division","ARG","Yes","9/27/2022","12/31/2023","$85K - $250K","Right","Fairly Strong","Very Strong","5'9""","165 lbs","560","206",119,155,9,9,12,14,14,10,12,12,6,4,13,15,7,15,14,15,18,16,16,17,16,14,18,13,8,13,14,12,9,9,10,9,10,9,10,11,10,9,12,18,16,15,13,17,14,7,14,15,14,3,1,3,1,2,2,2,1,3,1,2
"336",18104192,"Nicolas Raskin","2/23/2001 (22 years old)","DM, M (C)","Rangers","cinch Premiership","BEL","Yes","1/30/2023","5/31/2027","$12.5M - $19M","Right","Reasonable","Very Strong","5'10""","163 lbs","93","4",128,145,8,12,13,9,15,11,6,10,7,9,14,8,14,14,16,14,16,12,13,14,12,14,10,13,8,12,14,13,14,12,10,9,12,13,10,11,12,14,14,12,14,11,7,12,15,7,11,14,10,3,2,2,2,1,3,4,3,1,1,4
"337",29232937,"Jude Bellingham","6/29/2003 (19 years old)","DM, M/AM (C)","Borussia Dortmund","Bundesliga","ENG","No","6/13/2022","6/30/2028","$113M - $136M","Right","Fairly Strong","Very Strong","6'1""","165 lbs","133","16",168,188,11,11,16,14,16,11,12,13,6,12,15,13,15,16,17,15,17,16,12,14,20,16,16,16,12,16,16,18,15,15,14,12,16,14,16,12,14,8,9,18,18,16,6,16,12,12,16,20,16,3,1,2,4,1,2,1,3,1,2,1
"338",28122642,"Bukayo Saka","9/5/2001 (21 years old)","AM (RL)","Arsenal","English Premier Division","ENG","No","5/23/2023","6/30/2027","$282M - $369M","Left","Very Strong","Fairly Strong","5'10""","152 lbs","135","31",173,186,13,14,16,14,15,9,7,16,6,9,13,15,10,16,12,16,12,14,14,16,17,16,9,16,10,17,15,15,17,16,17,9,18,15,16,12,18,16,15,17,16,16,4,15,8,5,14,16,18,3,1,3,3,3,2,3,3,2,1,1
"339",28049320,"Harry Kane","7/28/1993 (29 years old)","AM (C), ST (C)","Tottenham","English Premier Division","ENG","Yes","6/14/2021","6/30/2024","$74M - $113M","Either","Very Strong","Very Strong","6'2""","187 lbs","373","227",183,185,9,15,14,19,15,10,15,15,6,8,18,20,10,17,11,15,14,18,15,18,19,12,15,17,10,18,19,16,12,12,14,13,16,14,16,15,9,14,11,20,18,18,12,14,8,12,17,18,10,1,1,1,3,3,3,3,2,3,1,3
"340",28108494,"Phil Foden","5/28/2000 (23 years old)","M (C), AM (RLC)","Man City","English Premier Division","ENG","No","10/13/2021","6/30/2027","$125M - $189M","Left","Very Strong","Reasonable","5'7""","141 lbs","129","35",165,180,13,13,17,14,17,13,8,12,5,8,17,12,8,17,7,14,13,15,15,14,14,16,8,16,9,14,16,16,16,17,15,7,14,16,15,9,13,16,14,14,12,13,6,16,6,12,15,15,12,2,2,2,3,4,3,1,3,1,2,2
"341",28054109,"Raheem Sterling","12/8/1994 (28 years old)","M/AM (RL)","Chelsea","English Premier Division","ENG","No","7/13/2022","6/30/2027","$183M - $221M","Right","Weak","Very Strong","5'8""","154 lbs","348","115",161,180,8,13,15,13,13,10,12,12,5,7,13,12,8,13,12,18,11,12,13,13,13,14,12,20,9,14,13,15,17,18,14,8,20,15,18,12,14,14,10,17,11,8,2,13,4,12,14,16,18,1,2,2,2,1,2,4,2,1,3,3
"342",2000034525,"Samuel Iling","10/4/2003 (19 years old)","WB/M/AM (L)","Juventus","Italian Serie A","ENG","No","12/19/2022","6/30/2025","$80M - $97M","Left","Very Strong","Reasonable","6'0""","156 lbs","21","4",133,179,12,15,13,12,12,7,11,11,7,6,12,11,8,13,10,11,11,12,9,11,13,14,8,13,10,10,10,11,16,11,13,11,15,15,13,13,14,12,13,14,16,8,7,12,6,5,12,16,16,3,2,3,3,1,3,3,2,1,1,3
"343",28106491,"Declan Rice","1/14/1999 (24 years old)","D (C), DM, M (C)","West Ham","English Premier Division","ENG","Yes","6/14/2021","6/30/2028","$92M - $116M","Right","Reasonable","Very Strong","6'1""","176 lbs","204","10",171,179,7,11,14,9,14,8,14,9,10,15,15,11,17,15,13,17,15,17,15,17,17,10,16,16,17,19,14,17,13,13,13,14,18,14,17,14,14,14,16,16,16,15,3,15,12,5,18,16,12,1,1,2,1,2,1,2,1,1,1,1
"344",28108490,"Jadon Sancho","3/25/2000 (23 years old)","M (RL), AM (RLC)","Man UFC","English Premier Division","ENG","No","7/23/2021","6/30/2026","$128M - $193M","Right","Reasonable","Very Strong","5'10""","167 lbs","162","47",148,177,12,13,18,13,16,13,4,8,3,5,16,12,7,17,8,15,6,14,12,12,9,16,5,14,6,14,15,13,15,17,14,7,13,14,13,8,14,10,13,6,11,9,6,13,5,14,11,17,12,2,2,3,3,1,3,2,3,3,1,2
"345",2000298715,"Mikey Moore","8/11/2007 (15 years old)","AM (RLC), ST (C)","Tottenham","English Premier Division","ENG","No","6/12/2023","6/30/2025","$44M - $55M","Right","Strong","Very Strong","5'8""","127 lbs","-","-",91,176,4,8,13,11,13,5,4,6,2,5,11,5,4,14,6,9,7,11,10,12,15,13,4,12,4,12,14,13,10,11,10,8,6,10,7,4,12,13,12,11,11,11,12,12,4,5,14,11,7,1,3,3,3,3,1,2,1,1,3,1
"346",14004049,"Guido Pizarro","2/26/1990 (33 years old)","D (C), DM, M (C)","Tigres","Mexican First Division","ARG","Yes","7/1/2020","6/30/2024","$3.7M - $7.2M","Right","Reasonable","Very Strong","6'2""","163 lbs","474","22",136,155,9,10,11,10,15,9,12,11,3,12,13,8,15,12,12,13,13,14,14,13,15,13,12,13,16,14,12,13,11,12,15,13,15,13,16,14,11,16,11,13,12,15,7,14,8,9,16,14,13,3,3,3,3,1,2,3,1,3,1,2
"347",28067800,"Jack Grealish","9/10/1995 (27 years old)","M (RL), AM (RLC)","Man City","English Premier Division","ENG","Yes","8/5/2021","6/30/2027","$59M - $90M","Right","Strong","Very Strong","5'9""","180 lbs","276","42",164,175,13,15,17,13,15,11,11,13,3,6,14,12,9,15,11,13,14,14,12,13,14,16,12,13,11,14,16,16,15,16,14,7,15,14,14,14,9,10,6,13,16,15,10,14,13,12,15,16,12,3,1,1,3,1,2,2,2,2,1,3
"348",28104124,"Trent Alexander-Arnold","10/7/1998 (24 years old)","D/WB (R), DM","Liverpool","English Premier Division","ENG","No","7/30/2021","6/30/2025","$152M - $202M","Right","Fairly Strong","Very Strong","5'11""","154 lbs","198","12",159,174,14,17,12,9,17,14,11,11,14,11,18,12,13,17,12,13,11,15,11,14,13,13,12,14,11,15,16,13,14,14,14,11,15,14,14,14,14,14,12,16,14,19,5,14,10,7,13,16,15,2,1,3,3,3,3,3,1,4,3,2
"349",2000182795,"Archie Gray","3/12/2006 (17 years old)","DM, M (C)","Leeds","Sky Bet Championship","ENG","No","3/17/2023","6/30/2025","$15.5M - $19.5M","Right","Fairly Strong","Very Strong","6'0""","158 lbs","-","-",117,174,8,9,13,9,13,9,7,10,5,8,14,7,11,13,13,13,12,14,11,13,13,13,8,12,12,14,13,13,12,12,14,10,12,13,12,9,11,13,10,13,16,14,3,14,8,2,12,11,10,3,2,2,2,3,2,1,4,1,3,1
"350",28100266,"Marcus Rashford","10/31/1997 (25 years old)","AM (L), ST (C)","Man UFC","English Premier Division","ENG","No","6/14/2021","6/30/2028","$198M - $237M","Right","Reasonable","Very Strong","6'0""","154 lbs","239","76",163,173,6,13,15,16,14,13,12,13,3,2,14,16,4,15,13,14,10,13,13,11,17,18,12,16,5,12,13,10,18,16,16,12,17,17,15,15,12,18,12,17,15,16,6,18,6,4,13,16,9,1,2,2,2,1,2,2,3,2,2,1
"351",28103590,"Mason Mount","1/10/1999 (24 years old)","M (C), AM (RLC)","Chelsea","English Premier Division","ENG","No","6/14/2021","6/30/2028","$54M - $81M","Right","Fairly Strong","Very Strong","5'11""","160 lbs","193","43",158,170,15,12,11,14,15,14,9,12,5,7,14,15,11,14,15,14,15,15,12,14,18,13,12,17,14,18,12,20,14,13,10,9,15,15,19,11,12,17,16,16,14,11,8,14,6,6,12,18,16,2,1,1,2,3,3,1,3,1,3,2
"352",28108035,"Reece James","12/8/1999 (23 years old)","D (RC), WB (R)","Chelsea","English Premier Division","ENG","No","9/5/2022","6/30/2028","$166M - $198M","Right","Reasonable","Very Strong","5'10""","200 lbs","143","10",161,170,13,16,11,12,14,14,14,11,9,13,12,12,14,15,16,13,18,16,14,16,17,12,13,12,13,15,11,16,15,12,19,10,14,14,14,18,13,12,15,19,16,10,5,15,10,4,16,17,8,3,1,2,4,3,2,1,2,1,2,1
"353",28124573,"Levi Colwill","2/26/2003 (20 years old)","D (LC)","Chelsea","English Premier Division","ENG","No","6/13/2022","6/30/2028","$178M - $214M","Left","Very Strong","Reasonable","6'2""","194 lbs","46","2",141,170,9,7,11,5,13,6,13,2,8,13,14,11,13,14,10,12,11,16,12,14,13,5,13,11,14,12,12,14,15,12,15,15,14,15,14,13,16,17,12,13,12,10,7,8,9,5,11,10,13,2,3,2,1,3,2,1,3,2,1,1
"354",29193659,"Jacob Ramsey","5/28/2001 (22 years old)","M (C), AM (LC)","Aston Villa","English Premier Division","ENG","No","4/26/2022","6/30/2027","$106M - $133M","Right","Fairly Strong","Very Strong","5'11""","134 lbs","99","15",141,170,8,10,16,14,14,7,9,12,7,10,13,9,10,14,9,13,16,15,12,12,15,13,8,14,10,14,13,14,15,14,13,11,15,14,14,13,11,13,11,15,10,14,7,14,9,5,13,13,10,2,1,3,3,4,3,2,2,1,1,2
"355",28060397,"John Stones","5/28/1994 (29 years old)","D (RC), DM","Man City","English Premier Division","ENG","No","8/10/2021","6/30/2026","$268M - $292M","Right","Fairly Strong","Very Strong","6'2""","158 lbs","245","8",166,170,4,6,14,8,14,5,14,6,8,13,16,12,16,16,13,16,17,18,16,15,13,12,13,15,16,16,14,17,14,13,12,16,16,15,16,15,13,16,13,15,14,15,9,14,8,7,16,17,10,2,1,3,2,3,1,2,1,2,2,1
"356",2000108031,"Will Lankshear","4/20/2005 (18 years old)","ST (C)","Tottenham","English Premier Division","ENG","No","5/10/2023","6/30/2026","$19.5M - $24M","Right Only","Weak","Very Strong","5'11""","154 lbs","-","-",95,168,8,4,11,13,10,7,10,9,6,8,8,10,5,11,12,12,9,11,8,14,7,14,11,14,8,8,8,9,14,11,7,8,17,13,14,11,11,11,9,11,11,10,7,13,8,7,12,12,10,1,2,3,4,3,1,1,3,1,1,2
"357",2000096330,"Alejo Veliz","9/19/2003 (19 years old)","ST (C)","Rosario Central","Argentine Premier Division","ARG","No","1/1/2020","12/31/2025","$12M - $18.5M","Right","Reasonable","Very Strong","6'2""","169 lbs","60","19",125,154,8,9,11,14,12,9,15,12,7,8,11,13,8,12,9,13,12,13,12,12,13,10,9,14,7,11,10,12,13,11,13,14,14,12,13,14,6,11,8,13,12,12,8,13,7,7,13,12,10,1,3,1,1,1,2,4,1,2,3,4
"358",28108033,"Marc Guéhi","7/13/2000 (22 years old)","D (C)","Crystal Palace","English Premier Division","ENG","No","7/18/2021","6/30/2026","$72M - $87M","Right","Fairly Strong","Very Strong","6'0""","176 lbs","125","3",149,168,5,6,11,9,14,7,12,8,9,14,13,6,15,14,11,14,13,14,14,13,15,11,15,9,15,13,11,14,15,15,14,14,16,14,14,14,12,17,14,16,12,13,7,13,10,5,15,14,13,2,1,1,2,3,1,3,2,4,1,2
"359",2000098727,"Rico Lewis","11/21/2004 (18 years old)","D/WB (R), DM, M (C)","Man City","English Premier Division","ENG","No","7/1/2022","6/30/2025","$80M - $100M","Right","Weak","Very Strong","5'7""","143 lbs","14","-",136,167,3,9,12,7,11,5,11,4,9,10,12,11,12,12,15,11,16,14,12,13,17,12,13,12,15,12,11,15,14,16,12,7,13,13,14,12,17,15,14,16,14,10,3,14,10,4,15,13,10,1,1,1,1,1,2,2,4,2,3,1
"360",28124569,"Tino Livramento","11/12/2002 (20 years old)","D/WB (R)","Southampton","Sky Bet Championship","ENG","Yes","8/2/2021","6/30/2026","$40M","Right","Reasonable","Very Strong","6'1""","176 lbs","30","1",134,167,7,14,14,7,13,7,11,5,9,11,13,7,13,14,12,12,12,11,10,12,15,12,10,12,12,12,10,14,16,12,13,11,14,15,14,12,13,18,14,8,13,12,7,12,6,7,11,9,11,1,3,3,3,3,1,2,3,1,2,2
"361",95079228,"Alex Scott","8/21/2003 (19 years old)","DM, M (C), AM (RC)","Bristol City","Sky Bet Championship","ENG","No","8/21/2021","6/30/2025","$27M - $41M","Right","Weak","Very Strong","5'10""","152 lbs","83","5",132,166,5,12,14,11,14,6,8,9,4,8,13,7,12,13,12,14,12,15,11,13,18,15,9,15,13,14,14,15,13,15,14,8,12,14,14,9,13,13,14,13,10,15,7,13,8,8,11,10,10,1,1,1,1,1,3,1,3,2,1,1
"362",2000283271,"Ethan Nwaneri","3/21/2007 (16 years old)","M (C), AM (RLC), ST (C)","Arsenal","English Premier Division","ENG","No","6/12/2023","6/30/2025","$41M - $51M","Left","Very Strong","Weak","5'7""","127 lbs","1","-",115,166,10,10,14,12,12,7,5,12,1,5,13,8,8,14,11,9,9,11,8,8,13,14,7,11,6,13,13,12,15,14,11,6,13,14,10,6,14,20,10,9,11,12,10,4,10,4,12,16,15,3,3,3,2,1,1,2,1,3,2,1
"363",28005568,"Jordan Henderson","6/17/1990 (32 years old)","DM, M (C)","Liverpool","English Premier Division","ENG","No","6/14/2021","6/30/2025","$11M - $16.5M","Right","Reasonable","Very Strong","6'0""","176 lbs","441","34",150,165,11,13,11,8,15,10,10,9,9,15,14,10,14,14,14,15,16,15,15,15,19,11,19,14,15,18,14,18,12,12,14,12,14,13,14,15,13,19,15,20,19,18,9,16,8,4,13,18,15,3,2,3,1,4,1,1,1,3,3,2
"364",28106342,"Kiernan Dewsbury-Hall","9/6/1998 (24 years old)","M/AM (C)","Leicester","Sky Bet Championship","ENG","No","6/24/2022","6/30/2027","$17.5M - $27M","Left","Very Strong","Reasonable","5'9""","158 lbs","108","10",135,165,13,12,13,13,14,14,8,11,5,9,15,10,12,13,13,13,12,13,12,12,15,13,11,14,12,15,15,16,12,15,11,7,18,11,16,12,12,12,13,14,12,16,6,14,8,6,13,13,15,3,2,1,1,2,2,1,2,2,2,1
"365",28100207,"Harvey Barnes","12/9/1997 (25 years old)","M (L), AM (RLC)","Leicester","Sky Bet Championship","ENG","No","6/14/2021","6/30/2026","$37M - $46M","Right","Fairly Strong","Very Strong","5'10""","145 lbs","216","55",140,165,9,13,16,12,14,11,8,14,6,6,11,8,7,14,9,12,9,11,9,12,12,15,7,12,4,12,13,12,15,15,13,10,13,16,13,12,12,12,12,14,11,11,5,12,2,1,8,12,15,3,3,3,3,2,3,1,3,4,1,4
"366",37076092,"Noni Madueke","3/10/2002 (21 years old)","M (RL), AM (RLC)","Chelsea","English Premier Division","ENG","No","1/20/2023","6/30/2030","$103M - $155M","Left","Very Strong","Reasonable","5'9""","160 lbs","70","16",139,165,11,11,17,13,15,11,11,11,11,3,12,9,5,15,13,10,14,15,11,11,12,16,5,12,5,10,8,12,15,15,14,13,15,16,11,14,17,10,9,10,12,12,18,18,14,7,9,10,10,2,3,1,3,3,3,1,3,2,4,1
"367",29128536,"Ben Chilwell","12/21/1996 (26 years old)","D/WB (L)","Chelsea","English Premier Division","ENG","No","4/11/2023","6/30/2027","$114M - $172M","Left","Very Strong","Fairly Strong","5'11""","169 lbs","164","12",155,165,13,15,15,7,15,11,14,7,11,14,13,11,13,13,12,14,13,14,13,14,14,11,12,11,15,14,12,16,15,14,15,13,14,15,16,13,10,15,12,15,12,13,4,10,5,7,13,17,18,1,3,3,1,2,3,2,4,1,4,2
"368",14217167,"Alan Velasco","7/27/2002 (20 years old)","AM (RLC), ST (C)","FC Dallas","Major League Soccer","ARG","No","2/1/2022","12/31/2025","$5.4M - $6.8M","Right","Reasonable","Very Strong","5'6""","138 lbs","88","14",127,154,11,11,15,13,13,13,7,10,6,6,13,9,6,14,13,12,9,14,13,13,15,14,6,13,10,10,14,12,13,13,10,5,12,14,12,8,12,7,13,15,13,13,10,14,5,5,13,12,14,2,3,1,2,4,3,3,2,3,2,2
"369",28009441,"Kyle Walker","5/28/1990 (33 years old)","D/WB (R)","Man City","English Premier Division","ENG","No","6/14/2021","6/30/2024","$125M - $150M","Right","Reasonable","Very Strong","5'10""","182 lbs","420","8",164,164,4,11,14,7,13,11,13,8,12,14,13,6,13,13,13,16,13,13,13,13,16,10,15,13,14,15,12,16,19,13,13,11,20,18,17,13,14,15,14,14,7,14,7,13,5,7,18,15,10,1,1,1,1,1,3,2,3,1,1,3
"370",29115800,"Joe Gomez","5/23/1997 (26 years old)","D (RLC)","Liverpool","English Premier Division","ENG","No","7/7/2022","6/30/2027","$33M - $51M","Right","Weak","Very Strong","6'2""","191 lbs","129","-",150,164,4,11,11,2,15,5,15,2,16,15,14,4,15,14,14,13,15,14,13,14,13,5,9,10,15,15,7,14,16,15,14,14,15,16,15,15,13,14,11,15,13,14,8,13,9,6,12,14,14,1,2,1,1,3,1,3,2,3,1,2
"371",29233143,"Harvey Elliott","4/4/2003 (20 years old)","M (C), AM (R)","Liverpool","English Premier Division","ENG","No","8/11/2022","6/30/2027","$121M - $152M","Left Only","Very Strong","Weak","5'7""","141 lbs","83","8",145,164,12,15,14,11,17,12,8,10,7,9,16,12,10,16,13,14,14,15,14,14,16,15,10,15,11,17,16,17,12,15,16,7,11,13,14,11,12,12,9,13,14,16,7,13,5,8,12,15,15,1,1,1,2,1,4,3,3,2,1,1
"372",28108036,"Conor Gallagher","2/6/2000 (23 years old)","M/AM (C)","Chelsea","English Premier Division","ENG","Yes","9/17/2020","6/30/2025","$67M - $101M","Right","Fairly Strong","Very Strong","6'0""","169 lbs","144","19",146,164,12,12,13,14,13,13,8,12,6,9,13,7,13,13,17,11,15,13,14,14,17,12,11,14,13,15,13,19,15,14,11,10,16,13,18,11,8,14,9,13,14,13,4,11,8,7,13,13,8,3,3,1,3,2,1,1,1,2,3,1
"373",28109599,"Emile Smith Rowe","7/28/2000 (22 years old)","M (C), AM (RLC)","Arsenal","English Premier Division","ENG","No","7/22/2021","6/30/2026","$131M - $165M","Right","Reasonable","Very Strong","6'0""","167 lbs","89","14",148,164,11,12,15,12,14,12,5,13,2,6,15,11,8,15,13,14,11,13,12,13,15,15,8,15,8,15,15,15,16,15,15,8,13,14,14,9,15,15,15,15,15,15,13,13,6,6,13,15,10,2,3,1,3,1,2,1,1,1,1,3
"374",29123128,"Dominic Calvert-Lewin","3/16/1997 (26 years old)","ST (C)","Everton","English Premier Division","ENG","No","6/14/2021","6/30/2025","$60M - $91M","Right","Weak","Very Strong","6'2""","156 lbs","217","58",150,163,9,11,11,15,16,7,17,9,2,6,11,13,5,14,13,13,14,13,15,14,14,12,5,16,6,15,10,15,16,14,14,16,14,16,15,16,14,13,15,14,12,11,15,10,6,5,14,13,12,2,3,2,4,3,3,2,3,3,3,2
"375",2000036812,"Callum Doyle","10/3/2003 (19 years old)","D (LC)","Man City","English Premier Division","ENG","No","1/25/2023","6/30/2027","$15.5M - $24M","Left","Very Strong","Reasonable","6'3""","178 lbs","77","1",130,163,9,13,12,7,12,9,14,11,9,12,14,9,13,12,13,14,13,14,12,13,13,9,11,8,14,14,13,13,12,11,8,14,12,12,14,15,11,14,12,10,11,11,7,7,8,7,11,11,19,3,1,2,2,2,2,1,3,3,2,2
"376",5119142,"Joe Hart","4/19/1987 (36 years old)","GK","Celtic","cinch Premiership","ENG","No","8/3/2021","5/31/2024","$160K - $1.6M","Right","Reasonable","Very Strong","6'5""","178 lbs","513","-",124,163,2,2,8,2,8,1,5,3,1,1,9,13,3,5,14,11,13,10,12,10,14,4,15,2,12,14,8,15,12,12,13,17,13,8,14,13,1,12,14,16,10,11,7,12,4,5,16,13,12,13,10,15,13,13,11,14,13,14,14,14
"377",28093567,"James Maddison","11/23/1996 (26 years old)","M (LC), AM (RLC)","Leicester","Sky Bet Championship","ENG","Yes","6/14/2021","6/30/2026","$38M - $48M","Right","Fairly Strong","Very Strong","5'9""","160 lbs","259","65",155,163,12,14,17,14,15,16,5,14,4,7,16,14,11,17,8,13,12,15,12,14,15,16,12,14,11,12,16,14,13,16,17,8,15,13,13,8,8,13,8,15,14,12,12,12,9,12,14,17,12,4,2,1,3,1,2,2,3,4,3,3
"378",90008752,"Jamie Vardy","1/11/1987 (36 years old)","ST (C)","Leicester","Sky Bet Championship","ENG","No","8/20/2022","6/30/2024","$450K - $4.4M","Right","Reasonable","Very Strong","5'10""","158 lbs","550","279",136,163,7,12,12,15,14,7,12,12,5,3,13,17,11,14,15,14,15,15,16,13,17,12,12,13,5,16,14,15,15,12,12,11,12,15,11,12,10,7,10,16,15,18,13,14,17,14,12,16,8,3,1,3,3,2,3,3,2,1,1,1
"379",14112088,"Lucas Robertone","3/18/1997 (26 years old)","M (RC), AM (C)","Almería","Spanish First Division","ARG","Yes","12/23/2022","6/30/2028","$8.2M - $12.5M","Right","Reasonable","Very Strong","5'9""","154 lbs","151","20",135,154,15,14,12,12,15,15,9,15,5,9,14,12,8,15,13,13,13,14,12,13,14,14,8,16,12,14,16,13,13,13,12,8,13,12,13,11,12,8,15,13,13,10,6,13,12,5,13,13,14,1,1,1,2,4,3,3,2,3,3,2
"380",2000198728,"Kadan Young","1/19/2006 (17 years old)","M (R), AM (RL)","Aston Villa","English Premier Division","ENG","No","1/20/2023","6/30/2026","$17M - $25M","Right Only","Weak","Very Strong","6'0""","167 lbs","-","-",90,163,8,12,11,9,10,7,7,9,4,7,11,6,9,11,8,7,9,9,6,6,4,9,8,8,7,8,9,11,15,14,6,5,11,14,6,12,14,18,12,10,14,12,11,13,5,5,17,11,9,3,1,2,3,1,1,2,1,3,2,2
"381",29076105,"Luke Shaw","7/12/1995 (27 years old)","D (LC), WB (L)","Man UFC","English Premier Division","ENG","No","4/4/2023","6/30/2027","$169M - $204M","Left","Very Strong","Reasonable","5'11""","165 lbs","239","3",159,162,15,14,14,8,15,14,13,6,10,14,15,8,13,14,13,15,13,15,14,15,10,10,13,15,15,15,13,14,15,15,15,13,13,15,15,16,14,16,13,12,13,12,10,13,15,6,15,15,12,3,3,3,2,3,2,2,1,1,1,3
"382",29141472,"Benjamin White","10/8/1997 (25 years old)","D (RC)","Arsenal","English Premier Division","ENG","No","7/30/2021","6/30/2026","$172M - $238M","Right","Reasonable","Very Strong","6'1""","171 lbs","209","5",155,162,3,11,11,5,14,3,15,6,7,15,14,5,15,14,13,17,15,16,14,15,16,13,11,12,16,16,13,14,14,14,13,13,13,14,15,14,14,13,12,15,14,10,5,12,7,5,14,14,9,2,3,3,3,1,3,3,2,1,2,2
"383",29137172,"Aaron Ramsdale","5/14/1998 (25 years old)","GK","Arsenal","English Premier Division","ENG","No","5/18/2023","6/30/2026","$144M - $218M","Right","Weak","Very Strong","6'3""","187 lbs","188","-",155,162,3,1,2,3,12,6,6,1,2,2,13,3,3,12,12,13,16,14,13,14,17,10,13,9,13,15,15,10,8,16,12,14,11,7,12,15,14,14,12,16,17,13,4,15,7,5,15,16,17,16,11,16,10,17,16,16,10,15,15,14
"384",28044979,"Jack Butland","3/10/1993 (30 years old)","GK","Crystal Palace","English Premier Division","ENG","No","10/16/2020","6/30/2024","$6.2M - $7.6M","Right","Reasonable","Very Strong","6'5""","207 lbs","272","-",128,161,2,2,1,3,6,1,6,1,1,2,9,6,2,10,10,12,14,14,12,7,10,3,10,2,13,12,5,12,12,16,12,18,12,10,14,13,1,16,16,18,11,14,5,10,5,3,6,13,9,12,11,16,8,16,11,15,11,7,12,15
"385",2000256110,"Shea Lacey","4/14/2007 (16 years old)","AM (RC)","Man UFC","English Premier Division","ENG","Yes","6/12/2023","6/30/2025","$13.5M - $20M","Left","Very Strong","Fairly Strong","5'6""","116 lbs","-","-",80,161,11,8,14,10,12,13,2,10,1,1,12,8,2,13,12,9,8,11,6,6,12,18,4,10,3,8,11,9,13,12,10,4,10,11,8,4,10,19,13,11,11,11,7,4,5,6,12,8,19,2,2,2,2,2,2,3,1,1,3,3
"386",29125842,"Jarrod Bowen","12/20/1996 (26 years old)","M (RL), AM (RLC)","West Ham","English Premier Division","ENG","No","6/14/2021","6/30/2025","$55M - $83M","Left","Very Strong","Reasonable","5'9""","154 lbs","257","80",150,160,13,14,14,13,15,12,10,14,4,5,13,13,8,14,8,14,8,15,10,14,17,14,5,16,8,15,13,17,15,15,11,8,14,15,15,8,12,17,12,17,15,13,4,15,5,7,15,16,15,1,2,2,4,3,2,1,1,2,2,1
"387",29030379,"Danny Ings","7/23/1992 (30 years old)","ST (C)","West Ham","English Premier Division","ENG","No","1/20/2023","6/30/2025","$28M - $36M","Right","Reasonable","Very Strong","5'10""","163 lbs","328","107",135,160,4,11,12,15,13,10,13,12,3,8,13,13,11,15,13,13,14,13,14,12,18,14,14,14,10,16,14,15,13,14,15,11,13,13,14,13,9,16,13,18,14,15,13,10,5,8,13,17,13,1,2,1,1,3,3,1,2,2,3,3
"388",29173977,"Max Aarons","1/4/2000 (23 years old)","D/WB (R)","Norwich","Sky Bet Championship","ENG","No","6/15/2020","6/30/2027","$13M - $15.5M","Right","Reasonable","Very Strong","5'7""","138 lbs","201","5",130,160,4,9,14,5,13,6,9,7,6,12,12,5,14,14,8,13,11,16,13,13,17,11,6,12,12,15,12,16,15,15,15,7,15,15,15,9,14,16,13,16,14,16,3,14,2,4,15,15,16,1,3,1,1,1,3,3,4,1,1,1
"389",28112986,"Callum Hudson-Odoi","11/7/2000 (22 years old)","M (RL), AM (RLC)","Chelsea","English Premier Division","ENG","No","6/14/2021","6/30/2024","$9.2M - $13.5M","Right","Fairly Strong","Very Strong","6'0""","167 lbs","86","4",140,160,12,14,15,10,15,12,7,8,5,7,14,11,7,15,7,11,8,12,9,12,10,15,3,14,7,10,14,11,16,15,12,11,12,15,12,8,10,14,12,11,10,17,11,10,3,12,10,15,7,2,3,1,2,2,3,3,1,3,3,1
"390",2000032231,"Luka Romero","11/18/2004 (18 years old)","AM (RLC)","Lazio","Italian Serie A","ARG","Yes","7/21/2021","6/30/2026","$0","Left","Very Strong","Reasonable","5'5""","154 lbs","37","4",120,154,5,12,14,12,14,11,6,12,6,5,12,10,9,14,15,11,13,11,10,12,16,14,7,13,6,13,12,16,13,14,11,6,18,13,13,8,14,8,12,15,13,13,4,12,6,5,13,15,14,2,3,2,2,1,3,1,1,3,1,3
"391",28115831,"James Garner","3/13/2001 (22 years old)","DM, M (C)","Everton","English Premier Division","ENG","No","9/1/2022","6/30/2026","$95M - $119M","Right","Reasonable","Very Strong","6'0""","169 lbs","99","8",136,160,14,13,6,11,14,12,8,13,2,8,15,10,14,14,12,13,12,14,14,13,16,9,11,13,14,16,14,15,12,13,13,12,15,13,16,11,14,12,14,15,12,11,4,13,7,2,15,14,12,3,2,1,1,1,3,3,2,2,2,1
"392",78000335,"Luis Suárez","1/24/1987 (36 years old)","ST (C)","GRE","Brazilian National First Division","URU","Yes","12/31/2022","12/31/2024","Not for Sale","Right","Fairly Strong","Very Strong","6'0""","189 lbs","555","365",147,188,15,15,14,18,17,16,13,15,8,8,16,16,9,15,17,16,18,19,13,15,20,18,15,17,8,13,15,9,9,9,9,11,16,10,10,14,11,8,3,15,18,9,7,16,13,12,15,20,13,2,3,1,1,3,2,1,1,1,2,3
"393",78085068,"Ronald Araujo","3/7/1999 (24 years old)","D (RC), WB (R)","Barcelona","Spanish First Division","URU","Yes","4/26/2022","6/30/2026","$132M - $199M","Right","Weak","Very Strong","6'2""","200 lbs","168","19",170,176,5,7,11,11,13,7,17,11,10,18,11,13,17,12,16,16,18,15,17,14,18,9,16,7,15,15,11,17,14,13,12,16,15,16,16,16,13,14,12,17,14,14,13,14,11,8,17,18,16,3,1,1,2,1,3,3,3,2,2,2
"394",78084541,"Manuel Ugarte","4/11/2001 (22 years old)","DM, M (C)","Sporting CP","Portuguese Premier League","URU","No","8/9/2021","6/30/2028","$64M - $77M","Right","Reasonable","Very Strong","6'0""","169 lbs","129","3",152,175,12,10,11,8,12,10,8,10,10,14,13,12,18,12,19,16,18,12,17,12,19,12,13,8,16,18,12,17,12,12,16,11,18,13,17,14,13,13,15,15,14,10,4,14,13,4,16,13,16,2,1,3,3,1,3,4,1,3,2,2
"395",78074594,"Federico Valverde","7/22/1998 (24 years old)","M (RC), AM (R)","R. Madrid","Spanish First Division","URU","Yes","8/24/2021","6/30/2027","$143M - $216M","Right","Fairly Strong","Very Strong","5'11""","163 lbs","204","15",168,175,13,12,12,13,14,14,12,17,10,13,15,10,13,13,12,13,15,11,13,12,15,14,13,14,12,17,13,17,17,15,15,12,17,17,17,14,14,7,10,14,9,12,6,14,8,10,15,14,12,1,4,1,3,1,1,1,3,3,1,1
"396",78005742,"Edinson Cavani","2/14/1987 (36 years old)","ST (C)","Valencia","Spanish First Division","URU","Yes","6/30/2022","6/30/2024","$325K - $3.3M","Right","Reasonable","Very Strong","6'0""","156 lbs","503","275",143,174,12,12,10,16,15,14,18,13,4,9,12,16,8,13,15,14,15,14,13,12,17,10,14,15,11,14,10,18,12,13,13,13,17,12,12,14,13,10,17,15,13,13,13,14,8,9,13,17,9,3,3,4,2,3,2,2,4,3,1,2
"397",2000218258,"Álvaro Rodríguez","7/14/2004 (18 years old)","AM (L), ST (C)","R. Madrid C","Spanish Federation Third Group 7","URU","Yes","7/1/2021","6/30/2027","$35M - $53M","Left","Very Strong","Reasonable","6'4""","178 lbs","41","11",119,168,6,10,13,14,12,7,16,11,12,5,12,11,6,13,14,10,12,13,12,10,9,8,6,12,7,14,9,12,12,9,10,15,15,12,14,15,12,12,12,11,10,9,12,7,5,4,11,8,13,3,2,1,1,2,2,3,4,2,1,1
"398",78060464,"José Giménez","1/20/1995 (28 years old)","D (C)","A. Madrid","Spanish First Division","URU","Yes","8/11/2021","6/30/2025","$81M - $123M","Right","Fairly Strong","Very Strong","6'1""","169 lbs","219","6",159,166,7,10,11,7,12,6,16,8,13,15,12,10,16,12,15,15,17,16,15,15,15,10,13,10,16,16,11,16,14,12,13,13,12,13,15,15,12,9,7,14,14,16,16,13,14,6,13,15,15,3,4,1,1,1,1,1,2,1,1,3
"399",78090138,"Darwin Núñez","6/24/1999 (23 years old)","AM (L), ST (C)","Liverpool","English Premier Division","URU","No","6/13/2022","6/30/2027","$144M - $218M","Right","Fairly Strong","Very Strong","6'2""","180 lbs","131","61",156,165,5,13,13,15,12,9,12,13,5,7,11,15,9,14,16,13,14,12,13,12,17,14,6,17,7,15,14,16,17,14,12,15,15,17,15,14,10,11,12,14,12,10,8,12,7,3,13,16,12,3,1,1,3,2,1,2,1,3,3,1
"400",14094572,"Rodrigo Bentancur","6/25/1997 (25 years old)","DM, M (C)","Tottenham","English Premier Division","URU","No","1/31/2022","6/30/2026","$77M - $117M","Right","Fairly Strong","Very Strong","6'2""","169 lbs","219","8",156,164,12,12,14,10,15,12,12,11,7,14,16,8,16,14,16,15,13,15,13,14,12,11,10,10,16,15,14,16,12,14,15,13,14,13,15,14,16,11,15,18,17,15,7,11,15,5,14,12,16,1,3,2,1,2,3,2,1,3,1,3
"401",14042683,"Joaquín Correa","8/13/1994 (28 years old)","M (L), AM (LC), ST (C)","Inter","Italian Serie A","ARG","Yes","7/1/2022","6/30/2025","$220K - $2.2M","Right","Fairly Strong","Very Strong","6'2""","165 lbs","274","42",139,154,13,11,16,12,16,10,11,13,4,4,14,12,5,17,7,13,8,13,8,11,12,17,7,13,5,12,13,7,16,15,10,12,14,17,12,10,14,10,16,17,11,12,10,13,8,2,9,15,12,3,2,2,2,3,1,2,3,4,3,2
"402",78001113,"Fernando Muslera","6/16/1986 (36 years old)","GK","Galatasaray","Turkish Super League","URU","Yes","6/1/2021","6/30/2024","$1.3M - $2.8M","Right","Weak","Very Strong","6'3""","185 lbs","517","1",135,160,3,1,9,3,11,7,8,1,2,3,12,7,3,10,10,16,13,12,10,11,17,8,17,7,17,14,10,12,11,15,12,15,16,10,11,12,13,18,15,18,18,18,6,12,2,4,12,13,15,14,13,14,4,15,11,16,7,14,10,12
"403",78016342,"Sebastián Coates","10/7/1990 (32 years old)","D (C)","Sporting CP","Portuguese Premier League","URU","Yes","8/30/2022","6/30/2024","$10.5M - $16M","Right","Reasonable","Very Strong","6'5""","202 lbs","342","24",154,158,4,6,7,11,11,6,17,5,5,18,13,10,13,11,15,16,18,11,15,14,17,5,20,13,18,14,10,14,8,7,16,17,16,10,15,18,5,12,14,18,14,16,8,16,13,5,18,11,13,4,1,3,1,2,2,3,1,3,1,1
"404",78088646,"Facundo Torres","4/13/2000 (23 years old)","AM (RLC)","Orlando City","Major League Soccer","URU","No","3/1/2023","12/31/2027","$6.2M - $9.6M","Left","Very Strong","Fairly Strong","5'10""","156 lbs","107","24",140,158,13,13,15,14,16,13,7,13,9,8,13,15,7,15,12,12,9,14,12,13,15,17,10,14,8,13,15,13,15,15,12,9,12,14,14,8,13,12,10,13,10,11,12,4,4,11,12,11,13,1,3,2,1,4,2,2,2,2,3,2
"405",78078886,"Maximiliano Gómez","8/14/1996 (26 years old)","ST (C)","Trabzonspor","Turkish Super League","URU","No","9/1/2022","6/30/2025","$7.6M - $11.5M","Right","Reasonable","Very Strong","6'1""","187 lbs","240","85",131,155,5,11,11,15,12,9,13,13,8,7,11,14,7,12,14,15,16,14,16,11,15,12,12,14,5,15,9,14,11,11,15,16,15,11,14,16,5,4,5,12,14,10,5,16,14,14,13,15,14,1,1,2,3,3,1,2,1,1,2,3
"406",78076343,"Mathías Olivera","10/31/1997 (25 years old)","D/WB/M (L)","Parthenope","Italian Serie A","URU","Yes","7/1/2022","6/30/2027","$17.5M - $22M","Left","Very Strong","Reasonable","6'0""","171 lbs","151","5",145,155,11,14,12,9,13,9,15,10,13,13,13,8,16,12,11,14,14,13,14,13,14,12,11,13,14,15,11,16,14,13,14,13,14,14,15,14,11,10,10,12,10,3,7,12,11,7,14,11,7,1,3,1,1,3,2,2,2,3,4,3
"407",78027222,"Gastón Ramírez","12/2/1990 (32 years old)","M (C), AM (RLC), ST (C)","Entella","Italian Serie C/B","URU","No","10/22/2022","6/30/2024","$80K - $800K","Left","Very Strong","Reasonable","6'0""","171 lbs","345","50",114,155,13,13,12,11,14,14,10,10,8,8,14,14,6,14,15,13,9,10,11,12,14,16,12,12,6,11,15,9,10,11,13,10,10,10,9,9,15,6,9,12,8,5,12,10,16,13,11,14,12,3,1,1,2,2,3,2,1,3,3,3
"408",43201830,"Lucas Torreira","2/11/1996 (27 years old)","DM, M (C)","Galatasaray","Turkish Super League","URU","Yes","8/8/2022","6/30/2026","$26M - $40M","Right","Weak","Very Strong","5'6""","141 lbs","243","16",150,155,7,8,12,8,14,8,10,10,5,16,14,11,15,14,18,18,18,14,14,15,16,12,10,8,15,18,12,17,17,19,15,5,15,9,15,9,11,13,14,16,12,12,7,12,10,4,16,13,14,3,3,2,3,3,3,2,1,1,3,2
"409",78095389,"Facundo Pellistri","12/20/2001 (21 years old)","AM (R)","Man UFC","English Premier Division","URU","Yes","10/5/2020","6/30/2025","$46M - $55M","Right","Reasonable","Very Strong","5'9""","143 lbs","69","1",130,154,8,11,16,11,14,8,4,7,3,4,13,10,8,13,14,10,14,11,10,11,14,14,5,14,7,15,10,15,17,14,13,7,15,14,14,7,12,19,13,11,12,11,8,9,6,5,12,10,16,2,1,3,3,1,1,3,1,2,3,2
"410",78040720,"Matías Vecino","8/24/1991 (31 years old)","DM, M (C)","Lazio","Italian Serie A","URU","Yes","8/1/2022","6/30/2025","Not for Sale","Right","Reasonable","Very Strong","6'2""","178 lbs","298","27",143,150,10,10,10,14,13,12,16,13,4,13,14,13,12,14,14,17,14,12,13,13,18,14,13,18,14,16,13,15,11,13,15,14,17,12,14,15,16,13,13,18,14,10,10,17,11,7,14,18,13,2,2,1,1,1,3,3,2,2,2,2
"411",78000806,"Cristhian Stuani","10/12/1986 (36 years old)","AM (R), ST (C)","Girona","Spanish First Division","URU","Yes","7/5/2021","6/30/2026","Not for Sale","Right","Fairly Strong","Very Strong","6'0""","163 lbs","526","221",133,150,7,11,12,16,11,8,15,12,6,6,12,15,7,12,11,14,15,15,14,14,14,10,12,15,8,13,11,13,11,10,14,13,13,12,12,14,12,13,14,15,12,11,11,14,7,7,13,13,14,2,1,3,1,2,2,3,1,2,4,2
"412",14129337,"Nahuel Molina","4/6/1998 (25 years old)","D/WB/M (R)","A. Madrid","Spanish First Division","ARG","No","7/28/2022","6/30/2027","$24M - $29M","Right","Reasonable","Very Strong","5'9""","154 lbs","144","15",140,154,14,14,13,11,13,12,8,12,13,11,14,6,13,14,10,12,13,11,13,12,14,12,8,13,12,12,13,15,15,14,12,8,15,15,13,12,13,11,13,14,15,9,3,11,10,5,13,14,14,2,3,2,3,3,3,3,4,2,3,2
"413",78021572,"Martín Campaña","5/29/1989 (34 years old)","GK","Al-Riyadh","Saudi Professional League","URU","No","6/7/2023","6/30/2025","Not for Sale","Right","Weak","Very Strong","6'1""","187 lbs","390","-",135,150,3,2,3,2,12,6,2,3,3,3,12,3,2,11,8,13,13,13,14,12,13,8,16,4,13,14,11,10,10,13,12,13,13,10,11,12,11,12,15,15,10,13,6,16,8,6,14,7,14,14,12,16,11,14,13,14,15,14,12,12
"414",78062662,"Jonathan Rodríguez","7/6/1993 (29 years old)","AM (L), ST (C)","América","Mexican First Division","URU","No","7/1/2022","6/30/2026","$4.7M - $7.2M","Right","Reasonable","Very Strong","5'11""","171 lbs","286","108",138,150,6,10,13,15,14,13,14,12,4,7,12,10,6,13,10,13,12,14,11,10,15,13,9,15,8,10,10,14,16,15,12,11,8,15,11,13,10,14,9,10,14,8,8,14,8,3,15,14,12,1,3,3,3,1,3,1,3,1,2,1
"415",2000111471,"Matías Abaldo","4/3/2004 (19 years old)","AM (RLC)","Defensor Sporting","Uruguayan First Division","URU","Yes","6/13/2022","12/31/2024","$140K - $1.4M","Right","Fairly Strong","Very Strong","5'8""","147 lbs","42","3",119,150,12,12,14,16,15,13,9,12,7,5,12,6,4,14,9,11,8,11,8,11,3,15,12,13,6,11,11,11,15,14,8,7,10,14,9,7,14,19,8,13,11,12,10,3,6,2,11,12,19,1,3,1,1,2,2,2,4,2,2,3
"416",78059800,"Giorgian De Arrascaeta","6/1/1994 (29 years old)","M (L), AM (LC)","FLA","Brazilian National First Division","URU","Yes","1/18/2022","12/31/2026","$11M - $16.5M","Right","Weak","Very Strong","5'8""","160 lbs","242","63",144,150,14,13,16,13,16,12,12,12,4,4,17,13,10,17,10,16,13,11,11,13,15,17,11,13,7,13,17,13,15,16,13,12,12,13,12,11,12,12,12,12,9,10,13,17,6,9,12,12,13,2,3,2,3,3,2,2,1,1,3,2
"417",78102804,"Fabricio Díaz","2/3/2003 (20 years old)","DM, M (C)","Liverpool F.C.","Uruguayan First Division","URU","Yes","6/13/2022","5/31/2026","$950K - $9.6M","Right","Reasonable","Very Strong","5'9""","152 lbs","125","4",125,149,14,14,12,12,13,12,13,14,9,12,13,15,9,13,15,13,13,12,12,13,15,12,13,13,13,14,13,13,13,12,11,8,15,12,12,9,13,6,6,10,12,12,7,15,15,8,14,10,18,3,1,1,2,3,2,3,2,3,3,2
"418",78064881,"Mauro Arambarri","9/30/1995 (27 years old)","DM, M (RC)","Getafe","Spanish First Division","URU","Yes","2/6/2023","6/30/2028","$9.6M - $11.5M","Right","Fairly Strong","Very Strong","5'9""","156 lbs","226","7",137,149,8,10,12,10,13,11,8,12,4,13,13,6,15,13,15,14,16,13,15,13,15,11,8,12,14,16,12,16,12,12,14,6,12,13,16,13,12,12,8,14,10,12,14,13,13,7,15,12,8,3,3,2,1,2,1,3,1,3,1,3
"419",78088254,"Brian Rodríguez","5/20/2000 (23 years old)","AM (RLC)","América","Mexican First Division","URU","Yes","8/25/2022","6/30/2026","$7.2M - $11M","Right","Reasonable","Very Strong","5'8""","152 lbs","111","15",125,148,9,13,15,10,14,10,7,11,8,5,13,13,5,14,8,13,9,9,8,10,10,15,8,13,7,11,12,13,16,15,11,8,15,13,12,7,13,11,10,7,8,8,5,10,10,11,9,14,14,2,1,1,4,1,1,3,1,2,2,4
"420",78010878,"Martín Cáceres","4/7/1987 (36 years old)","D (RLC)","LA Galaxy","Major League Soccer","URU","No","11/14/2022","12/31/2023","$60K - $600K","Right","Fairly Strong","Very Strong","5'11""","171 lbs","309","20",122,148,3,11,10,9,12,11,14,6,14,13,12,13,17,11,16,16,14,12,9,8,14,12,9,12,13,13,9,15,13,13,15,14,15,11,11,12,13,14,12,8,12,7,15,14,12,13,13,14,12,3,3,2,1,1,1,3,3,1,2,4
"421",5513030,"Juan Albín","7/17/1986 (36 years old)","AM (LC), ST (C)","Universitario de Salto","-","URU","Yes","1/18/2023","12/31/2023","$0 - $9K","Left Only","Very Strong","Weak","5'10""","182 lbs","399","83",92,148,15,14,15,14,14,16,9,15,6,6,13,15,7,15,7,13,6,11,4,13,6,16,9,15,10,10,14,4,10,10,9,8,6,8,6,10,14,8,8,7,7,11,16,13,8,12,5,13,15,2,3,3,2,1,1,4,4,1,4,3
"422",78043711,"Nico López","10/1/1993 (29 years old)","AM (RLC), ST (C)","Tigres","Mexican First Division","URU","No","12/8/2019","12/31/2023","$0","Left","Very Strong","Reasonable","5'9""","147 lbs","259","65",130,147,14,13,14,13,14,13,11,13,6,5,13,14,5,15,7,12,8,14,8,12,14,15,6,12,6,10,13,13,13,13,10,8,13,14,14,7,13,7,8,8,11,8,8,12,5,15,9,15,5,2,2,3,1,1,3,4,1,1,1,1
"423",14035968,"Walter Benítez","1/19/1993 (30 years old)","GK","PSV","Eredivisie","ARG","Yes","7/1/2022","6/30/2025","$10M - $15M","Right Only","Weak","Very Strong","6'3""","200 lbs","243","-",140,154,3,3,3,2,8,7,6,2,2,3,11,3,3,8,2,14,15,12,15,12,15,15,15,12,15,15,10,15,8,12,16,16,15,8,13,15,12,15,14,16,15,18,6,16,4,6,15,15,8,12,10,15,9,15,13,15,6,14,16,14
"424",78088553,"Brian Ocampo","6/25/1999 (23 years old)","AM (RL)","Cádiz","Spanish First Division","URU","No","8/27/2022","6/30/2026","$16M - $19.5M","Right","Reasonable","Very Strong","5'8""","147 lbs","114","9",135,147,14,15,15,13,15,14,8,15,6,5,13,9,6,16,13,13,10,10,9,10,11,16,7,13,7,11,13,13,16,15,9,7,12,15,11,7,12,8,11,9,5,9,12,11,7,10,10,14,8,2,2,4,1,1,4,2,1,3,2,3
"425",78094302,"Gastón Álvarez","3/24/2000 (23 years old)","D (LC)","Boston River","Uruguayan First Division","URU","No","4/7/2021","12/31/2024","$0","Left","Very Strong","Weak","6'0""","158 lbs","77","6",126,147,8,10,10,5,10,7,14,8,11,14,9,10,13,11,15,14,15,12,13,12,6,7,6,12,12,14,10,14,13,12,13,12,14,14,14,13,16,10,7,15,12,10,6,2,13,7,14,12,12,1,1,1,3,3,4,1,2,2,3,3
"426",67271371,"Rodrigo Zalazar","8/12/1999 (23 years old)","DM, M/AM (C)","Schalke 04","Bundesliga 2","URU","Yes","7/1/2022","6/30/2027","$5M - $6.4M","Right","Reasonable","Very Strong","5'10""","158 lbs","104","16",133,146,15,14,15,9,13,14,8,14,6,9,13,12,11,15,16,12,15,12,10,12,17,16,8,13,10,12,14,16,13,15,10,8,12,14,13,10,14,8,9,10,10,13,7,15,12,10,13,15,14,2,3,1,3,3,4,1,1,2,3,3
"427",2000090622,"Santiago Mouriño","2/13/2002 (21 years old)","D (RC)","Racing C.M.","Uruguayan First Division","URU","No","1/31/2022","12/31/2023","$500K - $4.9M","Right","Reasonable","Very Strong","6'0""","167 lbs","32","-",125,146,5,7,10,6,12,6,14,7,9,14,11,6,15,12,14,13,14,12,13,12,14,12,13,10,12,12,10,14,11,11,13,14,12,14,13,14,11,7,11,13,12,11,8,7,11,7,12,15,12,4,3,1,1,1,1,2,1,3,1,2
"428",78095755,"Emiliano Martínez","8/17/1999 (23 years old)","DM, M (C)","FC Midtjylland","3F Superliga","URU","No","1/1/2023","6/30/2027","$350K - $3.5M","Right","Fairly Strong","Very Strong","6'0""","141 lbs","71","1",129,146,7,7,12,8,13,11,11,8,7,14,13,7,14,14,13,13,12,13,14,13,18,12,9,11,14,14,11,14,13,12,12,12,11,13,12,12,17,10,12,11,12,12,11,14,13,8,13,13,15,1,3,1,1,2,1,2,1,2,2,3
"429",78089358,"Sebastián Cáceres","8/18/1999 (23 years old)","D (C)","América","Mexican First Division","URU","No","1/15/2020","12/31/2024","$275K - $9.4M","Right","Reasonable","Very Strong","5'11""","169 lbs","153","3",129,146,8,6,9,8,10,4,15,6,12,15,11,9,14,10,14,13,14,13,11,10,13,8,11,13,15,14,8,15,14,11,14,12,13,14,15,12,11,12,10,14,10,15,10,10,14,8,13,13,14,3,1,2,1,1,3,3,3,2,3,1
"430",2001906,"Álvaro González","10/29/1984 (38 years old)","DM, M (RC)","La Luz","Uruguayan First Division","URU","Yes","5/24/2022","12/31/2023","$0 - $6K","Right","Weak","Very Strong","5'9""","158 lbs","399","19",94,146,10,10,7,8,9,10,12,9,11,14,10,10,14,10,16,11,17,12,14,10,17,7,13,10,12,15,9,14,9,9,12,8,17,9,9,12,17,9,8,13,12,15,8,14,12,9,15,13,13,2,1,1,1,3,1,1,1,3,3,2
"431",78074060,"Ignacio de Arruabarrena","1/16/1997 (26 years old)","GK","Arouca","Portuguese Premier League","URU","Yes","6/27/2022","6/30/2024","$550K - $5.2M","Right","Reasonable","Very Strong","5'11""","160 lbs","164","-",132,145,1,1,2,3,7,1,7,1,2,3,11,4,1,8,13,13,14,12,11,12,14,8,8,3,14,13,8,14,12,15,13,11,12,11,12,13,1,12,12,12,13,12,6,10,5,9,13,15,11,13,14,16,15,14,12,13,6,13,12,11
"432",78067241,"Nahitan Nández","12/28/1995 (27 years old)","WB (R), DM, M (RC)","Cagliari","Italian Serie A","URU","Yes","6/14/2021","6/30/2024","$3.8M - $7.6M","Right","Reasonable","Very Strong","5'7""","154 lbs","232","18",129,145,8,11,11,9,11,7,8,12,4,12,12,9,15,12,17,13,15,12,15,10,18,11,13,15,13,16,13,16,14,14,14,7,18,13,13,13,15,8,10,15,14,12,7,16,14,7,14,14,14,1,1,3,1,1,1,4,2,2,1,2
"433",2000032456,"Facundo González","6/6/2003 (20 years old)","D (C)","Valencia B","Spanish Federation Second Group 3","URU","Yes","7/1/2019","6/30/2027","$750K - $7.4M","Left","Very Strong","Weak","6'4""","169 lbs","60","4",106,145,6,4,6,4,10,6,12,4,10,13,12,10,12,12,10,13,10,10,10,12,8,4,4,10,12,14,10,12,12,12,13,15,15,12,15,10,10,17,10,13,11,11,10,10,4,5,10,11,10,2,3,2,1,3,1,2,2,3,1,1
"434",2000097988,"Valentín Carboni","3/5/2005 (18 years old)","AM (RC), ST (C)","Inter","Italian Serie A","ARG","Yes","4/8/2022","6/30/2026","$210K - $2.1M","Left","Very Strong","Weak","6'1""","154 lbs","5","-",112,154,7,12,14,14,14,8,5,12,5,4,14,9,5,15,7,12,9,12,8,13,16,15,6,12,5,11,13,11,13,14,11,9,15,14,11,8,14,15,11,14,13,9,3,12,5,5,13,18,19,3,2,3,2,1,2,2,1,1,2,3
"435",78045749,"Diego Rolan","3/24/1993 (30 years old)","AM (RLC), ST (C)","Peñarol","Uruguayan First Division","URU","No","2/2/2023","6/30/2024","$1.1M - $2.3M","Right","Reasonable","Very Strong","5'10""","152 lbs","267","68",122,145,11,13,13,12,13,12,11,11,6,7,12,13,6,14,12,12,7,9,5,10,10,14,7,12,6,8,11,8,15,14,9,9,9,14,12,8,14,13,14,6,6,10,15,9,8,11,7,14,7,3,1,1,1,2,2,2,1,2,4,3
"436",78000812,"Walter Gargano","7/23/1984 (38 years old)","DM, M (C)","River Plate","Uruguayan First Division","URU","Yes","2/6/2023","12/31/2023","$24K - $240K","Right","Weak","Very Strong","5'6""","143 lbs","495","9",111,145,15,15,10,7,13,13,6,10,9,15,14,13,15,13,17,14,16,14,15,15,17,8,15,7,15,16,14,11,5,8,13,6,15,6,7,14,5,10,7,10,10,10,13,13,14,16,14,13,9,1,3,2,2,2,1,1,3,2,1,2
"437",78088243,"Alan Rodríguez","1/25/2000 (23 years old)","DM, M/AM (RC)","Argentinos Jrs.","Argentine Premier Division","URU","No","8/12/2022","12/31/2026","$275K - $2.8M","Right","Reasonable","Very Strong","5'7""","138 lbs","156","14",127,145,13,11,14,16,14,11,7,12,11,12,13,11,10,14,14,12,12,12,11,14,13,14,10,14,10,14,13,13,15,14,12,7,9,10,13,7,18,16,8,11,9,7,12,2,10,6,14,13,8,1,2,3,1,2,1,2,1,2,3,3
"438",78027200,"Leandro Cabrera","6/17/1991 (31 years old)","D (LC)","Espanyol","Spanish Second Division","URU","Yes","6/14/2021","6/30/2024","$550K - $5.4M","Left","Very Strong","Reasonable","6'2""","180 lbs","425","11",136,145,4,8,6,4,8,7,13,8,18,15,8,5,15,8,16,12,18,11,16,12,18,6,14,8,15,18,9,18,10,10,9,16,9,14,14,16,15,6,7,17,13,7,11,8,14,4,17,14,16,3,1,1,1,1,1,3,3,1,3,1
"439",78018171,"Nicolás Lodeiro","3/21/1989 (34 years old)","M (LC), AM (RLC)","Seattle","Major League Soccer","URU","No","6/14/2021","12/31/2023","$50K - $475K","Left","Very Strong","Reasonable","5'7""","152 lbs","332","70",131,145,14,14,14,14,12,14,10,12,1,6,13,12,8,14,5,11,9,11,13,13,14,14,14,11,5,13,13,14,13,14,10,7,16,13,13,13,13,12,15,14,9,10,11,10,8,6,10,14,15,3,1,4,3,1,2,1,3,2,2,1
"440",128009,"Martín Silva","3/25/1983 (40 years old)","GK","Libertad","Paraguay First Division Primera División","URU","No","1/17/2023","12/31/2023","$22K - $70K","Right","Weak","Very Strong","6'1""","176 lbs","554","1",118,145,3,2,3,1,8,6,2,1,3,2,11,4,3,9,12,12,13,11,11,12,12,6,15,3,13,12,9,12,11,13,13,13,13,8,12,12,10,12,12,15,13,16,13,14,12,5,16,12,12,12,10,14,12,13,9,14,3,13,10,12
"441",78093405,"Federico Viñas","6/30/1998 (24 years old)","ST (C)","América","Mexican First Division","URU","No","6/13/2020","6/30/2024","$3.5M - $7M","Left","Very Strong","Weak","5'11""","178 lbs","150","32",120,144,8,10,11,13,15,5,15,13,10,6,14,12,7,13,14,13,14,12,13,12,13,12,7,12,9,13,11,14,12,11,15,13,8,12,9,11,6,12,13,14,11,12,12,14,7,6,10,13,13,1,1,2,3,1,4,3,3,3,1,3
"442",78064824,"Fernando Gorriarán","11/27/1994 (28 years old)","M (RLC)","Tigres","Mexican First Division","URU","No","12/15/2022","12/30/2026","$6M - $9M","Right","Reasonable","Very Strong","5'6""","152 lbs","276","30",140,144,12,13,14,12,14,10,8,11,5,11,14,13,11,14,15,14,14,13,14,14,12,14,14,15,15,14,16,14,15,12,12,5,13,13,14,10,15,12,8,13,9,9,7,14,12,7,13,10,15,2,2,3,1,1,1,3,3,2,1,3
"443",78089395,"Bruno Méndez","9/10/1999 (23 years old)","D (RC)","COR","Brazilian National First Division","URU","Yes","2/25/2019","12/31/2023","$450K - $4.5M","Right","Weak","Very Strong","5'11""","178 lbs","106","2",128,144,5,9,9,6,11,5,12,5,9,14,10,8,14,11,13,14,16,13,13,12,14,7,14,10,15,13,8,16,13,13,13,12,14,13,14,12,15,8,11,13,13,12,4,14,6,7,13,13,12,2,3,3,2,1,1,2,2,3,4,2
"444",78020163,"Abel Hernández","8/8/1990 (32 years old)","ST (C)","Peñarol","Uruguayan First Division","URU","No","12/27/2022","12/31/2023","$35K - $350K","Left","Very Strong","Fairly Strong","6'1""","160 lbs","372","112",125,144,6,9,13,14,12,7,12,13,2,5,13,15,5,14,10,11,11,11,11,10,16,15,10,14,8,10,12,10,14,14,11,13,14,14,13,11,10,13,16,12,7,11,15,11,8,11,8,15,10,3,1,2,3,1,1,3,1,1,3,1
"445",67046662,"Mauro Icardi","2/19/1993 (30 years old)","ST (C)","Paris SG","Ligue 1 Uber Eats","ARG","Yes","6/14/2021","6/30/2026","$5.8M - $8.6M","Right","Fairly Strong","Very Strong","5'11""","165 lbs","309","167",155,174,4,10,12,18,15,4,19,11,2,5,14,17,5,14,10,18,12,18,12,15,14,16,12,17,6,12,14,11,11,12,14,12,14,11,14,13,7,18,14,10,20,12,7,20,8,18,15,12,14,1,4,2,3,2,1,2,1,3,1,3
"446",14181373,"Fausto Vera","3/26/2000 (23 years old)","DM, M (C)","COR","Brazilian National First Division","ARG","No","7/25/2022","12/31/2026","$8.8M - $10.5M","Right","Reasonable","Very Strong","5'10""","165 lbs","89","8",130,153,10,10,12,5,15,11,13,15,8,14,13,8,13,14,11,15,12,14,11,13,12,13,12,8,15,14,15,12,11,12,13,8,12,12,13,12,12,12,10,13,13,10,7,15,8,8,11,15,13,1,2,3,2,1,4,1,3,2,3,2
"447",78102085,"Anderson Duarte","3/23/2004 (19 years old)","AM (RLC), ST (C)","Defensor Sporting","Uruguayan First Division","URU","No","4/1/2023","12/31/2026","$1.5M - $3.2M","Right","Strong","Very Strong","5'9""","141 lbs","29","4",116,143,11,10,13,12,13,12,13,12,10,6,11,8,8,14,14,9,10,11,8,7,15,15,1,12,10,10,10,12,13,13,11,7,15,15,9,7,10,20,9,11,9,10,6,6,7,7,20,9,13,2,1,1,3,2,1,2,3,1,3,2
"448",85139014,"Kylian Mbappé","12/20/1998 (24 years old)","AM (RL), ST (C)","Paris SG","Ligue 1 Uber Eats","FRA","Yes","5/21/2022","6/30/2024","$156M - $235M","Right","Reasonable","Very Strong","5'10""","160 lbs","217","164",188,197,13,13,18,17,18,12,7,13,4,4,15,18,4,17,6,17,12,17,14,15,18,18,13,17,3,10,15,11,20,16,15,8,15,20,14,11,14,13,12,16,16,14,7,16,7,8,15,20,15,3,3,3,3,3,1,1,1,3,1,1
"449",8435089,"Karim Benzema","12/19/1987 (35 years old)","ST (C)","R. Madrid","Spanish First Division","FRA","Yes","6/14/2021","6/30/2024","$15.5M - $18.5M","Right","Strong","Very Strong","6'1""","180 lbs","551","281",170,185,10,12,16,17,20,12,14,12,7,7,17,16,9,20,7,15,10,18,13,16,16,17,12,15,11,15,17,13,12,14,15,11,11,12,12,14,8,18,17,20,15,12,11,15,4,17,14,14,15,2,2,3,3,2,1,1,3,3,2,1
"450",49039004,"William Saliba","3/24/2001 (22 years old)","D (C)","Arsenal","English Premier Division","FRA","Yes","6/14/2021","6/30/2028","$233M - $291M","Right","Reasonable","Very Strong","6'4""","182 lbs","111","3",164,182,6,10,11,9,14,6,16,11,6,15,13,10,16,13,15,17,14,17,15,15,15,11,10,8,14,17,12,15,14,14,15,16,14,14,16,16,7,15,13,14,14,11,9,14,10,6,15,15,15,1,1,2,1,2,2,3,3,3,3,3
"451",49056243,"Eduardo Camavinga","11/10/2002 (20 years old)","D (L), DM, M (C)","R. Madrid","Spanish First Division","FRA","Yes","8/31/2021","6/30/2027","$113M - $141M","Left","Very Strong","Reasonable","6'0""","149 lbs","134","4",165,180,6,12,12,11,14,6,13,12,13,14,15,7,15,15,15,16,15,14,13,14,15,12,12,14,15,16,13,18,15,14,14,11,16,16,18,17,11,17,13,15,16,14,5,15,9,5,15,13,16,2,1,2,3,3,3,3,2,1,3,3
"452",67086656,"Antoine Griezmann","3/21/1991 (32 years old)","AM (RLC), ST (C)","A. Madrid","Spanish First Division","FRA","Yes","10/9/2022","6/30/2026","Not for Sale","Left","Very Strong","Fairly Strong","5'9""","156 lbs","495","181",168,180,14,15,16,14,16,15,13,14,4,5,16,13,10,17,12,15,12,12,13,13,17,17,12,16,10,14,16,14,15,14,14,9,15,14,15,10,14,10,12,16,14,13,5,13,9,13,14,18,16,2,3,2,1,3,1,2,2,4,2,3
"453",49037900,"Wesley Fofana","12/17/2000 (22 years old)","D (C)","Chelsea","English Premier Division","FRA","Yes","8/31/2022","6/30/2029","$96M - $147M","Right","Reasonable","Very Strong","6'1""","187 lbs","70","2",151,180,10,6,12,7,12,12,16,5,8,15,12,8,15,14,12,14,13,14,13,12,16,10,10,12,15,13,12,13,15,13,10,16,16,16,15,15,8,12,9,11,12,8,15,15,10,13,15,16,14,2,2,2,3,1,2,2,1,1,3,3
"454",2000181790,"Junior Kroupi","6/23/2006 (16 years old)","AM (C), ST (C)","FC Lorient","Ligue 1 Uber Eats","FRA","Yes","6/10/2022","6/30/2025","$25M - $38M","Right","Weak","Very Strong","5'10""","154 lbs","1","-",110,178,11,11,13,13,12,11,9,8,5,7,12,9,8,15,5,14,8,13,12,16,13,13,6,12,12,13,13,12,13,14,12,10,14,13,11,7,8,10,10,13,13,13,7,12,10,8,13,12,12,1,4,2,2,1,2,1,1,2,3,3
"455",48042326,"Aurélien Tchouameni","1/27/2000 (23 years old)","DM, M (C)","R. Madrid","Spanish First Division","FRA","Yes","6/30/2022","6/30/2028","$54M - $82M","Right","Reasonable","Very Strong","6'2""","178 lbs","132","5",157,177,8,10,12,6,14,6,14,13,8,15,15,10,16,14,16,16,16,15,14,15,16,13,11,13,15,15,14,16,14,14,15,14,16,14,17,16,11,13,14,15,16,13,5,13,7,7,15,15,7,3,2,3,2,3,3,2,1,2,2,3
"456",85140178,"Ousmane Dembélé","5/15/1997 (26 years old)","M/AM (RL)","Barcelona","Spanish First Division","FRA","Yes","6/14/2021","6/30/2024","$37M - $57M","Either","Very Strong","Very Strong","5'10""","147 lbs","185","42",164,176,13,17,19,12,14,10,7,12,6,4,12,11,6,17,9,11,11,9,8,8,13,18,8,14,5,7,15,11,18,18,11,9,12,18,12,11,14,13,14,9,12,9,12,13,5,13,11,14,13,1,2,3,2,1,1,3,1,1,3,1
"457",14229525,"Enzo Fernández","1/17/2001 (22 years old)","DM, M/AM (C)","Chelsea","English Premier Division","ARG","No","1/31/2023","6/30/2031","$160M - $192M","Right","Fairly Strong","Very Strong","5'10""","154 lbs","89","11",158,174,12,12,13,12,15,9,7,16,8,10,16,14,14,16,15,14,13,14,13,14,15,14,12,17,13,15,17,14,12,14,16,10,17,12,16,13,13,12,13,5,17,2,4,13,10,15,16,18,18,2,2,1,3,3,2,2,2,1,1,3
"458",48036304,"Jules Koundé","11/12/1998 (24 years old)","D (RC), WB (R)","Barcelona","Spanish First Division","FRA","Yes","7/28/2022","6/30/2027","$89M - $135M","Right","Reasonable","Very Strong","5'10""","154 lbs","179","8",160,175,6,13,12,9,13,5,15,7,8,16,13,8,15,13,14,17,16,14,13,14,16,12,14,12,15,16,14,16,15,16,16,13,15,14,15,14,15,12,13,16,13,13,9,14,7,6,14,15,15,3,1,1,1,2,3,1,2,2,3,2
"459",85075627,"Raphaël Varane","4/25/1993 (30 years old)","D (C)","Man UFC","English Premier Division","FRA","Yes","8/14/2021","6/30/2025","$138M - $173M","Right","Strong","Very Strong","6'3""","178 lbs","305","11",162,172,3,4,8,6,13,4,16,2,7,16,13,10,16,12,11,17,13,12,16,13,14,5,14,4,17,14,6,12,15,14,11,17,15,15,14,15,10,16,17,14,17,13,16,15,6,6,16,16,15,2,3,1,3,1,3,2,2,1,3,4
"460",85140301,"Christopher Nkunku","11/14/1997 (25 years old)","M (C), AM (RLC), ST (C)","RB Leipzig","Bundesliga","FRA","Yes","6/14/2021","6/30/2027","$59M - $71M","Right","Fairly Strong","Very Strong","5'10""","149 lbs","174","55",162,172,15,12,16,14,15,16,12,14,5,8,15,15,8,16,14,16,12,16,12,13,15,17,8,17,8,12,15,12,15,16,12,10,13,16,14,12,18,12,12,13,15,12,9,16,11,8,16,17,13,1,3,2,2,1,2,3,3,1,1,3
"461",2000179712,"Warren Zaïre-Emery","3/8/2006 (17 years old)","DM, M (C)","Paris SG","Ligue 1 Uber Eats","FRA","Yes","7/15/2022","6/30/2025","$43M - $64M","Right","Reasonable","Very Strong","5'10""","158 lbs","26","2",136,171,11,10,13,8,15,8,9,10,4,12,14,10,12,14,13,14,14,13,13,14,16,13,7,14,14,15,14,15,13,14,13,9,14,13,13,13,11,12,14,15,14,15,4,12,8,4,13,13,13,3,1,2,1,2,3,1,1,3,3,2
"462",85081880,"N'Golo Kanté","3/29/1991 (32 years old)","DM, M (C)","Chelsea","English Premier Division","FRA","Yes","6/14/2021","6/30/2025","Not for Sale","Right","Weak","Very Strong","5'6""","156 lbs","357","29",160,170,6,10,11,10,14,6,9,10,6,12,15,10,19,14,15,18,15,14,16,16,19,13,5,15,15,19,14,18,14,13,15,7,18,14,17,11,10,15,15,20,15,17,9,18,5,1,18,13,18,1,2,1,1,2,2,3,3,3,1,2
"463",85104424,"Kingsley Coman","6/13/1996 (26 years old)","M/AM (RL)","FC Bayern","Bundesliga","FRA","Yes","1/12/2022","6/30/2027","$68M - $102M","Right","Fairly Strong","Very Strong","5'10""","165 lbs","200","38",162,170,11,12,18,12,15,10,8,13,6,8,14,10,8,17,13,13,12,12,12,13,13,17,11,13,8,12,14,12,18,17,12,10,12,17,12,10,16,10,9,13,15,14,13,17,9,12,13,16,16,4,1,2,1,3,1,2,3,2,2,2
"464",8428653,"Hugo Lloris","12/26/1986 (36 years old)","GK","Tottenham","English Premier Division","FRA","Yes","1/21/2022","6/30/2024","$2M - $4.1M","Left Only","Very Strong","Weak","6'2""","180 lbs","579","-",135,170,2,3,5,1,8,6,9,1,2,4,8,1,10,10,15,16,17,7,13,13,15,6,15,6,14,15,9,14,11,15,11,13,15,10,14,13,1,19,18,17,14,18,14,14,2,4,11,14,13,11,13,15,13,15,11,15,12,13,11,11
"465",85086702,"Anthony Martial","12/5/1995 (27 years old)","AM (L), ST (C)","Man UFC","English Premier Division","FRA","Yes","6/14/2021","6/30/2024","$24M - $36M","Right","Fairly Strong","Very Strong","5'11""","167 lbs","257","73",140,170,5,9,15,15,16,8,12,12,4,5,14,15,5,16,5,13,10,15,11,13,8,15,6,12,6,14,10,9,14,15,16,9,12,15,14,13,10,12,11,8,10,12,18,13,8,12,10,14,16,2,3,2,2,2,4,1,2,2,3,3
"466",2000006280,"Mohamed-Ali Cho","1/19/2004 (19 years old)","AM (RL), ST (C)","Real San Sebastián","Spanish First Division","FRA","Yes","6/30/2022","6/30/2027","$18.5M - $29M","Left","Very Strong","Reasonable","6'0""","145 lbs","72","5",120,168,8,9,13,11,14,9,11,9,4,7,11,10,7,13,10,10,12,12,11,11,14,11,8,10,9,9,11,9,15,14,11,11,12,14,13,10,10,17,12,12,12,9,4,10,7,4,10,12,9,2,3,1,3,2,3,1,2,3,1,3
"467",16182894,"Dayot Upamecano","10/27/1998 (24 years old)","D (C)","FC Bayern","Bundesliga","FRA","Yes","7/1/2021","6/30/2026","$80M - $120M","Right","Reasonable","Very Strong","6'1""","198 lbs","202","5",156,168,3,7,12,7,13,3,14,6,10,15,16,7,17,13,16,13,17,16,13,14,16,12,10,10,15,16,15,15,15,12,16,15,15,17,14,17,10,10,12,10,12,10,7,12,10,10,14,17,15,3,1,2,2,3,4,3,1,2,2,3
"468",14000219,"Ángel Di María","2/14/1988 (35 years old)","M (R), AM (RLC), ST (C)","Juventus","Italian Serie A","ARG","Yes","7/8/2022","6/30/2024","$6.4M - $8M","Left","Very Strong","Weak","5'11""","165 lbs","484","98",158,174,16,17,18,13,17,14,5,17,4,4,18,14,7,20,12,16,12,17,12,13,16,17,10,15,4,10,18,10,13,16,12,10,15,12,12,9,16,12,6,18,20,13,11,20,14,10,13,18,12,1,1,2,1,2,2,3,3,3,3,2
"469",67211695,"Theo Hernández","10/6/1997 (25 years old)","D/WB/M (L)","AC Milan","Italian Serie A","FRA","Yes","2/11/2022","6/30/2026","$106M - $133M","Left","Very Strong","Weak","6'0""","178 lbs","208","24",158,167,9,15,14,12,14,12,13,15,7,12,13,14,14,13,18,15,13,12,10,12,16,12,14,17,11,12,12,13,17,14,16,12,16,18,16,14,11,9,6,13,15,10,7,13,13,14,15,15,17,3,3,2,1,1,3,1,2,1,1,3
"470",2000104892,"Eliesse Ben Seghir","2/16/2005 (18 years old)","M/AM (C)","AS Monaco","Ligue 1 Uber Eats","FRA","Yes","8/5/2022","6/30/2025","$38M - $58M","Right","Fairly Strong","Very Strong","5'6""","132 lbs","19","4",121,167,11,12,14,11,14,11,7,12,4,6,13,11,7,14,13,12,11,13,12,12,14,14,8,13,7,13,13,14,13,14,11,7,13,12,12,10,14,14,15,15,13,12,5,11,10,4,13,14,12,3,1,1,2,1,2,3,3,2,2,1
"471",85094520,"Mike Maignan","7/3/1995 (27 years old)","GK","AC Milan","Italian Serie A","FRA","Yes","7/1/2021","6/30/2026","$90M - $138M","Right","Weak","Very Strong","6'3""","196 lbs","203","-",162,167,1,1,6,1,11,1,6,10,5,1,13,8,13,12,9,16,14,17,16,14,18,6,15,1,15,15,13,12,8,16,14,15,16,11,16,15,1,12,12,16,15,15,11,14,5,5,16,19,15,14,7,17,9,15,16,15,12,16,15,13
"472",29221846,"Michael Olise","12/12/2001 (21 years old)","AM (RC)","Crystal Palace","English Premier Division","FRA","Yes","7/8/2021","6/30/2026","$32M - $48M","Left","Very Strong","Reasonable","6'0""","156 lbs","130","11",142,166,14,14,16,11,16,15,7,13,4,9,15,12,9,15,6,11,9,13,11,14,12,16,9,13,10,12,15,13,15,15,14,11,13,14,12,11,8,8,11,13,15,8,9,12,5,5,14,16,8,1,2,3,1,2,1,1,3,2,3,3
"473",48037822,"Ibrahima Konaté","5/25/1999 (24 years old)","D (C)","Liverpool","English Premier Division","FRA","Yes","7/1/2021","6/30/2026","$95M - $144M","Right","Reasonable","Very Strong","6'4""","209 lbs","107","3",155,166,3,5,13,7,14,6,16,5,12,14,13,7,16,14,15,14,16,14,14,14,15,8,10,7,14,15,9,14,14,13,16,17,14,16,13,17,7,15,11,14,15,10,9,15,9,10,15,16,14,2,3,2,3,1,2,3,1,3,1,3
"474",85093001,"Thomas Lemar","11/12/1995 (27 years old)","WB (L), M/AM (LC)","A. Madrid","Spanish First Division","FRA","Yes","7/20/2022","6/30/2027","$27M","Left","Very Strong","Weak","5'7""","127 lbs","253","26",149,165,16,15,15,12,15,16,6,13,2,7,16,14,6,16,9,12,10,13,12,12,15,16,10,14,8,14,15,15,15,16,11,7,13,14,13,9,16,16,18,16,15,16,14,15,5,3,12,15,7,1,2,2,3,3,1,2,2,3,1,3
"475",49056279,"Rayan Cherki","8/17/2003 (19 years old)","AM (RLC), ST (C)","OL","Ligue 1 Uber Eats","FRA","Yes","4/25/2023","6/30/2025","$63M - $80M","Either","Very Strong","Very Strong","5'10""","156 lbs","83","5",128,165,13,13,16,12,15,13,4,10,3,3,12,10,3,16,6,8,8,15,7,9,13,16,8,10,5,8,13,7,14,15,11,6,12,14,8,12,16,19,11,12,14,14,7,13,6,1,10,14,16,2,2,3,3,2,2,2,3,2,1,1
"476",85132406,"Allan Saint-Maximin","3/12/1997 (26 years old)","M/AM (RL), ST (C)","Newcastle","English Premier Division","FRA","Yes","10/14/2020","6/30/2026","$20M - $30M","Right","Weak","Very Strong","5'8""","147 lbs","237","25",150,165,13,13,19,10,16,11,5,10,4,2,12,12,3,16,7,11,9,12,11,12,11,19,10,13,6,10,13,10,16,17,13,7,14,16,13,12,15,15,14,13,10,12,12,12,6,7,12,15,7,2,2,2,1,2,3,1,2,1,3,3
"477",49048365,"Tanguy Nianzou","6/7/2002 (21 years old)","D (C), DM","Sevilla","Spanish First Division","FRA","Yes","8/17/2022","6/30/2027","$96M - $116M","Right","Reasonable","Very Strong","6'3""","187 lbs","48","4",134,165,4,7,12,7,12,4,16,7,5,13,14,6,13,13,16,13,14,15,13,13,16,12,12,10,14,14,13,13,12,11,15,16,13,13,13,15,14,10,12,13,12,12,8,12,13,12,12,16,10,3,1,3,1,1,1,1,3,3,1,1
"478",85059774,"Samuel Umtiti","11/14/1993 (29 years old)","D (C)","Barcelona","Spanish First Division","FRA","Yes","6/14/2021","6/30/2025","$5.6M - $8.6M","Left","Very Strong","Weak","6'0""","165 lbs","247","5",136,165,4,9,9,6,12,7,15,9,9,15,13,8,15,14,14,15,15,13,15,13,14,8,12,9,16,12,10,12,12,11,12,12,6,12,11,15,11,14,14,14,13,7,16,14,12,13,12,13,12,2,1,2,2,2,3,3,3,1,3,3
"479",2000033291,"Valentín Barco","7/23/2004 (18 years old)","D/WB (L), M (LC), AM (L)","Boca","Argentine Premier Division","ARG","No","2/3/2023","12/31/2024","$8M - $10M","Left Only","Very Strong","Weak","5'8""","154 lbs","42","2",130,173,13,13,15,9,13,13,3,13,11,10,13,14,12,15,12,12,15,11,14,14,5,16,10,13,12,14,16,13,13,15,13,7,16,13,10,6,18,15,11,11,12,10,13,14,7,4,14,13,13,1,3,4,3,2,3,2,1,2,2,2
"480",48043084,"Boubacar Kamara","11/23/1999 (23 years old)","DM, M (C)","Aston Villa","English Premier Division","FRA","Yes","7/1/2022","6/30/2027","$55M - $82M","Right","Reasonable","Very Strong","6'0""","149 lbs","154","3",146,164,6,8,12,5,14,6,14,8,5,15,15,7,15,14,12,16,14,16,13,14,13,10,9,13,15,16,13,16,14,14,15,14,15,15,15,13,12,20,13,14,12,13,10,13,11,8,15,14,9,1,1,2,3,3,1,3,1,1,3,3
"481",49061868,"Elye Wahi","1/2/2003 (20 years old)","AM (L), ST (C)","Montpellier","Ligue 1 Uber Eats","FRA","Yes","3/14/2022","6/30/2025","$26M - $39M","Right","Weak","Very Strong","6'0""","163 lbs","84","32",134,164,8,9,14,16,13,11,13,12,6,6,11,12,6,14,11,12,11,14,12,11,13,13,8,14,8,13,11,13,15,13,12,11,12,16,13,14,12,9,9,14,15,14,8,12,9,9,13,15,13,1,1,2,3,3,1,3,2,2,2,3
"482",67197145,"Lucas Hernández","2/14/1996 (27 years old)","D (LC)","FC Bayern","Bundesliga","FRA","Yes","6/14/2021","6/30/2027","$49M - $59M","Left","Very Strong","Weak","6'0""","174 lbs","160","2",160,164,4,12,12,6,14,9,14,7,12,16,14,7,17,13,17,16,19,14,15,14,19,10,13,12,16,16,12,18,14,13,15,14,12,15,15,14,14,7,8,10,13,9,14,15,12,18,14,18,12,1,1,1,2,3,2,2,4,3,1,3
"483",48044574,"Moussa Diaby","7/7/1999 (23 years old)","AM (RL), ST (C)","Bayer 04","Bundesliga","FRA","Yes","6/14/2021","6/30/2028","$51M - $76M","Left","Very Strong","Reasonable","5'7""","147 lbs","152","33",151,163,11,11,16,13,13,8,4,12,4,5,12,11,6,15,16,12,8,12,10,11,12,15,4,13,6,11,12,11,18,17,12,5,16,18,13,8,10,7,7,11,11,13,5,13,10,4,13,15,13,3,3,2,2,1,1,1,1,3,3,4
"484",2000182819,"Leny Yoro","11/13/2005 (17 years old)","D (C)","LOSC","Ligue 1 Uber Eats","FRA","Yes","1/10/2022","6/30/2025","$19M - $24M","Right","Weak","Very Strong","6'3""","182 lbs","14","-",113,163,8,8,10,6,12,6,15,8,5,12,11,7,13,11,10,13,12,11,12,12,16,11,12,11,12,13,10,12,11,11,11,15,12,11,11,13,8,12,12,16,14,14,5,18,7,6,11,14,8,1,3,2,3,3,1,2,4,3,1,2
"485",2000094715,"Guillaume Restes","3/11/2005 (18 years old)","GK","Toulouse FC","Ligue 1 Uber Eats","FRA","Yes","7/1/2021","6/30/2026","$29M - $37M","Left","Very Strong","Weak","6'2""","180 lbs","-","-",120,163,3,1,1,2,12,7,3,3,1,3,12,2,3,11,5,12,14,12,12,12,16,7,5,1,12,12,12,11,15,13,12,12,14,13,11,11,12,13,12,14,11,14,5,11,5,7,12,14,14,11,11,15,8,13,12,11,6,12,11,10
"486",48043873,"Randal Kolo Muani","12/5/1998 (24 years old)","AM (RL), ST (C)","Eintracht Frankfurt","Bundesliga","FRA","Yes","7/1/2022","6/30/2027","$88M - $106M","Right","Reasonable","Very Strong","6'2""","160 lbs","125","39",157,163,6,9,16,14,15,7,13,10,6,6,13,15,6,15,13,15,12,14,12,13,15,16,8,16,6,12,14,12,17,16,14,15,16,17,14,13,12,12,13,14,15,12,4,14,9,10,15,17,16,2,2,3,1,3,2,1,1,1,2,3
"487",49038952,"Khephren Thuram","3/26/2001 (22 years old)","DM, M (C)","OGC Nice","Ligue 1 Uber Eats","FRA","Yes","9/30/2021","6/30/2025","$31M - $46M","Right","Reasonable","Very Strong","6'4""","176 lbs","113","8",140,163,6,7,15,12,15,7,12,13,5,13,15,9,12,15,14,12,12,12,11,13,17,14,13,14,14,15,14,14,15,13,14,15,16,14,15,12,16,15,13,16,15,15,6,15,6,8,14,17,13,2,3,2,1,1,1,3,3,3,2,2
"488",49038942,"Benoît Badiashile","3/26/2001 (22 years old)","D (C)","Chelsea","English Premier Division","FRA","Yes","1/5/2023","6/30/2030","$82M - $123M","Left","Very Strong","Weak","6'4""","165 lbs","117","7",147,163,3,5,9,6,13,4,17,7,8,15,13,7,15,12,10,14,15,16,12,14,15,9,11,6,14,14,11,13,14,11,15,17,15,15,15,16,5,14,14,15,14,16,5,13,6,6,13,15,20,1,2,2,3,3,3,1,2,2,3,2
"489",49047182,"Manu Koné","5/17/2001 (22 years old)","DM, M (C)","Borussia M'gladbach","Bundesliga","FRA","Yes","1/21/2021","6/30/2025","$57M - $86M","Right","Weak","Very Strong","6'1""","176 lbs","107","6",138,163,4,8,16,8,14,4,11,12,6,12,15,7,15,16,17,13,16,13,12,13,16,16,7,12,12,13,14,16,14,14,13,11,13,13,15,16,12,8,8,14,15,10,8,13,13,8,13,16,17,2,4,3,1,2,1,1,2,3,4,3
"490",2000094152,"Claudio Echeverri","1/2/2006 (17 years old)","AM (RLC), ST (C)","River","Argentine Premier Division","ARG","No","6/13/2022","12/31/2025","$10M - $15.5M","Right","Reasonable","Very Strong","5'7""","138 lbs","16","1",107,167,9,11,14,11,15,12,6,11,2,6,13,4,10,14,7,15,6,9,9,13,14,16,12,11,8,10,11,11,13,10,10,7,15,13,6,7,14,16,12,11,11,15,9,5,5,1,4,9,16,4,2,1,4,3,3,2,2,3,1,1
"491",2000183492,"Bastien Meupiyou","3/19/2006 (17 years old)","D (C), DM","FC Nantes","Ligue 1 Uber Eats","FRA","Yes","11/2/2022","6/30/2025","$11.5M - $17.5M","Left","Very Strong","Weak","6'3""","176 lbs","-","-",104,163,6,8,11,6,12,6,14,11,4,12,10,9,11,11,13,12,13,11,11,10,14,9,8,9,12,13,10,13,11,11,13,14,10,11,12,13,10,10,13,13,11,14,4,11,8,3,11,12,13,1,1,2,2,2,2,2,1,1,1,3
"492",85141999,"Presnel Kimpembe","8/13/1995 (27 years old)","D (C)","Paris SG","Ligue 1 Uber Eats","FRA","Yes","7/11/2020","6/30/2024","$43M - $54M","Left","Very Strong","Reasonable","6'0""","169 lbs","163","1",153,162,4,9,10,6,13,5,16,6,8,16,12,10,17,13,17,15,18,15,13,13,16,8,13,10,15,16,10,16,13,12,15,14,15,13,15,16,10,14,16,15,15,15,9,15,9,7,14,17,13,2,2,4,1,2,3,2,3,1,1,1
"493",85075595,"Kurt Zouma","10/27/1994 (28 years old)","D (RC)","West Ham","English Premier Division","FRA","Yes","8/28/2021","6/30/2025","$71M - $89M","Right Only","Weak","Very Strong","6'3""","211 lbs","282","16",153,162,4,10,9,8,11,6,17,7,8,13,11,7,15,10,15,13,14,11,12,14,16,7,13,8,14,13,8,15,16,11,19,18,12,15,14,20,8,13,15,17,14,13,9,15,13,5,15,17,13,1,1,2,3,3,3,3,2,1,1,3
"494",49048599,"Joris Chotard","9/24/2001 (21 years old)","DM, M (C)","Montpellier","Ligue 1 Uber Eats","FRA","Yes","6/29/2022","6/30/2026","$28M - $35M","Right","Weak","Very Strong","5'10""","154 lbs","120","1",130,162,8,8,12,6,13,9,10,6,5,11,14,6,14,14,13,14,14,13,14,14,13,12,9,11,13,16,13,16,14,14,14,12,14,14,13,14,10,12,12,15,13,12,8,13,13,8,15,13,13,1,3,3,2,3,2,2,1,4,4,1
"495",49047065,"Mohamed Simakan","5/3/2000 (23 years old)","D (RC), WB (R)","RB Leipzig","Bundesliga","FRA","Yes","12/6/2022","6/30/2027","$56M - $67M","Right","Reasonable","Very Strong","6'2""","180 lbs","90","3",145,162,3,12,13,8,12,4,14,7,12,14,13,6,15,12,13,14,16,14,13,13,16,12,10,11,14,14,12,14,14,13,14,14,12,16,14,15,13,9,9,13,14,12,12,14,8,7,13,16,13,3,1,1,2,2,2,1,1,3,3,3
"496",49048357,"Lucas Chevalier","11/6/2001 (21 years old)","GK","LOSC","Ligue 1 Uber Eats","FRA","Yes","1/30/2023","6/30/2027","$19M - $23M","Right","Weak","Very Strong","6'2""","185 lbs","62","-",125,161,5,3,3,3,12,7,1,1,2,1,12,5,3,10,12,9,14,12,12,16,14,1,11,2,12,12,11,11,11,12,6,14,13,11,11,12,13,19,13,15,13,14,5,6,5,7,12,13,10,11,11,15,5,14,12,12,8,11,13,12
"497",34011687,"Alexandre Lacazette","5/28/1991 (32 years old)","ST (C)","OL","Ligue 1 Uber Eats","FRA","Yes","7/1/2022","6/30/2025","Not for Sale","Right","Reasonable","Very Strong","5'9""","160 lbs","396","181",140,161,5,11,14,15,15,11,13,12,3,5,12,14,5,15,10,15,14,14,14,14,12,14,15,16,7,15,12,14,13,14,15,10,13,13,13,12,10,14,14,14,12,15,8,13,10,7,12,13,14,2,2,3,3,1,2,3,1,2,2,1
"498",49040115,"Illan Meslier","3/2/2000 (23 years old)","GK","Leeds","Sky Bet Championship","FRA","Yes","8/13/2021","6/30/2026","$22M - $27M","Left Only","Very Strong","Weak","6'5""","163 lbs","145","-",132,161,3,1,3,3,10,5,9,1,3,2,10,2,3,12,12,14,15,13,12,11,12,6,8,4,12,12,10,12,9,16,12,17,15,9,13,8,7,15,10,13,9,13,6,14,6,6,13,13,15,13,15,16,10,17,12,13,10,12,11,17
"499",48037391,"Matteo Guendouzi","4/14/1999 (24 years old)","DM, M/AM (C)","OM","Ligue 1 Uber Eats","FRA","Yes","7/1/2022","6/30/2025","$11M - $14M","Right","Weak","Very Strong","6'1""","149 lbs","178","8",144,161,9,12,14,9,15,11,12,11,5,12,15,7,15,16,14,14,15,12,12,13,14,14,12,14,13,15,15,16,15,15,14,11,13,14,15,12,8,13,7,12,10,8,7,13,15,15,15,13,15,3,3,2,2,1,3,1,2,1,3,1
"500",85133751,"Ferland Mendy","6/8/1995 (28 years old)","D/WB (L)","R. Madrid","Spanish First Division","FRA","Yes","6/14/2021","6/30/2025","$26M - $33M","Left","Very Strong","Fairly Strong","5'11""","160 lbs","195","10",154,160,5,13,13,7,13,5,9,11,13,13,12,7,12,13,14,14,17,13,11,11,15,13,6,13,13,15,11,17,17,15,16,11,15,16,16,15,15,12,10,14,12,12,12,13,8,9,13,16,12,1,2,2,3,1,2,2,1,3,2,2
"501",23233176,"Lo'ay Omran","7/22/1988 (34 years old)","M/AM (RC), ST (C)","Shabab Ordon","Jordanian Professional League","JOR","No","1/16/2022","6/30/2024","$0 - $20K","Right","Reasonable","Very Strong","6'1""","167 lbs","107","20",78,110,7,9,6,12,9,6,8,7,7,6,10,7,9,8,9,9,6,9,8,12,3,8,4,11,8,8,11,9,11,9,8,14,15,9,9,6,9,11,12,11,11,12,9,3,10,2,18,9,10,3,3,3,4,3,2,3,1,2,3,1
"502",22067326,"Valentin Antov","11/9/2000 (22 years old)","D (C)","Brianza","Italian Serie A","BUL","Yes","7/1/2022","6/30/2026","$150K - $1.5M","Right","Reasonable","Very Strong","6'2""","165 lbs","85","3",118,143,6,7,9,8,9,7,12,7,11,13,11,9,14,11,14,13,14,12,12,12,15,6,14,9,13,18,11,14,10,11,11,15,14,11,13,12,15,18,16,18,18,14,8,14,9,1,14,15,8,2,3,2,2,2,2,3,1,1,1,1
"503",2000155718,"Eldin Cikotic","2/19/2003 (20 years old)","D/M/AM (L)","Rodange","Luxembourg Division of Honour","LUX","Yes","7/1/2022","6/30/2023","$0","Left Only","Very Strong","Weak","5'6""","138 lbs","11","-",69,109,6,11,10,9,10,7,3,7,7,7,8,6,9,10,7,7,8,4,8,13,13,11,11,14,7,8,9,9,14,12,8,3,15,13,5,3,10,17,11,13,9,10,14,10,5,4,9,13,16,1,2,3,2,1,2,2,3,2,3,1
"504",48020053,"Milos Todorovic","8/18/1995 (27 years old)","D (C), DM, M (C)","Jeunesse Esch","Luxembourg National Division","LUX","Yes","6/1/2021","6/30/2024","$24K - $70K","Right Only","Weak","Very Strong","5'11""","167 lbs","229","15",83,108,5,5,7,5,8,8,10,8,10,10,11,5,11,10,12,11,10,10,11,11,13,8,13,10,11,13,8,12,10,10,12,11,13,10,13,11,13,10,15,15,12,18,7,12,12,8,14,10,16,3,2,3,4,2,3,1,3,1,2,2
"505",18077534,"David Turpel","10/19/1992 (30 years old)","ST (C)","Swift Hesperange","Luxembourg National Division","LUX","Yes","7/1/2020","6/30/2024","$0 - $65K","Right Only","Weak","Very Strong","6'2""","165 lbs","206","132",89,108,7,6,12,12,11,8,11,8,1,4,11,13,5,13,8,13,8,13,10,10,9,14,6,14,10,11,11,8,12,11,12,12,12,11,10,12,13,10,10,10,9,9,10,7,7,8,13,9,8,3,1,2,3,1,1,3,3,1,1,2
"506",91165988,"Eric Veiga","2/18/1997 (26 years old)","D/WB (L), DM","Vilafranquense","Portuguese Lower Regional Divisions","LUX","Yes","9/9/2020","-","$0","Left Only","Very Strong","Weak","6'0""","156 lbs","115","5",100,108,14,13,11,5,11,15,10,9,5,11,10,4,12,11,12,12,11,12,12,10,12,7,10,8,12,11,10,12,12,12,10,11,10,12,13,10,11,11,11,14,12,11,6,7,8,9,12,12,10,1,1,3,2,2,3,2,3,3,3,1
"507",2000137454,"Fabio Lohei","4/12/2005 (18 years old)","D/WB (L)","FC Metz","Ligue 1 Uber Eats","LUX","Yes","7/1/2021","6/30/2025","$100K - $1M","Right Only","Weak","Very Strong","5'9""","147 lbs","-","-",78,108,6,9,9,6,9,2,9,4,7,7,10,6,12,8,11,10,9,9,9,14,9,5,10,7,9,13,6,9,14,11,14,9,11,12,8,4,10,14,12,14,10,11,7,8,8,2,11,12,14,1,1,3,1,3,3,3,1,3,3,1
"508",95064785,"Léon Schmit","9/28/2001 (21 years old)","D/WB/M (L)","Buchbach","German Regional Division Bavaria","LUX","Yes","7/1/2022","6/30/2024","$30K - $90K","Left Only","Very Strong","Weak","5'10""","156 lbs","98","8",82,108,9,14,5,2,7,8,8,2,3,9,10,3,15,10,14,12,9,10,7,12,12,7,10,9,6,9,5,10,14,9,9,10,12,10,15,6,11,18,11,9,10,12,10,5,6,4,10,12,20,1,2,3,1,1,3,1,4,2,3,2
"509",88026183,"Marko Stamenić","2/19/2002 (21 years old)","DM, M (C)","FC København","3F Superliga","NZL","No","9/1/2020","12/31/2024","$75K - $750K","Right","Reasonable","Very Strong","6'2""","171 lbs","80","10",118,148,8,9,11,9,13,10,11,8,4,13,13,10,13,14,14,13,13,12,11,12,14,13,8,12,13,13,11,14,12,12,14,15,14,12,12,12,15,13,14,14,13,13,7,12,13,5,11,15,16,1,2,2,2,2,1,2,3,1,2,3
"510",2000204619,"Kian Donkers","9/12/2004 (18 years old)","AM (RL), ST (C)","N.E.C. Nijmegen","Eredivisie","NZL","Yes","1/31/2023","6/30/2025","$130K - $1.3M","Right Only","Weak","Very Strong","6'2""","180 lbs","27","14",73,140,8,5,9,12,10,9,7,7,1,7,7,11,5,11,10,12,10,10,10,10,6,10,1,10,8,11,8,11,11,8,6,11,8,11,10,11,9,18,12,9,12,11,11,10,11,8,8,11,11,1,1,2,3,3,3,2,2,3,2,2
"511",88025279,"Alex Paulsen","7/4/2002 (20 years old)","GK","Wellington Phoenix","Isuzu UTE A-League","NZL","No","1/2/2022","6/30/2025","$120K - $1.2M","Right","Reasonable","Very Strong","6'4""","182 lbs","30","-",94,139,6,2,8,2,9,7,6,3,3,3,8,4,3,9,14,12,12,13,11,9,14,11,8,2,10,11,10,10,9,12,10,13,12,9,10,10,11,15,8,14,10,11,4,12,7,4,9,13,20,11,7,13,13,12,12,10,15,12,11,11
"512",5108293,"Chris Wood","12/7/1991 (31 years old)","ST (C)","Nottm Forest","English Premier Division","NZL","No","1/13/2022","6/30/2025","$28M - $34M","Right","Reasonable","Very Strong","6'3""","198 lbs","475","143",130,138,3,9,11,13,12,10,15,11,3,7,12,15,9,12,14,14,16,13,13,14,15,10,14,12,10,16,9,15,12,11,16,16,14,11,15,15,5,13,13,16,15,15,9,13,7,5,11,11,15,2,1,2,2,1,2,3,2,2,2,1
"513",7508952,"Ivelin Popov","10/26/1987 (35 years old)","M/AM (C), ST (C)","Levski","Bulgarian First League","BUL","Yes","7/1/2022","6/30/2024","$0","Right","Reasonable","Very Strong","6'0""","158 lbs","410","76",116,140,13,12,14,12,13,13,9,13,7,8,13,13,10,13,13,14,11,14,13,13,16,15,13,15,10,13,13,10,11,11,12,12,14,11,9,11,14,7,10,13,12,12,10,11,11,17,12,14,12,2,3,4,2,1,3,3,4,2,1,2
"514",88024471,"Liberato Cacace","9/27/2000 (22 years old)","D/WB (L)","Empoli","Italian Serie A","NZL","Yes","1/1/2023","6/30/2025","$275K - $2.8M","Left","Very Strong","Weak","6'0""","145 lbs","145","6",118,137,6,13,12,8,13,5,8,12,11,12,11,4,14,13,7,11,10,10,10,10,15,11,5,12,11,12,11,12,15,13,14,10,16,14,14,12,9,16,8,10,10,11,5,11,10,8,14,14,18,2,3,3,1,1,3,3,1,2,1,2
"515",29006555,"Tommy Smith","3/31/1990 (33 years old)","D (C)","Colchester","Sky Bet League Two","NZL","No","8/25/2020","6/30/2024","$500 - $4.5K","Left Only","Very Strong","Weak","6'2""","182 lbs","425","31",76,135,5,6,6,7,8,6,10,5,12,10,8,4,11,7,12,10,14,10,11,10,15,2,14,9,12,12,6,12,7,7,12,13,11,7,13,13,9,15,14,16,12,13,6,11,4,4,11,12,11,2,1,1,1,3,2,3,2,2,2,2
"516",53184886,"Joe Bell","4/27/1999 (24 years old)","DM, M (C)","Brøndby IF","3F Superliga","NZL","No","1/31/2022","6/30/2026","$90K - $900K","Right","Fairly Strong","Very Strong","6'0""","171 lbs","123","3",117,130,13,8,12,8,12,12,6,9,6,8,12,6,12,12,16,12,13,12,13,13,16,9,12,11,13,15,12,16,11,12,13,10,14,12,13,12,15,17,16,16,10,12,4,13,5,2,9,14,14,2,4,2,1,1,3,3,1,1,1,3
"517",28106413,"Michael Woud","1/16/1999 (24 years old)","GK","Kyoto","J1 League","NZL","Yes","1/4/2022","12/31/2024","$475K","Right Only","Weak","Very Strong","6'5""","196 lbs","55","-",99,129,1,3,1,3,8,6,2,1,2,2,9,3,1,5,6,11,12,11,10,12,12,3,12,1,11,10,9,9,8,11,11,10,12,13,9,9,12,17,11,12,10,13,13,7,8,4,10,14,11,11,12,12,10,12,12,11,7,10,11,13
"518",2000253993,"Gabriel Sloane-Rodrigues","7/3/2007 (15 years old)","AM (RLC)","Wellington Phoenix","Isuzu UTE A-League","NZL","No","1/1/2022","6/30/2029","$170K - $500K","Right","Reasonable","Very Strong","5'9""","147 lbs","-","-",53,129,6,10,10,11,12,5,3,6,2,1,12,4,5,11,9,3,12,7,6,5,16,17,10,5,4,4,6,6,11,11,13,6,11,13,5,6,13,17,10,13,10,12,5,10,10,2,3,12,19,1,3,3,1,2,1,2,1,2,2,2
"519",88023585,"Sarpreet Singh","2/20/1999 (24 years old)","M/AM (RLC)","FC Bayern","Bundesliga","NZL","No","7/1/2019","6/30/2028","$80K - $230K","Left","Very Strong","Reasonable","5'10""","154 lbs","164","33",115,128,15,12,13,10,13,13,6,11,6,8,14,12,10,15,13,11,10,12,10,12,11,14,3,11,8,12,15,11,12,14,12,7,11,13,12,8,13,8,8,8,10,10,8,12,10,13,12,12,12,2,2,2,3,1,3,3,2,1,2,2
"520",2000127883,"Henry Gray","3/29/2005 (18 years old)","GK","Ipswich","Sky Bet Championship","NZL","Yes","5/14/2023","6/30/2025","$55K - $550K","Right","Reasonable","Very Strong","6'2""","174 lbs","24","-",76,127,3,2,2,2,7,4,1,3,2,1,6,3,3,2,13,7,8,8,10,6,13,2,9,3,12,7,7,6,6,17,8,13,11,9,1,6,10,19,10,10,9,11,7,9,11,7,14,10,20,6,15,11,9,10,12,11,5,8,12,11
"521",37047951,"Ryan Thomas","12/20/1994 (28 years old)","M/AM (C)","PEC Zwolle","Eredivisie","NZL","Yes","6/2/2023","6/30/2024","$300K - $3M","Right","Reasonable","Very Strong","5'9""","141 lbs","200","17",116,126,11,11,14,6,14,8,10,10,7,7,15,13,5,15,10,13,8,12,12,12,15,9,9,16,11,14,12,15,12,14,12,9,9,12,10,9,17,11,10,12,11,12,18,7,7,8,12,12,16,2,1,1,3,3,2,2,1,3,3,2
"522",88025225,"Matthew Garbett","4/13/2002 (21 years old)","M/AM (RC)","NAC Breda","Keuken Kampioen Divisie","NZL","Yes","8/26/2021","6/30/2028","$0","Right","Weak","Very Strong","6'2""","169 lbs","66","16",101,122,10,7,10,10,12,13,10,11,9,5,13,6,5,12,8,11,10,11,12,11,11,12,8,10,6,12,11,12,12,13,11,14,13,13,13,9,18,12,12,12,12,9,8,4,12,6,9,11,14,2,1,1,3,1,4,1,2,3,2,3
"523",88024945,"Ben Waine","6/11/2001 (22 years old)","ST (C)","Plymouth","Sky Bet Championship","NZL","No","1/1/2023","6/30/2025","$650K - $1.4M","Right","Reasonable","Very Strong","5'10""","174 lbs","120","33",98,122,4,12,10,12,12,7,10,11,2,3,8,10,7,12,9,10,12,8,10,9,17,9,6,12,4,11,9,16,13,12,12,12,15,13,13,12,13,12,12,14,11,13,6,14,6,4,10,14,14,2,3,2,3,3,3,2,2,2,4,1
"524",22074169,"Dominik Yankov","7/28/2000 (22 years old)","M (C), AM (RLC)","Ludogorets","Bulgarian First League","BUL","Yes","6/25/2022","6/30/2025","$1.9M - $3.9M","Right","Fairly Strong","Very Strong","5'11""","154 lbs","144","19",113,140,12,11,13,11,12,11,8,11,5,7,13,11,9,13,12,12,10,11,9,10,16,14,9,13,9,13,13,13,13,14,12,8,12,13,10,7,13,11,10,14,12,13,8,14,9,7,10,16,16,2,2,3,3,3,3,2,1,4,1,2
"525",2000293527,"Tyler Bindon","1/27/2005 (18 years old)","D (RC), WB (R)","Reading","Sky Bet League One","NZL","No","6/12/2023","6/30/2025","$140K - $1.4M","Right","Reasonable","Very Strong","6'0""","169 lbs","-","-",97,122,7,7,7,5,11,7,12,8,14,12,10,5,10,7,11,10,12,11,12,9,15,5,9,9,10,12,8,13,12,12,10,12,17,13,13,12,12,19,11,11,13,10,8,8,14,3,12,11,14,2,1,1,3,2,1,2,1,1,2,1
"526",29162696,"Oliver Whyte","1/20/2000 (23 years old)","DM, M/AM (C)","FC Haka","Finnish Premier League","NZL","No","1/1/2022","11/15/2023","$45K - $450K","Left","Very Strong","Reasonable","6'0""","167 lbs","93","24",92,121,9,10,11,7,12,10,7,10,5,9,12,8,11,13,12,12,10,11,11,10,3,11,9,12,10,13,12,13,10,11,11,7,12,8,12,7,9,15,11,11,13,10,7,13,9,2,13,11,12,3,1,3,1,3,1,3,3,4,3,1
"527",1302065,"Jeremy Brockie","7/10/1987 (35 years old)","AM (R), ST (C)","Brothers FC","FQ Premier League - Northern","NZL","No","1/1/2023","-","$0","Right","Reasonable","Very Strong","6'0""","176 lbs","309","89",87,120,5,11,10,12,11,7,13,12,8,4,8,10,8,10,11,11,12,12,10,11,13,10,7,12,11,9,10,9,9,9,10,14,12,7,10,13,13,11,11,12,9,5,7,9,10,10,11,18,14,1,1,1,1,1,1,1,1,1,1,1
"528",15001285,"Kosta Barbarouses","2/19/1990 (33 years old)","M/AM (R), ST (C)","Wellington Phoenix","Isuzu UTE A-League","NZL","Yes","6/21/2022","6/30/2024","$140K - $425K","Right","Reasonable","Very Strong","5'7""","149 lbs","347","87",99,120,10,13,11,10,11,4,6,9,6,8,8,7,6,14,9,13,10,10,10,7,12,13,6,11,6,10,7,14,14,13,10,6,12,13,12,8,10,10,10,14,9,4,7,9,6,6,13,16,11,3,2,2,3,1,2,3,1,2,4,1
"529",88031066,"Marco Lorenz","10/17/2003 (19 years old)","D (RC), WB (R)","Wellington Phoenix","Isuzu UTE A-League","NZL","No","7/2/2021","6/30/2025","$120K - $1.2M","Right","Weak","Very Strong","6'3""","176 lbs","53","1",72,120,5,9,9,2,10,2,9,8,1,13,13,3,12,10,7,9,9,8,5,11,3,5,4,6,6,9,9,12,10,9,9,17,12,8,11,6,10,17,11,12,9,9,8,10,5,1,8,13,13,2,2,2,1,1,4,3,2,2,3,3
"530",88023243,"Logan Rogerson","5/28/1998 (25 years old)","AM (RL), ST (C)","FC Haka","Finnish Premier League","NZL","No","1/1/2022","11/15/2023","$8K - $85K","Right Only","Weak","Very Strong","6'0""","169 lbs","125","29",100,120,5,7,13,7,12,7,8,8,5,6,7,7,7,13,11,9,9,8,7,6,14,14,9,13,6,9,9,14,15,13,12,9,12,14,12,9,11,6,7,9,15,12,7,12,13,7,7,12,18,3,3,1,2,1,2,1,3,1,3,2
"531",88024900,"Callum McCowatt","4/30/1999 (24 years old)","M (LC), AM (L)","FC Helsingør","NordicBet Liga","NZL","No","9/6/2020","12/31/2023","$0","Right","Fairly Strong","Very Strong","5'10""","160 lbs","156","61",113,120,9,12,12,12,13,9,10,11,7,4,12,9,8,13,12,13,10,12,12,10,12,12,13,13,7,14,11,12,13,11,11,9,13,12,13,9,14,15,10,12,12,11,6,13,8,1,13,11,12,3,2,1,3,1,1,2,2,1,1,2
"532",85134381,"Bill Tuiloma","3/27/1995 (28 years old)","D (C), DM","Charlotte FC","Major League Soccer","NZL","No","2/16/2023","12/31/2025","$2.4M - $4.9M","Right","Reasonable","Very Strong","5'10""","176 lbs","153","15",116,119,5,9,12,11,11,10,14,10,12,11,10,8,13,12,9,12,12,10,11,10,12,12,5,11,10,10,9,14,15,12,13,11,14,13,13,14,12,14,14,15,13,12,8,9,9,5,13,9,13,2,1,2,2,2,3,4,3,1,3,2
"533",88024943,"Sam Sutton","12/10/2001 (21 years old)","D/WB (L), M (C)","Wellington Phoenix","Isuzu UTE A-League","NZL","No","6/13/2022","6/30/2025","$85K - $850K","Left","Very Strong","Weak","5'9""","163 lbs","95","4",94,119,10,11,11,8,13,13,7,13,3,10,12,9,11,12,10,10,6,13,10,13,16,12,9,9,9,11,11,11,11,13,12,7,13,10,12,7,15,19,12,16,10,11,5,10,13,3,11,16,15,1,1,2,2,1,2,1,2,4,2,1
"534",2000257764,"Luke Supyk","3/4/2006 (17 years old)","AM (L), ST (C)","Wellington Phoenix","New Zealand Central League","NZL","No","1/1/2022","6/30/2027","$55K - $550K","Right","Reasonable","Very Strong","5'9""","141 lbs","-","-",64,118,8,11,14,11,12,6,8,4,4,6,9,3,4,7,9,10,1,9,7,10,7,7,2,12,6,12,7,6,13,9,6,6,14,10,8,5,11,15,13,12,13,11,5,9,11,4,2,10,18,3,2,1,1,3,3,2,2,2,3,2
"535",22077359,"Stanislav Shopov","2/23/2002 (21 years old)","M (C), AM (RC)","CSKA-Sofia","Bulgarian First League","BUL","Yes","6/4/2022","6/30/2025","$210K - $2.1M","Left","Very Strong","Reasonable","5'10""","149 lbs","68","2",108,140,14,13,14,9,13,14,6,11,5,7,14,10,8,14,9,11,8,10,9,11,14,15,11,13,8,12,15,10,12,13,11,8,13,11,10,8,11,14,14,13,11,16,8,13,8,8,12,14,5,3,1,3,2,2,3,1,1,4,3,4
"536",2000007481,"Oliver Colloty","7/4/2003 (19 years old)","ST (C)","Auckland City","New Zealand Northern League","NZL","No","12/31/2022","12/31/2025","$10K - $35K","Right","Reasonable","Very Strong","6'4""","185 lbs","80","44",74,118,5,8,8,11,8,8,8,7,4,3,10,10,5,11,6,9,8,6,11,11,18,10,11,10,7,8,9,10,9,10,12,10,12,11,11,9,11,15,8,11,12,12,6,8,10,3,16,13,18,2,1,3,3,1,3,2,3,1,3,3
"537",2000252561,"Oliver Middleton","9/19/2005 (17 years old)","M/AM (C)","Auckland United","New Zealand Northern League","NZL","No","6/13/2022","-","$0","Right Only","Weak","Very Strong","5'10""","147 lbs","13","3",62,118,6,6,7,8,11,6,6,8,1,4,13,6,6,9,9,7,3,7,8,14,14,8,7,10,6,13,13,8,11,12,13,4,13,10,6,4,14,17,10,12,12,12,5,5,5,1,10,9,11,2,1,2,2,3,2,3,3,2,3,2
"538",2000181200,"Keegan Kelly","6/5/2005 (18 years old)","ST (C)","Western Springs","New Zealand Northern League","NZL","No","6/13/2022","-","$0","Left Only","Very Strong","Weak","6'4""","176 lbs","23","17",69,116,8,5,7,8,8,8,9,7,5,5,8,4,7,9,12,8,13,10,7,10,8,10,11,11,6,9,7,9,11,11,7,16,11,13,8,11,7,15,9,12,10,12,8,2,5,5,13,11,7,1,3,2,1,2,2,2,1,1,3,1
"539",2000210741,"Isaac Hughes","3/25/2004 (19 years old)","D (C)","Wellington Phoenix","Isuzu UTE A-League","NZL","No","1/1/2020","6/30/2025","$450K - $1.4M","Right Only","Weak","Very Strong","6'0""","165 lbs","28","-",78,116,5,6,7,5,9,6,11,5,4,10,9,6,9,8,11,12,11,12,12,12,3,10,11,10,11,13,9,10,9,9,8,11,10,8,11,11,10,18,11,12,14,11,5,2,5,5,12,11,19,3,3,1,1,1,3,3,1,1,3,1
"540",88000938,"Marco Rojas","11/5/1991 (31 years old)","M/AM (RL)","Colo Colo","Chilean First Division","NZL","No","7/11/2022","12/31/2023","$75K - $750K","Right","Fairly Strong","Very Strong","5'6""","141 lbs","282","56",110,116,11,12,13,10,13,12,5,12,6,4,12,9,5,14,13,12,7,10,9,8,11,16,6,14,5,13,13,9,14,16,8,5,14,13,10,6,14,18,16,16,7,6,6,9,6,7,8,13,11,1,3,1,2,1,1,1,2,2,3,3
"541",29162691,"Willem Ebbinge","1/6/2001 (22 years old)","M/AM (C)","Queenstown","New Zealand Southern Premier League","NZL","Yes","1/1/2019","-","$0","Right","Reasonable","Very Strong","6'0""","167 lbs","33","5",88,115,9,7,12,11,12,9,8,6,5,7,10,6,8,12,7,11,8,11,12,10,5,12,12,11,9,12,13,14,9,12,12,8,12,10,12,8,8,13,12,11,8,10,4,8,11,2,11,11,20,2,3,1,2,3,2,3,2,1,2,3
"542",690943,"Themis Tzimopoulos","11/20/1985 (37 years old)","D (C), DM","Levadeiakos","Greek Super League 2 North","NZL","Yes","2/10/2021","6/30/2024","$500 - $5K","Right","Reasonable","Very Strong","6'2""","180 lbs","431","29",95,115,4,9,9,6,10,7,14,13,9,12,14,8,12,12,15,10,14,12,12,10,15,8,15,10,12,14,12,13,7,6,14,13,15,7,10,15,11,12,13,16,15,16,3,15,14,10,13,16,12,2,4,4,3,2,3,1,3,3,2,3
"543",88021932,"James McGarry","4/9/1998 (25 years old)","D/WB/M/AM (L)","CC Mariners","Isuzu UTE A-League","NZL","Yes","2/7/2023","6/30/2025","$0","Left Only","Very Strong","Weak","5'10""","163 lbs","122","11",105,115,9,12,13,9,11,10,7,9,12,8,13,7,9,13,7,9,9,13,11,12,15,13,9,12,8,12,11,14,13,12,13,7,12,13,12,10,10,10,9,10,8,11,5,10,8,6,11,13,19,3,1,3,1,3,1,3,3,1,2,3
"544",29162697,"Max Mata","7/10/2000 (22 years old)","ST (C)","Sligo Rovers","Irish Premier Division","NZL","No","2/15/2022","12/31/2024","$0","Left","Very Strong","Weak","6'2""","200 lbs","138","49",98,115,4,8,10,12,10,9,14,10,4,6,9,12,6,10,14,12,13,10,9,11,14,12,5,12,8,10,10,11,11,12,13,13,13,11,12,15,8,9,5,11,9,8,5,11,14,7,11,15,13,2,4,2,2,4,3,1,1,2,2,1
"545",72051254,"Elliot Collier","2/22/1995 (28 years old)","M/AM (L), ST (C)","San Diego","USSL Championship Western Conference","NZL","No","12/27/2022","11/30/2023","$75K - $750K","Left","Very Strong","Reasonable","6'4""","180 lbs","124","14",98,115,11,10,12,10,10,6,12,9,9,8,12,10,8,12,15,10,12,11,11,10,11,13,6,12,7,11,12,11,9,10,9,16,7,11,10,14,14,13,14,12,11,12,10,4,7,7,5,11,13,2,1,3,1,2,2,2,3,1,1,1
"546",22064932,"Petko Hristov","3/1/1999 (24 years old)","D (C)","Venezia","Italian Serie B","BUL","Yes","7/5/2021","6/30/2025","$210K - $2.1M","Right","Reasonable","Very Strong","6'3""","187 lbs","127","5",118,139,5,5,8,9,11,6,14,8,8,14,10,2,13,8,11,13,13,12,12,13,13,11,10,8,12,14,8,14,11,12,11,14,13,12,12,14,2,11,11,14,12,11,7,11,9,7,14,13,18,2,2,3,4,3,1,2,3,1,2,1
"547",88023993,"Elijah Just","5/1/2000 (23 years old)","AM (RLC), ST (C)","AC Horsens","NordicBet Liga","NZL","No","8/1/2022","6/30/2026","$550K - $1.6M","Left","Very Strong","Fairly Strong","5'9""","154 lbs","167","46",103,115,11,11,13,10,12,7,6,8,4,5,12,8,5,12,10,8,6,9,10,7,11,12,7,11,6,12,10,11,13,14,11,7,11,12,11,7,12,14,12,12,11,12,5,8,8,2,9,10,10,2,1,3,2,3,3,3,2,3,2,2
"548",88031641,"Noah Karunaratne","6/27/2003 (19 years old)","M (L), AM (LC)","Wellington Phoenix","Isuzu UTE A-League","NZL","No","7/2/2019","6/30/2025","$550K - $1.6M","Right","Weak","Very Strong","6'1""","154 lbs","46","2",81,115,6,7,12,6,9,7,4,6,2,2,8,8,6,10,12,8,11,7,10,13,11,8,5,11,3,8,9,10,11,13,12,10,11,13,9,8,8,19,10,11,11,11,6,2,4,8,8,10,9,2,3,3,1,3,2,1,1,2,1,1
"549",88026173,"Ben Old","8/13/2002 (20 years old)","AM (RLC)","Wellington Phoenix","Isuzu UTE A-League","NZL","No","1/2/2022","6/30/2026","$700K - $1.6M","Left Only","Very Strong","Weak","5'8""","160 lbs","74","6",91,114,8,11,14,10,13,8,4,8,4,4,11,8,9,13,11,9,11,8,8,8,19,13,6,10,7,12,11,13,14,14,15,4,10,10,10,7,8,18,11,18,18,11,4,13,11,2,9,18,19,1,1,1,1,1,1,3,2,3,3,1
"550",2000040784,"Adam Supyk","2/21/2004 (19 years old)","D/WB (L)","Eastern Suburbs","New Zealand Northern League","NZL","No","6/13/2022","12/31/2025","$0 - $22K","Left Only","Very Strong","Weak","5'10""","154 lbs","28","1",75,114,11,10,10,9,11,8,6,9,5,7,9,7,9,11,6,9,10,11,14,10,4,12,11,8,11,13,10,12,13,11,13,7,11,11,9,6,10,10,11,7,11,11,5,8,6,4,7,13,18,1,3,3,1,3,1,3,3,1,3,1
"551",29141034,"Nik Tzanev","12/23/1996 (26 years old)","GK","AFC Wimbledon","Sky Bet League Two","NZL","Yes","9/7/2021","6/30/2024","$16K - $160K","Right","Reasonable","Very Strong","6'5""","176 lbs","142","-",88,114,2,2,8,3,9,4,5,3,3,3,8,3,1,8,4,9,11,11,7,9,13,4,6,7,7,9,8,9,8,13,7,14,14,9,10,9,9,9,10,14,9,8,2,8,5,5,10,10,11,12,11,13,5,13,7,15,3,9,12,14
"552",88027225,"Dylan de Jong","9/28/1997 (25 years old)","D/WB (L)","Inter Aliya Tel-Aviv","Israeli B League South A Division","NZL","No","3/22/2021","-","$0","Left Only","Very Strong","Weak","5'11""","163 lbs","41","2",60,114,6,12,6,1,7,1,6,2,3,7,7,2,10,5,12,7,8,5,10,8,3,7,13,2,7,7,7,8,13,13,7,10,12,13,13,3,11,11,14,11,10,9,6,14,9,8,19,9,9,2,3,3,1,3,3,3,1,3,1,2
"553",88022277,"Andre de Jong","11/2/1996 (26 years old)","AM (C), ST (C)","Stellenbosch FC","South African Premier Soccer League","NZL","Yes","1/18/2023","6/30/2024","$35K - $100K","Right Only","Weak","Very Strong","5'11""","174 lbs","189","61",96,114,9,9,10,10,12,11,12,11,9,8,11,6,11,12,11,12,4,13,12,12,9,9,10,9,11,12,12,12,9,10,12,13,13,10,13,13,7,18,12,8,11,9,9,5,6,5,14,13,9,1,3,1,1,2,1,1,2,3,3,1
"554",88024898,"Dalton Wilkins","4/15/1999 (24 years old)","D (LC), WB/M (L)","Kolding IF","NordicBet Liga","NZL","No","7/1/2022","6/30/2024","$18K - $170K","Left","Very Strong","Reasonable","5'11""","134 lbs","107","11",85,114,12,12,12,4,12,5,6,5,8,7,11,5,11,12,13,11,9,9,8,8,7,12,11,10,8,10,10,11,12,12,13,8,12,11,10,8,14,13,9,11,12,11,13,4,14,6,11,13,18,3,2,2,2,2,3,2,3,3,2,1
"555",2000296392,"Nathan Walker","1/30/2006 (17 years old)","M/AM (RL)","Fencibles","New Zealand NRFL Championship","NZL","No","1/1/2022","-","$0","Right","Weak","Very Strong","6'0""","158 lbs","24","5",55,114,6,10,12,5,9,5,4,7,6,6,9,4,6,11,12,6,1,4,3,6,5,15,4,12,3,7,7,10,13,13,5,9,8,11,7,6,14,12,11,8,13,11,11,2,8,5,9,13,7,3,1,2,1,2,1,1,1,1,1,2
"556",45015314,"Michael James","9/17/1988 (34 years old)","D (RC)","Niigata","J1 League","NZL","No","1/1/2022","1/31/2024","$0 - $75K","Right","Reasonable","Very Strong","6'1""","180 lbs","309","9",98,114,6,7,5,3,9,3,8,6,7,11,9,5,12,7,12,10,15,8,12,14,13,7,7,7,7,11,6,11,11,11,9,13,13,10,10,14,14,14,11,11,12,11,4,12,7,4,14,12,17,1,1,3,1,2,2,2,2,1,2,3
"557",22067634,"Preslav Borukov","4/23/2000 (23 years old)","ST (C)","Arda","Bulgarian First League","BUL","Yes","1/17/2023","6/30/2025","$240K - $2.4M","Right","Weak","Very Strong","6'2""","196 lbs","85","22",109,138,7,9,9,14,10,9,13,9,8,6,9,9,8,11,12,14,13,13,13,11,14,8,12,13,9,12,10,11,12,10,13,14,16,13,12,13,9,12,13,17,13,11,8,15,7,3,14,15,12,4,2,3,3,2,3,4,3,1,1,1
"558",2000254083,"Marley Leuluai","11/8/2006 (16 years old)","D (C), DM, M (C)","Man City","English Premier Division","NZL","No","6/13/2022","6/30/2024","$0","Right","Reasonable","Very Strong","6'2""","167 lbs","-","-",65,113,6,3,4,9,6,8,10,10,7,10,15,2,11,9,7,7,8,8,5,8,15,6,15,9,9,9,10,10,11,6,9,14,14,10,6,12,7,14,12,13,10,12,15,2,12,4,4,10,16,2,3,1,1,3,3,3,4,3,3,3
"559",88031138,"Kees Sims","3/27/2003 (20 years old)","GK","Ljungskile SK","Swedish First Division South","NZL","Yes","9/22/2022","12/31/2025","$0 - $65K","Right","Weak","Very Strong","6'4""","180 lbs","55","-",82,113,6,5,5,2,7,7,1,1,2,3,8,1,2,6,6,8,11,9,8,8,12,3,7,3,8,10,7,9,10,11,10,14,10,10,10,11,13,12,12,12,13,10,5,9,5,2,12,11,14,10,10,12,9,11,11,11,12,10,10,16
"560",2000128241,"Lukas Kelly-Heald","3/18/2005 (18 years old)","D (LC)","Wellington Phoenix","Isuzu UTE A-League","NZL","No","1/1/2021","6/30/2025","$325K - $950K","Left","Very Strong","Weak","6'6""","196 lbs","30","-",72,113,2,7,5,5,9,4,10,4,5,9,9,5,12,8,9,10,12,12,11,7,18,9,6,8,11,11,10,9,9,7,6,16,12,11,11,13,14,20,9,12,13,11,5,13,5,7,7,10,12,1,2,2,3,2,4,2,1,1,1,1
"561",88026780,"Luis Toomey","7/1/2001 (21 years old)","M/AM (RC)","Eastern Suburbs","New Zealand Northern League","NZL","No","4/1/2023","-","$0","Right Only","Weak","Very Strong","5'11""","147 lbs","64","23",79,112,6,10,12,8,11,10,7,9,1,7,11,5,9,12,12,7,8,9,7,14,10,14,1,14,9,8,11,13,10,11,10,13,12,11,13,10,15,18,11,10,12,13,6,16,5,3,13,9,17,3,1,3,3,4,1,3,3,2,2,1
"562",5204729,"Michael McGlinchey","1/7/1987 (36 years old)","M/AM (LC)","Weston Workers","National Premier Leagues - Northern NSW","NZL","No","4/20/2022","6/30/2024","$0","Right","Reasonable","Very Strong","5'8""","136 lbs","269","22",67,112,9,9,10,8,12,13,5,8,3,6,11,11,8,12,7,10,7,10,8,12,12,12,7,9,10,11,11,10,4,12,12,5,14,5,12,5,13,14,13,14,14,10,6,13,8,6,13,16,14,1,1,3,3,2,1,1,3,1,3,3
"563",2000266923,"Stipe Ukich","1/3/2007 (16 years old)","ST (C)","Auckland City","New Zealand Northern League","NZL","Yes","6/13/2022","12/31/2025","$500 - $3K","Right Only","Weak","Very Strong","6'1""","154 lbs","-","-",51,112,4,5,10,6,9,3,11,3,1,2,2,3,1,8,11,5,6,11,4,12,10,9,9,4,5,4,6,6,14,10,5,13,16,13,11,8,6,14,11,10,12,9,5,4,10,5,8,12,7,1,1,2,3,4,1,2,3,2,3,1
"564",2000022271,"Abbosbek Fayzullayev","10/3/2003 (19 years old)","AM (RLC)","Paxtakor","Uzbekistan Superleague","UZB","No","1/1/2020","12/31/2025","$55K - $550K","Right","Fairly Strong","Very Strong","5'6""","125 lbs","33","7",98,147,11,12,15,9,13,11,7,9,3,6,12,11,9,14,6,7,7,10,9,11,11,14,7,9,4,11,12,11,10,14,11,5,12,12,12,3,7,13,12,12,11,8,5,11,4,4,11,14,19,1,2,2,2,3,2,3,1,1,1,1
"565",59092011,"Azizjon G'aniev","2/22/1998 (25 years old)","DM, M (C)","Shabab Al-Ahli","UAE Professional League","UZB","No","1/1/2020","6/30/2025","$750K - $5.4M","Right","Reasonable","Very Strong","5'10""","141 lbs","120","9",115,135,13,12,10,12,12,13,11,9,9,11,12,9,10,12,12,12,13,12,11,12,15,12,10,12,12,14,12,16,12,14,12,10,11,13,13,10,12,14,14,14,11,13,14,15,11,5,12,12,15,3,1,3,3,1,1,1,4,2,3,1
"566",59061760,"Eldor Shomurodov","6/29/1995 (27 years old)","AM (L), ST (C)","Spezia","Italian Serie B","UZB","No","8/2/2021","6/30/2026","$325K - $3.2M","Right","Fairly Strong","Very Strong","6'1""","167 lbs","235","46",124,135,6,9,13,11,15,7,12,9,5,5,12,11,8,14,12,12,7,11,11,11,14,13,4,16,8,15,11,13,14,13,12,12,16,15,12,12,12,17,14,15,8,13,5,8,5,1,11,16,12,3,1,1,1,3,2,2,2,4,1,3
"567",8060272,"Vitaly Denisov","2/23/1987 (36 years old)","D/WB (L)","Olmaliq","Uzbekistan Superleague","UZB","No","1/5/2023","12/31/2023","$0 - $6K","Left","Very Strong","Fairly Strong","5'10""","174 lbs","360","4",92,135,9,10,10,7,11,9,13,9,16,11,12,10,12,12,14,15,15,12,12,11,13,10,12,12,12,13,8,13,8,10,11,8,14,9,10,10,13,12,14,14,15,12,13,11,8,12,16,12,15,2,2,3,4,2,3,1,1,1,1,3
"568",22080125,"Svetoslav Vutsov","7/9/2002 (20 years old)","GK","Slavia Sofia","Bulgarian First League","BUL","Yes","7/1/2021","6/30/2026","$1.4M - $3M","Right Only","Weak","Very Strong","6'4""","180 lbs","78","-",110,137,3,2,9,2,10,6,8,2,2,2,11,4,3,9,11,12,14,10,12,10,14,5,11,7,12,13,10,11,12,13,11,15,16,11,11,13,11,9,10,12,10,13,7,13,6,10,13,13,8,11,16,13,13,12,14,11,7,8,10,14
"569",59132804,"Dilshod Saitov","2/2/1999 (24 years old)","D (R), M (C)","Paxtakor","Uzbekistan Superleague","UZB","No","1/2/2023","12/31/2025","$14K - $140K","Right","Reasonable","Very Strong","5'7""","145 lbs","106","11",100,132,9,13,9,8,13,9,11,9,7,12,8,6,12,11,15,8,10,11,13,13,17,10,5,10,11,10,12,11,15,15,10,4,15,15,9,8,15,13,13,11,10,12,11,5,5,6,20,10,17,2,1,2,2,2,1,1,1,3,3,2
"570",59123129,"Islomjon Qobilov","6/1/1997 (26 years old)","D (C)","Lokomotiv Toshkent","Uzbekistan Pro League","UZB","No","1/1/2021","12/31/2023","$35K - $110K","Right","Reasonable","Very Strong","6'1""","169 lbs","143","8",106,131,5,4,1,5,8,1,14,8,4,12,6,7,14,8,5,14,10,9,10,14,10,5,7,8,14,8,5,9,14,14,9,8,8,14,14,9,12,20,10,10,10,13,10,12,7,6,11,10,15,2,2,3,1,4,1,1,3,2,1,2
"571",59123147,"Abrorbek Ismoilov","1/8/1998 (25 years old)","M (C)","Navbahor","Uzbekistan Superleague","UZB","No","1/1/2023","12/31/2023","$3.5K - $35K","Right","Fairly Strong","Very Strong","5'9""","154 lbs","123","8",107,130,8,6,8,9,12,8,5,10,1,11,14,4,9,14,9,9,5,11,6,10,9,5,3,13,10,9,14,13,14,14,9,9,9,14,14,7,10,18,10,11,8,9,7,11,10,6,14,13,16,3,2,3,1,1,3,3,2,3,3,1
"572",2000131971,"Umarali Rahmonaliyev","8/18/2003 (19 years old)","DM, M (C)","Rubin","Russian Premier League","UZB","No","1/1/2023","6/10/2026","$85K - $850K","Right","Weak","Very Strong","5'7""","149 lbs","30","7",99,129,8,8,7,8,13,8,6,7,7,11,9,8,11,11,8,9,13,13,11,8,11,7,10,8,9,16,7,17,14,14,10,6,12,14,14,7,10,15,11,10,10,10,7,9,5,4,11,10,19,1,1,2,2,1,1,3,1,3,4,1
"573",2000168014,"Abdukodir Khusanov","2/29/2004 (19 years old)","D (C)","Energetik-BGU","Belarusian Highest League","UZB","No","3/17/2022","12/31/2024","$0","Right","Reasonable","Very Strong","6'1""","171 lbs","35","4",95,128,10,1,6,2,10,14,12,14,6,14,9,1,14,5,14,12,12,7,9,14,4,5,11,7,13,8,4,10,11,8,14,12,14,7,9,8,14,11,11,12,10,13,8,8,14,2,11,9,11,4,3,3,2,2,2,2,3,3,2,2
"574",2000220969,"Dilshod Berdiyev","4/14/2002 (21 years old)","AM (C)","Nasaf","Uzbekistan Superleague","UZB","No","1/1/2023","12/31/2023","$75K - $230K","Right","Reasonable","Very Strong","6'2""","171 lbs","-","-",101,128,4,4,8,12,13,5,8,14,1,8,10,8,5,11,10,10,7,8,4,6,5,11,9,12,9,9,10,13,14,14,8,11,12,14,14,6,15,12,9,13,11,12,6,17,7,3,13,11,8,3,3,2,3,3,3,2,3,3,3,3
"575",59126076,"Islom Kenjaboyev","9/1/1999 (23 years old)","AM (RL)","Qizilqum","Uzbekistan Superleague","UZB","No","6/30/2021","12/31/2023","$20K - $200K","Right","Reasonable","Very Strong","5'7""","134 lbs","104","12",104,127,7,11,13,12,13,9,7,11,9,9,12,6,6,15,10,14,5,13,11,11,15,13,9,11,9,5,12,10,15,15,9,5,12,15,8,2,13,15,13,8,10,12,11,12,8,3,10,11,8,3,3,1,4,3,1,1,1,2,2,2
"576",59044494,"Igor Sergeev","4/30/1993 (30 years old)","ST (C)","Tobyl","Kazakhstan Premier League","UZB","No","7/19/2021","12/31/2025","$230K - $2.3M","Left","Very Strong","Weak","6'2""","174 lbs","268","127",117,127,6,7,12,15,14,6,12,9,3,6,8,12,6,13,11,15,14,15,12,14,14,13,6,15,8,10,12,10,12,12,11,11,13,12,11,12,14,8,11,15,12,12,5,13,10,6,13,12,9,3,1,2,3,3,4,2,3,2,2,2
"577",2000021241,"Ibrohimxalil Yo'ldoshev","2/14/2001 (22 years old)","D/WB (L)","Pari NN","Russian Premier League","UZB","No","4/18/2022","6/10/2025","$1.5M - $3.2M","Left","Very Strong","Reasonable","5'8""","152 lbs","81","6",107,127,11,11,12,6,15,8,6,4,4,12,10,5,11,11,6,12,10,12,10,12,11,9,13,6,10,13,10,13,13,14,12,7,5,13,12,7,16,20,11,10,10,11,9,1,5,7,13,13,9,1,4,1,1,2,2,1,2,4,1,3
"578",59060373,"Odiljon Hamrobekov","2/13/1996 (27 years old)","DM, M (C)","Paxtakor","Uzbekistan Superleague","UZB","No","7/24/2021","12/31/2024","$90K - $275K","Right","Reasonable","Very Strong","5'11""","160 lbs","183","2",118,127,9,7,5,9,14,9,9,11,4,14,11,7,11,11,6,10,10,11,5,14,16,6,14,11,14,10,13,13,14,14,10,7,11,14,14,8,15,19,14,9,14,14,12,8,6,2,14,14,12,2,3,1,1,1,2,3,2,3,3,1
"579",22064853,"Daniel Naumov","3/29/1998 (25 years old)","GK","CSKA 1948","Bulgarian First League","BUL","Yes","12/22/2020","6/30/2024","$650K - $1.4M","Right Only","Very Weak","Very Strong","6'2""","171 lbs","177","-",115,137,1,3,9,2,10,1,7,1,3,2,11,4,1,9,9,11,16,11,12,10,17,6,13,7,10,13,9,11,13,15,12,14,15,11,11,12,1,16,14,16,17,14,7,15,7,2,13,16,9,11,16,15,13,15,12,11,7,9,9,12
"580",7900570,"Anzur Ismoilov","4/21/1985 (38 years old)","D (C)","Olmaliq","Uzbekistan Superleague","UZB","No","1/5/2022","12/31/2023","$0 - $10K","Right","Fairly Strong","Very Strong","6'3""","180 lbs","390","26",110,126,2,5,4,4,8,6,14,5,9,13,7,8,14,7,10,12,13,11,12,11,3,9,11,8,12,12,9,12,10,9,13,12,14,11,12,12,7,11,13,15,11,13,7,15,9,11,11,9,15,2,1,2,2,1,3,2,3,1,2,1
"581",2000130823,"Po'latxo'ja Xoldorxonov","7/6/2003 (19 years old)","ST (C)","Paxtakor","Uzbekistan Superleague","UZB","No","12/31/2022","12/31/2023","$8K - $80K","Right","Reasonable","Very Strong","6'1""","180 lbs","44","11",88,125,7,7,10,11,8,9,12,9,6,6,9,12,8,9,9,10,12,10,11,11,13,8,8,10,7,13,8,14,11,8,12,12,12,11,14,13,6,15,10,11,10,10,9,10,8,6,10,10,17,3,3,3,2,2,1,1,2,4,3,1
"582",59124116,"Hojiakbar Alijonov","4/19/1997 (26 years old)","D (RL), WB (R)","Paxtakor","Uzbekistan Superleague","UZB","No","1/8/2020","12/31/2023","$0 - $120K","Right","Weak","Very Strong","5'11""","156 lbs","102","4",116,125,7,12,13,6,11,5,11,11,10,12,12,5,14,9,7,12,13,9,13,14,15,7,15,11,13,13,11,16,13,8,10,10,16,14,14,10,15,12,11,11,11,10,12,9,9,3,13,9,18,2,1,3,4,2,1,3,2,3,3,1
"583",59138187,"Sherzod Nasrullayev","7/23/1998 (24 years old)","D/M (L)","Nasaf","Uzbekistan Superleague","UZB","No","7/28/2021","6/30/2024","$6K - $60K","Left","Very Strong","Fairly Strong","5'11""","154 lbs","78","3",106,125,9,9,9,7,11,9,9,9,7,11,11,7,11,10,11,9,11,10,11,8,5,6,10,9,9,6,10,11,15,15,10,7,14,15,15,11,13,10,10,9,9,11,10,5,9,1,8,11,15,1,1,4,1,3,2,3,2,1,1,2
"584",59023730,"Bahodir Nasimov","5/2/1987 (36 years old)","ST (C)","Dinamo Samarqand","Uzbekistan Pro League","UZB","No","1/1/2023","12/31/2023","$0 - $5K","Right Only","Weak","Very Strong","6'0""","176 lbs","362","82",82,124,6,5,10,9,14,8,13,9,1,8,7,5,5,10,10,15,4,11,8,14,6,8,10,11,7,8,9,9,12,9,9,14,10,11,12,11,10,16,12,14,11,12,7,10,5,8,10,8,15,2,3,4,3,1,3,1,3,2,1,2
"585",59072151,"Nurillo To'xtasinov","2/19/1997 (26 years old)","M (C)","Neftchi Farg'ona","Uzbekistan Superleague","UZB","No","1/1/2023","12/31/2023","$0","Right","Fairly Strong","Very Strong","5'8""","145 lbs","132","24",109,123,9,8,7,10,15,9,3,14,2,11,15,5,10,12,10,9,7,8,10,10,11,5,4,9,11,10,15,13,15,15,10,7,14,15,8,7,17,18,11,12,12,12,5,13,10,4,9,11,12,2,1,1,2,3,2,3,4,1,1,1
"586",59117489,"Islom Rashidxonov","10/22/1997 (25 years old)","AM (C)","Lokomotiv Toshkent","Uzbekistan Pro League","UZB","No","6/12/2023","12/31/2023","$22K - $70K","Right","Reasonable","Very Strong","5'9""","147 lbs","155","7",92,123,2,5,11,12,13,6,7,8,4,7,11,8,6,13,5,11,9,9,8,13,4,13,14,10,8,8,13,9,13,13,8,7,13,13,8,5,13,18,12,11,14,11,11,9,8,4,12,13,19,3,2,2,3,2,3,1,1,1,1,2
"587",73000065,"Jasur Hasanov","8/2/1983 (39 years old)","M (R)","So'g'diyona","Uzbekistan Superleague","UZB","No","7/2/2019","12/31/2023","$2.5K - $7K","Left","Very Strong","Reasonable","5'9""","156 lbs","400","41",95,122,11,13,11,6,13,11,11,4,7,10,12,8,12,8,10,13,7,17,10,14,16,5,14,11,11,12,14,15,9,9,9,11,14,9,10,9,15,18,13,12,12,12,10,7,12,4,14,12,20,2,1,3,3,1,3,2,4,1,1,2
"588",2000280545,"Shahzod Ne'matjonov","8/6/2003 (19 years old)","M/AM (C), ST (C)","Metallurg Bekobod","Uzbekistan Superleague","UZB","No","1/1/2023","12/31/2023","$65K - $190K","Right Only","Weak","Very Strong","6'0""","156 lbs","11","-",75,122,6,6,11,13,14,4,5,9,5,4,9,2,2,10,9,11,7,5,6,9,6,13,10,10,8,8,9,12,14,14,13,7,10,13,7,3,11,14,13,12,10,9,12,7,7,2,17,12,10,2,2,3,1,3,3,2,3,1,3,3
"589",59071777,"Anvarjon G'ofurov","6/28/1995 (27 years old)","D/M (R)","Neftchi Farg'ona","Uzbekistan Superleague","UZB","No","1/1/2023","12/31/2023","$16K - $45K","Right","Reasonable","Very Strong","5'9""","158 lbs","134","6",96,122,8,13,9,8,12,8,8,7,8,9,10,7,8,13,5,9,9,10,8,14,11,12,9,8,10,9,8,6,14,14,9,7,13,14,10,11,12,18,10,13,10,11,6,9,7,5,13,9,9,2,1,2,2,1,4,1,2,3,1,3
"590",22064939,"Iliyan Stefanov","9/20/1998 (24 years old)","AM (RLC), ST (C)","Levski","Bulgarian First League","BUL","Yes","2/9/2023","12/31/2025","$35K - $375K","Right","Fairly Strong","Very Strong","6'1""","167 lbs","110","17",112,136,11,10,13,12,11,11,13,13,7,5,12,12,8,13,9,13,11,11,8,9,15,14,10,13,8,11,12,12,13,12,12,13,12,12,10,11,14,13,12,13,13,11,11,14,8,5,9,14,13,1,2,1,1,1,3,1,2,3,1,1
"591",59130591,"Avazbek O'lmasaliyev","3/27/2000 (23 years old)","D (RL)","Bunyodkor","Uzbekistan Superleague","UZB","No","1/1/2021","12/31/2023","$4K - $40K","Right","Reasonable","Very Strong","6'2""","167 lbs","87","7",85,122,5,8,5,1,9,2,4,3,7,9,9,2,14,9,11,9,9,9,9,13,8,6,1,7,7,8,8,9,14,14,8,11,14,14,8,6,12,20,9,10,10,12,10,2,9,6,12,12,11,3,1,2,1,2,3,1,1,1,2,1
"592",59034605,"Sardor Rashidov","6/14/1991 (31 years old)","AM (RL), ST (C)","Paxtakor","Uzbekistan Superleague","UZB","No","2/15/2023","12/31/2024","Not for Sale","Right Only","Weak","Very Strong","6'0""","167 lbs","182","57",115,122,9,13,11,14,14,9,10,10,9,9,14,6,3,11,6,11,6,8,4,10,8,10,4,14,9,10,11,9,14,14,10,8,13,14,14,8,13,10,9,9,10,11,6,5,5,3,8,11,15,2,1,3,3,1,3,3,3,3,4,1
"593",59123092,"Sanjar Qodirqulov","5/27/1997 (26 years old)","AM (RL), ST (C)","Lokomotiv Toshkent","Uzbekistan Pro League","UZB","No","1/1/2021","12/31/2023","$0 - $120K","Right","Fairly Strong","Very Strong","5'7""","134 lbs","137","8",105,122,6,9,14,11,14,8,10,7,8,8,13,8,7,12,7,11,8,7,9,12,5,12,10,11,8,9,8,10,14,14,9,6,11,14,7,2,12,10,10,9,12,13,6,1,6,4,12,10,14,3,3,3,2,1,2,2,3,2,1,2
"594",59072137,"Akramjon Komilov","3/14/1996 (27 years old)","D (LC)","Olmaliq","Uzbekistan Superleague","UZB","No","1/8/2022","12/31/2023","$30K - $90K","Left","Very Strong","Fairly Strong","5'10""","154 lbs","182","5",105,121,6,10,9,4,11,3,14,6,9,15,8,4,15,10,12,11,11,10,11,13,12,5,8,11,9,10,8,11,11,15,10,10,15,14,12,8,10,14,12,11,11,11,12,10,4,2,12,13,17,1,1,3,2,1,2,1,1,3,4,3
"595",59117610,"Javohir Sidiqov","12/8/1996 (26 years old)","M/AM (C)","Nasaf","Uzbekistan Superleague","UZB","No","1/1/2022","12/31/2023","$0 - $110K","Right","Reasonable","Very Strong","5'5""","130 lbs","132","21",105,121,9,9,11,12,15,9,9,8,6,9,11,5,9,12,13,13,4,11,9,15,14,10,12,11,10,8,10,13,15,14,10,5,13,14,11,4,16,15,12,11,10,11,12,12,6,6,20,9,14,3,3,3,1,2,2,1,3,2,2,1
"596",59130566,"Oston O'runov","12/19/2000 (22 years old)","M (R), AM (C)","Navbahor","Uzbekistan Superleague","UZB","No","2/23/2023","12/31/2023","$22K - $220K","Right","Reasonable","Very Strong","5'11""","180 lbs","108","4",108,121,10,11,13,11,13,7,11,10,6,10,12,9,10,15,12,12,11,10,13,9,7,11,8,10,9,8,8,11,13,15,13,8,8,13,11,9,10,8,15,7,8,7,8,13,10,13,9,13,4,2,3,3,3,1,3,4,1,1,3,1
"597",59072150,"Dostonbek Hamdamov","7/24/1996 (26 years old)","AM (RL)","Paxtakor","Uzbekistan Superleague","UZB","No","7/24/2021","12/31/2024","$28K - $275K","Right","Reasonable","Very Strong","5'11""","149 lbs","194","58",113,121,11,12,9,12,10,12,5,10,6,8,13,6,10,14,7,9,11,11,13,13,7,11,7,9,9,11,14,10,14,12,11,10,17,14,13,8,10,20,8,14,13,15,6,9,11,3,10,12,19,3,1,1,3,3,1,2,4,3,2,1
"598",59023615,"Fozil Musaev","1/2/1989 (34 years old)","D (C), DM","Neftchi Farg'ona","Uzbekistan Superleague","UZB","No","7/2/2022","12/31/2023","$500 - $4.5K","Right","Fairly Strong","Very Strong","6'0""","165 lbs","295","27",108,121,6,9,4,10,14,9,11,11,7,14,10,8,13,9,12,13,10,10,10,15,12,5,12,9,15,8,9,13,8,10,10,7,13,10,10,8,13,16,11,10,9,12,15,12,12,1,10,11,12,1,2,2,1,3,1,1,3,3,2,2
"599",59123134,"Umidjon Ergashev","3/20/1999 (24 years old)","GK","Nasaf","Uzbekistan Superleague","UZB","No","7/28/2021","12/31/2024","$0 - $130K","Right","Reasonable","Very Strong","6'2""","178 lbs","43","-",85,121,4,3,3,3,4,5,1,3,1,2,11,1,2,6,14,11,15,8,10,9,14,2,11,1,10,8,7,7,13,8,5,13,15,11,7,11,12,10,11,11,11,11,9,5,8,2,12,11,16,6,13,13,7,10,10,14,5,7,7,14
"600",2000007402,"Hojimat Erkinov","5/29/2001 (22 years old)","M/AM (RLC)","Torpedo Moscow","Russian First Division","UZB","No","7/8/2022","6/10/2025","$120K - $1.2M","Right","Reasonable","Very Strong","5'7""","147 lbs","74","7",104,120,8,9,9,8,12,7,7,7,8,7,9,14,7,12,11,12,11,11,9,11,15,13,9,12,7,14,8,14,14,13,8,6,11,13,14,6,13,18,12,13,11,12,11,10,6,5,13,9,16,2,3,1,2,2,3,3,1,3,1,3
"601",92086318,"Iliya Gruev","5/6/2000 (23 years old)","DM, M (C)","SV Werder","Bundesliga","BUL","Yes","6/26/2022","6/30/2025","$900K - $12M","Left","Very Strong","Reasonable","6'1""","158 lbs","77","3",122,136,12,9,10,7,13,12,11,10,6,12,13,10,14,12,13,13,15,13,12,13,16,10,11,9,13,16,12,15,11,11,13,12,13,12,15,12,12,11,12,16,15,16,5,12,8,6,15,13,10,1,2,3,2,1,3,3,2,1,3,2
"602",59123172,"Jasur Yaxshiboyev","6/24/1997 (25 years old)","ST (C)","Navbahor","Uzbekistan Superleague","UZB","No","7/5/2022","12/31/2023","$0 - $130K","Left","Very Strong","Strong","5'11""","163 lbs","99","22",111,120,13,10,14,14,13,11,7,12,2,3,12,15,3,14,12,13,10,14,8,13,14,14,7,12,6,12,12,10,14,13,12,8,10,13,7,8,13,11,10,10,11,13,8,11,10,8,10,14,5,3,3,3,3,2,1,2,2,1,2,3
"603",59062049,"Jaloliddin Masharipov","9/1/1993 (29 years old)","M/AM (RL)","Al-Nassr (KSA)","Saudi Professional League","UZB","No","1/30/2021","6/30/2025","$1.3M - $2.7M","Right","Reasonable","Very Strong","5'10""","154 lbs","220","34",105,120,13,11,13,9,12,12,9,10,5,6,12,10,7,12,8,11,8,10,9,10,11,12,7,11,7,10,12,12,13,14,12,9,10,12,12,8,11,14,12,11,9,10,9,10,11,7,11,12,13,3,1,1,3,4,2,1,1,3,2,1
"604",59072225,"Otabek Shukurov","6/22/1996 (26 years old)","M (C)","Fatih Karagümrük","Turkish Super League","UZB","No","7/29/2022","6/30/2024","$1.1M - $2.3M","Right","Weak","Very Strong","6'0""","163 lbs","185","16",115,120,10,10,12,13,13,7,7,13,12,10,13,5,12,14,12,11,4,12,11,14,14,10,11,11,10,11,14,15,12,13,9,5,12,11,14,11,7,16,16,12,12,11,9,12,8,11,10,14,13,1,2,2,2,3,2,1,1,2,1,1
"605",59144930,"Husniddin Aliqulov","4/4/1999 (24 years old)","D (C)","Nasaf","Uzbekistan Superleague","UZB","No","6/15/2020","12/31/2025","$130K - $1.3M","Right","Fairly Strong","Very Strong","6'1""","176 lbs","90","10",104,120,4,8,7,1,11,3,12,6,4,11,8,3,11,6,13,11,10,9,11,14,4,5,10,8,12,8,2,9,14,14,9,12,13,14,13,11,17,20,9,10,10,13,6,3,6,8,10,10,17,2,4,4,2,1,1,2,2,1,3,3
"606",59127934,"Abdujamol Isroilov","12/24/1996 (26 years old)","M (RLC)","Dinamo Samarqand","Uzbekistan Pro League","UZB","No","1/1/2022","12/31/2023","$0 - $14K","Left","Very Strong","Reasonable","5'11""","154 lbs","77","2",63,120,5,9,7,6,12,5,1,7,5,5,7,1,6,12,11,4,5,11,5,12,12,5,4,7,5,6,11,11,13,12,6,7,10,13,12,3,16,11,12,9,10,11,6,4,7,2,11,12,15,2,4,3,3,4,3,2,1,2,2,1
"607",2000022264,"Nodirxon Ne'matxonov","6/14/2001 (21 years old)","WB (L)","Neftchi Farg'ona","Uzbekistan Superleague","UZB","No","7/2/2022","12/31/2023","$12K - $130K","Left","Very Strong","Fairly Strong","5'9""","149 lbs","15","-",67,120,5,12,5,5,12,2,1,1,6,6,10,2,7,10,15,10,6,7,6,9,16,5,4,2,10,7,4,7,14,12,4,9,14,13,7,6,15,13,10,11,12,9,9,11,13,3,12,9,12,1,1,2,4,2,2,2,3,3,2,2
"608",2000022272,"Diyor Ramazonov","6/5/2001 (22 years old)","DM","Surxon","Uzbekistan Superleague","UZB","No","2/1/2023","12/31/2023","$20K - $210K","Right","Fairly Strong","Very Strong","6'0""","167 lbs","34","-",90,119,7,5,7,7,9,7,7,9,1,13,11,4,13,13,9,11,9,5,9,13,8,6,11,7,13,8,11,10,13,13,8,6,11,13,6,8,13,12,13,11,10,12,9,5,12,8,20,10,17,1,1,1,2,1,1,1,2,3,1,1
"609",59022324,"Oleg Zoteev","7/5/1989 (33 years old)","D (L)","Lokomotiv Toshkent","Uzbekistan Pro League","UZB","No","2/2/2023","12/31/2023","$0 - $16K","Left","Very Strong","Reasonable","5'9""","163 lbs","291","25",101,119,12,12,12,8,11,11,9,7,9,10,11,9,15,11,10,10,11,11,8,10,7,8,15,12,11,10,8,12,13,13,8,7,12,12,13,7,16,12,12,12,11,11,11,8,10,3,10,11,13,3,2,1,3,3,3,1,3,1,1,2
"610",59060363,"Zabihillo O'rinboyev","3/30/1995 (28 years old)","ST (C)","Metallurg Bekobod","Uzbekistan Superleague","UZB","No","1/1/2022","12/31/2023","$2.5K - $22K","Right","Reasonable","Very Strong","6'0""","158 lbs","159","14",92,119,7,3,13,13,13,4,13,8,1,6,8,4,7,10,6,9,6,8,6,9,11,11,7,13,7,7,3,8,13,13,8,6,11,13,12,6,13,10,11,14,11,10,13,17,6,2,13,12,8,3,2,2,2,3,3,2,3,3,3,2
"611",59023925,"Artyom Filiposyan","1/6/1988 (35 years old)","D (C)","Surxon","Uzbekistan Superleague","UZB","No","2/14/2023","12/31/2023","$0","Right","Reasonable","Very Strong","6'1""","180 lbs","305","10",102,119,6,7,3,4,9,3,12,10,6,8,10,9,12,9,15,16,11,10,7,15,14,5,15,10,11,10,8,11,11,8,11,11,16,10,10,12,16,18,9,13,13,11,13,6,11,1,10,12,15,3,2,3,3,3,3,4,2,1,1,3
"612",2000274678,"Mo Abualnadi","2/8/2001 (22 years old)","D (LC), DM","Sporting KC","Major League Soccer","JOR","No","1/30/2023","12/31/2026","$0 - $100K","Left","Very Strong","Reasonable","6'1""","165 lbs","-","-",85,110,6,9,1,4,8,7,9,4,4,8,5,4,11,8,15,14,9,8,7,13,11,5,3,7,13,7,8,9,10,14,8,13,10,11,8,8,15,10,12,9,9,9,5,4,5,2,20,10,19,1,2,2,2,2,2,2,2,2,2,1
"613",7500597,"Emil Gargorov","2/15/1981 (42 years old)","M/AM (C), ST (C)","Vitosha Bistritsa","Bulgarian Third League South-West","BUL","Yes","1/5/2023","-","$0","Left","Very Strong","Fairly Strong","5'6""","154 lbs","453","134",82,136,14,12,12,11,13,14,7,11,2,3,13,15,6,13,6,11,6,12,12,11,15,15,13,13,6,10,13,7,6,10,10,7,14,6,5,4,15,10,14,14,12,9,8,14,5,12,15,16,8,1,3,2,2,3,2,3,3,2,1,3
"614",2000118063,"Murodbek Rahmatov","1/17/2002 (21 years old)","DM","Qizilqum","Uzbekistan Superleague","UZB","No","1/1/2020","12/31/2024","$7K - $70K","Right","Fairly Strong","Very Strong","6'4""","178 lbs","29","1",93,119,5,6,4,8,14,7,8,12,5,11,14,3,14,10,8,14,7,4,11,14,3,5,10,8,6,9,10,11,10,11,9,11,12,12,8,6,15,14,13,12,11,12,10,19,9,4,11,14,9,3,1,1,3,1,3,3,1,2,3,1
"615",59117483,"Bobir Abdiholiqov","4/23/1997 (26 years old)","ST (C)","Ordabasy","Kazakhstan Premier League","UZB","No","2/24/2023","12/31/2024","$50K - $475K","Right","Reasonable","Very Strong","5'9""","138 lbs","156","73",111,118,4,4,14,16,13,6,9,5,6,6,10,14,7,14,10,11,10,14,14,14,13,14,6,14,10,12,8,11,14,12,12,7,14,15,12,8,13,14,10,11,12,13,6,6,10,2,18,10,17,1,2,3,3,3,1,1,3,3,3,1
"616",59123093,"Mirjahon Mirahmadov","7/15/1997 (25 years old)","ST (C)","Paxtakor","Uzbekistan Superleague","UZB","No","7/18/2022","12/31/2023","$20K - $60K","Right","Reasonable","Very Strong","6'1""","176 lbs","99","24",88,118,6,2,11,13,13,6,13,7,2,4,7,6,1,8,9,6,6,7,7,11,15,8,10,13,4,4,3,8,13,11,7,7,7,12,13,10,9,16,10,9,12,10,13,7,10,7,16,12,16,1,1,3,2,3,3,1,3,1,2,3
"617",2000021253,"Farruxbek Muxtorov","3/16/2002 (21 years old)","DM, M/AM (C)","Olimpik Toshkent","Uzbekistan Superleague","UZB","No","2/1/2021","12/31/2024","$35K - $110K","Right","Reasonable","Very Strong","5'7""","138 lbs","43","1",87,118,4,7,8,11,13,5,7,10,7,6,11,6,10,12,7,11,8,8,8,14,15,12,8,6,11,7,13,12,13,13,8,3,5,13,7,1,11,15,13,11,13,12,7,9,5,7,11,12,13,2,1,2,1,1,2,1,1,1,3,3
"618",59073276,"Doston Tursunov","6/13/1995 (27 years old)","D (C)","Paxtakor","Uzbekistan Superleague","UZB","No","7/3/2022","12/31/2023","$0 - $80K","Right Only","Very Weak","Very Strong","6'1""","176 lbs","115","7",88,118,3,4,7,6,12,6,13,3,4,13,8,6,12,11,13,10,14,10,5,8,4,6,7,7,14,10,13,10,12,11,14,14,11,8,11,14,8,12,9,13,12,8,6,8,12,5,8,11,11,1,3,1,1,2,1,3,3,1,3,2
"619",59044172,"Eldorbek Suyunov","4/12/1991 (32 years old)","GK","Paxtakor","Uzbekistan Superleague","UZB","No","6/14/2021","12/31/2023","$0 - $90K","Right","Reasonable","Very Strong","6'4""","180 lbs","172","-",114,118,1,2,2,2,3,6,1,2,3,2,11,1,3,5,14,13,15,4,9,12,15,2,7,3,14,10,9,9,12,16,10,14,14,12,9,7,11,20,11,11,12,12,8,5,9,1,19,11,10,10,9,13,11,12,14,13,5,11,11,14
"620",49039003,"Logan Costa","4/1/2001 (22 years old)","D (C)","Toulouse FC","Ligue 1 Uber Eats","CPV","Yes","8/20/2021","6/30/2025","$5.4M - $6.8M","Right","Reasonable","Very Strong","6'3""","194 lbs","34","-",122,147,7,10,9,6,12,5,14,8,8,13,12,6,13,11,13,13,13,12,13,12,14,6,8,10,13,13,11,13,12,13,13,14,13,12,13,14,10,14,12,12,10,11,6,10,7,6,12,12,12,2,1,2,2,1,2,2,3,2,3,3
"621",55041935,"Djaniny","3/21/1991 (32 years old)","AM (R), ST (C)","Trabzonspor","Turkish Super League","CPV","No","6/1/2023","6/30/2025","$110K - $1.1M","Right","Reasonable","Very Strong","6'3""","171 lbs","330","106",120,145,10,12,11,14,13,8,12,9,5,7,11,13,7,13,10,13,12,13,13,11,13,16,8,14,8,12,11,12,11,11,13,14,15,13,13,14,12,12,12,13,10,9,8,12,6,7,14,13,12,3,4,1,3,3,1,3,3,3,1,2
"622",55023086,"Bébé","7/12/1990 (32 years old)","AM (RL)","Zaragoza","Spanish Second Division","CPV","Yes","6/22/2021","6/30/2025","$150K - $1.5M","Right","Fairly Strong","Very Strong","6'3""","171 lbs","279","39",120,140,10,11,13,11,12,14,10,15,8,4,12,13,7,14,10,8,8,7,7,10,14,17,5,13,7,9,8,13,15,12,11,15,15,14,14,15,12,12,12,10,12,10,13,9,7,10,9,17,6,2,2,2,1,3,2,3,3,2,3,1
"623",83228313,"Telmo Arcanjo","6/21/2001 (21 years old)","M (L), AM (RC)","TND","Portuguese Second League","CPV","Yes","7/1/2019","6/30/2026","$550K - $1.6M","Left Only","Very Strong","Weak","5'11""","167 lbs","55","7",114,140,13,13,13,9,14,11,7,12,5,8,14,10,11,15,12,12,14,11,9,12,13,5,10,8,8,12,14,12,12,12,14,10,13,12,13,13,5,10,11,12,13,14,10,10,5,5,12,13,7,2,1,3,2,2,2,2,3,1,2,1
"624",2000091584,"Krasian Kolev","1/18/2004 (19 years old)","M (C), AM (LC)","Botev Plovdiv","Bulgarian First League","BUL","Yes","12/29/2022","6/30/2026","$350K - $3.4M","Right","Weak","Very Strong","6'0""","154 lbs","64","5",98,136,13,13,11,10,11,12,11,12,7,8,13,11,9,13,9,11,12,11,9,10,14,12,9,11,10,13,12,13,11,12,11,13,12,11,10,11,9,14,2,10,10,10,9,14,9,4,10,13,8,1,1,2,2,3,1,1,4,3,3,2
"625",49047077,"Bryan Teixeira","9/1/2000 (22 years old)","M/AM (RL)","SK Sturm Graz","Austrian Premier Division","CPV","Yes","1/7/2023","6/30/2024","$2.8M - $5.8M","Right","Weak","Very Strong","5'8""","160 lbs","70","8",117,138,9,13,13,9,12,10,8,9,9,10,10,11,10,13,8,10,8,10,9,10,11,9,8,12,10,9,11,11,14,14,13,8,13,13,13,10,11,9,10,13,10,11,9,8,9,9,11,9,9,3,2,3,3,1,3,2,2,2,1,2
"626",83111471,"Jovane Cabral","6/14/1998 (24 years old)","AM (RLC), ST (C)","Sporting CP","Portuguese Premier League","CPV","Yes","8/23/2022","6/30/2025","$170K - $1.7M","Right","Reasonable","Very Strong","5'9""","156 lbs","109","17",129,138,12,12,15,13,13,13,4,13,5,3,13,12,5,14,8,10,7,9,8,10,11,16,8,13,4,6,13,11,15,14,13,5,14,15,13,9,9,13,12,14,13,12,4,13,3,3,12,11,13,2,3,2,3,2,1,1,3,3,3,2
"627",55027991,"Bruno Varela","11/4/1994 (28 years old)","GK","VTSC","Portuguese Premier League","CPV","Yes","5/12/2023","6/30/2026","$375K - $3.7M","Right","Weak","Very Strong","6'3""","187 lbs","230","-",131,136,2,1,3,3,10,5,4,1,2,2,11,1,3,10,12,12,14,10,12,12,15,3,14,1,13,12,12,14,12,14,12,14,13,12,11,13,9,8,5,15,8,16,13,11,13,8,12,14,20,12,12,16,14,14,14,12,13,15,9,14
"628",85042178,"Ryan Mendes da Graça","1/8/1990 (33 years old)","M/AM (RL)","Al-Nasr (UAE)","UAE Professional League","CPV","Yes","7/3/2020","6/30/2025","Not for Sale","Right","Reasonable","Very Strong","5'8""","165 lbs","312","66",120,135,7,11,15,12,13,7,10,10,5,5,12,11,5,14,8,11,10,11,10,9,13,15,8,14,7,12,12,13,14,15,12,7,14,15,13,8,8,15,15,12,12,11,13,14,8,6,12,14,13,1,3,4,2,3,3,2,1,1,4,3
"629",83185560,"Duk","2/16/2000 (23 years old)","AM (L), ST (C)","Aberdeen","cinch Premiership","CPV","Yes","7/15/2022","5/31/2025","$110K - $6.2M","Right Only","Weak","Very Strong","5'11""","171 lbs","79","27",120,135,9,9,15,13,12,12,11,12,7,6,10,12,8,14,10,12,11,8,9,8,13,13,7,12,5,12,10,10,17,10,11,10,13,16,12,15,10,13,4,13,11,9,8,12,2,8,6,13,12,3,3,2,1,1,2,2,2,2,3,2
"630",860985,"Garry Rodrigues","11/27/1990 (32 years old)","M/AM (RL)","Olympiacos","Greek Super League 1","CPV","Yes","9/18/2021","6/30/2024","$0","Right","Weak","Very Strong","5'8""","154 lbs","310","64",120,135,10,12,13,12,13,11,8,11,4,7,12,12,7,13,8,12,9,11,9,11,12,14,7,14,7,11,13,12,15,15,13,8,9,14,12,8,13,13,10,14,12,8,15,12,9,10,12,13,12,2,3,1,2,2,1,1,3,2,2,2
"631",55029260,"Ricardo Gomes","12/18/1991 (31 years old)","ST (C)","Partizan","Serbian SuperLeague","CPV","Yes","7/1/2021","6/30/2025","Not for Sale","Right","Fairly Strong","Very Strong","6'2""","187 lbs","378","129",131,131,7,10,12,15,13,8,13,12,5,4,11,13,5,12,12,14,12,14,11,12,13,13,10,14,6,9,11,12,13,12,14,14,15,13,14,15,9,12,9,14,12,11,8,13,7,11,14,12,12,1,3,2,1,3,3,1,2,1,1,2
"632",48043561,"Kenny Rocha Santos","1/3/2000 (23 years old)","M/AM (C)","Oostende","Belgian Challenger Pro League","CPV","No","7/1/2021","6/30/2025","$0","Right Only","Weak","Very Strong","5'9""","147 lbs","111","7",108,130,12,12,14,12,12,10,8,12,8,7,14,11,7,13,6,13,13,11,11,12,12,12,8,13,9,12,12,11,13,15,10,13,12,14,14,12,11,13,11,12,8,12,10,11,8,1,12,14,12,2,1,2,2,1,2,2,3,3,2,2
"633",85115643,"Julio Tavares","11/19/1988 (34 years old)","ST (C)","Al-Raed","Saudi Professional League","CPV","Yes","7/25/2022","6/30/2024","$130K - $1.3M","Right","Weak","Very Strong","6'2""","194 lbs","416","139",125,130,3,9,14,16,12,10,16,10,5,5,9,13,4,11,11,12,13,12,11,9,13,10,10,13,10,15,10,15,13,12,15,13,15,14,14,14,5,12,12,13,11,15,6,17,7,1,14,13,15,2,1,3,3,4,2,2,2,3,2,3
"634",12007043,"Babanco","7/27/1985 (37 years old)","DM, M (C)","Leiria","Portuguese Second League","CPV","No","12/30/2022","6/30/2024","$0 - $1.5K","Left","Very Strong","Weak","5'10""","158 lbs","278","14",85,128,12,12,9,8,12,13,9,10,8,11,13,8,11,12,12,9,11,12,12,12,13,12,13,10,12,12,13,10,8,7,9,8,5,9,8,10,16,13,13,14,12,13,14,13,11,7,14,13,13,1,1,1,2,1,4,2,1,1,3,3
"635",2000087466,"Nikolay Zlatev","12/12/2004 (18 years old)","AM (RL), ST (C)","Cherno More","Bulgarian First League","BUL","Yes","6/10/2022","6/30/2025","$210K - $2.1M","Right","Reasonable","Very Strong","5'11""","160 lbs","31","2",84,136,11,10,12,9,11,11,7,8,8,5,11,9,7,11,9,8,7,7,7,7,12,12,8,9,6,11,10,9,13,12,9,8,12,12,8,8,9,10,8,12,11,12,8,7,8,8,8,11,16,2,1,3,1,3,2,2,2,1,1,1
"636",2000039621,"Gilson Benchimol","12/29/2001 (21 years old)","ST (C)","SLB B","Portuguese Second League","CPV","Yes","9/8/2020","6/30/2025","$700K - $1.6M","Right Only","Weak","Very Strong","6'2""","165 lbs","28","3",107,128,7,8,12,13,12,10,11,6,5,4,8,10,6,11,14,12,12,11,8,8,14,14,12,14,5,8,9,10,16,14,10,14,15,15,11,9,10,16,10,13,14,13,7,13,10,1,11,12,20,3,3,2,4,2,1,3,2,3,3,2
"637",84105508,"João Correia","9/5/1996 (26 years old)","D/WB (R)","Chaves","Portuguese Premier League","CPV","Yes","6/24/2022","6/30/2025","$275K - $2.8M","Right","Fairly Strong","Very Strong","5'9""","152 lbs","192","21",122,126,10,12,13,8,12,5,10,8,11,7,13,11,9,14,8,13,14,12,12,11,13,14,11,14,9,13,14,11,14,14,12,6,14,14,13,11,14,11,5,13,12,14,5,12,11,6,13,10,15,3,3,1,1,2,1,4,3,1,2,3
"638",55012348,"Stopira","5/20/1988 (35 years old)","D (LC)","Fehérvár","Hungarian Division I","CPV","Yes","6/14/2021","6/30/2024","$0 - $85K","Left Only","Very Strong","Weak","6'0""","167 lbs","337","22",99,126,5,7,10,10,11,3,5,5,10,9,8,6,12,10,12,11,16,12,15,12,15,7,15,12,10,13,7,13,11,13,10,16,15,11,13,11,11,5,14,13,14,20,7,14,10,3,10,14,14,1,3,3,2,2,1,1,1,1,3,2
"639",48037370,"Nuno Da Costa","2/10/1991 (32 years old)","AM (C), ST (C)","AJ Auxerre","Ligue 2 BKT","CPV","Yes","8/5/2022","6/30/2024","$0","Right","Weak","Very Strong","6'0""","154 lbs","275","70",118,126,10,7,13,12,13,6,13,12,5,8,10,14,6,13,11,11,13,12,11,12,11,8,8,12,8,7,10,12,14,13,14,13,13,15,13,13,9,12,10,12,12,12,10,12,6,10,11,14,11,1,3,1,1,3,2,1,3,2,1,1
"640",55005547,"Fernando Varela","11/26/1987 (35 years old)","D (C)","Casa Pia","Portuguese Premier League","CPV","Yes","7/8/2022","6/30/2024","$7K - $65K","Right","Reasonable","Very Strong","6'1""","191 lbs","420","26",118,125,4,7,10,8,10,5,13,7,10,15,11,6,14,11,13,13,15,13,12,12,15,6,16,11,13,14,9,12,8,8,14,13,12,10,13,16,4,14,13,15,14,13,7,15,12,6,15,15,15,2,1,1,3,1,3,1,3,3,3,3
"641",2000091607,"Hélio Varela","5/3/2002 (21 years old)","AM (RL)","PTM","Portuguese Premier League","CPV","Yes","7/1/2022","6/30/2026","$70K - $700K","Right Only","Weak","Very Strong","5'9""","152 lbs","30","4",114,125,10,13,13,8,10,8,7,12,5,6,11,10,6,12,13,9,11,10,10,9,13,13,6,13,7,12,11,15,16,13,13,8,11,15,10,12,12,12,13,15,10,10,4,12,5,5,12,12,15,3,2,1,3,1,3,3,1,1,1,3
"642",55082129,"Ivanildo Fernandes","3/26/1996 (27 years old)","D (C)","VIZ","Portuguese Premier League","CPV","Yes","8/19/2021","6/30/2025","$0","Left","Very Strong","Weak","6'4""","182 lbs","172","4",116,125,5,8,11,7,10,8,12,8,10,14,12,9,13,12,15,12,14,11,10,10,13,7,13,6,13,14,11,12,11,11,14,15,15,12,13,15,10,13,14,15,11,11,4,9,13,5,12,16,8,3,2,2,2,2,1,2,1,4,3,3
"643",37041867,"Jamiro Monteiro","11/23/1993 (29 years old)","M/AM (C)","San Jose","Major League Soccer","CPV","Yes","2/14/2022","12/31/2023","$160K - $1.6M","Right","Fairly Strong","Very Strong","5'8""","141 lbs","214","25",123,125,11,9,13,10,14,11,11,11,8,6,14,12,7,13,12,12,12,12,10,11,10,14,7,14,7,15,12,13,14,12,12,11,15,14,14,9,13,10,11,10,9,10,6,13,8,5,12,13,14,1,2,1,3,1,1,4,3,2,2,1
"644",83257700,"João Paulo","5/26/1998 (25 years old)","M (LC), AM (L)","Feirense","Portuguese Second League","CPV","No","7/9/2021","6/30/2025","$60K - $600K","Left","Very Strong","Weak","5'9""","169 lbs","126","13",105,125,6,8,13,8,11,6,7,10,7,10,11,8,12,13,11,12,11,9,10,10,12,12,6,13,8,12,10,14,13,12,12,10,12,13,13,14,13,18,11,13,15,8,7,10,8,1,9,11,13,2,3,1,2,1,3,1,3,1,1,2
"645",83111400,"Diogo Mendes","1/24/1998 (25 years old)","DM, M (C)","MRT","Portuguese Second League","CPV","Yes","7/2/2021","6/30/2026","$75K - $750K","Right","Fairly Strong","Very Strong","5'9""","149 lbs","119","3",106,124,7,8,10,7,11,8,11,8,9,11,10,5,13,10,14,12,10,11,12,10,13,5,13,11,13,12,10,12,12,13,12,8,14,13,13,12,10,13,12,14,13,13,4,8,8,6,9,12,7,2,1,1,1,2,3,3,4,2,4,2
"646",2000076241,"Plamen Andreev","12/15/2004 (18 years old)","GK","Levski","Bulgarian First League","BUL","Yes","6/9/2023","6/30/2025","$3M - $6.2M","Right Only","Weak","Very Strong","6'2""","154 lbs","37","-",107,135,2,1,1,2,9,6,9,3,2,2,10,2,3,9,8,12,13,9,13,10,14,4,12,5,11,15,8,11,10,12,10,14,13,9,10,12,10,16,18,16,14,16,8,14,7,3,14,12,16,13,13,12,7,11,13,12,6,9,13,13
"647",85146318,"Steven Fortes","4/17/1992 (31 years old)","D (C)","RC Lens","Ligue 1 Uber Eats","CPV","Yes","7/1/2019","6/30/2025","$180K - $1.8M","Right Only","Weak","Very Strong","6'4""","187 lbs","185","2",112,124,3,6,8,7,10,4,14,5,4,12,10,6,13,10,14,13,14,12,11,12,14,9,13,12,12,11,6,14,10,12,15,15,15,11,14,15,8,13,9,15,12,13,8,13,13,10,10,14,14,3,2,1,1,3,1,1,2,1,3,1
"648",83106036,"Vágner","1/10/1996 (27 years old)","AM (RL)","FC Metz","Ligue 1 Uber Eats","CPV","No","7/2/2020","6/30/2024","$55K - $550K","Right Only","Weak","Very Strong","5'6""","152 lbs","124","23",105,124,9,11,13,11,12,9,7,11,4,5,11,8,5,13,8,10,10,11,10,10,16,12,8,12,7,11,12,10,12,14,11,7,10,12,14,8,15,11,12,14,11,14,6,14,11,3,13,15,13,2,2,1,3,3,4,2,1,1,4,1
"649",28099978,"Kristopher Da Graça","1/16/1998 (25 years old)","D (C)","IK Sirius","Swedish Premier Division","CPV","Yes","1/29/2022","7/15/2025","$65K - $650K","Right","Weak","Very Strong","6'2""","187 lbs","111","-",102,124,5,9,7,4,9,5,13,6,8,13,11,7,13,9,15,10,14,10,9,10,12,6,10,7,12,11,8,11,12,8,14,14,14,13,12,15,7,7,8,10,12,10,13,8,14,8,10,10,10,3,1,2,3,3,2,2,2,2,1,4
"650",37063421,"Deroy Duarte","7/4/1999 (23 years old)","DM, M/AM (C)","Fortuna Sittard","Eredivisie","CPV","Yes","8/12/2021","6/30/2024","$1.2M - $2.6M","Right","Fairly Strong","Very Strong","5'10""","158 lbs","195","26",110,122,8,11,14,9,13,11,9,11,5,8,11,4,7,11,13,11,13,12,12,8,9,14,9,12,10,14,12,14,12,14,12,10,10,12,13,10,16,17,10,11,8,12,10,13,14,4,10,8,15,1,2,3,2,3,1,3,1,2,1,2
"651",2000115620,"Kelvin Patrick","7/8/2000 (22 years old)","DM","Racing Besançon","French National 2 - D","CPV","No","10/10/2022","6/30/2024","$22K - $220K","Right Only","Weak","Very Strong","6'1""","171 lbs","24","2",90,122,8,8,7,6,14,8,9,10,5,11,11,4,11,10,13,13,9,6,5,14,12,8,9,8,12,9,9,13,13,10,9,10,13,8,13,7,16,14,9,9,10,13,10,10,10,7,11,13,10,2,1,1,3,2,3,3,2,4,1,2
"652",83215595,"Kevin Pina","1/27/1997 (26 years old)","DM, M (C)","Krasnodar","Russian Premier League","CPV","No","9/8/2022","6/30/2025","$130K - $1.3M","Right","Fairly Strong","Very Strong","6'3""","171 lbs","118","6",115,122,8,8,12,7,12,8,12,7,5,13,13,6,12,13,12,12,14,12,15,11,17,11,8,11,11,14,12,14,12,12,13,15,14,12,14,12,16,18,17,18,12,12,5,7,8,5,12,14,14,2,4,2,2,4,2,1,2,2,3,2
"653",55076417,"Ponck","1/13/1995 (28 years old)","D (C), DM","Başakşehir FK","Turkish Super League","CPV","Yes","7/29/2019","6/30/2025","$1.7M - $3.6M","Right","Fairly Strong","Very Strong","6'0""","185 lbs","257","4",116,122,6,7,7,6,10,5,14,9,8,13,11,9,13,11,12,14,15,8,11,10,12,6,10,9,11,14,8,14,12,10,11,13,15,13,15,16,10,13,9,8,11,8,3,11,14,8,14,11,13,1,3,3,3,1,3,1,1,3,3,3
"654",93049432,"Sixten Mohlin","1/17/1996 (27 years old)","GK","Örgryte IS","Swedish First Division Elite","CPV","Yes","12/21/2021","12/31/2024","$0 - $130K","Right Only","Weak","Very Strong","6'3""","176 lbs","101","-",89,120,5,3,3,1,7,8,5,1,2,1,7,3,3,7,9,12,11,9,10,11,11,3,7,1,12,11,8,8,10,12,12,18,12,10,10,11,12,8,12,7,7,11,14,7,8,10,7,11,11,10,12,13,5,13,7,12,12,9,10,11
"655",55074583,"Zimbabwe","11/3/1992 (30 years old)","DM, M (C)","Sp. Covilhã","Portuguese Third Division - South","CPV","No","1/3/2023","6/30/2023","$500 - $6K","Right Only","Weak","Very Strong","5'10""","167 lbs","256","25",101,118,8,9,10,8,13,7,9,11,4,10,12,6,12,11,12,11,9,12,11,11,13,7,10,11,12,13,11,13,12,13,13,9,14,12,15,13,10,20,13,12,13,8,6,12,11,8,12,11,8,3,1,4,1,1,3,3,1,1,1,3
"656",53101975,"Bruno Leite","3/26/1995 (28 years old)","DM, M (RLC)","Haugesund","Norwegian Premier Division","CPV","Yes","11/24/2022","12/31/2025","$8K - $80K","Right","Reasonable","Very Strong","6'0""","171 lbs","200","20",105,118,9,9,14,7,14,9,7,8,6,11,13,6,11,14,13,8,11,10,10,7,12,14,12,11,12,15,12,15,13,12,13,10,14,12,13,11,11,10,12,14,12,11,12,11,7,4,12,15,14,1,2,1,3,3,3,3,2,2,1,1
"657",22082747,"Mark-Emilio Papazov","10/8/2003 (19 years old)","AM (RL), ST (C)","CSKA-Sofia","Bulgarian Third League South-West","BUL","Yes","1/4/2023","6/30/2026","$100K - $1M","Right","Fairly Strong","Very Strong","6'0""","154 lbs","50","8",77,135,9,9,11,10,11,9,9,10,8,5,10,3,6,11,9,9,7,8,7,6,5,14,8,11,6,9,10,10,11,9,11,9,17,12,7,9,12,16,7,13,10,13,12,9,15,1,10,11,10,1,1,3,1,2,1,3,1,1,1,2
"658",83107944,"Yannick Semedo","12/29/1995 (27 years old)","M (C)","Länk FC Vilaverdense","Portuguese Second League","CPV","No","8/1/2022","6/30/2024","$65K - $650K","Right Only","Weak","Very Strong","5'8""","130 lbs","138","9",104,118,6,7,12,6,11,5,7,9,5,14,12,7,13,12,14,13,12,10,12,11,15,5,6,13,10,15,11,15,13,13,11,6,13,12,15,12,15,19,9,10,11,11,6,11,9,7,13,9,15,1,2,1,2,3,1,1,2,1,3,2
"659",37052840,"Laros Duarte","2/28/1997 (26 years old)","DM, M (C)","FC Groningen","Keuken Kampioen Divisie","CPV","Yes","8/31/2021","6/30/2025","$275K - $2.8M","Right","Reasonable","Very Strong","5'11""","147 lbs","177","10",112,118,14,8,13,8,12,15,11,12,7,7,12,8,9,14,15,11,13,11,11,12,11,12,8,11,9,13,11,13,11,14,14,12,13,12,14,11,14,10,10,12,14,12,12,13,13,1,12,13,12,3,3,3,3,2,1,2,4,1,3,3
"660",13196530,"Emerson","8/22/1996 (26 years old)","M (C)","Boavista da Praia","Santiago (South) Premier Division","CPV","No","6/15/2020","6/30/2024","$0","Right","Fairly Strong","Very Strong","6'0""","160 lbs","-","-",60,117,4,4,4,5,12,4,4,8,2,7,12,1,7,7,15,5,2,4,5,11,6,5,13,7,5,6,12,11,12,10,3,6,14,12,8,5,14,19,13,11,12,10,11,18,8,3,17,10,17,3,4,1,3,2,3,1,3,2,2,3
"661",55046002,"Kuca","8/2/1989 (33 years old)","AM (RL)","Marinhense","Portugal Championship - Group C","CPV","Yes","10/1/2022","6/30/2023","$0","Right","Reasonable","Very Strong","5'11""","154 lbs","257","73",83,117,10,10,12,9,13,10,8,10,6,6,12,10,7,13,8,9,11,12,8,10,9,15,9,14,8,11,12,11,10,11,9,11,10,10,7,8,13,14,14,7,11,7,9,10,7,12,8,12,8,1,2,2,2,3,1,3,1,1,2,1
"662",37058270,"Alessio da Cruz","1/18/1997 (26 years old)","M (R), AM (RC)","KV Mechelen","Jupiler Pro League","CPV","Yes","7/12/2022","6/30/2025","$0","Right","Reasonable","Very Strong","6'1""","163 lbs","185","30",107,117,10,12,14,11,11,13,9,12,2,3,12,10,11,12,11,10,11,11,11,8,13,13,10,14,6,11,11,13,13,12,13,10,14,13,13,10,16,19,12,12,11,10,5,13,5,3,13,14,8,3,3,1,1,4,3,1,2,4,3,1
"663",2000124845,"Tiago Gomes","8/14/2002 (20 years old)","GK","Union SG","Jupiler Pro League","CPV","Yes","6/30/2022","-","$0","Right Only","Weak","Very Strong","6'4""","187 lbs","18","-",81,117,2,2,1,1,6,5,1,3,1,3,10,1,3,7,7,12,7,9,13,6,17,2,1,3,11,9,8,7,10,18,9,16,9,10,2,8,11,18,9,9,11,13,9,15,12,1,10,11,9,11,7,14,10,10,11,12,7,9,10,11
"664",83191278,"Aílson Tavares","7/20/1998 (24 years old)","DM, M (C)","Anadia","Portuguese Third Division - North","CPV","Yes","3/14/2023","6/30/2024","$0 - $45K","Right Only","Weak","Very Strong","6'2""","158 lbs","114","5",86,116,4,8,8,9,11,8,10,4,4,10,11,8,12,11,13,10,12,9,11,10,13,10,6,10,12,12,8,12,12,13,11,12,12,11,13,13,10,12,13,14,12,8,10,12,10,6,12,14,11,1,3,3,3,3,1,1,1,2,3,2
"665",55082787,"Diney","1/17/1995 (28 years old)","D (C)","FAR Rabat","Botola Pro 1","CPV","Yes","9/19/2019","6/30/2025","$0","Right Only","Weak","Very Strong","6'1""","180 lbs","203","19",105,115,3,5,7,5,9,4,14,9,8,13,10,7,12,10,16,11,13,8,11,10,13,6,14,8,12,12,6,12,12,11,12,13,16,13,13,14,11,12,12,14,6,12,3,11,13,10,14,11,12,1,3,3,3,2,3,1,4,3,2,3
"666",85125661,"Steeve Furtado","11/22/1994 (28 years old)","D/WB/M (R)","CSKA 1948","Bulgarian First League","CPV","Yes","7/4/2022","6/30/2024","$240K - $700K","Right","Weak","Very Strong","5'9""","149 lbs","140","1",107,115,8,10,12,7,11,8,7,10,8,8,11,6,9,12,9,10,8,11,11,10,9,10,7,12,8,11,9,13,14,14,10,7,13,15,14,11,12,13,12,10,7,10,8,16,10,1,10,12,15,2,3,3,1,3,3,3,3,2,1,1
"667",2000023555,"Kelvin Pires","6/5/2000 (23 years old)","D (C)","Trencin","Slovak First Division","CPV","No","8/17/2021","6/30/2025","$12K - $120K","Right","Fairly Strong","Very Strong","6'4""","191 lbs","52","4",90,115,4,1,3,3,8,1,13,4,1,13,4,1,13,4,13,10,10,8,9,13,12,5,7,7,13,7,1,8,13,8,8,10,13,12,13,7,12,12,12,12,12,9,8,14,9,3,20,12,19,3,3,2,2,3,3,2,4,1,3,1
"668",2000249925,"Martin Bachev","6/28/2004 (18 years old)","DM","Pirin Blagoevgrad","Bulgarian First League","BUL","Yes","7/1/2020","6/30/2026","$190K - $600K","Right","Weak","Very Strong","6'1""","176 lbs","11","-",74,135,6,5,3,7,8,5,8,7,1,10,7,2,11,8,12,7,12,7,8,13,15,5,11,6,12,7,7,12,13,13,7,14,11,11,5,11,12,18,6,11,11,12,5,2,15,1,18,12,15,3,1,3,1,3,2,1,1,1,3,2
"669",37017042,"Jeffry Fortes","3/22/1989 (34 years old)","D/WB (R), DM, M (R)","De Graafschap","Keuken Kampioen Divisie","CPV","Yes","8/12/2021","6/30/2024","$35K - $350K","Right Only","Weak","Very Strong","6'0""","165 lbs","314","28",108,115,9,11,12,6,11,7,12,7,10,12,12,13,13,13,13,11,12,12,11,10,14,11,8,14,11,12,10,14,11,12,14,12,13,11,11,11,12,10,14,16,10,15,7,11,6,2,12,11,9,1,1,1,3,1,3,3,4,4,3,2
"670",13131187,"Vózinha","6/3/1986 (37 years old)","GK","Trencin","Slovak First Division","CPV","No","6/4/2023","6/30/2024","$500 - $4.5K","Right Only","Weak","Very Strong","6'2""","165 lbs","230","-",100,115,5,3,2,3,11,7,7,2,3,1,9,1,2,10,8,12,12,11,11,10,14,3,12,3,12,13,6,8,9,10,15,15,9,10,11,12,11,9,12,12,11,12,7,13,6,4,12,12,13,14,12,12,16,12,13,11,14,10,13,12
"671",2000219197,"Mimitcha","11/28/2000 (22 years old)","ST (C)","Desportivo Huíla","Angolan Championship","CPV","No","9/21/2022","6/30/2024","$35K - $100K","Left Only","Very Strong","Weak","5'9""","156 lbs","30","23",80,115,7,7,14,14,14,7,12,7,2,7,8,5,3,9,11,8,8,12,8,7,6,12,14,14,7,7,4,8,14,13,4,4,10,14,7,10,11,16,12,11,10,10,9,7,9,1,13,10,13,3,3,3,3,2,1,3,1,3,3,2
"672",55082014,"Hélio Cruz","8/8/1993 (29 years old)","M (RC), AM (C)","Belenenses","Portuguese Second League","CPV","Yes","7/4/2022","6/30/2024","$50K - $500K","Right Only","Weak","Very Strong","5'11""","158 lbs","212","6",100,115,7,7,12,5,13,9,5,10,4,10,12,8,14,12,12,9,10,9,11,8,13,11,9,13,12,16,13,16,13,13,13,9,12,12,11,13,15,14,14,13,10,13,10,12,10,7,12,11,12,1,2,3,1,3,3,3,2,1,4,1
"673",83111532,"David Tavares","3/19/1999 (24 years old)","DM, M (C)","Famalicão","Portuguese Premier League","CPV","Yes","6/29/2021","6/30/2026","$50K - $500K","Left","Very Strong","Weak","6'3""","180 lbs","65","-",104,115,11,12,12,8,12,9,8,9,5,10,13,10,11,13,14,11,13,12,8,10,8,13,8,10,8,13,11,15,13,12,13,14,16,13,12,14,15,4,7,5,8,5,15,10,10,18,11,18,18,3,1,3,2,3,1,2,1,3,3,1
"674",55070481,"Fábio Arcanjo","10/18/1994 (28 years old)","M (C)","Oriental","Portugal Championship - Group D","CPV","Yes","7/1/2022","6/30/2024","$150K - $450K","Right","Strong","Very Strong","5'11""","160 lbs","231","10",104,115,8,10,11,8,11,5,6,12,4,6,12,6,6,14,13,10,12,12,12,13,15,11,5,12,12,13,13,12,11,10,13,9,12,12,11,10,4,10,13,12,13,8,6,10,6,6,12,13,12,2,1,1,3,1,1,1,1,3,1,2
"675",67295644,"Iker Álvarez","7/25/2001 (21 years old)","GK","Villarreal B","Spanish Second Division","AND","No","6/13/2022","6/30/2027","$5.2M - $7.8M","Right","Reasonable","Very Strong","6'3""","174 lbs","71","-",114,146,5,3,1,1,11,8,2,2,2,2,12,3,3,7,5,11,11,11,11,12,17,1,13,3,15,11,10,10,10,12,8,13,15,11,7,6,12,14,12,12,11,10,6,9,5,6,13,11,15,12,12,13,12,11,15,14,8,10,8,15
"676",67248945,"Max Llovera","1/8/1997 (26 years old)","D (C)","C.P. San Cristóbal","Spanish Federation Third Group 5","AND","No","7/1/2021","6/30/2024","$50K - $150K","Right","Fairly Strong","Very Strong","5'11""","158 lbs","101","1",84,115,4,1,8,4,10,1,10,7,4,12,10,2,11,8,6,9,6,9,12,15,7,5,4,8,9,11,4,9,11,10,9,8,7,12,12,11,15,20,10,12,11,13,5,5,10,1,13,13,20,3,3,1,1,2,1,2,2,2,2,1
"677",2000191215,"Andy Villar","1/15/2002 (21 years old)","M/AM (RL), ST (C)","Las Palmas B","Spanish Federation Third Group 12","AND","Yes","7/1/2020","6/30/2024","$4.5K - $45K","Left","Very Strong","Reasonable","5'8""","143 lbs","31","9",85,110,7,8,9,14,14,7,12,5,5,7,4,7,4,11,11,10,8,11,6,13,13,10,7,14,7,8,5,9,14,10,8,3,10,16,7,4,13,11,11,11,13,10,9,2,10,5,15,8,19,3,1,3,2,3,1,2,2,1,3,4
"678",67293228,"Joan Cervós","2/24/1998 (25 years old)","D/WB (L)","Rudar (Pr)","Republic of Srpska First League","AND","No","7/1/2022","7/15/2023","$0","Left Only","Very Strong","Weak","5'11""","163 lbs","104","3",84,105,6,9,6,7,6,1,8,3,7,9,9,4,14,8,8,9,9,7,8,8,5,5,5,7,7,13,8,13,13,13,9,10,7,12,14,10,13,10,10,8,12,13,7,15,11,2,6,11,15,2,1,3,2,3,2,3,2,3,1,2
"679",2000033983,"Petar Andreev","7/2/2004 (18 years old)","M (L), AM (RL)","Lokomotiv Plovdiv","Bulgarian First League","BUL","Yes","7/1/2020","6/30/2025","$35K - $350K","Left","Very Strong","Weak","6'2""","156 lbs","8","-",79,135,10,13,11,11,12,10,8,9,8,8,11,6,8,9,8,11,9,10,8,7,8,6,12,8,7,9,12,13,10,9,11,14,7,12,9,8,12,17,9,12,12,11,7,15,12,5,11,10,10,1,1,1,2,1,2,1,1,2,2,2
"680",47005468,"Jordi Rubio","11/1/1987 (35 years old)","D/WB (R), M/AM (RC)","Engordany","Andorran Lower Division","AND","No","8/19/2022","6/30/2024","$0","Right Only","Weak","Very Strong","5'8""","158 lbs","292","53",83,105,12,11,11,13,10,12,7,12,4,6,12,13,8,11,8,6,7,10,7,7,15,9,12,6,6,5,12,7,11,7,8,7,13,10,11,6,14,17,10,12,9,11,5,10,10,7,12,11,7,1,1,2,2,3,2,2,2,2,3,4
"681",67293232,"Álex Martínez","10/10/1998 (24 years old)","M (R), AM (RL), ST (C)","Atlètic Escaldes","Andorran First Division","AND","No","8/5/2021","6/30/2024","$0","Right","Reasonable","Very Strong","6'1""","169 lbs","164","46",79,105,5,9,11,12,12,5,6,10,3,5,7,3,4,10,7,9,4,3,4,12,9,11,6,9,5,2,7,7,12,11,6,7,14,11,12,6,13,16,11,11,15,11,14,11,12,7,14,12,13,3,4,1,1,1,2,3,3,1,3,3
"682",823437,"Ildefons Lima","12/10/1979 (43 years old)","D (C)","Inter d'Escaldes","Andorran First Division","AND","Yes","1/13/2023","6/30/2023","$0","Right","Fairly Strong","Very Strong","6'3""","198 lbs","433","43",71,104,2,5,5,4,6,5,13,8,6,11,9,6,12,5,14,12,16,4,8,8,16,7,14,11,8,14,9,12,8,6,9,15,10,7,7,15,3,16,6,14,7,10,4,6,18,12,10,12,12,3,2,1,1,2,4,3,3,1,1,2
"683",2000269216,"Biel Borra","10/22/2005 (17 years old)","D (R)","Girona","Spanish First Division","AND","Yes","7/1/2022","-","$0","Right","Fairly Strong","Very Strong","5'10""","147 lbs","-","-",65,102,7,12,6,2,9,5,8,7,5,7,6,1,13,6,9,8,9,8,5,9,15,9,7,7,10,8,8,9,14,9,8,8,12,9,14,5,11,19,13,9,11,10,5,13,6,8,10,11,18,3,2,1,2,3,1,1,2,2,1,1
"684",67065285,"Marc Vales","4/4/1990 (33 years old)","D (C), DM","Real Irún","Spanish Federation First Division A","AND","Yes","2/13/2023","6/30/2024","$24K - $75K","Right","Reasonable","Very Strong","6'0""","174 lbs","277","20",97,100,6,7,6,7,10,7,12,7,10,14,10,7,14,9,16,12,15,8,9,11,8,6,12,6,12,14,8,15,9,8,12,12,12,10,13,13,13,11,9,10,11,10,13,10,6,6,10,11,12,1,3,3,1,2,3,2,3,3,1,2
"685",2000074896,"Albert Rosas","8/19/2002 (20 years old)","AM (L), ST (C)","F.C. Andorra B","Spanish Regional Division","AND","No","7/1/2022","6/30/2025","$24K - $240K","Right","Reasonable","Very Strong","5'10""","154 lbs","58","29",84,100,9,7,11,11,9,12,9,10,7,5,9,9,7,11,10,10,6,10,8,8,10,12,7,12,8,10,10,9,12,12,10,9,12,13,11,7,13,12,12,13,10,12,10,10,8,5,12,8,8,1,2,3,2,3,3,1,1,2,1,2
"686",67248949,"Aarón Sánchez","6/5/1996 (27 years old)","AM (C), ST (C)","U.E. Santa Coloma","Andorran First Division","AND","Yes","7/1/2022","6/30/2024","$0","Right Only","Weak","Very Strong","6'0""","176 lbs","119","25",64,97,5,6,9,13,13,5,7,6,1,5,8,3,3,11,8,6,7,10,6,12,15,11,11,10,6,3,3,8,11,11,5,9,6,12,12,6,8,12,12,10,11,11,9,16,8,2,8,12,19,3,3,3,4,2,1,1,3,1,2,3
"687",67207298,"Marc Rebés","7/3/1994 (28 years old)","D (C), DM","F.C. Santa Coloma","Andorran First Division","AND","No","7/1/2022","6/30/2024","$0","Right Only","Weak","Very Strong","5'9""","145 lbs","206","16",86,95,5,10,6,6,9,7,12,7,4,11,9,8,10,8,13,10,13,12,12,10,7,5,14,10,10,13,9,14,13,14,12,13,14,11,12,9,13,18,9,12,10,16,13,7,8,6,12,6,4,1,2,3,3,2,2,3,2,2,1,2
"688",67243429,"Jordi Aláez","1/23/1998 (25 years old)","AM (RLC)","F.C. Santa Coloma","Andorran First Division","AND","No","3/29/2023","6/30/2024","$0","Right Only","Weak","Very Strong","5'9""","154 lbs","110","11",76,95,8,8,9,8,11,8,6,10,2,7,10,11,6,11,10,11,9,8,9,11,16,11,13,9,9,9,11,12,11,12,9,8,11,11,9,8,12,13,10,10,10,11,8,6,5,3,11,10,12,3,1,1,1,3,3,2,3,1,2,2
"689",67248950,"Jesús Rubio","9/9/1994 (28 years old)","D/WB (R)","Inter d'Escaldes","Andorran First Division","AND","No","8/15/2021","6/30/2024","$0","Right Only","Weak","Very Strong","5'6""","136 lbs","215","9",73,95,6,9,10,6,11,2,11,3,11,12,7,4,12,12,9,9,10,11,13,13,17,5,10,9,10,11,9,11,12,12,11,6,10,11,10,4,15,14,9,12,10,12,11,9,8,6,12,10,13,1,4,2,3,2,1,2,2,1,2,1
"690",22078623,"Ivan Yordanov","11/7/2000 (22 years old)","DM, M/AM (C)","Spartak Varna","Bulgarian Second League","BUL","Yes","12/15/2019","6/30/2025","$160K - $1.6M","Left","Very Strong","Fairly Strong","5'9""","149 lbs","92","7",113,135,12,11,13,9,11,13,7,12,7,8,13,11,10,13,12,11,14,10,11,12,14,15,9,12,10,14,13,12,13,14,12,6,13,12,10,7,13,18,12,13,12,14,9,13,8,5,12,14,13,3,2,2,3,2,2,1,3,1,3,1
"691",67024811,"Ludovic Clemente","5/9/1986 (37 years old)","AM (C)","U.E. Santa Coloma","Andorran First Division","AND","No","8/12/2022","6/30/2024","$0","Right Only","Weak","Very Strong","5'4""","132 lbs","51","2",70,95,9,5,6,12,10,9,9,8,5,9,11,9,7,15,5,12,8,12,10,9,12,12,13,13,11,10,14,15,10,10,7,2,8,10,10,1,12,13,10,12,10,9,5,3,12,1,11,9,20,2,3,2,4,1,3,2,1,1,1,3
"692",28038455,"Márcio Vieira","10/10/1984 (38 years old)","M (C)","Monzón","Spanish Federation Third Group 17","AND","Yes","6/14/2021","6/30/2023","$0","Right","Reasonable","Very Strong","5'11""","176 lbs","473","58",90,95,10,5,8,6,12,10,8,10,8,15,15,6,9,14,10,12,5,10,12,12,15,10,14,11,13,11,11,15,9,9,9,10,12,9,10,9,16,11,11,9,12,20,10,12,6,1,12,13,16,1,3,2,3,3,1,2,4,3,1,2
"693",95061360,"Christian García","2/4/1999 (24 years old)","D (C), DM","U.E. Santa Coloma","Andorran First Division","AND","No","7/1/2022","6/30/2024","$0","Right","Weak","Very Strong","6'0""","167 lbs","78","11",73,91,8,3,7,4,8,8,10,9,2,7,12,5,10,7,9,13,9,7,8,12,16,5,8,8,7,9,8,14,11,10,9,12,15,9,9,9,11,16,9,11,10,12,5,8,13,6,11,12,8,2,3,3,3,2,2,1,3,2,2,1
"694",67182698,"Moisés San Nicolás","9/17/1993 (29 years old)","D/WB (RL)","Atlètic Escaldes","Andorran First Division","AND","Yes","8/24/2020","6/30/2024","$0","Right","Fairly Strong","Very Strong","6'2""","176 lbs","203","2",73,90,9,12,6,2,9,8,8,9,12,7,9,6,10,8,7,9,10,9,8,9,4,9,5,10,9,12,11,14,11,8,8,8,12,10,13,8,6,17,12,11,13,12,15,8,9,1,11,12,7,1,1,2,1,3,3,1,2,3,1,3
"695",67129256,"Kiki","10/16/1989 (33 years old)","D/WB/M/AM (R), ST (C)","Ordino","Andorran First Division","AND","No","1/1/2023","6/30/2024","$0","Right Only","Weak","Very Strong","5'7""","141 lbs","364","156",71,90,6,11,10,9,9,4,10,7,7,7,12,14,5,10,12,9,8,7,9,12,15,12,4,9,7,8,6,9,12,7,5,7,12,10,8,3,12,11,12,10,10,13,8,1,10,1,12,10,14,1,3,3,1,3,2,2,3,1,1,3
"696",95056842,"Luigi San Nicolas","6/28/1992 (30 years old)","AM (RL), ST (C)","Pas de la Casa","Andorran First Division","AND","No","9/1/2022","-","$0","Left","Very Strong","Fairly Strong","5'9""","149 lbs","190","41",64,90,6,10,9,9,9,6,8,6,4,5,10,1,7,13,4,8,7,8,7,10,9,10,13,10,6,7,7,9,8,10,7,7,13,10,13,4,11,20,11,9,10,11,11,4,12,7,9,12,7,1,3,2,2,4,2,1,1,2,2,1
"697",67287933,"Cucu","3/19/1999 (24 years old)","ST (C)","C.P. San Cristóbal","Spanish Federation Third Group 5","AND","No","7/1/2022","6/30/2024","$35K - $110K","Right","Weak","Very Strong","5'8""","154 lbs","90","32",88,90,7,8,14,12,12,6,14,8,5,6,8,5,1,7,5,11,5,11,8,10,4,6,12,12,8,5,5,9,12,12,8,7,14,11,14,10,11,19,12,9,10,11,12,7,6,1,9,12,9,3,3,1,2,1,2,2,4,1,1,1
"698",95066819,"Aarón Fernández","3/21/2001 (22 years old)","M (C)","FS Massana","Andorran Second Division","AND","No","7/1/2021","6/30/2024","$0","Left","Very Strong","Reasonable","5'5""","132 lbs","77","7",63,86,3,5,3,6,8,3,6,9,3,9,11,5,8,13,5,8,3,6,8,15,13,8,9,5,9,8,11,13,15,9,4,3,12,11,9,3,13,12,12,12,12,11,13,7,5,3,8,10,18,2,2,3,1,3,3,3,1,1,3,3
"699",67248245,"Kiko Pomares","9/21/1998 (24 years old)","D (L)","Gran Tarajal","Spanish Federation Third Group 12","AND","Yes","11/25/2022","-","$0","Left","Very Strong","Weak","6'1""","163 lbs","80","2",65,85,5,10,5,1,8,2,8,3,3,9,7,1,12,7,11,8,8,7,6,6,9,7,12,4,9,7,4,7,14,14,7,9,10,14,9,9,9,20,12,11,10,13,13,4,6,5,13,12,18,4,1,3,1,3,2,1,1,1,3,3
"700",7445079,"Marc Pujol","8/21/1982 (40 years old)","M/AM (C), ST (C)","Engordany","Andorran Lower Division","AND","Yes","8/19/2022","6/30/2024","$0","Right Only","Weak","Very Strong","5'6""","143 lbs","418","69",72,85,9,7,5,8,14,13,4,12,2,8,14,15,4,10,14,11,8,12,9,14,17,9,14,9,9,8,13,9,7,6,5,5,12,8,12,3,11,12,12,12,12,12,5,1,12,1,10,12,16,2,1,2,1,4,2,3,2,2,3,2
"701",28122192,"Sylvester Jasper","9/13/2001 (21 years old)","AM (RL)","Fulham","English Premier Division","BUL","Yes","7/1/2018","6/30/2026","$450K - $9.4M","Right","Reasonable","Very Strong","5'11""","165 lbs","33","2",115,135,8,13,14,8,12,11,5,13,2,7,14,9,6,13,8,11,9,12,13,12,14,14,7,11,9,10,13,12,14,12,12,6,12,14,11,8,12,12,5,10,10,11,11,10,7,5,8,12,14,2,2,1,2,2,1,3,2,1,2,1
"702",67044850,"Josep Gomes","12/3/1985 (37 years old)","GK","F.C. Santa Coloma","Andorran First Division","AND","Yes","8/18/2022","6/30/2024","$0","Right Only","Weak","Very Strong","6'0""","171 lbs","332","1",72,85,2,1,3,1,6,6,1,1,1,1,10,2,3,1,13,10,13,7,7,14,4,1,13,3,13,8,6,7,8,8,8,11,12,5,6,5,9,13,13,12,13,9,9,12,7,4,17,9,8,7,5,12,14,10,13,7,5,9,10,8
"703",144794,"Sebastián Gómez","11/1/1983 (39 years old)","AM (RL), ST (C)","Engordany","Andorran Lower Division","AND","No","6/14/2021","6/30/2024","$0","Right Only","Weak","Very Strong","5'9""","165 lbs","307","42",71,85,11,11,9,15,15,12,7,12,8,8,14,14,4,11,3,10,7,10,8,7,4,12,13,13,6,12,12,12,7,7,7,9,9,7,7,7,10,10,11,11,11,11,13,5,2,8,13,13,15,2,3,3,3,1,2,3,1,3,3,3
"704",2000269211,"Ian Olivera","10/5/2004 (18 years old)","D (C)","Zaragoza B","Spanish Federation Second Group 2","AND","No","7/1/2022","6/30/2023","$0","Left Only","Very Strong","Weak","6'2""","174 lbs","6","-",60,85,4,7,3,1,7,2,15,3,4,12,8,1,8,2,15,11,8,7,7,13,17,6,2,6,7,7,5,8,10,12,8,14,12,9,5,6,12,16,13,11,10,12,13,9,9,8,9,12,9,1,2,2,2,2,1,3,2,3,2,1
"705",2000101055,"Mauro Rabelo","7/1/2002 (20 years old)","GK","Mavlon FC Andorra","Andorran First Division","AND","No","1/13/2023","6/30/2024","$0","Right Only","Weak","Very Strong","5'10""","154 lbs","16","-",75,85,3,1,3,1,2,7,1,3,1,1,11,3,3,3,6,7,15,6,8,13,11,3,9,1,6,7,6,6,12,11,7,7,11,12,3,5,11,10,11,13,14,11,13,4,8,3,10,11,14,8,11,11,11,10,10,13,5,9,10,7
"706",95058985,"Victor Bernat","5/17/1987 (36 years old)","AM (R), ST (C)","Engordany","Andorran Lower Division","AND","Yes","7/1/2022","6/30/2024","$0","Right Only","Weak","Very Strong","5'9""","154 lbs","189","80",72,85,7,11,10,14,12,3,12,10,1,4,9,7,2,9,11,9,2,12,7,11,3,10,11,12,6,7,10,9,11,9,8,5,12,11,9,7,12,11,12,12,11,12,14,8,13,7,9,12,16,1,3,1,4,2,3,3,2,3,2,3
"707",67243428,"Andreu Matos","12/1/1995 (27 years old)","AM (LC), ST (C)","CF Esperança","Andorran First Division","AND","No","7/1/2022","6/30/2024","$0","Left Only","Very Strong","Weak","5'10""","154 lbs","130","28",51,83,2,6,9,8,11,6,9,8,8,6,10,8,3,8,4,9,6,8,7,8,10,8,12,11,7,7,9,8,9,10,7,9,9,10,6,8,10,13,13,10,9,12,5,12,5,5,9,12,20,3,1,2,1,3,1,3,1,1,2,2
"708",95066092,"Roberto Gomes","10/21/1999 (23 years old)","M/AM (RL), ST (C)","Pas de la Casa","Andorran First Division","AND","Yes","6/12/2023","-","$0","Left Only","Very Strong","Weak","5'4""","121 lbs","116","31",54,80,2,7,10,8,11,1,6,6,5,5,10,2,2,8,8,4,2,8,5,9,5,12,1,7,5,6,5,7,13,13,6,1,16,13,5,1,10,19,12,12,13,12,5,10,11,2,13,11,11,2,1,3,3,2,2,2,4,2,1,2
"709",67159441,"Xavi Vieira","1/14/1992 (31 years old)","DM, M/AM (C)","Engordany","Andorran Lower Division","AND","Yes","8/19/2022","6/30/2024","$0","Right","Reasonable","Very Strong","5'11""","176 lbs","253","34",69,80,6,9,8,5,12,8,6,6,1,7,12,2,10,15,9,9,7,8,7,9,11,13,3,8,8,8,13,13,9,8,7,10,11,9,12,4,8,13,11,11,10,14,14,5,11,6,7,10,11,3,3,3,1,2,1,3,2,3,2,3
"710",67065286,"Emili García","1/11/1989 (34 years old)","D (C)","U.E. Santa Coloma","Andorran First Division","AND","No","8/12/2022","6/30/2024","$0","Right Only","Weak","Very Strong","6'2""","180 lbs","377","19",65,80,4,2,5,1,8,1,9,4,1,9,6,1,8,7,11,7,8,6,9,14,8,5,4,5,14,6,6,8,10,8,7,14,14,8,5,8,9,16,11,11,14,8,6,6,10,1,15,12,12,2,3,1,2,2,2,1,4,2,1,3
"711",2000049498,"Brian Pubill","7/26/2000 (22 years old)","M (L), AM (RL)","Ordino","Andorran First Division","AND","Yes","9/13/2021","6/30/2024","$0","Right Only","Weak","Very Strong","6'1""","163 lbs","85","14",62,80,5,7,11,9,12,5,3,6,5,5,9,2,5,7,9,10,7,9,6,10,12,10,13,5,5,5,5,10,13,10,6,12,9,13,5,4,12,17,11,12,10,10,6,10,14,8,16,11,19,1,2,2,3,2,2,3,2,3,3,2
"712",19047159,"Cicinho","12/26/1988 (34 years old)","D/WB (R)","BAH","Brazilian National First Division","BUL","Yes","1/13/2023","12/31/2024","$40K - $375K","Right","Reasonable","Very Strong","5'6""","143 lbs","307","16",107,135,11,12,12,8,12,11,6,7,12,9,12,11,11,12,15,10,14,10,11,9,13,11,8,11,9,13,10,14,14,14,10,6,13,13,12,9,13,3,4,11,10,13,8,11,13,6,13,13,8,2,3,3,1,3,1,3,2,1,3,2
"713",95067081,"Marc Ferré","1/11/1994 (29 years old)","M (C)","Mavlon FC Andorra","Andorran First Division","AND","No","1/19/2023","6/30/2024","$0","Right Only","Weak","Very Strong","5'9""","160 lbs","241","8",60,80,10,6,3,5,11,6,4,10,1,8,14,2,5,10,4,9,5,8,7,8,7,9,4,8,9,8,7,13,9,9,8,9,10,10,13,10,8,19,10,10,11,13,5,10,5,1,9,10,13,3,3,1,2,3,1,1,2,1,1,1
"714",95056964,"Lluis Blanco","1/15/1990 (33 years old)","M (C)","Engordany","Andorran Lower Division","AND","Yes","7/1/2022","6/30/2024","$0","Right","Fairly Strong","Very Strong","6'0""","163 lbs","204","31",62,80,11,10,11,6,8,11,4,9,3,9,10,7,6,9,9,8,8,8,9,8,12,5,13,9,9,9,8,13,11,8,6,11,17,10,8,6,11,13,10,11,8,10,5,13,11,5,10,11,8,2,3,1,1,1,3,2,2,1,2,2
"715",2000075022,"Eric Vales","8/18/2000 (22 years old)","M (C)","Tamarite","Spanish Federation Third Group 17","AND","No","1/1/2020","6/30/2024","$0","Right","Weak","Very Strong","6'3""","185 lbs","47","1",78,80,8,5,3,7,15,8,8,10,3,8,11,1,7,15,5,10,3,8,8,11,9,6,11,10,12,9,11,14,10,10,5,16,13,10,11,11,15,20,12,13,10,12,10,12,15,3,14,10,17,1,3,1,3,2,3,3,2,3,2,3
"716",2000269208,"Marc de Castro","3/11/2004 (19 years old)","GK","R.C. Alcobendas","Spanish Regional Division","AND","No","7/1/2022","-","$0","Right Only","Weak","Very Strong","5'11""","152 lbs","-","-",60,79,3,1,1,1,1,7,1,2,3,3,7,1,2,1,11,9,10,5,8,13,13,2,1,3,7,6,5,4,11,5,6,7,16,12,1,4,8,10,10,13,11,9,8,6,7,8,15,10,10,8,11,13,8,6,11,13,5,6,12,10
"717",67102591,"Alberto Molina","4/21/1988 (35 years old)","DM, M (C)","Ranger's FC","Andorran Second Division","AND","Yes","6/30/2022","6/30/2023","$0","Right Only","Weak","Very Strong","5'11""","171 lbs","243","24",54,78,12,9,7,8,9,9,8,4,3,6,11,3,7,8,10,11,8,10,5,10,5,5,8,9,12,10,9,14,8,9,9,10,8,10,9,7,12,13,10,10,12,9,5,7,12,5,12,9,7,3,3,2,1,1,1,4,3,3,2,1
"718",95058767,"Carlos Gomes","10/18/1993 (29 years old)","M (L), AM (RL), ST (C)","Pas de la Casa","Andorran First Division","AND","Yes","7/1/2022","-","$0","Right","Reasonable","Very Strong","5'10""","160 lbs","169","85",56,78,8,9,8,7,10,5,6,7,1,5,10,1,3,12,6,8,6,6,5,11,2,12,9,10,5,6,7,8,10,8,6,8,8,9,12,4,11,14,11,10,11,10,8,3,11,2,10,13,10,2,2,1,1,3,1,3,3,1,3,1
"719",95058931,"Josep Cabanes","4/2/1996 (27 years old)","D (RL), WB (R)","Inter d'Escaldes","Andorran First Division","AND","No","7/1/2020","6/30/2024","$0","Right Only","Weak","Very Strong","5'9""","143 lbs","90","9",69,78,6,10,8,6,9,1,8,7,5,8,9,4,8,8,3,9,9,7,8,14,19,5,7,6,7,8,6,10,10,9,6,7,10,9,15,7,11,17,10,10,12,10,7,15,11,8,10,12,14,1,2,2,1,2,2,2,1,2,2,1
"720",2000074832,"Izan Fernández","3/10/2001 (22 years old)","M/AM (RL), ST (C)","Monzón","Spanish Federation Third Group 17","AND","No","6/30/2022","6/30/2024","$0","Right Only","Very Weak","Very Strong","5'8""","143 lbs","69","13",61,77,8,8,10,9,9,8,7,9,6,3,8,8,4,9,5,7,9,8,7,8,11,11,5,10,3,7,8,7,13,14,8,7,12,12,7,6,15,11,12,7,11,13,5,10,10,6,10,12,14,1,2,3,4,3,1,3,3,1,1,2
"721",2000269215,"Marc Rodríguez","6/21/2005 (17 years old)","D (L)","F.C. Andorra B","Spanish Regional Division","AND","No","7/1/2022","6/30/2026","$0","Left","Very Strong","Reasonable","5'10""","149 lbs","-","-",60,77,4,12,7,3,8,2,8,5,3,6,8,4,12,7,8,8,8,7,10,15,5,5,9,2,9,8,4,8,13,9,5,6,8,13,8,5,11,12,10,11,13,11,14,12,9,3,10,13,8,3,3,1,2,3,3,1,2,1,3,2
"722",2000074893,"Ion Rodríguez","8/28/2001 (21 years old)","GK","Inter d'Escaldes","Andorran First Division","AND","No","6/12/2023","6/30/2024","$0","Right","Reasonable","Very Strong","6'0""","163 lbs","32","-",73,76,3,1,3,3,3,5,1,1,1,1,8,1,1,1,10,8,13,7,13,13,9,1,13,3,9,7,6,6,10,7,7,10,8,13,2,5,10,15,13,11,11,12,11,10,15,7,15,11,18,8,9,13,8,11,7,13,5,8,8,7
"723",64042141,"Abdullah Nassib","2/25/1993 (30 years old)","D (C)","Hussein","Jordanian Professional League","JOR","No","6/7/2023","12/31/2024","$40K - $120K","Right","Reasonable","Very Strong","6'1""","167 lbs","32","2",100,110,2,3,5,6,9,6,14,2,4,14,9,4,14,7,10,14,10,9,7,12,4,5,7,8,12,8,5,9,14,14,9,13,9,14,13,6,12,15,9,11,10,12,8,11,10,1,12,13,13,2,1,1,2,2,1,2,1,1,4,1
"724",22064302,"Tonislav Yordanov","11/27/1998 (24 years old)","ST (C)","Beroe","Bulgarian First League","BUL","Yes","1/1/2023","6/30/2025","$90K - $900K","Right","Fairly Strong","Very Strong","5'11""","154 lbs","171","59",106,135,8,9,12,13,11,15,11,13,5,4,10,14,6,13,9,12,8,12,9,10,12,14,8,14,6,10,12,11,13,13,12,10,13,13,11,7,14,10,10,12,12,12,7,14,7,7,12,12,11,1,1,4,3,2,1,4,3,1,1,4
"725",95061361,"Sebastià Bertrán","12/10/1992 (30 years old)","M (C)","Pas de la Casa","Andorran First Division","AND","No","7/1/2022","-","$0","Right","Strong","Very Strong","5'8""","149 lbs","216","65",57,75,5,4,10,4,7,10,5,7,8,6,10,4,6,8,7,9,6,4,7,8,7,6,13,7,7,6,6,11,12,13,7,6,9,13,12,5,12,12,10,10,12,9,11,13,15,8,10,11,7,1,1,2,2,2,1,3,1,1,4,3
"726",95056556,"Josete","10/3/1997 (25 years old)","M (RL), AM (L)","Ordino","Andorran First Division","AND","No","1/18/2022","6/30/2024","$0","Left","Very Strong","Reasonable","5'9""","145 lbs","101","19",52,75,4,9,9,5,7,4,1,1,1,4,5,1,2,7,3,6,3,6,5,9,5,10,2,9,4,5,5,6,12,12,5,2,13,12,9,5,13,15,11,9,11,12,10,11,2,3,7,10,7,1,3,3,3,3,3,3,2,3,1,1
"727",2000269213,"Guillem Acosta","2/4/2006 (17 years old)","D (R)","F.C. Andorra","Spanish Second Division","AND","No","7/1/2022","-","$0","Right","Reasonable","Very Strong","5'9""","143 lbs","-","-",55,75,6,12,1,2,11,1,8,4,7,9,6,5,13,6,13,7,8,4,9,6,14,6,4,6,6,8,6,8,15,12,8,10,13,13,7,5,12,19,10,14,11,10,11,11,7,6,4,10,17,3,2,3,2,2,1,1,2,3,1,4
"728",67159439,"Deco","6/16/1992 (30 years old)","M/AM (RC), ST (C)","Pas de la Casa","Andorran First Division","AND","Yes","7/1/2022","-","$0","Right Only","Weak","Very Strong","5'9""","147 lbs","218","193",59,75,5,7,11,8,6,5,5,10,5,4,5,4,4,11,6,5,5,6,6,9,11,9,3,8,6,6,7,8,11,10,6,5,17,10,13,4,13,11,11,12,10,10,12,14,7,1,14,12,9,3,1,3,1,3,3,1,3,1,2,1
"729",2000105388,"Aleix Viladot","6/26/1997 (25 years old)","D (LC), WB (L)","Mavlon FC Andorra","Andorran First Division","AND","No","1/19/2023","6/30/2024","$0","Right Only","Weak","Very Strong","5'9""","154 lbs","100","2",52,75,2,8,2,5,6,1,7,4,5,8,5,1,9,7,13,10,6,5,7,9,2,5,7,4,6,2,5,7,13,13,6,9,10,13,10,7,14,15,11,10,11,9,6,9,13,6,12,8,15,1,2,1,3,2,1,2,2,2,1,2
"730",95056965,"Canario","4/2/1993 (30 years old)","D/WB (L)","Pas de la Casa","Andorran First Division","AND","No","7/1/2022","-","$0","Left Only","Very Strong","Weak","5'11""","163 lbs","203","8",57,74,4,10,6,4,10,1,7,6,9,7,10,1,7,9,5,11,6,5,7,12,5,5,1,5,8,8,6,9,11,12,8,10,13,10,14,5,10,12,11,13,11,11,10,7,14,6,16,12,12,1,1,3,2,2,1,3,1,1,1,1
"731",28121290,"Karl Jakob Hein","4/13/2002 (21 years old)","GK","Arsenal","English Premier Division","EST","Yes","9/17/2021","6/30/2025","$850K - $10.5M","Right","Weak","Very Strong","6'4""","194 lbs","10","-",112,132,4,3,2,2,9,7,1,1,3,2,8,2,3,7,12,11,13,10,12,10,13,6,7,3,13,12,8,10,12,13,9,14,14,10,10,12,14,14,8,12,9,10,9,11,15,1,11,11,16,11,9,14,11,13,14,13,4,10,10,14
"732",2000019993,"Maksim Paskotši","1/19/2003 (20 years old)","D (C)","Tottenham","English Premier Division","EST","Yes","9/21/2020","9/6/2023","$0","Right","Reasonable","Very Strong","6'2""","180 lbs","31","-",95,132,5,5,7,10,10,2,12,7,7,10,9,5,12,11,13,11,13,12,10,10,13,5,12,8,10,12,9,12,10,12,11,12,12,9,12,10,13,12,10,9,13,15,12,6,5,1,16,13,20,3,3,3,2,3,3,1,2,2,3,3
"733",2000085195,"Rocco Robert Shein","7/14/2003 (19 years old)","DM, M (C)","FC Utrecht","Keuken Kampioen Divisie","EST","Yes","6/30/2022","6/30/2027","$0","Right","Strong","Very Strong","6'1""","169 lbs","99","8",112,131,11,10,11,8,11,11,9,12,4,10,13,6,9,11,15,11,11,12,10,12,13,12,8,11,11,14,11,13,11,12,12,11,6,11,13,12,10,20,12,13,9,10,5,14,6,8,9,13,14,2,3,1,1,1,1,2,1,2,2,2
"734",47070304,"Georgi Tunjov","4/17/2001 (22 years old)","M (RLC), AM (C)","SPAL","Italian Serie C/B","EST","Yes","6/15/2020","6/30/2025","$75K - $750K","Left","Very Strong","Reasonable","6'1""","160 lbs","84","3",104,130,6,6,6,8,14,6,5,8,6,6,15,8,9,14,8,9,8,9,9,12,15,12,8,11,8,12,12,11,13,12,12,13,12,13,14,14,12,15,10,11,11,10,5,5,8,5,13,10,13,3,1,3,2,3,1,1,1,2,1,1
"735",22063989,"Svetoslav Kovachev","3/14/1998 (25 years old)","M/AM (RL)","Arda","Bulgarian First League","BUL","Yes","6/1/2021","6/30/2025","$350K - $1M","Left","Very Strong","Fairly Strong","5'8""","143 lbs","193","31",106,135,12,10,13,10,11,12,5,10,4,5,11,8,6,13,13,9,12,10,8,8,13,15,8,12,5,10,11,11,15,15,12,6,12,14,9,5,11,10,10,12,12,12,8,12,9,7,10,12,8,2,3,4,3,2,3,1,1,2,3,1
"736",47023240,"Karol Mets","5/16/1993 (30 years old)","D (C), DM","St. Pauli","Bundesliga 2","EST","Yes","1/7/2022","6/30/2025","$0","Left","Very Strong","Weak","6'3""","174 lbs","365","12",120,128,3,7,10,6,11,4,13,6,13,14,12,10,12,11,16,12,14,13,12,12,13,7,14,8,14,13,11,12,11,8,14,15,16,14,12,15,12,9,10,16,13,8,5,13,10,11,15,12,16,1,2,2,4,3,1,3,2,1,2,1
"737",47100593,"Oliver Jürgens","5/10/2003 (20 years old)","ST (C)","Torino","Italian Serie A","EST","Yes","8/19/2022","6/30/2024","$0","Right","Reasonable","Very Strong","5'10""","163 lbs","25","35",73,127,7,7,10,11,12,11,9,9,5,4,11,11,7,11,11,9,10,8,7,8,12,10,8,9,7,11,10,8,12,11,10,8,10,10,10,8,11,13,11,11,10,9,14,8,5,6,11,11,20,3,1,3,2,4,2,2,1,2,1,1
"738",2000065555,"Aleksandr Šapovalov","2/28/2003 (20 years old)","ST (C)","Flora","Estonian First League","EST","Yes","2/4/2022","12/31/2024","$7K - $70K","Right","Reasonable","Very Strong","5'7""","149 lbs","90","64",80,127,6,5,13,13,13,6,8,6,3,3,9,7,6,13,13,8,6,9,7,13,15,13,11,13,7,7,3,11,13,13,13,5,9,13,8,1,14,14,10,12,12,13,10,12,7,4,8,16,13,2,2,2,2,2,2,1,1,3,1,3
"739",29140619,"Mattias Käit","6/29/1998 (24 years old)","M (C)","FC Rapid","Romanian First League","EST","Yes","1/18/2022","6/30/2024","$70K - $700K","Right","Reasonable","Very Strong","6'0""","163 lbs","100","5",111,125,8,10,12,12,13,7,11,12,5,7,13,9,10,12,11,11,10,12,10,12,10,14,9,11,12,14,12,14,14,14,10,12,14,12,11,11,12,11,8,9,10,11,9,13,11,5,13,12,11,1,1,2,1,1,1,1,2,3,1,2
"740",47070170,"Erik Sorga","7/8/1999 (23 years old)","ST (C)","Lokomotiv Plovdiv","Bulgarian First League","EST","Yes","1/1/2023","6/30/2026","$12K - $130K","Right","Weak","Very Strong","5'9""","149 lbs","187","95",92,125,7,8,11,11,11,7,10,8,6,8,10,8,8,11,12,11,12,11,11,10,12,7,7,13,9,12,8,12,12,12,11,8,11,12,12,11,6,10,10,10,8,10,7,14,7,5,11,12,7,3,3,2,1,4,1,3,1,2,2,1
"741",7681391,"Konstantin Vassiljev","8/16/1984 (38 years old)","M/AM (C)","Flora","Estonian Premier League","EST","Yes","2/27/2019","12/31/2023","$7K - $70K","Right","Fairly Strong","Very Strong","5'9""","167 lbs","547","144",100,121,14,12,12,12,13,14,8,15,7,8,15,10,10,14,14,15,11,16,10,14,11,12,13,10,8,14,16,8,6,7,10,6,9,7,8,8,12,13,12,13,13,12,7,10,7,8,14,6,13,3,3,1,3,2,2,2,4,1,4,1
"742",7681689,"Ats Purje","8/3/1985 (37 years old)","AM (RL), ST (C)","Tallinna Kalev","Estonian Premier League","EST","Yes","1/1/2021","12/31/2023","$18K - $55K","Right","Reasonable","Very Strong","5'11""","169 lbs","451","147",84,120,8,11,10,12,12,9,7,11,5,5,11,13,5,12,7,10,9,11,9,9,8,10,6,12,6,14,9,15,8,12,12,8,12,9,11,9,12,12,16,12,10,12,9,10,4,4,12,8,13,2,1,1,1,1,2,1,1,4,3,4
"743",2000124904,"Karel Mustmaa","8/8/2005 (17 years old)","AM (L), ST (C)","Benfica","Portuguese Premier League","EST","Yes","9/1/2021","6/30/2024","$14K - $140K","Left","Very Strong","Weak","6'2""","154 lbs","6","4",80,120,9,10,10,13,12,10,7,10,5,6,9,10,5,12,10,10,9,10,8,9,14,14,6,10,8,7,10,7,12,11,9,8,14,12,9,10,16,16,13,13,9,12,5,8,5,4,9,9,16,3,1,1,2,3,3,1,1,1,2,2
"744",47040336,"Matvei Igonen","10/2/1996 (26 years old)","GK","Podbeskidzie","Polish First Division","EST","Yes","1/1/2022","6/30/2024","$35K - $325K","Right","Reasonable","Very Strong","6'2""","171 lbs","272","-",101,120,4,3,3,2,11,8,7,1,3,2,11,3,2,8,13,10,11,8,9,10,12,1,7,3,11,12,9,13,8,11,14,14,13,10,14,12,12,15,14,14,10,13,5,17,5,5,7,13,13,10,10,13,8,11,15,11,7,12,11,14
"745",28100550,"Andreas Vaikla","2/19/1997 (26 years old)","GK","Scrosoppi FC","League1 Ontario","EST","Yes","3/1/2023","-","$0","Right Only","Very Weak","Very Strong","6'6""","202 lbs","88","-",97,118,2,1,1,1,6,6,1,2,2,1,6,3,2,7,7,11,13,10,11,11,13,2,9,3,11,11,6,10,12,12,11,16,11,11,6,12,14,13,12,12,12,8,8,9,5,4,12,12,14,12,12,12,12,11,11,11,8,11,12,14
"746",22072957,"Tomislav Papazov","8/24/2001 (21 years old)","D (C)","Badalona","Spanish Federation Third Group 5","BUL","Yes","7/31/2022","6/30/2025","$325K - $1M","Right","Weak","Very Strong","6'1""","154 lbs","74","3",86,133,5,7,10,7,11,9,12,7,1,10,8,2,11,10,13,12,13,8,9,9,13,7,10,7,12,13,8,12,11,11,12,13,12,11,10,8,12,11,11,13,10,12,5,9,5,7,13,12,19,2,2,3,3,1,4,1,3,3,3,1
"747",7681709,"Taijo Teniste","1/31/1988 (35 years old)","D (RL), WB (L), M (R)","Tammeka","Estonian Premier League","EST","Yes","1/1/2021","12/31/2023","$20K - $60K","Right","Fairly Strong","Very Strong","5'8""","143 lbs","415","18",113,117,9,12,10,8,10,8,7,9,14,11,10,7,11,11,3,10,12,13,13,11,11,9,8,10,10,13,10,15,12,13,9,7,9,12,13,11,15,15,15,14,10,17,2,10,3,1,13,10,12,1,1,1,2,3,1,3,1,4,3,1
"748",7681708,"Kaimar Saag","8/5/1988 (34 years old)","ST (C)","Paide LM","Estonian Premier League","EST","Yes","12/31/2021","12/31/2023","$0 - $60K","Right Only","Weak","Very Strong","5'11""","165 lbs","419","163",90,116,5,6,8,13,12,6,8,8,6,7,9,11,6,10,15,12,12,12,9,10,12,7,7,12,9,10,9,15,12,9,13,11,12,12,13,13,9,8,13,10,11,8,7,10,6,7,10,12,9,3,2,1,2,4,3,3,3,1,3,3
"749",47023277,"Artur Pikk","5/5/1993 (30 years old)","D/WB (L)","Odra Opole","Polish First Division","EST","Yes","1/4/2023","6/30/2024","$160K - $475K","Left","Very Strong","Reasonable","5'10""","160 lbs","335","17",103,115,9,11,10,5,8,8,12,9,10,13,12,7,12,8,9,12,10,10,12,13,11,6,8,11,12,10,13,14,12,11,9,10,13,12,13,10,7,10,13,14,14,8,5,10,7,6,10,13,15,1,3,3,1,3,2,3,1,1,3,1
"750",31000025,"Sergei Zenjov","4/20/1989 (34 years old)","AM (R), ST (C)","Flora","Estonian Premier League","EST","Yes","1/20/2021","12/31/2023","$40K - $110K","Right","Reasonable","Very Strong","6'0""","158 lbs","418","120",108,114,8,8,10,8,12,8,10,12,8,4,11,10,10,12,13,10,13,9,10,12,13,12,8,14,8,12,11,15,13,13,13,10,15,13,11,10,15,8,11,12,12,12,11,14,11,12,12,15,12,3,3,3,3,2,2,3,2,1,2,2
"751",31000156,"Henri Anier","12/17/1990 (32 years old)","ST (C)","Muangthong Utd","Thai League","EST","Yes","1/4/2022","6/30/2025","Not for Sale","Right Only","Weak","Very Strong","6'0""","176 lbs","371","149",104,113,4,8,10,12,11,7,12,11,7,6,10,8,7,11,13,12,11,12,12,11,12,8,8,13,9,13,9,15,13,11,13,12,11,12,11,14,8,10,12,10,12,11,8,11,4,4,11,11,14,2,1,1,2,1,3,2,3,1,1,1
"752",47040180,"Rauno Sappinen","1/23/1996 (27 years old)","AM (C), ST (C)","Stal Mielec","PKO Bank Polski Ekstraklasa","EST","Yes","2/1/2022","6/30/2025","$0","Right","Weak","Very Strong","5'10""","160 lbs","301","136",105,113,10,8,11,12,12,10,11,12,4,5,10,7,5,12,10,12,12,13,10,12,14,12,11,13,5,13,12,13,12,12,12,11,12,12,13,11,10,12,13,12,11,12,10,5,5,8,13,10,11,3,1,3,3,3,3,2,2,1,1,1
"753",2000267713,"Soufian Gouram","5/1/2006 (17 years old)","DM, M (C)","Hertha","Bundesliga 2","EST","Yes","7/1/2022","6/30/2024","$220K - $650K","Left Only","Very Strong","Weak","6'1""","165 lbs","-","-",74,113,8,6,6,8,14,8,8,10,2,9,14,6,15,14,5,6,9,10,10,11,16,5,5,9,8,9,11,13,7,10,9,13,11,11,8,9,14,13,8,13,9,13,7,12,5,7,9,11,10,3,1,2,2,3,4,1,2,2,2,2
"754",47079707,"Vladislav Kreida","9/25/1999 (23 years old)","DM, M (C)","St. Pat's Athletic","Irish Premier Division","EST","Yes","6/15/2020","12/31/2024","$30K - $300K","Right","Reasonable","Very Strong","5'11""","180 lbs","181","12",98,112,9,10,7,6,11,10,9,11,6,11,11,6,12,11,12,12,12,10,12,12,11,7,9,8,12,15,8,14,11,10,12,11,12,12,12,11,13,12,12,12,13,10,9,14,7,6,12,14,12,1,1,1,1,3,1,4,3,1,3,1
"755",47056532,"Vlasiy Sinyavskiy","11/27/1996 (26 years old)","WB/M (R), AM (L)","Slovácko","Czech First Division","EST","Yes","7/4/2022","6/30/2025","$120K - $1.2M","Right","Reasonable","Very Strong","5'11""","163 lbs","322","57",106,112,10,12,10,8,13,10,5,7,11,14,6,7,12,12,8,11,12,8,8,10,5,9,8,11,13,12,6,11,14,12,10,7,12,13,14,8,13,18,11,9,11,12,11,11,6,5,12,8,17,1,3,1,3,3,3,2,1,3,2,2
"756",47044347,"Mihkel Ainsalu","3/8/1996 (27 years old)","M (C)","FCI Levadia","Estonian Premier League","EST","Yes","2/8/2023","12/31/2023","$3K - $30K","Right","Strong","Very Strong","6'2""","176 lbs","211","27",81,111,11,7,3,8,14,6,7,9,7,11,11,7,11,9,11,7,6,9,6,8,6,6,8,9,11,10,11,13,8,10,8,8,12,9,14,7,10,13,9,11,9,11,10,11,5,5,7,13,19,1,2,3,1,2,2,2,2,2,3,1
"757",19008615,"Marcelinho","8/24/1984 (38 years old)","M/AM (C)","Princesa","Brazilian National Fourth Division","BUL","Yes","4/24/2023","12/31/2024","Not for Sale","Right","Fairly Strong","Very Strong","5'10""","154 lbs","329","83",95,133,11,11,12,11,12,12,10,13,3,4,12,12,5,15,12,12,9,10,9,9,14,13,13,15,5,10,12,9,12,14,11,9,16,10,11,9,15,4,3,10,11,13,8,15,16,17,8,15,14,1,2,1,3,1,3,1,1,2,2,2
"758",31000243,"Mihkel Kuresoo","9/29/1988 (34 years old)","ST (C)","Piraaja","Estonian Lower Leagues","EST","Yes","6/14/2021","-","$0","Right","Reasonable","Very Strong","5'10""","169 lbs","24","1",58,110,2,1,8,13,11,5,10,1,1,5,6,4,2,9,11,7,5,10,6,12,13,9,11,9,6,5,6,6,10,9,6,8,12,7,10,6,10,18,12,12,13,9,5,4,13,2,20,13,12,1,2,2,2,1,1,3,1,1,3,2
"759",7681702,"Sander Puri","5/7/1988 (35 years old)","M (RLC), AM (R)","Tammeka","Estonian Premier League","EST","Yes","12/31/2021","12/31/2023","$0 - $95K","Right","Reasonable","Very Strong","5'10""","158 lbs","344","56",90,108,11,10,12,9,14,10,6,10,6,7,13,12,9,13,12,10,7,10,7,9,10,12,7,9,6,10,11,10,12,12,12,8,14,11,10,6,16,12,9,11,12,12,8,10,6,13,9,12,6,3,1,1,2,3,1,1,3,2,2,3
"760",7681381,"Dmitri Kruglov","5/24/1984 (39 years old)","D/WB (L)","FCI Tallinn","Estonian Lower Leagues","EST","Yes","3/10/2022","-","$0","Left Only","Very Strong","Weak","5'8""","158 lbs","380","38",83,108,10,10,10,6,10,13,10,14,12,9,11,14,12,7,14,11,12,10,9,10,13,11,11,10,8,12,7,12,9,10,10,10,15,9,13,12,14,17,13,13,14,12,10,9,6,5,5,14,12,1,2,2,4,3,2,3,4,3,3,1
"761",47100574,"Robi Saarma","5/20/2001 (22 years old)","AM (RLC), ST (C)","Paide LM","Estonian Premier League","EST","Yes","1/16/2022","12/31/2024","$26K - $275K","Right","Reasonable","Very Strong","5'7""","136 lbs","34","16",83,108,7,7,9,11,12,7,9,8,4,7,8,6,6,10,11,10,3,8,3,6,14,9,3,11,7,6,7,10,14,9,14,3,7,13,13,3,15,15,11,15,12,11,9,12,9,8,14,12,15,2,3,1,2,1,2,2,4,2,4,2
"762",43409592,"Markus Soomets","3/2/2000 (23 years old)","DM, M (C)","Flora","Estonian Premier League","EST","Yes","1/17/2020","12/31/2024","$45K - $425K","Right","Reasonable","Very Strong","5'11""","154 lbs","81","4",90,108,8,9,8,6,10,9,8,9,8,9,11,8,14,10,16,12,12,9,7,11,16,10,11,9,12,12,10,12,14,13,9,8,14,14,12,6,12,16,10,14,11,14,9,13,12,9,13,12,10,1,1,3,4,1,1,2,2,3,3,2
"763",2000195986,"Dimitri Jepihhin","10/28/2005 (17 years old)","AM (RLC)","Paide LM","Estonian First League","EST","Yes","1/1/2023","12/31/2023","$0 - $75K","Right","Weak","Very Strong","5'7""","127 lbs","34","10",68,108,5,7,10,10,13,5,5,6,1,5,8,1,6,11,11,3,7,6,5,11,4,11,2,6,6,6,7,7,13,13,6,6,16,13,12,2,11,13,12,11,9,12,6,8,10,3,11,12,13,2,1,2,2,2,3,3,1,2,1,3
"764",7681148,"Aleksandr Dmitrijev","2/18/1982 (41 years old)","DM, M (C)","Puuma","Estonian Lower Leagues","EST","Yes","7/1/2022","-","$0","Right","Reasonable","Very Strong","5'9""","163 lbs","341","13",64,108,8,10,7,5,8,8,8,11,3,10,10,5,12,8,11,11,8,14,13,11,10,5,12,8,10,11,13,9,5,6,10,8,4,4,8,8,10,14,9,12,11,12,5,9,9,5,12,11,16,2,1,1,2,4,1,3,3,2,2,3
"765",47040170,"Brent Lepistu","3/26/1993 (30 years old)","DM, M (C)","CS Mioveni","Romanian Second League","EST","Yes","1/13/2023","6/30/2024","$90K - $900K","Left","Very Strong","Weak","6'1""","176 lbs","304","25",100,108,8,9,6,6,10,10,11,12,8,12,12,7,13,11,16,12,17,10,12,12,19,5,16,6,12,16,8,12,10,8,11,12,18,10,13,16,13,9,12,13,16,12,5,14,12,13,12,14,9,1,1,3,2,3,1,3,3,2,1,3
"766",7681360,"Mihkel Aksalu","11/7/1984 (38 years old)","GK","Paide LM","Estonian Premier League","EST","Yes","1/4/2021","12/31/2023","$0 - $35K","Right","Weak","Very Strong","6'3""","174 lbs","388","1",88,107,2,3,2,3,5,5,5,3,1,1,7,1,2,5,7,12,12,9,11,11,13,6,12,3,12,12,7,9,9,9,10,10,13,7,10,11,10,16,15,16,12,12,8,12,5,5,11,12,11,12,8,10,7,10,9,12,7,14,12,11
"767",47100548,"Sten Jakob Viidas","2/24/2003 (20 years old)","AM (RL)","Paide LM","Estonian Premier League","EST","Yes","8/1/2022","12/31/2025","$20K - $200K","Right","Reasonable","Very Strong","5'9""","147 lbs","17","1",80,106,7,12,12,13,13,5,5,5,7,4,9,5,8,10,10,9,6,9,7,13,11,10,3,10,7,8,7,9,13,12,8,4,16,11,7,4,17,19,9,13,12,13,5,10,13,6,19,12,16,3,3,1,1,2,1,1,1,3,3,1
"768",7506718,"Nikolay Mihaylov","6/28/1988 (34 years old)","GK","Levski","Bulgarian First League","BUL","Yes","5/20/2022","6/30/2024","$0 - $85K","Right Only","Weak","Very Strong","6'4""","198 lbs","224","-",98,132,2,3,1,3,9,7,10,1,2,1,9,9,2,7,6,13,7,11,11,11,11,6,13,5,14,14,8,9,8,11,10,15,10,7,7,13,10,15,15,10,11,16,12,10,7,14,9,11,14,8,14,11,8,11,11,14,7,13,12,14
"769",47040184,"German Šlein","3/28/1996 (27 years old)","DM","Kalju","Estonian Premier League","EST","Yes","1/26/2022","12/31/2023","$0 - $100K","Right","Reasonable","Very Strong","6'0""","169 lbs","189","9",78,106,5,4,7,5,8,5,7,8,1,9,10,4,13,9,13,7,8,7,9,8,7,10,3,10,13,12,6,8,13,13,7,8,15,13,13,7,12,19,12,11,13,10,9,12,7,7,10,11,17,2,2,2,2,2,2,1,2,2,1,1
"770",47085589,"Alex Matthias Tamm","7/24/2001 (21 years old)","ST (C)","Kalju","Estonian Premier League","EST","Yes","6/13/2022","12/31/2024","$110K - $325K","Right","Fairly Strong","Very Strong","6'2""","171 lbs","114","35",86,105,3,3,8,11,10,6,12,8,6,4,8,10,6,9,12,11,13,12,10,9,13,10,8,12,8,12,8,8,11,9,12,13,13,11,11,13,9,12,13,12,13,12,11,10,10,7,12,12,10,1,1,2,1,2,1,3,4,2,3,1
"771",47092598,"Mattias Männilaan","9/8/2001 (21 years old)","AM (R), ST (C)","Kuressaare","Estonian Premier League","EST","Yes","6/13/2022","12/31/2024","$35K - $375K","Right","Reasonable","Very Strong","6'2""","169 lbs","132","46",82,105,6,6,8,12,10,8,10,10,13,5,8,10,8,10,12,11,12,10,10,10,12,10,10,11,7,12,8,11,10,9,10,11,14,12,10,12,13,11,12,12,14,12,8,12,11,9,11,13,11,2,1,1,2,3,2,1,3,2,3,2
"772",7681387,"Vitali Teleš","10/17/1983 (39 years old)","GK","Maardu","Estonian Lower Leagues","EST","Yes","1/22/2020","12/31/2023","$500 - $5K","Right","Reasonable","Very Strong","6'0""","178 lbs","456","1",85,105,4,3,2,2,5,9,2,3,3,3,12,1,2,5,10,6,12,6,11,8,5,2,2,2,11,11,13,12,8,5,10,11,10,9,6,11,8,5,12,10,5,13,5,10,6,5,8,8,10,17,10,17,16,13,10,14,15,9,8,13
"773",47044352,"Sören Kaldma","7/3/1996 (26 years old)","DM","ReUnited","Estonian Lower Leagues","EST","Yes","12/31/2020","-","$0","Right","Reasonable","Very Strong","6'1""","165 lbs","192","16",81,104,6,4,3,7,8,6,6,4,1,9,8,6,13,10,14,13,4,8,7,13,9,5,5,9,10,7,5,12,12,9,7,12,13,9,13,11,12,10,10,10,11,12,14,15,7,6,10,10,12,1,3,3,3,3,2,1,2,4,1,2
"774",47075813,"Alex Roosalu","5/4/1999 (24 years old)","D (C), DM","Ulasabat","Estonian Lower Leagues","EST","Yes","12/31/2021","-","$0","Right","Reasonable","Very Strong","6'4""","178 lbs","140","2",68,104,5,4,5,1,7,5,10,6,2,9,7,1,10,5,7,9,4,5,8,12,2,5,13,5,12,5,6,8,11,10,6,11,13,12,13,6,11,18,12,11,11,10,7,2,7,2,8,11,12,4,1,3,2,2,2,2,3,2,3,1
"775",28016389,"Henrik Ojamaa","5/20/1991 (32 years old)","M/AM (RL), ST (C)","Flora","Estonian Premier League","EST","Yes","1/7/2021","12/31/2023","$26K - $75K","Right Only","Weak","Very Strong","5'9""","169 lbs","367","52",95,104,8,10,11,7,11,5,8,8,4,5,11,10,5,11,11,10,13,9,11,8,11,14,11,12,6,8,7,10,12,13,13,8,13,13,13,12,15,8,9,13,9,7,9,11,8,6,7,13,17,3,1,2,2,2,2,1,1,3,3,2
"776",31001377,"Marko Meerits","4/26/1992 (31 years old)","GK","Kalju","Estonian Premier League","EST","Yes","12/31/2019","12/31/2023","$140K - $425K","Right Only","Weak","Very Strong","6'1""","185 lbs","283","-",86,104,4,2,1,3,1,8,1,3,3,1,8,3,1,1,5,10,15,5,9,13,11,3,7,2,11,7,6,10,12,9,12,10,15,12,9,12,11,10,13,13,11,13,8,12,6,7,10,11,12,10,12,11,8,6,12,10,10,8,7,11
"777",47045880,"Pavel Marin","6/14/1995 (27 years old)","AM (RL)","Kalju","Estonian Premier League","EST","Yes","2/1/2021","12/31/2023","$45K - $450K","Right","Reasonable","Very Strong","5'9""","158 lbs","342","81",88,104,10,10,11,9,10,10,8,10,8,7,12,10,9,9,11,10,9,12,10,10,11,14,9,13,6,10,12,10,11,12,10,9,10,11,9,12,13,11,12,13,14,12,10,11,10,9,10,12,10,3,2,1,1,4,3,3,2,3,1,4
"778",47021111,"Nikita Baranov","8/19/1992 (30 years old)","D (RC)","Pyunik","Armenian High League","EST","Yes","8/27/2021","12/31/2024","$4K - $40K","Right Only","Weak","Very Strong","6'1""","176 lbs","300","9",100,104,9,10,6,4,7,5,12,5,12,13,10,3,13,9,14,11,13,9,11,9,13,8,8,8,13,14,9,13,11,9,11,14,13,13,13,13,13,13,11,12,10,11,8,11,16,3,8,15,14,3,3,3,1,2,3,3,2,1,2,2
"779",22029370,"Ivaylo Chochev","2/18/1993 (30 years old)","DM, M (C)","CSKA 1948","Bulgarian First League","BUL","Yes","8/25/2022","6/30/2027","$500K - $5M","Left","Very Strong","Reasonable","6'3""","178 lbs","298","72",130,132,10,11,13,15,13,13,13,12,7,11,14,16,12,13,9,14,7,15,13,14,18,15,12,15,13,16,13,11,12,12,13,15,12,12,12,11,14,20,20,20,19,18,11,16,6,1,17,15,14,4,1,1,2,1,1,2,4,3,1,1
"780",47070164,"Markus Poom","2/27/1999 (24 years old)","DM, M/AM (C)","Shamrock Rovers","Irish Premier Division","EST","Yes","6/15/2020","12/31/2024","$60K - $600K","Left","Very Strong","Reasonable","6'1""","158 lbs","208","27",95,103,12,11,9,8,8,12,8,13,7,6,14,10,10,12,12,10,11,11,10,10,12,11,8,10,9,12,13,12,12,11,12,8,14,12,12,11,13,12,12,12,13,13,8,12,10,10,13,14,10,2,2,1,3,2,2,1,2,1,4,3
"781",47040096,"Robert Kirss","9/3/1994 (28 years old)","AM (L), ST (C)","Sandecja","Polish Second Division","EST","Yes","1/4/2023","6/30/2024","$30K - $325K","Right","Fairly Strong","Very Strong","6'0""","163 lbs","393","111",88,102,4,5,8,12,8,6,12,9,6,4,10,10,6,11,12,13,11,11,12,10,15,10,8,10,7,10,8,9,11,11,12,12,15,11,12,12,13,13,14,14,15,13,7,14,6,7,13,10,9,2,2,2,2,3,3,2,1,2,2,2
"782",47075809,"Mark Anders Lepik","9/10/2000 (22 years old)","AM (L), ST (C)","Flora","Estonian Premier League","EST","Yes","6/15/2020","12/31/2024","$100K - $300K","Left","Very Strong","Reasonable","6'0""","158 lbs","96","35",82,102,8,8,11,9,12,8,8,8,6,4,8,10,6,11,9,10,8,11,9,8,9,13,7,12,3,8,10,9,13,13,12,8,12,12,11,6,13,12,12,13,12,10,10,10,10,9,10,14,10,1,1,3,1,2,3,1,3,2,2,2
"783",47053542,"Tanel Lang","8/15/1995 (27 years old)","DM, M (C)","Tammeka","Estonian Premier League","EST","Yes","2/1/2022","12/31/2023","$0 - $70K","Right","Reasonable","Very Strong","6'0""","176 lbs","277","29",69,102,6,6,5,5,9,6,6,9,4,8,14,1,14,6,13,11,7,6,6,8,17,5,7,7,13,7,9,11,13,12,7,8,13,12,7,7,12,20,11,14,12,10,10,10,7,8,10,12,19,2,1,3,1,2,2,2,2,3,2,3
"784",47049480,"Magnus Karofeld","8/20/1996 (26 years old)","GK","Kuressaare","Estonian Premier League","EST","Yes","1/1/2020","12/31/2024","$18K - $180K","Right Only","Weak","Very Strong","6'2""","185 lbs","218","-",82,102,1,2,3,2,6,4,3,1,1,3,6,2,2,6,8,8,12,7,10,12,11,3,10,4,10,10,4,8,8,13,9,10,12,7,10,9,8,12,13,12,11,13,7,11,8,8,12,9,10,8,7,14,12,8,8,12,3,12,7,12
"785",2000150964,"Robin Kane","5/29/2004 (19 years old)","D (C)","Lazio","Italian Serie A","EST","Yes","8/28/2021","6/30/2024","$18K - $180K","Right","Reasonable","Very Strong","6'2""","180 lbs","40","-",77,102,2,4,3,5,8,1,9,1,2,14,7,2,14,3,14,8,9,6,7,14,13,5,9,5,8,7,3,8,8,11,8,9,14,11,6,10,12,15,12,11,12,10,5,11,11,7,8,12,10,2,2,1,2,1,2,3,1,1,4,3
"786",29164969,"Jordan Zemura","11/14/1999 (23 years old)","D/WB (L)","Bournemouth","English Premier Division","ZIM","No","7/8/2019","6/30/2027","$12.5M - $15M","Left","Very Strong","Weak","5'8""","138 lbs","54","3",127,145,7,11,14,9,11,6,8,6,7,11,12,6,13,12,9,12,9,12,11,11,15,11,8,12,11,14,11,16,15,15,13,7,16,15,16,10,8,14,13,15,10,15,4,10,6,4,14,12,10,3,2,1,4,3,4,3,3,2,3,1
"787",2000217199,"Prince Ndlovu","1/19/2006 (17 years old)","AM (C)","Highlanders FC (ZIM)","Zimbabwean Premier Division","ZIM","No","3/1/2023","-","$0","Right","Reasonable","Very Strong","5'3""","119 lbs","-","-",80,141,8,8,10,8,13,8,9,9,5,8,15,6,9,15,11,11,8,13,8,12,8,13,10,11,7,13,10,10,9,13,9,1,11,10,5,1,13,14,12,11,13,12,6,5,8,2,13,12,14,1,2,2,3,1,2,1,1,2,1,2
"788",65010051,"Khama Billiat","8/19/1990 (32 years old)","AM (RLC), ST (C)","Kaizer Chiefs","South African Premier Soccer League","ZIM","No","7/1/2018","6/30/2024","$8K - $80K","Right Only","Weak","Very Strong","5'7""","147 lbs","278","76",119,140,13,14,12,11,11,11,12,12,6,7,15,14,5,12,6,7,9,10,11,9,12,13,6,14,8,12,15,12,15,10,11,8,11,15,11,10,11,11,12,11,8,9,9,14,6,9,11,15,13,2,2,2,3,3,1,4,3,3,2,1
"789",13104090,"Marvelous Nakamba","1/19/1994 (29 years old)","DM, M (C)","Aston Villa","English Premier Division","ZIM","No","6/15/2020","6/30/2026","$475K - $4.7M","Left","Very Strong","Weak","5'9""","158 lbs","197","4",134,138,8,9,12,7,12,9,10,9,9,13,13,10,15,12,18,14,16,13,13,13,13,12,8,15,14,15,13,16,13,14,16,8,14,13,16,13,11,8,8,14,12,13,7,10,15,14,13,12,7,3,2,2,3,1,1,3,1,1,2,3
"790",91194664,"Lukas Petkov","11/1/2000 (22 years old)","M (C), AM (RLC)","Fürth","Bundesliga 2","BUL","Yes","1/31/2023","6/30/2026","$400K - $4.1M","Right","Fairly Strong","Very Strong","6'0""","167 lbs","85","18",112,132,11,11,14,10,13,11,7,10,6,7,12,11,7,13,12,10,10,11,10,10,13,15,4,12,7,12,12,13,13,14,10,9,13,13,12,8,12,11,12,13,13,15,5,10,6,4,12,13,8,2,4,2,1,2,1,2,2,1,1,2
"791",29032618,"Tendayi Darikwa","12/13/1991 (31 years old)","D/WB (RL)","Wigan","Sky Bet League One","ZIM","No","1/11/2021","6/30/2024","$22K - $230K","Right","Weak","Very Strong","6'2""","171 lbs","316","13",106,136,5,10,10,8,10,6,12,8,7,9,9,11,12,9,13,10,14,8,9,10,14,10,12,10,9,13,8,15,14,12,13,12,10,14,13,12,12,12,11,13,9,10,3,11,14,7,9,13,8,3,1,2,2,4,1,3,4,1,2,2
"792",13167102,"Marshall Munetsi","6/22/1996 (26 years old)","DM, M/AM (C)","Reims","Ligue 1 Uber Eats","ZIM","No","5/20/2022","6/30/2026","$550K - $8.2M","Right","Reasonable","Very Strong","6'2""","182 lbs","178","16",125,135,6,8,12,11,14,8,12,13,8,10,14,10,12,14,12,12,15,13,12,12,13,11,11,12,12,15,12,15,13,12,12,13,14,12,15,15,11,14,13,15,13,15,11,12,10,3,12,11,12,2,2,3,1,3,2,3,1,3,3,3
"793",93070869,"Tino Kadewere","1/5/1996 (27 years old)","AM (RC), ST (C)","OL","Ligue 1 Uber Eats","ZIM","No","1/24/2020","6/30/2024","$1.7M - $3.6M","Right","Weak","Very Strong","6'0""","158 lbs","173","57",124,134,8,11,12,12,13,8,13,10,7,7,12,13,5,13,9,12,12,12,11,11,12,14,8,14,8,12,12,12,15,13,12,12,12,15,14,13,15,9,9,12,10,8,8,12,8,6,9,14,10,4,2,3,2,3,2,2,1,3,2,3
"794",65008768,"Knowledge Musona","6/22/1990 (32 years old)","AM (RLC)","Al-Riyadh","Saudi Professional League","ZIM","No","6/3/2023","6/30/2024","$425K - $4.2M","Right","Reasonable","Very Strong","5'9""","149 lbs","299","83",115,130,12,12,14,13,13,12,8,13,5,8,14,12,6,14,12,11,13,14,12,10,14,14,11,13,6,10,14,10,13,14,12,7,12,12,11,8,14,11,9,10,11,11,5,14,8,6,11,16,8,1,2,2,1,1,3,1,1,3,1,1
"795",65041555,"Junior Zindoga","7/28/1998 (24 years old)","AM (R), ST (C)","Ngezi Platinum","Zimbabwean Premier Division","ZIM","No","3/1/2023","12/31/2023","$2K - $18K","Right","Fairly Strong","Very Strong","6'1""","165 lbs","-","-",82,128,6,10,13,13,13,6,8,8,4,2,13,1,1,13,10,9,7,6,7,8,11,13,8,8,5,7,6,8,13,11,7,11,6,13,13,13,11,17,12,10,13,12,5,7,12,4,17,13,13,2,2,1,2,2,1,3,2,2,1,2
"796",2000182491,"Brighton Ncube","4/19/1999 (24 years old)","ST (C)","Chicken Inn","Zimbabwean Premier Division","ZIM","No","3/1/2023","12/31/2023","$1K - $9K","Right","Reasonable","Very Strong","5'10""","158 lbs","-","-",78,128,6,5,9,13,13,6,8,7,1,6,10,8,2,10,15,12,4,13,6,13,3,10,12,11,5,6,7,9,13,13,13,3,7,13,11,5,10,10,12,9,10,13,9,4,7,5,11,14,18,1,2,2,2,1,2,1,3,2,1,2
"797",28100209,"Admiral Muskwe","8/21/1998 (24 years old)","AM (RL), ST (C)","Luton","English Premier Division","ZIM","No","7/15/2021","6/30/2024","$170K - $500K","Right","Reasonable","Very Strong","6'0""","171 lbs","56","6",103,126,10,12,11,12,11,12,11,8,3,6,10,11,7,11,7,9,8,11,10,9,9,8,5,10,10,12,10,13,13,12,12,10,14,13,12,11,12,10,12,12,9,10,5,10,5,10,10,10,10,1,1,2,1,3,1,2,1,1,3,1
"798",65010095,"Nyasha Mushekwi","8/21/1987 (35 years old)","ST (C)","Zhejiang","Chinese Super League","ZIM","No","1/1/2022","1/31/2024","$24K - $240K","Left","Very Strong","Weak","6'2""","154 lbs","382","179",121,125,6,7,10,13,13,5,16,11,8,6,9,11,5,11,11,12,12,13,11,12,14,11,11,15,9,12,9,13,13,11,14,16,17,13,12,15,11,11,13,13,11,12,7,14,8,7,14,12,15,2,2,3,3,3,1,3,2,3,3,1
"799",2000018055,"Denzel Khumalo","2/11/1998 (25 years old)","M (C)","Chicken Inn","Zimbabwean Premier Division","ZIM","No","2/3/2023","12/31/2023","$2.5K - $24K","Right","Fairly Strong","Very Strong","5'10""","163 lbs","-","-",90,124,5,7,3,6,13,7,7,8,1,9,13,3,9,12,15,9,9,9,7,13,14,8,3,9,11,8,11,12,13,13,8,6,7,13,13,8,13,12,9,11,12,10,5,7,8,1,12,12,17,3,3,2,1,2,1,2,2,3,1,4
"800",91206083,"Jonah Fabisch","8/13/2001 (21 years old)","DM, M/AM (C)","HSV","Bundesliga 2","ZIM","Yes","6/13/2022","6/30/2025","$16K - $150K","Right","Reasonable","Very Strong","5'10""","156 lbs","72","15",99,123,12,9,12,11,12,13,8,12,6,11,12,11,12,12,15,9,12,11,10,9,13,12,13,11,11,11,12,12,11,12,9,8,13,12,12,8,14,9,11,16,14,16,6,11,12,4,14,13,6,1,3,4,2,3,3,1,2,1,3,2
"801",2000271417,"Ilian Antonov","5/22/2005 (18 years old)","AM (RL)","CSKA-Sofia","Bulgarian First League","BUL","Yes","6/13/2022","6/30/2024","$300K - $850K","Right","Weak","Very Strong","5'11""","163 lbs","-","-",73,131,8,10,11,8,6,6,6,5,6,6,9,4,7,10,12,8,4,7,6,7,13,14,8,9,7,7,6,8,13,12,7,5,8,13,13,8,12,14,5,12,10,13,8,2,10,3,17,8,11,1,3,3,3,2,2,4,1,1,3,2
"802",13148160,"Teenage Hadebe","9/17/1995 (27 years old)","D (LC)","Houston","Major League Soccer","ZIM","No","6/22/2021","12/31/2023","$275K - $2.7M","Left Only","Very Strong","Weak","5'11""","163 lbs","118","5",122,122,4,4,11,7,11,5,13,5,6,13,13,5,15,10,16,14,18,14,14,13,12,13,7,7,13,10,12,15,13,11,15,12,16,13,15,13,5,17,11,12,10,8,11,12,14,6,12,12,20,1,1,3,2,2,1,1,3,2,2,3
"803",29103699,"Brendan Galloway","3/17/1996 (27 years old)","D (LC)","Plymouth","Sky Bet Championship","ZIM","No","5/10/2023","6/30/2024","$12K - $110K","Left","Very Strong","Reasonable","6'2""","191 lbs","73","2",101,121,5,10,11,6,11,6,12,6,10,12,12,7,12,12,10,13,12,13,9,10,15,8,9,11,10,10,9,12,12,12,12,12,14,12,13,12,14,12,12,14,12,10,20,11,8,3,11,14,13,1,4,3,1,2,1,1,1,1,2,1
"804",2000182514,"Stanley Murove","11/12/2000 (22 years old)","ST (C)","Herentals (ZIM)","Zimbabwean Premier Division","ZIM","No","3/1/2023","12/31/2023","$0 - $85K","Right","Fairly Strong","Very Strong","5'11""","156 lbs","-","-",70,121,5,3,10,13,12,6,13,7,1,6,7,5,1,8,5,10,3,6,7,11,8,8,7,13,6,6,7,7,10,12,7,9,13,13,4,6,13,18,14,14,12,11,5,11,14,2,20,12,7,1,3,1,1,2,1,1,3,2,2,2
"805",29087400,"Macauley Bonne","10/26/1995 (27 years old)","ST (C)","Charlton","Sky Bet League One","ZIM","No","1/12/2023","6/30/2025","$24K - $240K","Right","Reasonable","Very Strong","5'11""","169 lbs","324","81",102,121,9,8,9,12,11,8,12,9,9,6,8,12,6,10,10,12,14,10,11,10,15,12,9,9,5,14,6,14,12,13,14,12,16,13,15,14,8,8,8,14,11,10,6,2,4,8,8,11,9,1,2,4,1,1,3,3,1,4,3,2
"806",13117517,"Kudakwashe Mahachi","9/29/1993 (29 years old)","M (L), AM (RLC)","SuperSport Utd","South African Premier Soccer League","ZIM","No","7/1/2019","6/30/2024","$0","Left Only","Very Strong","Weak","5'5""","141 lbs","153","20",100,120,10,13,12,8,13,11,6,12,3,6,11,11,6,12,9,8,5,9,8,11,12,15,5,12,7,9,12,11,15,10,12,4,11,14,11,9,13,19,11,11,10,10,8,12,11,1,8,14,19,3,1,2,2,1,2,1,1,3,2,1
"807",65000097,"Onismor Bhasera","1/7/1986 (37 years old)","D/WB/M/AM (L)","SuperSport Utd","South African Premier Soccer League","ZIM","No","6/14/2021","6/30/2024","$2.5K - $7K","Left Only","Very Strong","Weak","5'8""","158 lbs","480","8",95,120,6,7,11,5,10,7,10,6,9,7,8,8,11,11,14,7,11,9,5,5,5,10,5,7,7,9,7,9,14,13,12,7,13,13,13,12,10,13,14,8,9,10,6,11,10,9,8,12,16,1,1,4,1,1,2,1,3,1,1,2
"808",65014125,"Charlton Mashumba","12/12/1992 (30 years old)","M/AM (C)","JDR Stars","South African National First Division Championship","ZIM","No","7/1/2022","6/30/2024","$24K - $70K","Right","Weak","Very Strong","5'10""","160 lbs","184","49",90,120,7,8,13,12,13,7,8,9,1,7,13,6,7,13,11,10,8,10,8,8,14,13,11,11,9,8,8,9,13,13,8,6,12,13,13,6,10,14,13,10,9,10,11,9,10,2,13,11,13,2,1,2,2,1,4,3,1,2,3,4
"809",2000102778,"Washington Navaya","4/29/1998 (25 years old)","ST (C)","Highlanders FC (ZIM)","Zimbabwean Premier Division","ZIM","No","3/1/2023","12/31/2023","$0 - $70K","Right","Reasonable","Very Strong","6'0""","171 lbs","-","-",90,120,7,7,13,11,13,7,13,8,2,4,8,1,4,13,15,12,9,6,6,13,12,13,7,13,6,7,8,8,13,13,8,7,9,13,13,10,11,19,9,11,9,8,11,6,7,1,13,10,12,3,2,1,1,1,2,1,1,3,1,3
"810",13148158,"Donovan Bernard","7/12/1995 (27 years old)","GK","Chicken Inn","Zimbabwean Premier Division","ZIM","No","2/3/2023","12/31/2023","$0 - $110K","Right","Fairly Strong","Very Strong","5'11""","160 lbs","-","-",97,120,5,2,2,2,1,6,1,1,2,2,13,3,1,3,10,9,14,8,11,13,7,3,8,1,12,8,4,7,13,14,8,5,5,10,5,5,11,15,11,11,11,10,12,4,5,2,20,11,19,10,5,12,10,10,7,12,13,9,7,10
"811",29157388,"Andy Rinomhota","4/21/1997 (26 years old)","DM, M (C)","Cardiff","Sky Bet Championship","ZIM","No","7/1/2022","6/30/2025","$50K - $500K","Right","Weak","Very Strong","5'9""","180 lbs","164","3",110,120,9,10,11,10,13,8,9,10,12,14,13,10,13,9,13,12,15,10,12,9,17,8,11,12,13,15,8,16,13,10,10,10,17,12,15,13,14,12,14,15,15,13,12,11,8,8,11,12,16,1,2,2,2,3,3,3,1,1,2,1
"812",22071728,"Martin Minchev","4/22/2001 (22 years old)","M (R), AM (RL), ST (C)","Sparta Prague","Czech First Division","BUL","Yes","6/25/2020","6/30/2024","$0","Right","Fairly Strong","Very Strong","6'1""","178 lbs","128","23",115,131,8,10,14,12,11,10,6,11,2,3,11,13,5,13,11,10,12,13,10,12,14,15,7,12,4,9,12,11,14,13,10,9,11,14,10,9,13,11,13,15,13,12,8,13,8,7,12,15,6,1,1,3,2,1,2,2,1,2,3,1
"813",13148157,"Tatenda Mkuruva","1/4/1996 (27 years old)","GK","Michigan Stars","National Independent Soccer Association","ZIM","No","4/4/2022","11/30/2023","$90K - $275K","Right Only","Weak","Very Strong","5'11""","158 lbs","41","-",100,120,4,1,1,3,6,7,1,1,2,1,7,1,2,6,9,9,12,6,12,14,6,1,12,2,14,9,8,8,13,11,9,8,12,14,8,7,11,16,12,10,10,10,5,1,9,6,20,11,19,6,7,14,10,7,14,11,11,11,11,12
"814",13187139,"King Nasama","12/31/1998 (24 years old)","ST (C)","Hwange","Zimbabwean Premier Division","ZIM","No","3/1/2023","12/31/2023","$1K - $12K","Right","Reasonable","Very Strong","6'1""","163 lbs","-","-",75,119,5,7,5,13,13,4,13,7,4,6,7,5,6,13,13,12,7,6,5,13,12,13,9,9,7,6,4,7,13,10,7,9,15,13,6,6,13,18,12,9,12,10,11,11,12,8,10,10,16,1,3,2,3,3,2,4,3,4,2,2
"815",18006329,"Vusumuzi Nyoni","4/21/1984 (39 years old)","D/WB/M/AM (L)","FC Poperinge","West-Flanders Provincial Division","ZIM","No","7/1/2021","-","$0","Right","Fairly Strong","Very Strong","5'9""","163 lbs","366","34",82,118,9,13,13,6,14,7,5,7,8,7,16,6,5,14,3,13,14,10,7,8,11,11,12,7,7,10,6,12,11,11,6,8,11,11,6,7,14,10,10,8,11,12,15,10,3,6,11,12,13,2,2,1,1,1,4,1,1,2,2,2
"816",2000105141,"Billy Veremu","1/4/1996 (27 years old)","AM (L), ST (C)","Bulawayo Chiefs","Zimbabwean Premier Division","ZIM","No","2/3/2023","12/31/2023","$0","Left","Very Strong","Reasonable","5'11""","152 lbs","-","-",78,117,4,8,12,12,12,5,10,6,3,5,11,1,1,12,13,8,7,6,6,10,8,13,10,11,4,3,7,7,12,12,6,8,11,12,10,6,10,15,10,11,10,13,7,3,14,7,11,9,16,2,3,3,3,3,2,2,2,1,2,1
"817",95059623,"Devine Mhindirira","12/22/2000 (22 years old)","M (C)","Highlanders FC (ZIM)","Zimbabwean Premier Division","ZIM","No","3/1/2023","12/31/2023","$3K - $30K","Right","Fairly Strong","Very Strong","5'10""","156 lbs","-","-",75,116,6,5,6,4,12,6,5,8,4,6,9,1,12,13,6,9,7,7,8,13,6,6,9,3,8,7,10,11,13,13,7,8,6,13,6,5,13,20,10,10,12,13,13,7,10,5,14,11,15,1,1,1,2,3,1,3,3,2,2,3
"818",2000236353,"Calum English-Brown","4/14/2001 (22 years old)","M (C)","Chicken Inn","Zimbabwean Premier Division","ZIM","No","11/24/2022","12/31/2024","$28K - $80K","Right","Fairly Strong","Very Strong","6'0""","160 lbs","-","-",84,116,6,6,7,4,13,5,5,8,4,7,11,3,12,9,5,11,3,10,7,13,4,5,7,12,10,7,12,11,13,12,7,5,11,12,9,5,12,17,9,9,12,11,9,10,13,8,5,11,8,2,2,3,3,1,2,1,1,3,3,2
"819",13169750,"Walter Musona","12/17/1995 (27 years old)","AM (RL)","FC Platinum","Zimbabwean Premier Division","ZIM","No","3/1/2023","12/31/2023","$0 - $110K","Right","Reasonable","Very Strong","5'10""","158 lbs","77","12",94,115,8,11,14,13,11,8,9,7,7,8,14,9,9,9,11,9,3,13,9,14,13,8,4,11,8,9,7,10,10,13,5,6,9,13,14,6,15,17,10,12,12,12,5,12,9,7,10,9,8,1,3,1,3,3,2,2,2,1,3,3
"820",2000168917,"Munashe Pini","4/26/2002 (21 years old)","ST (C)","Chicken Inn","Zimbabwean Premier Division","ZIM","No","2/3/2023","12/31/2023","$30K - $90K","Left","Very Strong","Reasonable","6'0""","160 lbs","-","-",85,115,6,5,13,13,13,6,12,7,4,6,4,7,1,12,9,13,7,8,3,10,9,12,2,13,3,6,5,7,13,13,7,10,17,13,6,6,11,15,14,10,11,10,13,10,8,1,19,12,12,3,1,2,2,2,3,3,2,1,3,3
"821",65032573,"Evans Rusike","6/13/1990 (32 years old)","ST (C)","Swallows","South African Premier Soccer League","ZIM","No","7/1/2022","6/30/2024","$100K - $300K","Right Only","Weak","Very Strong","5'11""","174 lbs","158","28",97,115,9,9,11,11,14,8,14,9,8,6,9,12,6,9,13,10,10,10,10,10,12,11,8,10,5,12,11,12,14,9,8,13,10,13,11,13,9,12,12,12,11,7,8,11,8,8,10,12,11,3,1,4,2,1,3,2,2,2,3,3
"822",13187729,"Terrence Dzvukamanja","5/5/1994 (29 years old)","AM (C), ST (C)","Orlando Pirates","South African Premier Soccer League","ZIM","No","7/1/2020","6/30/2024","$0","Left","Very Strong","Reasonable","5'8""","152 lbs","97","15",108,115,7,9,14,11,9,8,14,8,3,7,8,5,9,11,7,12,9,12,9,14,14,12,3,13,8,9,12,10,14,14,9,2,11,14,13,10,11,12,11,9,10,12,8,7,6,2,13,12,10,3,2,1,4,2,3,1,1,3,3,1
"823",2000255132,"Mihail Polendakov","6/5/2007 (16 years old)","D (C)","Septemvri Sofia","Bulgarian Second League","BUL","Yes","4/30/2023","6/30/2028","$100K - $1M","Right Only","Weak","Very Strong","5'10""","141 lbs","4","-",70,131,5,5,1,7,5,1,12,6,4,13,9,4,11,6,6,12,9,4,10,14,13,5,4,5,14,7,8,9,9,11,8,4,16,14,5,6,14,14,10,14,10,13,6,20,5,5,9,13,8,2,3,3,1,3,3,1,1,3,3,2
"824",2000102983,"Bill Antonio","9/3/2002 (20 years old)","AM (R)","Jong KV Mechelen","Belgian Second Amateur Division VV B","ZIM","No","9/6/2022","6/30/2024","$75K - $750K","Right Only","Weak","Very Strong","5'9""","147 lbs","20","5",92,115,8,8,14,13,14,8,9,9,4,8,13,5,7,12,13,9,4,6,8,12,14,15,7,13,8,9,10,10,14,11,9,5,16,12,10,6,10,10,10,13,9,10,5,4,5,6,13,14,15,3,2,1,2,3,3,2,2,2,2,4
"825",13167158,"Divine Lunga","5/28/1995 (28 years old)","D (L)","Sundowns","South African Premier Soccer League","ZIM","No","7/1/2021","6/30/2024","$0 - $45K","Left","Very Strong","Reasonable","5'9""","152 lbs","110","2",113,115,6,12,9,9,13,3,11,10,9,13,10,8,15,9,6,14,11,10,13,15,10,5,12,10,10,11,6,11,15,15,11,5,13,15,10,8,14,12,12,12,15,11,12,12,7,3,11,9,19,3,4,2,1,4,3,2,2,2,2,3
"826",2000213362,"Oscar Bhebhe","10/5/2002 (20 years old)","DM","FC Platinum","Zimbabwean Premier Division","ZIM","No","3/1/2023","12/31/2023","$0 - $60K","Right","Fairly Strong","Very Strong","6'4""","180 lbs","-","-",78,114,5,5,4,8,13,7,7,8,1,6,10,3,12,14,10,10,8,8,7,13,14,5,6,6,11,8,10,12,14,13,6,12,9,13,7,7,13,15,12,11,13,13,14,6,12,4,12,12,18,2,2,3,3,2,2,4,4,2,1,2
"827",13104096,"George Chigova","4/3/1991 (32 years old)","GK","SuperSport Utd","South African Premier Soccer League","ZIM","No","7/1/2020","6/30/2024","$28K - $275K","Right","Reasonable","Very Strong","6'5""","180 lbs","133","-",105,114,4,3,3,3,3,6,1,2,3,1,13,5,3,8,10,11,15,9,10,11,6,2,5,2,12,9,8,6,11,13,8,13,15,9,4,6,9,17,10,11,8,12,7,9,8,1,12,10,11,8,8,15,12,11,12,14,13,9,9,15
"828",13137480,"Hardlife Zvirekwi","5/5/1987 (36 years old)","D/M (R)","Simba Bhora","Zimbabwean Premier Division","ZIM","No","5/22/2021","12/31/2024","Not for Sale","Right Only","Weak","Very Strong","5'9""","156 lbs","-","-",104,114,9,12,8,8,16,10,11,10,10,12,12,6,13,12,10,12,11,10,9,16,7,9,8,10,10,11,10,12,11,11,11,6,12,11,11,9,16,15,11,10,11,9,12,14,6,3,12,11,13,2,2,3,1,3,1,3,3,3,1,3
"829",2000213356,"Thandolwenkosi Ngwenya","12/19/2002 (20 years old)","M (C)","FC Platinum","Zimbabwean Premier Division","ZIM","No","3/1/2023","12/31/2023","$0 - $110K","Right","Reasonable","Very Strong","5'7""","145 lbs","-","-",82,114,6,6,3,8,14,7,7,9,2,9,11,7,11,12,12,10,5,4,4,13,11,7,10,9,5,7,8,12,14,12,8,7,13,13,8,7,13,17,11,9,9,14,7,7,5,3,4,11,16,3,1,2,2,4,2,3,3,3,2,1
"830",2000180023,"Charles Teguru","8/24/1996 (26 years old)","M (C)","Manica Diamonds FC","Zimbabwean Premier Division","ZIM","No","3/1/2023","12/31/2023","$1K - $8K","Right","Reasonable","Very Strong","6'4""","178 lbs","-","-",95,114,8,6,9,7,14,8,8,10,3,10,14,4,6,13,11,9,7,8,8,14,2,5,5,10,11,9,11,8,14,10,9,14,14,13,11,7,13,10,12,9,14,9,9,1,12,8,9,10,14,2,1,2,3,3,2,1,1,2,1,1
"831",2000213364,"Tatenda Jamu","2/4/2003 (20 years old)","M (C)","FC Platinum","Zimbabwean Premier Division","ZIM","No","3/1/2023","12/31/2023","$0 - $60K","Right","Reasonable","Very Strong","5'9""","154 lbs","-","-",65,113,6,2,7,7,14,6,6,8,3,8,10,4,13,12,10,9,2,8,7,7,3,5,10,4,10,7,11,11,12,10,7,7,9,8,10,5,13,19,9,11,12,10,8,1,9,5,8,12,16,2,1,4,4,3,3,1,2,2,2,3
"832",12012972,"Washington Arubi","8/29/1985 (37 years old)","GK","SuperSport Utd","South African Premier Soccer League","ZIM","No","6/1/2023","6/30/2024","$0 - $28K","Right Only","Weak","Very Strong","5'11""","176 lbs","368","1",106,112,4,1,1,3,5,9,2,2,3,2,11,2,1,10,8,14,11,11,7,7,7,1,15,3,16,11,10,10,8,13,14,14,16,8,8,14,11,12,11,13,12,12,8,6,13,7,8,13,8,12,9,14,9,13,7,8,5,15,14,14
"833",95068494,"Prince Tafiremutsa","3/20/1998 (25 years old)","GK","Dynamos Harare","Zimbabwean Premier Division","ZIM","No","3/1/2023","12/31/2023","$0 - $22K","Right","Reasonable","Very Strong","6'5""","176 lbs","-","-",76,112,3,1,3,3,3,4,1,3,1,2,9,2,1,2,11,8,10,1,10,12,10,2,12,3,9,6,5,5,12,15,6,15,17,11,1,6,10,19,11,11,13,12,7,18,8,2,9,10,9,7,5,12,7,6,12,12,5,7,8,13
"834",64047651,"Yousef Abu Jazar","10/25/1999 (23 years old)","D (R), DM","Ramtha","Jordanian Professional League","JOR","No","6/15/2020","6/30/2025","$6K - $60K","Right","Fairly Strong","Very Strong","5'8""","147 lbs","-","-",85,110,7,10,7,4,9,5,7,9,1,8,11,5,14,8,8,8,8,7,9,12,3,5,4,7,14,8,5,11,14,14,8,4,9,14,7,6,10,10,11,11,12,10,8,10,8,2,10,12,20,3,2,1,4,1,3,3,3,3,4,3
"835",2000087471,"Rosen Marinov","2/2/2005 (18 years old)","D (C)","CSKA-Sofia","Bulgarian First League","BUL","Yes","7/1/2020","6/30/2025","$2.5K - $24K","Left Only","Very Strong","Weak","6'2""","180 lbs","-","-",73,131,6,6,7,7,9,8,11,7,8,10,8,4,11,7,11,10,10,7,9,10,4,7,9,6,10,12,7,10,10,10,11,15,12,12,7,11,11,11,11,10,12,11,9,7,6,5,10,13,12,2,1,2,2,2,1,1,4,3,2,3
"836",2000261579,"Tendai Nyakudya","12/11/1997 (25 years old)","D (C)","Wikki Tourists","Nigerian Second Division","ZIM","No","1/1/2022","6/30/2024","$20K - $200K","Right","Fairly Strong","Very Strong","6'3""","178 lbs","-","-",102,112,4,6,3,2,9,1,9,8,7,13,9,3,14,4,7,14,10,8,7,13,15,5,1,8,12,8,1,8,14,12,9,12,13,13,10,9,15,18,10,11,9,11,5,6,10,7,10,13,8,3,2,2,3,3,3,2,3,3,2,3
"837",2000260998,"Principe Magondo","2/1/2007 (16 years old)","AM (C)","Black Rhinos","Zimbabwean Premier Division","ZIM","No","3/1/2023","12/31/2025","$0 - $40K","Right","Reasonable","Very Strong","5'8""","130 lbs","-","-",70,112,4,5,8,11,12,5,4,9,5,2,12,1,6,12,7,6,8,3,4,12,10,13,9,8,3,5,10,10,12,11,6,2,10,10,12,3,10,17,12,12,12,12,13,10,12,8,8,11,10,3,3,2,2,2,2,3,1,1,2,3
"838",2000226024,"Manners Mangumba","3/28/2001 (22 years old)","GK","Bulawayo City","Zimbabwean Lower Division","ZIM","No","2/3/2022","12/31/2024","$0 - $28K","Right","Reasonable","Very Strong","6'3""","174 lbs","-","-",75,111,3,2,2,3,2,7,1,2,1,3,8,3,1,2,5,9,14,2,11,12,18,1,4,1,9,7,6,5,13,13,7,12,11,11,1,5,9,18,12,11,9,11,12,7,5,4,13,11,19,9,13,13,9,11,10,10,5,7,8,13
"839",95059667,"Vincent Menala","3/26/1998 (25 years old)","GK","Bulawayo City","Zimbabwean Lower Division","ZIM","No","2/3/2022","12/31/2024","$1K - $8K","Right","Reasonable","Very Strong","6'4""","178 lbs","-","-",75,111,2,1,3,2,3,4,1,3,1,3,12,1,3,4,7,11,14,6,10,12,10,1,12,3,7,6,5,5,10,14,6,12,8,10,5,4,11,13,12,12,11,13,15,5,9,3,10,11,8,8,9,12,9,5,10,12,15,7,9,12
"840",95068278,"Blessing Sarupinda","5/4/1999 (24 years old)","DM","CAPS Utd","Zimbabwean Premier Division","ZIM","No","2/3/2023","12/31/2023","$0 - $100K","Right","Weak","Very Strong","6'3""","176 lbs","12","-",91,110,7,5,4,4,13,7,7,9,1,9,7,4,13,12,6,10,9,8,8,13,6,5,8,7,12,8,11,12,13,11,8,15,12,12,13,6,14,17,12,12,10,12,13,17,12,2,11,8,10,3,1,1,2,3,2,2,3,4,2,2
"841",2000018050,"Panashe Mutimbanyoka","2/21/2002 (21 years old)","ST (C)","FC Platinum","Zimbabwean Premier Division","ZIM","No","3/1/2023","12/31/2023","$0 - $120K","Right","Reasonable","Very Strong","6'1""","174 lbs","-","-",100,110,8,4,14,14,13,8,11,9,3,8,9,9,3,8,10,10,9,8,9,10,16,7,8,14,8,8,4,9,14,10,8,11,13,11,10,9,14,19,10,9,12,13,6,2,7,4,11,10,11,1,2,2,1,2,2,4,2,3,2,3
"842",28044702,"Saido Berahino","8/4/1993 (29 years old)","AM (RC), ST (C)","AEL","Cypriot First Division","BDI","No","8/31/2022","5/31/2024","$65K - $650K","Right","Fairly Strong","Very Strong","5'11""","182 lbs","291","60",105,145,14,12,13,12,12,10,8,11,3,6,12,8,5,13,8,12,7,10,8,12,5,12,7,10,5,7,10,7,13,14,15,9,6,12,10,11,9,8,12,2,7,8,8,14,3,19,8,8,12,1,2,4,3,2,2,1,3,1,2,3
"843",70138807,"Youssouf Ndayishimiye","10/27/1998 (24 years old)","D (C), DM","OGC Nice","Ligue 1 Uber Eats","BDI","No","1/25/2023","6/30/2027","$13.5M - $17M","Right","Weak","Very Strong","6'2""","171 lbs","95","9",129,141,8,9,11,6,14,7,12,5,8,12,14,8,13,12,15,12,16,13,14,12,16,8,11,11,13,15,14,16,13,13,16,14,16,11,15,15,14,10,8,13,14,7,5,16,11,5,14,13,16,3,3,2,4,2,1,2,2,1,3,3
"844",13218729,"Bienvenue Kanakimana","12/28/1999 (23 years old)","M (R), AM (RL)","Vyškov","Czech Second Division","BDI","No","2/21/2019","6/30/2024","$250K - $750K","Right","Reasonable","Very Strong","5'9""","152 lbs","82","35",111,128,9,10,12,13,11,7,4,10,6,6,12,6,7,13,7,10,9,11,12,11,3,13,14,12,8,12,9,11,14,12,9,6,12,16,12,7,12,11,11,12,10,13,5,9,8,1,13,11,13,2,2,1,3,3,2,2,3,3,2,2
"845",2000138614,"Trésor Mossi","8/28/2001 (21 years old)","M (C)","Westerlo","Jupiler Pro League","BDI","No","7/1/2021","6/30/2026","$18K - $180K","Right Only","Weak","Very Strong","6'1""","178 lbs","20","-",96,128,8,5,5,9,14,8,1,9,4,10,12,5,13,13,5,11,6,7,10,8,14,5,9,10,11,9,14,13,14,10,14,10,16,12,12,14,18,13,11,11,10,11,10,10,6,4,10,12,12,2,3,2,1,3,1,1,3,1,2,3
"846",2000014837,"Martin Sorakov","10/23/2003 (19 years old)","AM (RL), ST (C)","Krumovgrad","Bulgarian First League","BUL","Yes","6/13/2022","6/30/2024","$500K - $1.5M","Right","Weak","Very Strong","6'0""","154 lbs","54","8",84,130,10,9,11,10,11,11,8,10,8,6,9,12,7,11,12,11,8,10,9,8,15,12,9,12,8,10,9,12,11,12,12,9,12,12,8,9,10,20,8,9,14,13,6,15,8,6,10,9,17,2,3,1,2,2,3,2,2,2,3,2
"847",53170039,"Parfait Bizoza","3/3/1999 (24 years old)","D (C), DM, M (C)","Lyngby","3F Superliga","BDI","Yes","1/31/2023","6/30/2025","$18K - $180K","Right","Reasonable","Very Strong","6'2""","171 lbs","163","26",96,126,6,6,8,6,11,6,12,7,12,11,12,4,12,11,8,11,10,12,11,10,12,12,11,11,9,12,9,11,11,9,10,14,13,11,14,13,11,13,11,10,13,11,14,8,6,8,10,13,17,2,4,2,3,3,2,4,2,3,4,2
"848",13218723,"Jospin Nshimirimana","12/12/2001 (21 years old)","DM, M (C)","Yeni Malatyaspor","-","BDI","No","1/30/2021","6/30/2024","$0","Right","Fairly Strong","Very Strong","5'10""","158 lbs","40","1",90,125,2,5,10,6,11,3,8,10,2,10,11,2,12,12,12,11,11,11,8,8,13,11,7,10,12,12,9,14,12,11,12,12,12,13,13,12,10,17,9,12,11,12,4,2,5,1,12,13,13,3,2,3,1,3,1,3,3,2,3,1
"849",65030078,"Freddy Nsabiyumva","4/26/1995 (28 years old)","D (C)","Västerås SK","Swedish First Division Elite","BDI","No","8/12/2022","12/31/2023","$55K - $550K","Right","Reasonable","Very Strong","6'3""","180 lbs","187","10",105,120,5,5,6,8,7,7,14,7,6,12,9,6,14,6,12,11,13,9,11,11,12,5,14,8,12,12,8,12,11,7,15,15,12,12,12,15,5,11,12,12,12,9,6,12,11,5,13,12,14,3,2,1,1,2,3,1,2,1,4,4
"850",18021200,"Ndabashinze Dugary","10/8/1989 (33 years old)","M (R), AM (RC), ST (C)","FC Galmaarden","Brabant Provincial Division (Fla)","BDI","No","6/14/2021","-","$0","Right","Weak","Very Strong","6'0""","169 lbs","149","13",74,118,6,9,11,7,11,6,7,6,4,4,7,2,2,12,12,8,14,5,8,6,13,12,5,6,4,8,3,6,14,12,12,10,12,11,10,12,11,12,10,6,6,14,18,12,10,8,10,12,7,1,2,3,3,1,3,1,3,3,2,1
"851",13211576,"Jonathan Nahimana","12/12/1999 (23 years old)","GK","Namungo","Tanzanian Mainland Premier Division","BDI","No","8/1/2022","6/30/2025","$0","Right Only","Weak","Very Strong","6'3""","167 lbs","23","-",80,116,2,3,3,1,4,6,1,3,1,1,10,2,2,1,11,8,15,5,9,13,18,1,12,2,12,7,6,6,13,6,7,13,18,11,4,6,12,14,11,11,12,11,7,11,12,7,15,12,17,8,15,13,10,9,7,9,5,6,12,12
"852",13211528,"Bonfils-Caleb Bimenyimana","11/21/1997 (25 years old)","ST (C)","Kaizer Chiefs","South African Premier Soccer League","BDI","No","1/2/2022","6/30/2024","$0 - $90K","Right","Reasonable","Very Strong","6'4""","176 lbs","61","15",95,115,8,7,9,11,8,8,13,5,6,6,6,17,5,11,11,14,9,8,8,12,12,10,14,14,9,8,9,9,14,14,9,11,12,14,7,10,11,18,10,11,10,9,11,5,5,7,11,12,15,1,1,4,3,2,2,1,1,1,3,1
"853",13117783,"Cédric Amissi","3/20/1990 (33 years old)","DM, M/AM (C)","Al-Qadsiah","Saudi First Division League","BDI","No","1/30/2022","6/30/2023","$2.5K - $22K","Right Only","Weak","Very Strong","5'8""","158 lbs","178","26",105,115,9,9,12,12,13,8,7,8,8,6,13,11,6,13,10,12,9,11,13,11,10,12,7,13,6,14,12,11,15,15,8,7,12,15,11,8,10,10,12,13,12,12,8,10,5,8,2,9,15,3,3,1,1,3,1,3,1,3,3,2
"854",37002947,"Saïdi Ntibazonkiza","5/1/1987 (36 years old)","M (R), AM (RL)","Simba","Tanzanian Mainland Premier Division","BDI","Yes","12/22/2022","6/30/2024","$500 - $5K","Right","Reasonable","Very Strong","5'7""","141 lbs","223","57",93,115,9,9,13,9,12,12,6,10,6,3,11,9,7,13,12,11,10,8,7,9,9,15,5,13,4,10,11,8,13,13,11,4,9,13,10,8,15,5,10,7,10,5,11,9,11,10,9,5,10,3,1,1,1,2,2,3,1,3,1,1
"855",13186201,"Enock Sabumukama","12/25/1995 (27 years old)","AM (RL)","Bumamuru Standard","Burundian Premier Division","BDI","No","3/2/2023","6/30/2024","$45K - $140K","Left","Very Strong","Reasonable","5'10""","132 lbs","2","-",85,114,11,12,13,7,12,12,8,12,3,5,12,11,6,12,6,6,8,8,6,14,5,10,1,11,5,8,6,11,12,14,8,8,7,12,9,6,10,18,9,10,13,13,6,14,11,5,14,11,19,2,2,3,2,2,2,1,3,3,1,2
"856",65032405,"Fiston Abdul Razak","9/5/1991 (31 years old)","ST (C)","Sur","Omani Professional League","BDI","No","9/1/2022","6/30/2024","$10K - $35K","Right Only","Weak","Very Strong","5'9""","165 lbs","84","19",95,110,6,9,10,11,12,9,12,10,2,7,10,6,9,12,13,11,12,8,8,9,2,13,11,13,9,8,12,9,14,11,11,8,12,13,13,11,12,14,11,14,11,9,9,11,8,6,8,13,16,2,1,2,3,1,3,3,1,3,3,4
"857",7506723,"Valeri Domovchiyski","10/5/1986 (36 years old)","AM (C), ST (C)","Maritsa","Bulgarian Second League","BUL","Yes","6/14/2021","6/30/2024","$1.5K - $18K","Left","Very Strong","Fairly Strong","5'11""","176 lbs","449","114",102,130,11,13,12,12,14,11,11,11,4,4,12,13,5,13,9,13,10,12,12,10,10,11,13,13,4,10,12,10,11,11,13,9,9,10,8,8,8,12,12,14,12,13,11,11,9,5,14,13,7,1,2,1,1,3,3,4,4,2,1,3
"858",13186129,"Chris Nduwarugira","6/22/1994 (28 years old)","DM, M (C)","Ac. Viseu","Portuguese Second League","BDI","No","7/1/2022","6/30/2024","$90K - $275K","Left","Very Strong","Weak","6'1""","176 lbs","141","2",98,110,6,6,9,7,8,10,12,10,10,11,11,11,12,12,12,10,14,11,12,10,13,10,11,11,11,14,10,14,11,11,13,14,13,11,13,14,8,10,12,13,13,13,8,10,5,6,12,12,13,4,2,2,2,2,2,2,1,3,2,3
"859",12022824,"Karim Nizigiyimana","3/12/1989 (34 years old)","D (RC)","Gasogi","Rwandan Premier Division","BDI","No","8/1/2022","6/30/2024","$0 - $50K","Right Only","Weak","Very Strong","5'8""","147 lbs","124","1",98,108,9,13,10,8,10,9,11,8,9,11,12,5,12,10,10,11,11,13,12,11,2,5,13,7,13,13,11,12,11,10,13,8,11,10,15,11,8,10,10,9,12,10,5,12,11,1,10,11,16,2,3,2,3,3,1,1,1,3,3,2
"860",89056596,"Elvis Kamsoba","7/21/1996 (26 years old)","M (R), AM (RL), ST (C)","Sepahan","Persian Gulf Premier League","BDI","No","7/23/2022","6/30/2025","$170K - $1.7M","Right Only","Weak","Very Strong","5'4""","127 lbs","238","65",108,108,10,8,14,7,11,10,10,7,10,9,8,8,10,8,11,11,13,6,11,5,14,14,11,16,11,13,6,16,15,15,9,5,16,13,14,5,12,19,14,12,10,9,8,15,4,4,12,10,7,3,1,1,3,2,1,3,2,1,2,4
"861",2000190251,"Abedi Bigirimana","1/1/2002 (21 years old)","M/AM (C)","Kiyovu","Rwandan Premier Division","BDI","No","9/1/2020","6/30/2025","$0","Right","Reasonable","Very Strong","5'8""","143 lbs","-","-",80,108,5,3,9,9,14,4,4,6,1,9,10,5,5,13,8,10,8,6,7,14,6,12,5,13,5,13,12,9,13,10,10,7,14,11,7,4,12,19,11,11,11,11,5,13,13,3,20,12,16,2,2,3,3,3,1,3,2,1,3,3
"862",2000284596,"Arthur Nibikora","4/20/2003 (20 years old)","AM (RC), ST (C)","Hatta","UAE Professional League","BDI","No","6/12/2023","5/31/2025","$55K - $550K","Right Only","Weak","Very Strong","5'5""","156 lbs","-","-",80,105,7,9,14,14,14,3,11,8,4,7,14,9,5,13,13,10,8,10,7,9,13,12,3,7,7,8,9,9,13,13,8,1,9,12,5,2,9,10,13,9,11,9,11,2,11,1,10,8,16,1,2,1,1,3,1,1,1,3,3,2
"863",15083740,"Pacifique Niyongabire","3/15/2000 (23 years old)","AM (L), ST (C)","Valour FC","Canadian Premier League","BDI","No","12/19/2022","12/31/2025","$45K - $450K","Right","Reasonable","Very Strong","5'9""","171 lbs","61","8",89,105,9,12,8,15,12,8,13,9,7,3,8,7,8,8,5,11,8,9,8,14,14,14,8,10,4,8,7,10,10,13,8,11,14,15,8,9,13,15,12,12,11,12,10,9,9,6,10,12,19,3,2,2,3,2,3,2,2,4,2,1
"864",2000078807,"Irakoze Donasiyano","2/3/1998 (25 years old)","DM, M (C)","Oakland","USSL Championship Western Conference","BDI","No","2/1/2023","11/30/2023","$12K - $130K","Right","Weak","Very Strong","5'9""","156 lbs","21","-",89,105,7,7,5,11,14,7,7,10,1,9,14,6,14,9,15,7,8,9,6,8,5,5,5,10,10,13,9,13,12,11,11,8,6,12,14,9,12,18,10,11,11,11,7,10,11,4,8,12,10,1,1,1,2,3,3,2,3,3,2,3
"865",13218538,"Sudi Abdallah","1/5/2000 (23 years old)","ST (C)","Kuching","Malaysian Super League","BDI","No","1/12/2023","11/30/2024","$30K - $300K","Right","Fairly Strong","Very Strong","6'1""","165 lbs","31","15",95,105,8,4,12,14,12,8,14,5,3,7,7,10,1,10,10,11,3,10,6,10,3,13,2,14,7,8,7,9,14,14,9,8,16,14,9,8,10,20,11,11,11,10,10,9,6,2,13,10,10,1,1,3,2,2,2,1,2,4,3,4
"866",18110714,"Diamant Ramazani","2/18/1999 (24 years old)","D/WB (R)","Almería B","Spanish Federation Third Group 9","BDI","Yes","6/30/2022","6/30/2023","$0","Right Only","Weak","Very Strong","5'9""","154 lbs","33","-",85,105,10,12,12,5,12,7,10,5,9,10,12,6,6,13,14,11,12,10,10,11,12,12,7,9,8,10,8,10,14,11,8,8,13,14,10,8,9,19,13,8,8,9,10,9,10,5,12,14,10,2,3,1,1,3,3,1,2,4,1,3
"867",13218770,"Jules Ulimwengu","4/21/1999 (24 years old)","ST (C)","Green Eagles","Zambian Premier League","BDI","No","8/1/2022","6/30/2024","$0 - $40K","Right","Reasonable","Very Strong","6'0""","167 lbs","-","-",88,105,6,7,13,13,13,6,12,6,3,4,7,7,1,10,10,13,8,8,7,11,14,10,12,13,5,6,6,7,13,11,7,9,6,13,9,6,11,18,13,9,13,9,10,13,5,4,9,11,20,2,3,1,2,2,1,2,3,1,1,4
"868",22035923,"Todor Nedelev","2/7/1993 (30 years old)","M (C), AM (RC)","Ludogorets","Bulgarian First League","BUL","Yes","2/28/2023","6/30/2026","$75K - $750K","Left","Very Strong","Reasonable","5'9""","154 lbs","276","74",117,130,18,17,14,13,13,15,4,14,6,5,17,14,6,14,7,11,6,10,12,13,12,16,10,12,8,11,18,10,12,12,11,7,10,11,8,7,13,14,14,11,8,20,9,14,3,6,12,11,5,3,3,3,1,3,2,4,2,1,2,2
"869",13102944,"Didier Kavumbagu","5/2/1988 (35 years old)","ST (C)","SV Everbeek","East-Flanders Provincial Division","BDI","No","6/12/2023","-","$0","Right","Reasonable","Very Strong","6'0""","167 lbs","19","4",85,102,7,6,10,14,13,7,13,4,1,6,8,9,1,12,14,8,7,12,8,13,5,11,10,12,7,7,8,8,10,10,8,11,12,9,10,7,13,15,10,12,14,12,12,8,11,6,14,10,16,2,4,1,1,3,3,3,1,2,2,3
"870",13169276,"Steve Nzigamasabo","12/10/1990 (32 years old)","M/AM (C)","KMC","Tanzanian Mainland Premier Division","BDI","No","8/1/2022","6/30/2023","$0","Right","Weak","Very Strong","5'7""","143 lbs","163","14",87,102,11,11,12,9,13,12,6,11,4,6,14,12,7,12,9,12,11,15,10,11,10,11,9,13,8,10,13,10,10,11,10,9,12,10,10,7,11,13,13,12,12,12,6,10,5,4,11,12,12,1,2,3,2,2,3,2,3,3,1,1
"871",2000244704,"Yannick Nkurunziza","6/20/2002 (20 years old)","DM, M (C)","Antalyaspor","Turkish Super League","BDI","No","2/7/2023","6/30/2027","$0","Right Only","Weak","Very Strong","5'11""","182 lbs","-","-",75,101,7,4,11,6,10,7,10,10,4,11,11,7,14,12,14,7,11,9,9,12,11,5,10,6,10,13,7,9,13,12,9,13,12,12,8,8,10,18,12,10,10,10,6,11,12,4,14,13,7,1,2,3,4,1,1,4,2,1,3,4
"872",37076346,"Mohamed Amissi","8/3/2000 (22 years old)","AM (RL)","Leiria","Portuguese Second League","BDI","Yes","1/23/2023","6/30/2025","$0 - $60K","Right","Weak","Very Strong","5'9""","154 lbs","26","-",85,100,6,9,11,9,9,6,7,8,7,5,9,11,6,12,8,11,12,9,9,8,11,11,4,8,5,10,8,11,13,12,9,6,9,14,10,9,11,15,8,7,7,9,3,9,5,8,7,14,9,1,1,1,2,1,1,1,1,1,2,1
"873",13186168,"Gaël Duhayindavyi","4/14/1990 (33 years old)","DM, M (C)","Bumamuru Standard","Burundian Premier Division","BDI","No","1/17/2022","6/30/2024","$0 - $45K","Right Only","Weak","Very Strong","6'0""","167 lbs","-","-",80,100,6,7,7,8,9,7,7,9,1,9,13,3,13,8,11,11,8,9,9,14,16,6,7,8,11,8,10,13,9,10,8,9,11,11,11,9,17,18,12,10,12,13,10,14,5,5,7,12,19,2,1,3,1,3,3,3,2,3,2,3
"874",13132160,"Pierre Kwizera","4/16/1991 (32 years old)","DM, M (C)","Rayon Sports","Rwandan Premier Division","BDI","No","1/28/2022","1/1/2024","$0 - $85K","Left Only","Very Strong","Weak","5'7""","149 lbs","11","-",98,100,8,8,5,7,13,8,8,14,7,9,11,3,14,14,10,12,9,10,10,13,11,5,12,8,11,9,12,11,9,12,9,7,16,11,10,8,15,11,13,9,12,11,13,14,7,4,12,10,13,3,3,1,1,4,3,2,4,3,3,3
"875",13218722,"Shaban Mabano","12/15/1999 (23 years old)","DM, M (C)","Kayanza Utd","Burundian Premier Division","BDI","No","7/1/2020","6/30/2024","$14K - $140K","Right","Reasonable","Very Strong","6'1""","171 lbs","-","-",80,100,5,7,6,8,13,7,7,9,3,7,11,6,12,8,12,7,3,9,5,14,13,5,7,8,9,8,12,13,8,12,8,13,10,11,10,7,13,17,12,12,12,10,5,6,6,2,11,11,11,3,1,2,2,1,3,2,2,2,1,3
"876",2000082030,"Blanchard Ngabonziza","11/25/2001 (21 years old)","D (RC)","Polisi Tanzania","Tanzanian Championship","BDI","No","9/1/2022","6/30/2024","$0","Right","Fairly Strong","Very Strong","6'4""","178 lbs","-","-",72,100,6,11,7,6,8,5,9,7,5,9,9,6,12,3,9,6,9,9,5,14,2,5,8,7,6,8,4,9,12,12,9,16,7,14,11,6,12,13,10,11,10,11,8,7,6,1,17,9,15,2,2,3,4,3,2,3,2,2,2,2
"877",2000082038,"Asman Ndikumana","6/10/1999 (24 years old)","D (L)","Aigle Noir","Burundian Premier Division","BDI","No","7/1/2018","6/30/2024","$18K - $170K","Left","Very Strong","Reasonable","6'1""","165 lbs","-","-",82,100,7,13,8,4,11,2,9,7,6,8,10,5,12,10,14,10,9,7,9,10,4,5,8,5,12,9,7,9,15,13,9,12,12,15,11,6,15,19,9,12,13,13,6,8,10,8,10,12,14,2,1,2,1,1,3,2,3,3,2,3
"878",13211580,"Bienvenue Shaka","12/29/1999 (23 years old)","ST (C)","AFC Leopards","Kenyan Premier Division","BDI","No","7/1/2020","6/30/2025","$0","Right","Reasonable","Very Strong","5'6""","136 lbs","9","1",78,100,7,8,7,14,13,7,14,8,1,6,6,8,1,13,14,10,6,11,5,10,13,12,6,13,6,4,7,8,13,11,3,1,9,10,7,2,9,14,14,13,11,14,5,1,15,5,15,10,19,3,2,3,2,1,2,1,1,1,1,1
"879",22086856,"Velislav Boev","12/19/2003 (19 years old)","D (L)","Spartak Varna","Bulgarian Third League North-East","BUL","Yes","7/1/2019","6/30/2024","$110K - $1.1M","Left","Very Strong","Weak","5'6""","130 lbs","65","2",76,129,10,8,6,8,9,8,6,5,10,6,7,9,11,9,13,9,12,11,10,8,13,5,14,9,12,13,10,12,13,13,6,7,13,12,10,6,10,20,12,12,11,9,15,5,10,1,14,9,14,1,2,3,2,1,3,3,3,1,2,1
"880",18110459,"Jordi Liongola","5/17/2000 (23 years old)","M/AM (RL)","RAAL La Louvière","Belgian First National Amateur Division","BDI","Yes","7/1/2022","6/30/2023","$0 - $1.5K","Right Only","Weak","Very Strong","5'6""","141 lbs","54","7",89,100,9,11,13,13,12,8,8,10,7,9,11,9,8,11,9,8,14,12,8,8,17,13,13,11,4,10,6,7,15,13,6,5,8,15,6,6,10,18,11,11,11,10,8,6,14,2,10,11,20,2,2,2,3,1,2,3,3,2,3,4
"881",8183830,"David Habarugira","8/16/1988 (34 years old)","D (RC), WB (R)","Diest","Belgian Third Amateur Division VV B","BDI","Yes","7/1/2020","6/30/2024","$0","Right Only","Weak","Very Strong","6'1""","185 lbs","171","7",87,99,8,8,8,8,9,8,12,8,7,12,10,7,11,9,10,11,9,11,11,12,14,12,13,8,8,12,8,12,10,10,13,5,6,11,12,13,13,10,14,8,10,11,7,11,10,7,10,12,9,2,4,1,3,3,2,2,2,1,2,2
"882",12012026,"Aimé Ndizeye","2/2/2002 (21 years old)","GK","Aigle Noir","Burundian Premier Division","BDI","No","6/13/2022","6/30/2024","$0 - $80K","Right Only","Very Weak","Very Strong","5'10""","149 lbs","-","-",75,99,1,1,2,3,4,5,1,1,3,2,9,1,2,6,9,10,15,6,13,13,10,3,12,3,7,7,6,6,10,15,7,7,12,10,1,4,10,15,12,8,12,9,13,11,7,4,11,11,15,9,15,13,5,8,11,11,5,6,7,6
"883",13218523,"Pacifique Ndayikeza","6/11/2002 (21 years old)","GK","Vital'ô","Burundian Premier Division","BDI","No","7/1/2018","6/30/2024","$2K - $22K","Left Only","Very Strong","Weak","5'10""","165 lbs","-","-",71,99,5,1,1,1,5,6,1,1,1,3,5,3,3,6,11,8,13,7,11,13,13,3,2,2,7,7,6,6,13,15,7,5,10,10,3,4,10,16,11,9,12,8,6,12,9,4,13,13,17,9,7,9,5,8,10,13,5,7,10,7
"884",13186171,"Shasiri Nahimana","8/5/1993 (29 years old)","M/AM (C)","Bandari FC","Kenyan Premier Division","BDI","No","3/22/2023","6/30/2025","$4.5K - $45K","Right","Fairly Strong","Very Strong","5'5""","127 lbs","13","1",90,98,7,5,9,11,12,7,7,5,3,8,9,3,9,10,5,9,9,7,8,13,15,10,4,9,8,8,13,12,13,13,8,4,10,13,9,1,15,17,13,12,11,9,5,12,6,7,11,11,18,3,2,1,2,2,1,2,2,2,3,1
"885",13186176,"Hussein Shabani","9/26/1990 (32 years old)","AM (RLC), ST (C)","AS Kigali","Rwandan Premier Division","BDI","No","5/31/2020","6/30/2024","$0","Right","Reasonable","Very Strong","5'6""","132 lbs","2","-",91,97,9,9,14,12,8,9,7,9,5,9,13,13,9,13,5,12,5,12,10,15,12,10,9,15,10,10,8,8,9,13,9,7,15,10,13,2,9,16,11,10,9,9,6,6,6,1,11,11,18,1,2,3,3,4,3,1,1,1,1,3
"886",37051320,"Marco Weymans","7/9/1997 (25 years old)","D/WB/M/AM (L)","Beerschot","Belgian Challenger Pro League","BDI","Yes","5/30/2023","6/30/2024","$30K - $300K","Left Only","Very Strong","Weak","5'11""","158 lbs","96","5",96,97,10,11,11,6,11,9,10,10,7,10,11,9,10,11,12,11,10,11,10,10,11,9,8,11,10,11,11,11,13,8,12,10,14,13,11,12,8,7,9,11,10,9,10,8,9,6,10,11,11,2,3,3,4,3,2,1,3,3,1,2
"887",13218764,"Confident Rubugebuge","1/4/2001 (22 years old)","D (RC)","Inter Star","Burundian Premier Division","BDI","No","7/1/2019","6/30/2024","$0","Right","Fairly Strong","Very Strong","5'8""","152 lbs","-","-",51,96,3,10,4,3,7,1,13,3,2,9,6,1,9,6,10,4,8,6,10,13,10,5,9,5,9,4,6,6,13,11,6,6,15,9,6,6,13,20,12,9,10,9,5,15,8,5,13,10,8,1,2,3,1,2,2,4,3,3,1,1
"888",13218718,"Kelvin Bizimana","1/1/2002 (21 years old)","D/WB (R)","Aigle Noir","Burundian Premier Division","BDI","No","7/1/2018","6/30/2025","$0 - $40K","Right","Strong","Very Strong","6'0""","182 lbs","-","-",68,96,5,11,6,1,9,2,5,1,3,8,8,1,11,8,14,5,7,7,8,6,7,5,6,6,8,7,7,7,14,11,7,7,12,14,10,6,13,19,9,12,11,10,9,16,7,1,10,10,17,4,2,1,2,3,1,3,3,2,2,1
"889",13218613,"Abdoul Karim Barandondera","10/17/2003 (19 years old)","D (R)","Flambeau du Centre","Burundian Premier Division","BDI","No","6/13/2022","6/30/2024","$9K - $28K","Right","Reasonable","Very Strong","5'10""","149 lbs","-","-",65,96,5,11,7,4,8,3,6,2,5,7,9,4,13,9,13,7,8,8,8,11,3,5,11,7,7,8,5,8,12,15,8,7,8,15,7,8,11,15,8,11,12,12,10,2,5,6,7,10,17,2,3,1,3,3,1,3,1,2,1,2
"890",22082817,"Petar Georgiev","5/10/2002 (21 years old)","AM (RLC)","Ludogorets","Bulgarian Second League","BUL","Yes","6/13/2022","6/30/2025","$325K - $950K","Left","Very Strong","Weak","5'10""","152 lbs","73","5",76,129,9,9,12,10,11,11,6,10,3,3,12,11,6,12,9,7,7,9,10,9,14,14,8,11,7,11,13,9,10,12,10,8,8,10,10,6,10,18,2,7,12,11,13,9,12,5,10,12,16,2,2,2,2,3,3,1,1,1,2,1
"891",13186210,"Rashid Harerimana","3/14/1994 (29 years old)","D (R)","Bumamuru Standard","Burundian Premier Division","BDI","No","9/14/2021","6/30/2024","$18K - $180K","Right","Reasonable","Very Strong","5'6""","134 lbs","4","-",88,95,5,12,7,2,10,3,8,3,7,10,5,2,14,5,8,6,9,6,8,14,7,5,7,4,7,8,8,9,14,14,8,3,12,14,14,3,15,15,10,8,11,13,11,7,13,7,11,9,16,2,1,3,2,1,3,2,1,4,1,2
"892",2000082062,"Trésor Shaka","12/25/2002 (20 years old)","AM (RL), ST (C)","Vital'ô","Burundian Premier Division","BDI","No","7/1/2020","6/30/2024","$0 - $75K","Right","Reasonable","Very Strong","6'2""","171 lbs","-","-",73,95,7,11,10,11,10,7,9,7,1,5,10,4,4,12,5,10,2,11,3,9,12,11,2,11,7,8,9,9,13,11,8,12,12,12,6,7,11,16,12,12,11,12,13,17,6,5,12,10,15,2,3,1,4,3,2,3,2,1,1,1
"893",13218717,"Hamza Hitimana","2/2/2002 (21 years old)","D (L)","Aigle Noir","Burundian Premier Division","BDI","No","7/1/2018","6/30/2024","$22K - $70K","Left","Very Strong","Fairly Strong","5'10""","167 lbs","-","-",72,95,7,12,7,3,14,2,7,6,7,9,9,5,13,9,15,5,6,7,5,9,17,5,5,7,9,8,8,8,14,14,8,8,13,14,7,7,12,11,10,10,11,10,11,7,8,6,10,11,14,2,2,2,1,2,3,3,1,1,1,3
"894",2000277483,"Aruna Madjaliwa","4/12/2000 (23 years old)","M/AM (C)","Bumamuru Standard","Burundian Premier Division","BDI","No","7/1/2022","6/30/2024","$0","Right","Reasonable","Very Strong","6'1""","169 lbs","-","-",73,95,7,5,9,12,10,7,7,9,4,9,14,3,6,10,11,8,8,8,8,9,4,9,1,9,7,8,8,12,13,10,7,9,12,11,8,6,15,20,13,12,12,11,12,9,9,4,11,12,14,1,1,3,2,2,1,1,4,2,3,3
"895",13201695,"Omar Moussa","8/30/1997 (25 years old)","D (C)","Police FC","Rwandan Premier Division","BDI","No","6/30/2019","6/30/2024","$0","Right","Reasonable","Very Strong","5'10""","158 lbs","64","-",82,95,2,1,5,2,8,1,14,5,5,13,8,5,10,4,15,8,9,8,10,9,12,5,8,4,14,7,3,8,13,13,8,4,13,11,10,9,16,19,9,14,12,8,8,12,6,8,19,10,8,3,2,3,2,2,3,1,1,1,3,3
"896",2000081516,"Akbar Muderi","1/1/2002 (21 years old)","AM (C), ST (C)","Le Messager Ngozi","Burundian Premier Division","BDI","No","7/1/2020","6/30/2024","$0 - $80K","Right","Reasonable","Very Strong","5'9""","158 lbs","-","-",70,95,3,2,11,13,13,6,13,8,4,5,8,3,5,10,14,10,8,7,6,13,6,10,13,9,2,7,6,8,13,11,7,4,13,12,5,4,10,17,13,12,12,9,12,10,10,1,13,12,12,2,3,2,1,2,3,2,2,1,2,1
"897",18091019,"Akram Afif","11/18/1996 (26 years old)","AM (L), ST (C)","Al-Sadd","Qatar Stars League","QAT","No","7/8/2020","5/31/2025","$16.5M - $20M","Right","Weak","Very Strong","5'9""","152 lbs","141","82",130,135,12,13,15,14,14,12,3,12,5,4,13,14,2,15,8,12,13,11,10,10,16,15,8,14,5,8,14,10,16,16,15,8,14,14,13,8,13,12,9,12,12,12,7,11,6,8,12,14,13,1,3,3,1,2,3,2,1,1,3,3
"898",16183022,"Almoez Ali","8/19/1996 (26 years old)","AM (RL), ST (C)","Al-Duhail","Qatar Stars League","QAT","No","6/15/2020","6/30/2025","$13M - $20M","Right","Reasonable","Very Strong","6'0""","152 lbs","150","49",130,135,11,10,14,14,13,6,13,12,8,7,12,13,7,13,10,12,12,11,10,11,15,15,13,14,9,10,12,11,14,13,13,11,14,15,14,12,11,6,11,15,12,12,7,13,9,12,12,15,12,2,4,2,3,1,1,3,2,2,2,2
"899",8829832,"Sebastián Soria","11/8/1983 (39 years old)","ST (C)","Qatar SC","Qatar Stars League","QAT","No","6/23/2021","6/30/2024","$85K - $850K","Right","Weak","Very Strong","6'1""","189 lbs","444","217",105,135,3,6,8,13,12,8,14,7,5,11,9,14,8,11,14,12,15,14,10,11,15,8,14,14,6,15,9,15,11,11,13,11,17,11,11,15,7,12,15,20,12,10,8,15,8,8,10,15,15,1,3,3,3,3,3,2,2,3,4,1
"900",2000041825,"Mohammed Waad","9/18/1999 (23 years old)","D/WB (L), DM, M (C)","Al-Sadd","Qatar Stars League","QAT","No","6/15/2020","6/30/2026","$5.8M - $10.5M","Left","Very Strong","Reasonable","6'0""","154 lbs","48","2",110,125,12,11,10,10,12,10,10,10,12,11,14,12,11,14,10,11,10,11,10,10,12,12,11,10,10,12,11,13,12,12,12,11,14,13,12,12,14,12,12,8,10,8,12,12,10,5,9,13,13,1,2,1,2,1,2,3,2,1,3,1
"901",2000188992,"Kristiyan Boychev","8/10/2005 (17 years old)","AM (C)","CSKA 1948","Bulgarian First League","BUL","Yes","7/1/2022","6/30/2025","$50K - $500K","Right","Reasonable","Very Strong","5'11""","145 lbs","-","-",66,129,5,5,10,9,11,5,5,3,1,5,13,1,2,10,12,6,4,5,4,10,10,8,5,9,6,7,11,12,13,11,6,9,16,12,11,5,12,16,3,9,13,9,13,17,5,4,6,10,16,1,3,2,4,2,2,3,3,1,1,3
"902",23442016,"Bassam Al-Rawi","12/16/1997 (25 years old)","D (RC), WB (R)","Al-Duhail","Qatar Stars League","QAT","No","6/15/2020","6/30/2025","$8.6M - $13M","Right","Reasonable","Very Strong","5'9""","163 lbs","77","5",115,125,8,12,10,9,12,12,13,7,10,13,12,11,13,13,12,13,14,14,11,11,15,10,11,9,12,13,12,13,12,12,12,9,14,13,13,12,9,10,12,12,12,9,13,13,13,11,12,15,13,2,3,3,1,3,2,1,1,2,1,4
"903",23155758,"Abdelkarim Hassan","8/28/1993 (29 years old)","D (LC), WB (L)","Jahra","Kuwaiti Premier League","QAT","No","1/25/2023","6/30/2024","$275K - $2.8M","Left","Very Strong","Weak","6'1""","174 lbs","220","30",115,125,11,11,11,9,9,14,12,14,12,12,11,9,12,11,15,11,14,12,11,11,15,9,11,8,12,12,9,14,12,11,13,12,13,14,14,15,11,10,12,12,12,11,14,11,11,11,12,15,12,1,3,1,4,2,1,1,3,2,4,1
"904",85027981,"Karim Boudiaf","9/16/1990 (32 years old)","DM, M (C)","Al-Duhail","Qatar Stars League","QAT","Yes","6/14/2021","6/30/2025","Not for Sale","Right","Reasonable","Very Strong","6'3""","187 lbs","235","16",120,125,7,10,10,8,12,6,13,11,8,12,13,12,12,13,12,13,13,14,11,12,13,10,11,11,13,16,13,13,11,10,14,15,12,12,14,14,8,13,11,14,12,14,8,12,14,4,14,11,15,1,2,2,1,1,3,4,2,2,2,3
"905",2000047058,"Nayef Al-Hadhrami","6/7/2001 (22 years old)","AM (RC)","Al-Rayyan","Qatar Stars League","QAT","No","7/1/2019","6/30/2026","$5.8M - $8.8M","Right","Fairly Strong","Very Strong","5'11""","163 lbs","39","2",95,125,7,10,13,15,15,9,9,11,1,8,10,4,8,11,10,12,7,7,11,15,10,15,11,14,10,10,11,11,12,11,4,10,6,12,9,8,12,11,12,13,14,9,12,9,10,5,15,10,13,2,1,3,3,2,1,3,1,1,1,2
"906",23117278,"Abdulaziz Hatem","10/28/1990 (32 years old)","DM, M (C)","Al-Rayyan","Qatar Stars League","QAT","No","6/10/2022","5/31/2025","$600K - $11M","Left","Very Strong","Weak","6'0""","154 lbs","283","34",115,125,12,10,11,12,12,13,10,14,12,11,13,11,11,12,12,11,12,13,12,12,5,8,14,11,12,14,12,15,11,12,12,11,12,12,13,12,12,11,10,10,12,9,8,11,12,4,12,10,17,2,1,1,3,1,2,2,2,2,1,2
"907",23458634,"Meshaal Barsham","2/14/1998 (25 years old)","GK","Al-Sadd","Qatar Stars League","QAT","No","6/15/2020","6/30/2025","$6.4M - $9.8M","Right","Weak","Very Strong","5'11""","152 lbs","55","-",115,125,1,2,8,1,10,1,2,3,1,1,10,2,1,9,6,12,14,9,11,12,11,6,9,6,12,14,8,10,9,14,12,12,13,11,12,11,2,14,11,12,10,11,7,14,8,7,11,12,7,13,12,14,6,11,12,12,10,12,12,12
"908",23046562,"Hasan Al-Haydos","12/11/1990 (32 years old)","M (R), AM (RC)","Al-Sadd","Qatar Stars League","QAT","No","10/18/2021","5/31/2025","$4.9M - $7.4M","Right","Weak","Very Strong","5'7""","143 lbs","304","98",120,125,9,12,14,12,14,14,7,11,9,7,13,15,7,14,11,12,11,13,11,12,15,13,15,13,8,12,13,14,13,14,13,7,13,12,13,8,14,13,14,15,12,19,8,12,11,7,12,13,7,3,3,1,3,2,2,1,2,1,4,3
"909",12038077,"Boualem Khoukhi","7/9/1990 (32 years old)","D (C), DM","Al-Sadd","Qatar Stars League","QAT","No","6/14/2021","6/30/2024","$4.7M - $9M","Right","Reasonable","Very Strong","6'1""","165 lbs","244","43",120,125,6,7,8,8,12,12,14,12,6,13,12,8,12,12,12,12,14,13,12,12,14,8,12,9,13,14,10,12,11,11,13,14,12,11,12,14,10,14,13,14,11,12,8,11,8,7,12,12,17,1,3,2,3,2,1,3,3,2,1,2
"910",16170436,"Assim Madibo","10/22/1996 (26 years old)","DM, M (C)","Al-Duhail","Qatar Stars League","QAT","No","6/15/2020","6/30/2025","$9M - $13.5M","Right","Weak","Very Strong","5'6""","158 lbs","74","-",115,125,11,11,10,8,11,11,10,9,13,12,11,7,12,11,14,11,13,12,13,13,15,9,8,10,12,15,12,14,14,13,11,5,12,14,14,11,14,13,13,13,14,14,10,10,12,13,13,14,9,2,1,2,4,2,3,1,1,3,4,2
"911",67245193,"Tarek Salman","12/5/1997 (25 years old)","D (C)","Al-Sadd","Qatar Stars League","QAT","No","1/31/2020","5/31/2024","$2.2M - $4.6M","Right","Weak","Very Strong","5'10""","169 lbs","73","1",110,120,6,8,10,8,12,10,13,6,7,13,11,5,12,12,12,13,15,12,9,11,14,5,11,9,12,13,9,15,12,12,12,10,11,13,14,13,10,10,11,11,11,9,13,12,12,11,12,14,12,2,2,1,2,3,3,3,4,3,3,3
"912",19008134,"Wanderson","1/2/1988 (35 years old)","M (L), AM (RLC)","SPT","Brazilian National Second Division","BUL","Yes","8/1/2022","12/31/2023","$0 - $7K","Right","Reasonable","Very Strong","5'6""","134 lbs","256","65",104,129,12,11,13,13,14,13,8,13,2,3,13,11,7,13,8,10,7,12,11,10,14,13,12,13,5,11,13,11,12,15,14,6,12,11,10,9,13,2,6,11,10,15,10,16,11,16,13,12,12,3,3,1,3,3,3,4,3,2,2,1
"913",23245775,"Mohammed Muntari","12/20/1993 (29 years old)","ST (C)","Al-Duhail","Qatar Stars League","QAT","No","8/30/2020","6/30/2024","$900K - $5.8M","Right","Reasonable","Very Strong","6'4""","169 lbs","131","45",110,120,8,10,10,13,11,8,13,12,10,8,11,14,8,13,9,13,11,12,8,12,9,10,9,11,8,10,11,9,12,12,12,16,12,11,11,13,10,12,13,12,10,12,4,12,6,2,9,11,14,1,1,1,1,3,1,1,1,2,2,2
"914",2000136280,"Ahmed Reyed","2/1/2003 (20 years old)","M/AM (R)","Al-Khor","Qatar League","QAT","No","6/1/2021","6/30/2025","$425K - $4.3M","Right","Reasonable","Very Strong","6'2""","174 lbs","5","-",70,120,5,11,13,9,9,4,6,7,6,6,13,1,7,13,5,5,2,3,6,5,9,13,5,8,4,7,7,8,11,13,7,11,12,13,9,6,10,12,10,12,14,9,9,6,12,6,11,11,15,2,1,2,3,2,2,3,2,1,2,2
"915",23155600,"Pedro Miguel","8/6/1990 (32 years old)","D (RC), WB (R)","Al-Sadd","Qatar Stars League","QAT","Yes","1/14/2020","5/31/2025","$220K - $2.2M","Right Only","Weak","Very Strong","6'2""","154 lbs","223","13",110,120,6,9,10,8,10,10,11,8,12,11,9,12,13,11,14,12,14,9,10,10,14,12,12,10,11,13,9,14,13,12,12,14,17,14,14,14,12,9,11,16,12,10,11,12,12,5,11,12,18,1,4,3,1,1,1,2,2,2,3,3
"916",18111375,"Salah Zakaria","4/24/1999 (24 years old)","GK","Al-Duhail","Qatar Stars League","QAT","No","1/3/2021","6/30/2026","$600K - $5M","Right","Reasonable","Very Strong","6'2""","189 lbs","45","-",110,120,4,1,3,3,5,8,2,2,3,3,9,4,2,9,12,10,13,9,11,11,12,5,10,6,12,14,8,9,11,13,12,12,12,10,11,13,11,11,9,12,12,11,9,12,5,8,11,12,20,11,5,14,10,11,13,12,5,9,12,12
"917",23046614,"Saad Al-Sheeb","2/19/1990 (33 years old)","GK","Al-Sadd","Qatar Stars League","QAT","No","6/14/2021","6/30/2025","Not for Sale","Right Only","Weak","Very Strong","6'1""","176 lbs","195","1",115,120,3,2,1,1,8,7,1,3,3,2,9,1,3,10,6,10,12,12,11,13,10,5,13,5,12,15,9,9,10,13,12,14,13,11,11,12,12,10,11,14,12,18,8,13,14,7,12,9,20,11,10,13,12,11,13,13,8,11,11,14
"918",23439033,"Homam Ahmed","8/25/1999 (23 years old)","D/WB (L)","Al-Gharafa","Qatar Stars League","QAT","No","8/1/2019","6/30/2026","$6M - $11M","Left","Very Strong","Weak","6'1""","156 lbs","64","7",105,120,7,10,11,9,11,5,10,8,12,10,11,8,10,12,10,11,11,13,11,12,12,10,9,11,10,13,11,12,12,12,13,12,14,13,12,12,8,11,9,12,13,10,7,15,14,3,12,15,9,2,3,1,3,2,2,2,1,3,2,3
"919",2000135379,"Mahdi Salem","4/4/2004 (19 years old)","M (C), AM (RC)","Al-Sadd","Qatar Lower Division","QAT","No","7/1/2019","6/30/2027","$0","Right","Reasonable","Very Strong","5'5""","127 lbs","4","-",75,118,7,9,13,8,9,6,7,8,2,4,8,4,5,13,5,4,3,7,7,10,6,13,12,9,7,6,10,11,11,13,8,3,10,13,10,1,8,10,10,11,12,13,5,12,8,6,9,11,20,1,2,3,3,1,3,1,3,1,1,2
"920",2000041000,"Hadi Tabasideh","9/14/2001 (21 years old)","AM (RL)","Al-Sailiya","Qatar League","QAT","No","6/1/2022","6/30/2024","$30K - $300K","Left","Very Strong","Fairly Strong","5'6""","125 lbs","4","-",75,117,8,11,12,10,12,6,6,7,6,5,10,2,7,12,11,10,4,9,2,11,12,12,8,10,6,7,8,8,13,12,5,2,11,13,6,1,17,13,12,13,8,10,6,3,11,8,10,12,10,1,1,1,2,2,2,4,2,3,4,2
"921",2000136789,"Abdelrahman Raafat","9/8/2002 (20 years old)","DM, M (C)","Umm-Salal","Qatar Stars League","QAT","No","7/1/2019","6/30/2026","$2.7M - $5.4M","Right","Fairly Strong","Very Strong","5'7""","149 lbs","32","-",80,116,3,6,5,7,13,7,7,10,1,9,14,1,11,8,12,11,11,9,9,14,12,7,8,4,11,13,8,12,9,9,10,6,10,10,12,8,8,11,9,11,12,14,7,13,12,2,11,12,7,4,2,1,3,2,4,3,1,2,3,2
"922",2000051269,"Jassem Gaber","2/20/2002 (21 years old)","D (C), DM","Al-Arabi","Qatar Stars League","QAT","No","7/1/2019","6/30/2026","$5.2M - $9.6M","Right Only","Weak","Very Strong","6'0""","143 lbs","52","-",95,115,6,8,6,8,7,8,14,8,1,12,8,5,12,7,13,9,12,10,8,14,4,5,10,8,12,13,10,13,11,11,12,11,14,11,6,12,8,15,13,11,14,11,12,1,15,2,20,11,11,2,3,1,3,3,3,2,1,1,2,1
"923",2000272319,"Kristiyan Bachev","1/21/2007 (16 years old)","ST (C)","Pirin Blagoevgrad","Bulgarian First League","BUL","Yes","7/1/2022","6/30/2026","$10K - $100K","Right","Fairly Strong","Very Strong","5'10""","134 lbs","-","-",59,129,4,5,12,12,9,4,12,5,1,4,5,7,3,10,7,6,3,12,4,5,15,11,8,12,2,4,4,5,12,12,5,6,12,12,7,3,9,12,4,12,10,11,13,6,5,7,6,7,17,3,4,4,1,1,2,1,3,3,2,1
"924",23400728,"Ahmed Suhail","2/8/1999 (24 years old)","D (C)","Al-Sadd","Qatar Stars League","QAT","No","6/15/2020","6/30/2026","$210K - $2.1M","Right Only","Weak","Very Strong","6'0""","143 lbs","68","1",100,115,6,7,9,5,11,6,12,5,9,12,10,8,11,10,13,12,12,12,11,12,11,9,7,9,13,13,8,11,11,10,12,11,12,12,12,12,8,10,10,12,11,10,13,11,12,8,18,12,13,2,3,2,2,2,2,4,2,3,3,1
"925",2000045310,"Ali Karami","2/26/1999 (24 years old)","D/WB (R)","Al-Duhail","Qatar Lower Division","QAT","No","1/3/2021","6/30/2027","$0","Right","Reasonable","Very Strong","5'7""","154 lbs","68","2",90,115,6,11,7,5,11,5,10,6,12,8,9,2,9,10,12,10,11,10,9,9,6,5,6,8,9,12,9,12,12,15,9,6,15,14,14,7,11,11,9,10,11,11,9,12,9,6,18,10,14,3,2,1,1,2,3,1,1,3,1,3
"926",85028820,"Amine Lecomte","4/26/1990 (33 years old)","GK","Al-Sailiya","Qatar League","QAT","Yes","7/23/2021","6/30/2025","$0","Right Only","Weak","Very Strong","6'4""","202 lbs","192","-",100,115,4,1,1,1,7,5,1,3,1,1,6,1,3,7,12,11,12,9,11,10,15,5,10,4,10,12,6,7,9,15,14,16,15,10,11,16,1,11,11,13,9,11,5,8,12,12,13,16,16,8,11,13,9,13,6,12,8,8,10,16
"927",1021790,"Magid Mohammed","10/1/1985 (37 years old)","AM (R), ST (C)","Al-Shamal","Qatar Stars League","QAT","No","7/1/2020","6/30/2024","$40K - $375K","Right Only","Weak","Very Strong","5'9""","165 lbs","310","46",90,115,6,7,12,10,12,8,12,8,5,7,8,7,7,12,12,13,10,12,11,14,7,13,8,12,6,11,8,12,13,13,11,7,13,13,13,5,10,15,12,12,13,12,8,14,7,4,12,9,7,1,4,3,3,1,2,3,2,3,1,3
"928",18093608,"Abdullah Al-Ahrak","5/10/1997 (26 years old)","M/AM (C)","Al-Duhail","Qatar Stars League","QAT","No","6/15/2020","6/30/2025","$475K - $4.7M","Right","Weak","Very Strong","5'9""","156 lbs","77","5",105,115,13,12,12,8,14,9,10,11,8,5,14,14,5,14,12,12,13,12,12,12,8,11,8,12,11,11,12,12,13,12,10,8,12,13,10,6,14,13,10,9,12,11,10,12,5,7,14,11,15,1,2,2,3,2,3,2,3,2,1,1
"929",1021806,"Majdi Abdulla Siddiq","9/3/1985 (37 years old)","DM, M (C)","Al-Sailiya","Qatar League","QAT","No","6/14/2021","6/30/2024","$26K - $275K","Right","Weak","Very Strong","5'9""","160 lbs","364","12",95,115,11,11,11,8,11,14,8,12,8,11,11,6,11,12,12,11,13,11,11,11,12,9,14,9,12,14,10,13,10,11,11,8,12,10,12,9,12,13,11,13,12,13,9,12,15,1,11,12,8,1,3,3,2,2,2,1,4,2,4,2
"930",2000136500,"Abdulla Al-Yazidi","3/28/2002 (21 years old)","M/AM (R)","Al-Sadd","Qatar Lower Division","QAT","No","6/1/2019","6/30/2025","$500K - $5M","Right","Reasonable","Very Strong","6'5""","187 lbs","20","-",90,115,7,11,14,10,12,8,6,8,7,8,6,6,6,11,7,10,7,8,9,14,10,13,10,14,8,9,10,12,13,10,9,16,11,14,7,9,14,14,12,10,8,13,11,7,5,5,11,10,11,3,1,4,2,2,1,2,3,2,1,3
"931",23155558,"Luiz Ceará","1/13/1989 (34 years old)","DM, M (C)","Al-Duhail","Qatar Stars League","QAT","No","6/14/2021","6/30/2024","$180K - $1.8M","Right","Reasonable","Very Strong","5'10""","169 lbs","235","10",110,115,8,9,10,8,12,6,9,11,9,12,12,9,13,12,16,12,15,12,11,12,13,9,12,8,12,16,11,15,10,11,12,9,14,11,13,12,8,8,9,16,10,14,8,12,14,6,12,12,17,1,1,2,3,2,3,2,3,3,3,2
"932",2000105542,"Yusuf Abdurisag","8/6/1999 (23 years old)","AM (RL), ST (C)","Al-Sadd","Qatar Stars League","QAT","No","6/15/2020","6/30/2026","$325K - $3.2M","Right","Weak","Very Strong","5'9""","163 lbs","71","9",100,115,8,11,13,12,12,10,9,11,9,9,9,11,8,13,12,10,9,8,9,10,12,13,8,12,7,9,10,12,12,12,12,8,14,13,12,9,12,16,12,14,14,10,8,12,12,5,11,10,8,3,2,2,2,1,2,3,1,1,1,2
"933",23400751,"Yousef Ayman Hafez","3/21/1999 (24 years old)","D (C)","Al-Duhail","Qatar Stars League","QAT","No","6/15/2020","6/30/2026","$325K - $3.2M","Right","Weak","Very Strong","6'2""","187 lbs","53","3",105,115,6,7,8,7,10,8,14,7,9,12,11,4,12,11,15,11,15,11,11,11,14,7,11,8,13,14,9,12,10,8,13,14,13,11,12,14,6,9,10,13,9,9,8,13,14,5,12,12,14,1,3,2,2,2,1,2,3,3,3,2
"934",2000085592,"Asen Mitkov","2/17/2005 (18 years old)","M/AM (C)","Levski","Bulgarian First League","BUL","Yes","7/1/2020","6/30/2025","$350K - $3.6M","Right","Reasonable","Very Strong","6'0""","147 lbs","23","-",101,129,13,12,13,10,11,13,9,11,8,7,13,10,9,13,9,12,8,11,10,11,13,14,12,12,10,13,13,11,11,12,13,7,12,11,10,6,13,16,4,11,13,10,9,14,6,7,12,11,8,2,3,2,3,1,2,4,1,2,3,2
"935",2000040177,"Mohamed Ayash","2/27/2001 (22 years old)","D (C)","Al-Duhail","Qatar Lower Division","QAT","No","5/31/2023","6/30/2025","$450K - $1.3M","Right","Weak","Very Strong","5'11""","169 lbs","33","2",85,115,1,4,1,6,9,1,14,3,3,14,6,5,14,7,6,10,8,4,10,14,14,5,8,7,13,7,2,8,13,11,8,9,12,12,5,11,13,11,9,13,11,12,8,10,6,1,20,14,12,3,3,3,2,2,1,3,1,3,2,1
"936",23359977,"Yousef Hassan","5/24/1996 (27 years old)","GK","Al-Gharafa","Qatar Stars League","QAT","No","6/15/2020","6/30/2024","$2.5M - $5.2M","Right","Weak","Very Strong","6'1""","171 lbs","102","-",105,115,4,2,1,3,5,6,2,3,3,3,9,2,1,9,12,11,12,11,11,12,13,5,8,5,12,13,10,10,10,12,10,12,12,10,10,10,12,11,9,11,13,10,10,7,5,3,11,12,14,12,12,13,5,11,11,12,8,14,11,11
"937",2000181543,"Osamah Al-Tairi","6/16/2002 (20 years old)","M (C), AM (RLC)","Al-Rayyan","Qatar Stars League","QAT","No","2/6/2022","6/30/2026","$750K - $5.4M","Right","Fairly Strong","Very Strong","5'8""","136 lbs","17","2",95,115,8,10,14,13,13,8,3,10,3,8,14,2,8,12,11,8,11,8,9,13,11,15,5,10,3,12,10,12,12,12,4,7,13,12,12,6,11,11,13,11,10,12,12,3,5,8,16,8,9,2,2,1,2,2,1,3,1,2,3,4
"938",2000136038,"Lotfi Madjer","5/1/2002 (21 years old)","AM (RL), ST (C)","Al-Duhail","Qatar Lower Division","QAT","No","7/1/2019","6/30/2025","$550K - $5.6M","Right","Fairly Strong","Very Strong","6'1""","165 lbs","18","-",80,114,5,8,10,9,13,6,7,7,4,6,10,3,1,13,12,10,3,10,7,6,3,13,6,11,5,7,8,8,13,13,7,8,13,13,6,6,13,10,13,8,13,11,8,10,8,7,12,11,15,2,2,3,2,3,2,1,3,1,3,3
"939",2000136523,"Mohammed Al-Mannai","10/30/2003 (19 years old)","D (C)","Al-Markhiya","Qatar Stars League","QAT","No","1/30/2023","6/30/2026","$220K - $2.2M","Right","Reasonable","Very Strong","6'4""","187 lbs","7","-",75,114,1,5,5,3,6,1,14,2,4,14,8,3,14,6,7,6,9,8,7,14,16,5,1,5,9,7,1,8,12,10,8,12,7,8,10,8,11,14,13,12,10,12,8,18,5,7,10,11,19,3,4,2,3,3,2,2,1,3,1,3
"940",23181497,"Ahmed Fathi","4/2/1991 (32 years old)","DM, M (C)","Al-Arabi","Qatar Stars League","QAT","No","6/14/2021","6/30/2025","Not for Sale","Right","Reasonable","Very Strong","5'7""","154 lbs","191","2",105,110,6,7,8,8,11,5,9,8,9,12,12,5,13,11,15,12,15,12,12,12,13,8,14,9,13,16,10,15,10,9,11,7,12,11,14,11,7,9,10,13,10,17,8,12,13,2,12,12,11,2,3,2,3,2,2,3,1,1,3,3
"941",2000136501,"Mostafa Tarek","3/28/2001 (22 years old)","DM, M/AM (C)","Al-Sadd","Qatar Lower Division","QAT","No","6/15/2020","6/30/2025","$2.4M - $4.9M","Left","Very Strong","Reasonable","5'9""","154 lbs","15","2",90,110,8,6,8,11,12,8,8,10,7,10,13,4,10,12,5,11,9,12,10,14,13,15,8,10,7,9,13,6,11,11,12,8,10,9,10,10,8,11,12,13,10,11,14,15,9,4,12,13,20,3,3,2,3,3,4,1,4,2,3,2
"942",2000136300,"Tameem Mansour","10/5/2002 (20 years old)","AM (RL)","Al-Rayyan","Qatar Stars League","QAT","No","7/1/2019","6/30/2026","$220K - $6.8M","Right","Reasonable","Very Strong","6'1""","169 lbs","28","2",95,110,9,10,11,13,10,6,10,8,8,6,11,8,6,12,10,10,10,9,9,9,11,11,8,10,8,11,10,13,12,11,10,12,14,12,12,8,13,17,13,12,13,9,7,7,10,7,10,11,12,1,3,2,1,1,3,2,1,3,2,3
"943",23181485,"Ahmed Yasser","5/17/1994 (29 years old)","D (C)","Al-Rayyan","Qatar Stars League","QAT","No","8/31/2021","5/31/2024","$3.7M - $7.2M","Left","Very Strong","Weak","5'11""","154 lbs","92","4",105,110,4,3,6,3,10,1,11,7,1,15,7,3,15,8,12,10,12,12,10,15,17,6,8,9,12,12,6,10,10,9,10,11,16,10,11,12,15,15,9,10,9,10,13,14,5,7,14,11,15,1,2,2,1,2,1,2,2,1,3,3
"944",23414121,"Abdul Rahman Fahmi Moustafa","4/5/1997 (26 years old)","AM (RL)","Al-Duhail","Qatar Lower Division","QAT","No","6/15/2020","6/30/2025","$750K - $1.6M","Left","Very Strong","Weak","5'6""","132 lbs","84","12",90,110,11,16,12,11,11,10,10,6,10,6,11,10,5,12,13,11,2,9,8,9,7,12,9,15,7,10,12,10,13,13,10,6,11,12,11,6,13,12,11,8,12,11,9,9,14,2,9,8,14,3,1,1,2,1,3,3,3,3,3,2
"945",2000193422,"Baker Kalbouneh","3/7/2004 (19 years old)","ST (C)","Jazeera","Jordanian First Division","JOR","No","1/1/2021","6/30/2024","$12K - $120K","Right","Fairly Strong","Very Strong","5'10""","156 lbs","-","-",70,110,3,5,13,13,10,5,12,6,1,5,3,6,1,6,5,7,5,13,7,11,10,8,7,13,7,6,3,7,8,13,7,3,15,12,7,7,12,16,12,13,12,12,7,9,6,2,11,11,9,3,1,3,2,3,2,3,2,3,1,1
"946",7506541,"Tsvetan Genkov","2/8/1984 (39 years old)","ST (C)","Kostinbrod","Bulgarian Third League South-West","BUL","Yes","6/14/2021","-","$0","Right Only","Weak","Very Strong","6'1""","167 lbs","377","148",70,128,5,9,12,12,12,9,15,11,5,5,12,12,6,12,8,10,13,13,10,11,10,10,10,12,8,12,9,10,5,4,12,14,14,7,6,13,10,8,8,11,12,11,11,12,13,15,8,10,5,2,2,3,1,4,1,3,2,1,1,1
"947",18093600,"Fahad Al-Abdulrahman","4/6/1995 (28 years old)","D/WB (L)","Al-Arabi","Qatar Stars League","QAT","No","1/1/2019","6/30/2024","$85K - $850K","Right","Fairly Strong","Very Strong","5'5""","132 lbs","107","-",90,110,11,12,13,7,11,8,4,8,8,11,9,5,13,11,18,11,14,11,12,10,12,13,10,8,10,12,7,12,13,12,5,5,10,12,11,6,9,10,15,10,9,15,10,11,18,4,11,14,10,1,1,2,1,1,1,2,1,3,1,4
"948",2000101880,"Aleks Bozhev","7/19/2005 (17 years old)","GK","CSKA-Sofia","Bulgarian First League","BUL","Yes","6/13/2022","6/30/2025","$0 - $70K","Right","Reasonable","Very Strong","6'2""","167 lbs","-","-",79,128,5,1,3,3,11,7,9,3,1,3,11,3,2,11,5,9,13,8,9,8,13,7,11,2,9,11,11,11,9,12,10,14,13,8,8,10,10,11,3,10,10,13,11,6,10,7,8,12,17,11,13,12,14,11,14,9,5,10,9,12
"949",22017457,"Borislav Tsonev","4/29/1995 (28 years old)","M/AM (C)","DL Pro","Chinese Super League","BUL","Yes","12/1/2022","12/31/2023","$550K - $1.6M","Right","Strong","Very Strong","5'9""","149 lbs","213","45",110,128,13,12,13,13,13,15,8,13,4,7,13,13,8,13,12,11,11,12,10,11,16,15,10,13,7,11,13,12,11,14,12,7,11,9,10,7,16,9,10,15,14,14,10,13,13,5,12,15,13,1,1,4,3,3,3,3,2,3,1,3
"950",22071545,"Ivan Dyulgerov","7/15/1999 (23 years old)","GK","Cherno More","Bulgarian First League","BUL","Yes","11/28/2021","6/30/2024","$650K - $1.4M","Right Only","Weak","Very Strong","6'3""","200 lbs","88","-",110,128,1,1,3,3,7,1,9,2,2,1,9,3,1,4,9,13,14,10,12,10,14,5,11,7,13,14,8,11,12,12,11,16,14,11,12,15,1,11,11,12,10,13,8,14,8,5,13,12,16,13,14,13,13,13,11,12,7,9,10,13
"951",22033474,"Anton Nedyalkov","4/30/1993 (30 years old)","D (LC)","Ludogorets","Bulgarian First League","BUL","Yes","7/25/2022","6/30/2024","$425K - $4.3M","Right","Fairly Strong","Very Strong","6'0""","160 lbs","274","2",125,128,7,11,9,7,11,9,11,8,13,12,11,8,13,11,9,12,11,11,14,10,18,8,15,12,13,17,10,15,14,11,12,13,17,15,14,12,16,9,9,17,14,11,11,18,7,3,15,15,12,2,4,2,3,1,1,1,2,1,3,1
"952",22068303,"Dimitar Kostadinov","8/14/1999 (23 years old)","AM (C), ST (C)","Levski","Bulgarian First League","BUL","Yes","9/2/2021","6/30/2025","$30K - $300K","Right","Fairly Strong","Very Strong","5'10""","169 lbs","99","19",105,128,11,10,12,13,12,12,11,13,5,7,12,13,10,12,11,13,10,13,9,10,13,14,9,13,8,10,11,11,12,12,13,9,12,13,9,10,13,10,10,9,11,9,9,14,8,17,10,13,9,2,2,1,2,3,2,4,1,1,2,2
"953",91187556,"Leandro Barreiro","1/3/2000 (23 years old)","DM, M (C)","Mainz 05","Bundesliga","LUX","Yes","5/27/2021","6/30/2024","$28M - $43M","Right","Fairly Strong","Very Strong","5'9""","143 lbs","124","10",132,148,11,8,11,8,12,8,10,8,6,12,12,6,16,12,16,14,17,12,13,12,17,10,12,12,13,16,11,18,12,13,14,8,17,13,16,11,10,10,11,16,15,17,5,13,12,7,13,16,13,3,1,2,1,2,3,3,2,2,2,2
"954",2000124674,"Yvandro Borges Sanches","5/24/2004 (19 years old)","M/AM (RL)","Borussia M'gladbach","Bundesliga","LUX","Yes","6/1/2022","6/30/2025","$350K - $9.2M","Right","Weak","Very Strong","5'9""","149 lbs","17","2",103,147,12,9,14,11,12,8,4,8,2,4,12,8,6,14,4,9,9,9,8,9,14,16,2,11,5,10,12,10,15,15,8,6,13,15,10,5,12,17,16,14,13,12,8,12,1,6,12,15,16,1,1,3,2,3,3,1,3,3,2,3
"955",18083446,"Christopher Martins Pereira","2/19/1997 (26 years old)","DM, M (C)","Spartak Moscow","Russian Premier League","LUX","Yes","6/3/2022","6/30/2026","$5.2M - $8M","Right","Fairly Strong","Very Strong","6'2""","176 lbs","125","10",128,138,8,7,12,8,13,8,12,11,5,13,13,9,14,13,13,13,13,12,13,12,12,10,8,11,12,14,11,15,12,12,14,14,16,13,16,14,13,18,9,13,15,11,13,11,13,2,12,14,14,1,1,3,1,3,3,2,3,3,2,3
"956",91193053,"Mathias Olesen","3/21/2001 (22 years old)","DM, M (C)","1. FC Köln","Bundesliga","LUX","Yes","2/4/2022","6/30/2025","$3.1M - $6.2M","Right","Reasonable","Very Strong","5'11""","176 lbs","73","4",116,136,7,8,12,8,11,7,12,9,8,12,11,7,12,11,11,12,11,11,12,12,16,9,11,10,12,16,13,15,11,11,12,11,13,13,17,14,16,15,16,18,14,16,7,10,7,7,12,14,17,2,1,2,2,3,1,1,2,3,3,4
"957",22086329,"Marin Petkov","10/2/2003 (19 years old)","AM (RLC), ST (C)","Levski","Bulgarian First League","BUL","Yes","11/18/2021","6/30/2024","$2.7M - $5.6M","Left","Very Strong","Reasonable","5'10""","152 lbs","81","10",110,148,13,11,12,13,12,13,8,12,6,6,13,14,9,13,9,10,8,11,9,9,13,14,7,13,8,13,13,12,11,12,12,8,12,13,10,7,14,16,12,14,13,14,9,13,7,1,13,13,13,3,3,1,1,1,1,3,2,2,3,3
"958",2000065873,"Timothé Rupil","6/12/2003 (20 years old)","DM, M/AM (C)","Mainz 05","Bundesliga","LUX","Yes","1/4/2023","6/30/2024","$1.3M - $2.7M","Right Only","Weak","Very Strong","5'7""","132 lbs","35","4",90,128,13,10,13,10,12,15,7,12,4,10,13,12,11,13,12,9,10,11,9,9,12,12,7,10,10,11,12,9,12,12,9,9,13,11,12,8,15,11,11,13,12,13,6,14,6,4,13,14,13,2,1,2,2,2,1,2,1,3,1,1
"959",29198448,"Danel Sinani","4/5/1997 (26 years old)","M (R), AM (RLC)","Norwich","Sky Bet Championship","LUX","Yes","7/1/2020","6/30/2026","$65K - $650K","Left","Very Strong","Reasonable","6'1""","154 lbs","209","54",112,128,14,12,13,11,13,14,6,12,6,6,13,13,7,14,11,12,8,12,9,11,12,13,11,11,6,11,13,10,13,13,12,10,12,13,11,10,12,13,12,14,12,13,4,12,5,5,10,12,12,1,3,2,3,3,2,3,2,3,1,3
"960",37072372,"Gerson Rodrigues","6/20/1995 (27 years old)","AM (RL), ST (C)","Dynamo Kyiv","Ukrainian Premier League","LUX","Yes","6/15/2020","6/30/2024","$450K - $4.4M","Right Only","Weak","Very Strong","6'3""","180 lbs","200","51",120,127,11,12,15,10,13,11,10,10,8,5,10,13,6,14,8,13,10,13,7,12,16,13,7,11,5,7,9,11,14,12,14,12,13,15,12,11,11,12,7,7,12,10,8,2,13,15,9,15,14,2,2,3,3,1,4,3,1,4,2,1
"961",2000130234,"Kevin Cardoso","4/5/2002 (21 years old)","ST (C)","Jeunesse Esch","Luxembourg National Division","LUX","Yes","7/1/2021","6/30/2023","$0","Left","Very Strong","Reasonable","5'9""","149 lbs","1","-",65,126,4,2,12,12,11,4,12,5,1,2,4,6,3,8,5,10,6,11,3,9,16,9,13,12,5,4,5,5,12,12,5,7,7,12,8,4,10,14,9,12,13,14,7,12,5,3,9,12,8,3,3,2,2,1,2,2,3,1,1,3
"962",91203207,"Seid Korać","10/20/2001 (21 years old)","D (RC)","Degerfors IF","Swedish Premier Division","LUX","Yes","1/26/2023","12/31/2025","$70K - $700K","Right","Weak","Very Strong","6'3""","171 lbs","43","1",100,126,4,5,5,5,9,6,13,5,6,13,10,4,13,9,14,11,14,8,12,11,14,4,10,4,12,11,7,13,8,8,11,16,12,13,13,13,15,8,10,12,12,10,13,15,13,7,12,12,12,3,1,2,2,1,1,3,2,3,2,1
"963",29198453,"Olivier Thill","12/17/1996 (26 years old)","DM, M/AM (C)","Eyüpspor","Turkish 1. League","LUX","Yes","8/15/2022","6/30/2024","$375K - $1.1M","Right","Reasonable","Very Strong","5'9""","167 lbs","220","40",105,125,14,12,12,8,12,14,6,12,4,6,12,12,7,14,8,12,8,12,8,12,12,12,8,12,8,14,14,12,12,13,11,7,12,11,12,9,10,14,12,13,8,10,13,12,6,6,12,12,14,2,1,1,1,1,1,3,2,2,2,2
"964",85003588,"Maxime Chanot","11/21/1989 (33 years old)","D (RC)","NYCFC","Major League Soccer","LUX","Yes","6/14/2021","12/31/2024","$0","Right","Weak","Very Strong","6'1""","174 lbs","320","12",114,124,8,8,8,7,11,6,15,7,8,14,12,7,13,11,14,11,15,15,14,12,15,10,14,9,12,13,9,12,9,11,14,12,15,11,11,14,10,13,13,14,12,9,8,13,12,7,12,14,10,1,1,4,1,1,1,1,1,1,2,1
"965",8189704,"Anthony Moris","4/29/1990 (33 years old)","GK","Union SG","Jupiler Pro League","LUX","Yes","8/25/2022","6/30/2026","Not for Sale","Left","Very Strong","Weak","6'1""","176 lbs","189","-",121,124,4,3,2,2,14,7,11,3,2,1,14,12,3,11,9,10,12,11,12,12,14,14,6,8,10,12,8,12,14,14,14,12,14,13,14,10,12,14,12,14,14,13,11,1,9,7,15,14,20,11,12,15,12,13,14,13,10,10,11,11
"966",48036161,"Vincent Thill","2/4/2000 (23 years old)","M (RC), AM (RLC)","Vorskla","Ukrainian Premier League","LUX","Yes","8/27/2021","6/30/2026","$0","Left","Very Strong","Fairly Strong","5'7""","138 lbs","93","16",111,122,12,12,13,10,13,13,5,12,7,6,12,8,7,13,14,9,6,13,11,11,12,14,5,10,8,12,12,12,13,12,11,5,13,13,12,9,12,12,10,12,12,3,7,12,13,6,12,12,9,3,4,1,3,3,3,2,1,2,2,1
"967",53004236,"Lars Gerson","2/5/1990 (33 years old)","D (C), DM, M (C)","Kongsvinger","Norwegian First Division","LUX","Yes","1/7/2022","12/31/2024","Not for Sale","Right Only","Weak","Very Strong","6'1""","167 lbs","296","30",105,122,12,10,9,8,9,12,11,11,9,10,11,13,11,10,12,13,12,12,12,13,12,7,13,10,11,13,12,13,11,8,10,12,14,11,12,12,18,14,14,15,13,10,14,12,9,6,12,12,12,1,2,2,3,3,3,1,2,3,1,4
"968",22073681,"Filip Krastev","10/15/2001 (21 years old)","M/AM (C)","Lommel SK","Belgian Challenger Pro League","BUL","Yes","6/12/2023","6/30/2027","$1.7M - $3.5M","Right","Reasonable","Very Strong","5'10""","149 lbs","94","15",118,148,15,14,13,11,13,14,6,11,6,8,14,13,11,13,8,11,12,12,8,10,13,15,10,12,10,14,13,13,13,14,13,8,13,12,13,7,13,17,17,17,17,13,7,15,7,1,11,16,9,3,3,3,3,1,1,2,1,3,1,1
"969",2000189121,"Tiago Pereira Cardoso","4/7/2006 (17 years old)","GK","Borussia M'gladbach","Bundesliga","LUX","Yes","7/1/2022","6/30/2025","$500K - $1.5M","Right Only","Weak","Very Strong","6'3""","178 lbs","-","-",86,121,3,3,2,3,8,6,5,3,1,1,9,2,2,8,7,8,11,8,9,8,15,4,8,1,12,10,8,10,8,12,11,16,13,8,8,10,10,13,13,13,12,10,4,10,4,4,12,12,15,9,12,12,10,12,11,11,8,11,11,12
"970",18076414,"Laurent Jans","8/5/1992 (30 years old)","D/WB (R)","SV Waldhof","3. Liga","LUX","Yes","8/19/2022","6/30/2024","$50K - $475K","Right Only","Weak","Very Strong","5'10""","167 lbs","285","3",110,120,11,12,8,8,8,8,8,7,12,12,9,8,12,9,14,13,13,14,13,14,12,10,10,10,12,14,11,14,12,10,11,8,12,13,13,12,13,20,13,14,10,14,10,10,12,5,14,14,16,3,3,4,1,1,2,3,4,3,3,2
"971",95064782,"Alexandre Sacras","12/14/2000 (22 years old)","D/WB (L)","Progrès","Luxembourg National Division","LUX","Yes","7/1/2022","6/30/2024","$12K - $130K","Left","Very Strong","Weak","5'7""","147 lbs","90","1",100,118,8,12,6,9,11,3,9,8,7,14,10,8,15,10,9,7,11,9,10,15,17,5,14,9,10,10,10,11,15,11,11,4,7,14,7,7,13,17,11,13,14,13,12,13,14,1,15,11,20,1,1,2,2,3,1,1,1,1,3,1
"972",2000107927,"Aiman Dardari","3/21/2005 (18 years old)","M (C), AM (RLC)","Mainz 05","Bundesliga","LUX","Yes","7/1/2021","6/30/2024","$24K - $240K","Right","Weak","Very Strong","5'10""","154 lbs","-","-",77,118,7,8,13,11,12,7,7,10,2,7,12,8,7,13,7,8,7,8,8,7,11,13,3,10,7,9,12,9,12,12,7,7,12,12,10,7,12,15,15,12,11,7,6,13,3,8,12,11,13,3,2,1,2,2,2,3,3,3,1,2
"973",2000055469,"Rayan Berberi","3/18/2004 (19 years old)","AM (C)","SL16 FC","Belgian Challenger Pro League","LUX","Yes","4/7/2022","6/30/2024","$900K - $1.9M","Right Only","Weak","Very Strong","5'10""","154 lbs","31","1",88,118,9,9,10,9,14,9,4,9,3,8,14,7,10,16,7,9,6,13,10,14,12,13,12,14,11,14,16,11,8,12,10,11,13,12,6,6,13,17,9,10,12,11,9,1,11,5,9,13,8,3,1,1,2,2,1,1,1,3,2,1
"974",2000071886,"Eldin Džogović","6/8/2003 (20 years old)","D (RC), WB (R)","Magdeburg","Bundesliga 2","LUX","Yes","7/1/2022","6/30/2024","$70K - $700K","Right Only","Weak","Very Strong","5'11""","169 lbs","28","10",92,118,7,9,10,8,10,7,11,8,12,12,10,10,12,10,13,9,11,9,11,9,13,8,6,11,12,13,10,12,12,11,11,11,12,12,13,11,11,9,9,12,11,13,6,6,9,5,12,12,15,2,1,2,2,3,1,3,2,1,1,3
"975",2000158354,"Joé Neves Araújo","12/6/2004 (18 years old)","AM (RL)","Rosport","Luxembourg National Division","LUX","Yes","7/1/2022","6/30/2024","$0 - $85K","Right Only","Weak","Very Strong","5'9""","145 lbs","46","1",83,116,8,12,11,14,14,7,7,6,2,4,9,5,4,12,5,9,8,7,5,6,6,11,9,12,7,5,10,9,13,14,5,4,11,14,13,4,13,19,11,11,12,9,7,12,5,8,9,11,18,3,1,2,3,2,3,1,1,1,1,3
"976",2000291193,"Ronaldo Machado","1/28/2005 (18 years old)","ST (C)","Racing FC Luxembourg","Luxembourg National Division","LUX","Yes","7/1/2021","6/30/2024","$0","Right","Reasonable","Very Strong","5'10""","152 lbs","1","-",65,116,1,5,13,13,13,5,8,2,3,5,6,6,2,13,6,11,7,13,4,8,11,13,5,10,3,5,4,6,13,11,3,3,10,13,8,8,9,16,12,12,9,11,8,3,6,6,17,11,12,1,2,3,2,1,3,2,2,2,2,1
"977",48020015,"Marvin Martins","2/17/1995 (28 years old)","D (RC), WB/M (R)","FK Austria Vienna","Austrian Premier Division","LUX","Yes","5/25/2023","6/30/2025","$200K - $2M","Right","Reasonable","Very Strong","6'1""","178 lbs","195","8",115,115,6,9,8,6,11,8,10,8,13,12,11,9,12,11,9,11,13,11,10,11,13,6,9,11,11,12,9,13,14,12,12,12,13,13,12,10,10,13,12,12,11,8,12,9,9,4,11,11,12,2,3,3,3,3,2,1,1,3,4,3
"978",85138198,"Belmin Muratović","3/27/1998 (25 years old)","AM (LC)","Progrès","Luxembourg National Division","LUX","Yes","7/1/2022","6/30/2023","$0 - $6K","Right Only","Weak","Very Strong","5'8""","152 lbs","62","8",90,115,7,9,11,12,10,14,1,13,3,6,12,3,10,12,13,9,8,11,9,14,5,11,10,13,8,12,13,11,12,13,13,6,8,13,8,7,15,17,12,11,10,9,15,12,12,5,18,10,13,2,3,2,1,1,3,4,2,2,1,3
"979",22086793,"Simeon Aleksandrov","9/24/2003 (19 years old)","AM (RL)","Septemvri Sofia","Bulgarian Second League","BUL","Yes","9/6/2022","6/30/2027","$140K - $400K","Right","Reasonable","Very Strong","5'6""","132 lbs","75","13",96,148,9,10,12,10,11,11,7,8,7,5,10,8,6,12,5,10,6,10,8,8,12,14,7,12,4,10,11,13,15,15,11,5,12,14,9,6,11,18,15,11,10,12,8,13,5,6,12,12,16,1,1,3,2,3,2,2,3,3,3,1
"980",18102999,"Tim Hall","4/15/1997 (26 years old)","D (C)","Újpest","Hungarian Division I","LUX","Yes","1/18/2023","6/30/2024","$10K - $100K","Left Only","Very Strong","Weak","6'3""","165 lbs","94","4",98,115,8,7,7,5,10,3,14,6,3,11,12,2,13,10,9,12,12,7,11,10,7,6,13,9,13,11,8,14,10,7,12,15,9,11,11,11,10,12,11,7,9,6,11,8,12,14,10,13,17,1,2,3,4,4,3,3,3,3,3,3
"981",2000290984,"Ben Kohnen","2/5/2006 (17 years old)","GK","Una Strassen","Luxembourg National Division","LUX","Yes","7/1/2022","6/30/2025","$0 - $30K","Right","Strong","Very Strong","6'2""","163 lbs","-","-",72,114,3,2,2,2,3,7,1,2,2,2,11,2,3,5,8,5,14,6,9,12,8,3,6,2,9,6,3,5,9,12,6,11,8,10,3,4,7,16,13,12,11,10,11,6,5,3,11,12,17,6,12,12,5,3,9,12,7,7,12,12
"982",85072767,"Chris Philipps","3/8/1994 (29 years old)","D (C), DM, M (C)","Wiltz","Luxembourg National Division","LUX","Yes","11/8/2020","6/30/2026","$4.5K - $45K","Right Only","Weak","Very Strong","6'0""","178 lbs","144","7",91,114,3,4,8,5,10,5,12,7,5,12,11,7,12,10,11,13,11,10,11,11,14,7,8,6,11,13,6,11,9,10,14,11,13,12,13,13,8,15,15,15,13,14,8,10,9,7,10,7,10,2,2,2,2,4,1,3,3,1,2,2
"983",224582,"Gary Bernard","10/24/2000 (22 years old)","AM (R), ST (C)","Jeunesse Esch","Luxembourg National Division","LUX","Yes","7/1/2022","6/30/2023","$0 - $3.5K","Right","Weak","Very Strong","5'7""","123 lbs","136","28",88,113,7,9,12,14,13,7,13,6,2,5,14,9,5,12,8,7,8,9,8,10,16,11,8,12,8,7,9,9,14,14,8,4,15,14,11,1,12,14,13,11,10,12,6,15,14,8,11,13,10,1,2,3,3,1,2,1,1,2,3,3
"984",2000290980,"Flavjo Hoxha","10/28/2006 (16 years old)","AM (RL)","Borussia M'gladbach","Bundesliga","LUX","Yes","1/1/2023","6/30/2025","$65K - $650K","Right Only","Weak","Very Strong","5'10""","141 lbs","-","-",71,113,8,12,14,9,9,7,8,7,2,5,12,5,8,13,5,7,2,7,8,10,9,12,2,11,4,8,9,9,14,9,8,5,13,10,10,6,12,10,9,11,10,11,15,10,11,8,7,12,17,3,3,2,3,2,1,1,2,3,2,3
"985",18045776,"Mathias Jänisch","8/27/1990 (32 years old)","D/WB (L), DM","Käerjéng","Luxembourg National Division","LUX","Yes","7/1/2022","6/30/2024","$0 - $40K","Left Only","Very Strong","Weak","6'0""","167 lbs","320","23",88,112,9,13,9,5,14,8,9,8,4,11,10,4,14,11,12,11,9,11,11,13,6,5,12,10,14,10,8,11,8,10,9,8,13,7,9,7,15,10,10,13,10,12,12,14,14,3,11,11,8,1,2,2,3,4,4,2,1,2,3,3
"986",55038676,"Michael Pinto","6/4/1993 (30 years old)","D/WB (L)","Sparta Rotterdam","Eredivisie","LUX","Yes","1/1/2020","6/30/2025","$250K - $2.5M","Left Only","Very Strong","Weak","5'9""","154 lbs","257","6",111,112,11,13,12,7,13,11,6,10,10,10,12,10,12,13,15,11,12,13,8,11,12,10,13,14,10,13,11,15,13,12,13,8,13,13,14,9,14,15,8,13,11,14,11,11,13,8,10,11,12,2,2,2,1,3,1,3,2,1,1,2
"987",95054966,"Luca Duriatti","2/11/1998 (25 years old)","M (C), AM (RLC)","Titus Pétange","Luxembourg National Division","LUX","Yes","7/1/2020","6/30/2025","$0 - $95K","Left Only","Very Strong","Weak","5'5""","134 lbs","88","5",86,112,10,10,11,8,11,10,6,9,3,8,10,6,10,13,13,7,12,9,12,8,15,12,12,12,9,12,10,13,12,12,11,6,13,12,12,5,15,13,14,13,11,8,11,12,13,6,12,13,11,2,1,3,3,2,3,3,2,3,1,1
"988",2000072379,"Fränz Sinner","9/19/2003 (19 years old)","D (LC)","Trier","German Div. Rhineland-Palatinate/Saar","LUX","Yes","5/3/2021","6/30/2023","$0","Left Only","Very Strong","Weak","6'2""","178 lbs","28","-",75,112,3,9,4,3,9,1,11,3,4,7,9,2,13,8,15,9,9,8,6,13,8,5,9,5,12,7,6,9,8,14,5,10,9,10,11,9,13,18,12,12,10,11,14,3,10,7,13,11,16,1,3,2,4,1,3,1,3,1,3,2
"989",29198467,"Aldin Skenderović","6/28/1997 (25 years old)","D (C), DM","Dudelange","Luxembourg National Division","LUX","Yes","7/1/2022","6/30/2025","$0","Right","Reasonable","Very Strong","6'1""","178 lbs","182","2",92,111,3,2,6,3,9,2,8,3,4,13,10,4,12,9,14,12,14,11,9,10,12,5,12,3,13,13,6,13,8,10,9,13,13,10,12,12,6,20,11,10,9,11,5,11,13,5,11,9,10,1,1,3,1,2,1,2,2,4,4,2
"990",22051266,"Kiril Despodov","11/11/1996 (26 years old)","AM (RL), ST (C)","Ludogorets","Bulgarian First League","BUL","Yes","6/18/2021","6/30/2024","$600K - $6M","Right","Reasonable","Very Strong","5'11""","154 lbs","221","60",140,145,15,14,13,13,12,15,11,12,7,5,13,13,8,13,9,12,7,14,9,13,16,16,14,13,9,14,14,8,16,13,13,11,14,16,10,10,14,9,9,14,14,14,10,16,7,9,13,17,11,2,2,2,3,4,1,2,1,2,2,1
"991",36515410,"Artur Abreu","8/11/1994 (28 years old)","AM (LC)","Titus Pétange","Luxembourg National Division","LUX","Yes","5/8/2021","6/30/2026","$0 - $100K","Right","Strong","Very Strong","6'0""","163 lbs","174","64",91,111,8,8,12,10,11,8,7,8,8,6,10,10,6,11,11,11,9,9,10,9,11,13,10,11,5,11,10,10,12,10,9,9,12,12,10,9,13,10,13,14,13,14,12,2,6,5,1,12,12,1,2,3,3,2,1,2,2,2,3,1
"992",91166671,"Florian Bohnert","11/9/1997 (25 years old)","D (R), M (L), AM (RL)","SC Bastia","Ligue 2 BKT","LUX","Yes","1/1/2023","6/30/2025","$40K - $400K","Right","Weak","Very Strong","6'0""","167 lbs","164","10",104,111,10,11,10,9,10,10,8,6,10,12,9,5,12,12,13,11,12,10,10,10,11,9,4,10,11,11,9,16,13,11,8,11,12,14,13,9,17,14,13,13,11,10,14,12,11,6,13,11,12,1,3,3,1,1,1,1,1,1,3,2
"993",18110493,"Timothy Martin","3/27/2001 (22 years old)","GK","RE Virton","Belgian First National Amateur Division","LUX","Yes","7/1/2021","6/30/2025","$40K - $120K","Left Only","Very Strong","Weak","6'3""","176 lbs","15","-",86,111,1,2,1,3,3,6,1,3,2,1,10,1,2,5,5,7,9,9,12,15,4,2,5,1,9,9,8,8,10,13,9,16,15,10,3,7,11,15,8,12,10,9,11,5,9,4,12,12,8,10,11,10,12,11,12,10,5,11,12,11
"994",2000065843,"David Jonathans","1/26/2004 (19 years old)","AM (RL), ST (C)","FC Bayern II","German Regional Division Bavaria","LUX","Yes","5/3/2022","6/30/2025","$7K - $70K","Right","Reasonable","Very Strong","6'2""","160 lbs","-","-",81,110,6,8,8,13,11,6,8,7,6,6,13,5,7,12,5,9,8,5,5,10,12,12,3,7,7,11,5,8,13,12,8,10,9,13,9,4,18,12,12,16,11,11,8,2,12,4,9,14,10,3,3,4,2,1,2,2,2,1,3,2
"995",95065322,"Florik Shala","7/19/1997 (25 years old)","AM (C), ST (C)","Swift Hesperange","Luxembourg National Division","LUX","Yes","7/1/2022","6/30/2023","$0 - $3.5K","Right","Weak","Very Strong","6'4""","174 lbs","113","35",92,110,7,9,13,10,7,7,12,9,2,7,9,3,3,10,11,12,9,11,9,11,2,10,13,13,6,7,7,9,13,9,9,13,15,13,13,6,12,19,9,10,11,10,5,9,6,7,20,11,19,1,3,2,2,1,1,1,2,2,1,3
"996",6601523,"Guy Blaise","12/12/1980 (42 years old)","D (C), DM, M (RC), AM (C)","ROC Meix-Dt-Virton","Belgian Third Amateur Division ACFF D","LUX","Yes","7/1/2018","6/30/2024","$0","Right Only","Weak","Very Strong","6'0""","174 lbs","448","16",92,110,5,9,7,7,8,8,10,7,1,12,10,6,12,8,12,13,12,14,12,15,10,8,18,10,12,15,14,10,6,5,14,10,12,6,10,14,16,20,10,11,14,20,11,12,15,2,17,12,10,1,2,1,2,2,1,2,1,1,3,4
"997",85138208,"Pit Simon","2/17/1998 (25 years old)","D (C)","Racing FC Luxembourg","Luxembourg National Division","LUX","Yes","6/15/2020","6/30/2024","$0 - $40K","Right","Strong","Very Strong","6'4""","171 lbs","88","7",74,110,3,1,2,2,7,6,10,2,6,8,7,1,13,6,15,10,9,5,8,10,6,5,10,3,13,6,6,7,12,12,7,10,8,11,7,6,12,13,13,10,13,10,13,5,7,1,9,11,8,3,3,1,2,2,3,3,1,2,3,3
"998",8159437,"Aurélien Joachim","8/10/1986 (36 years old)","AM (RL), ST (C)","RUS Ethe-Belmont","Luxembourg Provincial Division","LUX","Yes","7/1/2022","-","$0","Left","Very Strong","Fairly Strong","6'1""","187 lbs","356","113",86,110,6,9,9,12,12,5,11,11,7,5,10,13,6,9,11,12,12,13,12,8,7,12,12,11,6,14,9,13,7,9,14,12,13,8,8,15,9,11,11,12,8,8,14,13,5,8,10,8,2,2,3,1,3,2,3,4,1,2,1,3
"999",95065494,"Diogo Pimentel","7/16/1997 (25 years old)","D (L), DM, M (C)","Una Strassen","Luxembourg National Division","LUX","Yes","1/1/2023","6/30/2026","$0 - $110K","Right Only","Weak","Very Strong","5'10""","154 lbs","144","11",89,110,5,10,4,7,10,7,7,8,5,9,13,1,14,11,9,9,8,6,6,14,10,5,4,8,13,5,13,10,14,14,7,7,13,14,13,6,13,15,12,12,11,9,13,13,11,4,11,13,8,2,1,3,1,3,3,3,3,2,1,1
"1000",2000208934,"Noah Fernandes","10/19/2005 (17 years old)","M (C)","Etzella Ettelbruck","Luxembourg Division of Honour","LUX","Yes","5/31/2023","6/30/2025","$0 - $28K","Right","Reasonable","Very Strong","5'9""","152 lbs","8","1",65,110,6,5,4,3,14,6,6,8,1,8,9,6,6,12,10,5,7,7,4,11,4,5,6,8,4,8,14,12,14,11,7,6,12,11,7,4,11,12,11,11,11,11,5,14,5,2,9,12,11,3,2,3,4,1,3,1,4,2,2,2
"1001",23155633,"Baba Djibril Guèye","3/7/1983 (40 years old)","GK","Al-Khor","Qatar League","QAT","No","6/14/2021","6/30/2024","$30K - $95K","Right","Fairly Strong","Very Strong","6'4""","194 lbs","315","-",85,110,2,2,1,1,1,5,1,1,2,2,9,3,2,4,10,12,14,9,10,15,5,2,10,1,11,9,8,8,6,9,6,17,13,6,3,7,12,19,10,13,10,13,5,17,5,5,14,12,15,9,9,6,7,9,11,15,5,11,13,15
"1002",2000147571,"Abdullah Radif","1/21/2003 (20 years old)","ST (C)","Al-Hilal (KSA)","Saudi Professional League","KSA","No","7/1/2020","6/30/2026","$210K - $2.1M","Right","Reasonable","Very Strong","6'0""","147 lbs","17","2",95,137,9,7,11,11,15,8,14,11,8,6,11,7,3,11,15,14,14,11,9,9,13,13,12,11,9,9,8,11,12,10,8,7,15,12,6,10,12,20,13,14,11,11,10,9,8,8,12,11,14,2,2,1,3,2,1,3,2,1,1,2
"1003",82081885,"Donnegy Fer","1/9/1998 (25 years old)","M/AM (RL)","Inter Moengotapoe","SVB Eerste Divisie","SUR","No","7/1/2019","6/30/2024","$30K - $90K","Right Only","Weak","Very Strong","5'9""","152 lbs","21","2",85,100,8,9,11,7,9,8,9,3,3,5,10,9,7,9,8,8,8,8,8,8,14,14,6,10,8,10,10,10,14,12,10,9,15,14,9,9,5,13,13,11,10,9,2,14,13,3,12,15,16,1,2,1,3,2,2,2,2,3,2,2
"1004",37059605,"Delvechio Blackson","2/26/1995 (28 years old)","D (LC), WB (L)","Telstar","Keuken Kampioen Divisie","SUR","Yes","7/1/2021","6/30/2024","$100K - $325K","Left","Very Strong","Reasonable","6'1""","187 lbs","131","2",95,100,5,9,10,6,11,6,11,4,10,10,11,6,9,11,12,11,11,9,8,8,16,5,14,11,11,11,10,13,14,11,11,12,13,14,11,12,14,17,7,13,13,13,8,13,7,4,9,12,19,3,1,3,3,3,1,2,1,3,1,3
"1005",2000137707,"Chiverio Adely","11/29/2004 (18 years old)","M/AM (C)","Excelsior","Eredivisie","SUR","Yes","7/1/2022","6/30/2025","$14K - $140K","Right","Reasonable","Very Strong","5'11""","152 lbs","-","-",64,99,5,6,7,9,11,4,2,7,2,4,13,2,2,12,7,3,4,4,4,8,15,12,11,7,7,7,11,11,13,13,3,10,13,13,6,3,9,13,10,11,13,13,13,17,6,3,14,10,18,1,3,3,2,3,2,3,2,2,3,1
"1006",2000200689,"Gabriel De Mees","10/5/2004 (18 years old)","D/WB (R)","Transvaal","SVB Eerste Divisie","SUR","No","7/1/2020","6/30/2025","$18K - $50K","Right","Reasonable","Very Strong","5'11""","158 lbs","-","-",65,95,6,12,4,3,13,1,7,1,6,8,7,3,12,8,5,4,8,6,7,13,15,5,10,6,7,7,7,8,9,8,7,7,10,11,13,6,9,18,7,11,12,11,5,8,14,8,10,12,19,2,2,2,1,1,1,1,3,2,3,2
"1007",2000283914,"Renske Adipi","8/1/1999 (23 years old)","D (RL), DM, M (C)","Robinhood","SVB Eerste Divisie","SUR","No","7/1/2021","6/30/2025","$0 - $110K","Right","Reasonable","Very Strong","5'7""","149 lbs","-","-",85,95,7,10,11,6,11,7,8,7,1,9,10,2,14,7,12,11,15,7,11,13,14,5,5,6,9,9,9,14,10,8,11,3,9,10,12,7,14,15,12,8,13,13,5,4,6,5,16,11,9,2,4,3,1,2,3,3,2,3,1,2
"1008",82081641,"Ivanildo Rozenblad","5/16/1996 (27 years old)","AM (RL), ST (C)","Robinhood","SVB Eerste Divisie","SUR","No","6/15/2020","6/30/2024","$30K - $95K","Right","Reasonable","Very Strong","5'8""","143 lbs","-","-",85,95,8,13,14,14,14,7,14,8,3,6,10,4,2,11,12,8,6,7,7,11,5,10,12,13,7,7,9,9,14,14,7,5,15,14,6,6,12,17,10,11,12,11,6,7,7,1,10,11,20,3,1,1,1,2,1,1,1,3,4,3
"1009",23150719,"Omar Al-Soma","3/23/1989 (34 years old)","ST (C)","Al-Ahli (KSA)","Saudi Professional League","SYR","No","6/14/2021","6/30/2024","$375K - $3.8M","Right","Reasonable","Very Strong","6'4""","158 lbs","195","160",130,145,6,9,11,16,11,16,17,15,3,4,11,16,4,11,6,12,11,15,12,13,16,12,14,15,9,10,9,12,11,9,13,16,14,12,12,16,6,12,14,15,13,12,13,17,4,8,13,11,12,1,2,2,1,3,2,2,3,4,2,3
"1010",68020012,"Mahmoud Al-Aswad","6/28/2003 (19 years old)","M (C), AM (RC)","Al-Karamah","Syrian Premier League","SYR","No","7/1/2022","6/30/2024","$140K - $1.4M","Right","Reasonable","Very Strong","6'0""","160 lbs","63","3",88,140,8,10,12,10,10,8,7,9,5,8,11,10,8,11,12,10,15,11,8,8,17,11,11,10,12,11,12,11,11,10,12,8,11,11,12,10,12,10,11,15,9,15,7,7,5,8,10,17,12,3,1,1,2,1,3,3,2,1,2,2
"1011",2000075995,"Mohamad Al-Asaad","10/9/2003 (19 years old)","M/AM (C)","Tishreen","Syrian Premier League","SYR","No","7/1/2019","6/30/2025","$80K - $800K","Right","Reasonable","Very Strong","6'0""","165 lbs","31","3",77,140,8,9,13,10,9,8,4,10,2,9,14,4,10,14,7,9,8,7,8,10,17,14,12,11,7,10,11,10,9,11,10,7,12,9,8,5,11,8,7,12,8,12,6,2,9,7,9,15,10,2,2,1,2,3,2,2,2,3,2,1
"1012",2000228833,"Kawa Eissa","9/11/2006 (16 years old)","ST (C)","Al-Wahda (SYR)","Syrian Premier League","SYR","No","10/14/2022","6/30/2026","$325K - $1M","Right","Reasonable","Very Strong","6'1""","154 lbs","-","-",62,139,5,1,13,13,11,5,10,7,1,5,3,5,3,11,9,4,4,6,2,6,10,13,11,7,2,5,7,7,13,11,6,9,9,13,5,6,8,12,11,9,12,12,7,6,14,6,8,13,8,2,3,2,2,1,1,1,3,1,2,2
"1013",23471178,"Hassan Tambakti","2/9/1999 (24 years old)","D (C)","Al-Shabab","Saudi Professional League","KSA","No","6/15/2020","6/30/2027","$12.5M - $18.5M","Right Only","Weak","Very Strong","6'0""","160 lbs","55","-",130,135,6,7,10,7,11,8,13,8,11,15,12,10,16,12,14,12,13,11,12,12,16,7,14,8,16,13,12,14,11,12,13,13,12,12,12,15,8,11,12,15,9,12,15,12,7,7,10,16,16,4,3,2,3,2,3,2,2,1,2,2
"1014",2000059249,"Ali Reynah","6/1/2004 (19 years old)","D (C)","Al-Ahli SC (SYR)","Syrian Premier League","SYR","No","7/1/2019","6/30/2024","$650K - $1.4M","Right","Weak","Very Strong","6'1""","176 lbs","13","-",80,138,7,8,7,2,10,5,11,7,5,12,10,8,10,11,12,10,12,11,10,8,18,12,8,10,11,10,7,11,10,12,8,12,11,10,12,10,8,8,12,14,10,15,8,9,7,11,8,20,17,3,2,3,1,2,3,2,2,3,2,3
"1015",23438954,"Ibrahim Alma","10/18/1991 (31 years old)","GK","Al-Jaish (SYR)","Syrian Premier League","SYR","No","6/30/2021","6/30/2024","$0","Right","Weak","Very Strong","6'1""","165 lbs","152","-",105,135,1,3,1,1,2,5,1,3,1,3,11,2,2,6,14,14,15,9,9,14,15,1,17,1,13,9,8,8,13,6,7,9,9,13,7,15,14,16,13,12,14,10,7,11,7,12,10,15,15,11,9,15,12,10,9,14,5,10,8,12
"1016",23480661,"Mohamad Rihanieh","1/2/2001 (22 years old)","M (C), AM (RC)","Hatta","UAE Professional League","SYR","No","8/1/2019","6/30/2024","$850K - $1.9M","Left","Very Strong","Reasonable","5'9""","156 lbs","96","15",105,135,5,10,12,9,10,8,7,11,5,8,13,8,10,12,11,11,12,10,9,9,18,11,9,10,9,11,13,12,14,10,11,10,14,13,13,12,11,9,10,15,12,11,5,10,5,10,10,20,12,1,3,2,4,2,1,1,3,3,2,3
"1017",23439004,"Fares Arnaout","1/10/1997 (26 years old)","D (C)","Goa","Indian National Division","SYR","No","7/1/2022","6/30/2024","$0","Right Only","Weak","Very Strong","6'1""","189 lbs","35","4",100,135,3,2,3,2,9,1,11,7,6,12,10,6,13,6,12,12,13,6,13,10,16,8,14,7,13,7,6,12,13,13,10,12,8,13,12,9,11,19,8,15,17,13,8,12,9,11,13,15,12,2,2,2,1,4,4,2,2,3,3,2
"1018",2000073154,"Malek Janaer","2/1/2003 (20 years old)","DM, M/AM (C)","Al-Wasl","UAE Professional League","SYR","No","2/19/2023","5/31/2025","$550K - $5.8M","Right","Reasonable","Very Strong","5'10""","154 lbs","10","-",85,134,5,6,9,10,15,8,7,6,3,8,15,6,13,10,15,8,9,6,7,11,17,11,14,10,12,14,9,14,10,9,6,5,7,9,10,6,16,11,12,12,9,7,10,14,8,7,15,16,10,2,1,1,2,2,2,3,3,3,2,1
"1019",2000192807,"Mohamad Al-Thallaj","8/3/2005 (17 years old)","GK","Muharraq","Bahrain Premier League","SYR","No","7/1/2021","6/30/2025","$1.5K - $16K","Right","Reasonable","Very Strong","5'11""","149 lbs","-","-",60,132,4,2,3,2,1,8,1,2,1,1,5,3,2,4,5,6,15,4,10,13,6,3,7,2,10,6,3,5,10,11,6,5,12,6,3,3,9,16,13,11,8,13,10,6,6,6,14,11,15,8,13,13,8,8,7,9,6,9,4,5
"1020",2000311931,"Mahmoud Al-Omar","5/15/2005 (18 years old)","D (L)","Al-Ahli SC (SYR)","Syrian Premier League","SYR","No","6/12/2023","6/30/2027","$28K - $275K","Left","Very Strong","Reasonable","5'8""","145 lbs","-","-",63,131,5,8,8,2,9,2,9,3,6,10,7,5,10,9,15,9,15,9,9,5,16,5,1,5,9,8,6,12,12,13,8,9,7,13,7,6,13,7,11,12,9,9,11,13,5,11,10,15,12,3,4,1,1,1,2,1,1,1,4,4
"1021",23320665,"Omar Kharbin","1/15/1994 (29 years old)","AM (RL), ST (C)","Al-Wahda (UAE)","UAE Professional League","SYR","No","2/10/2022","5/31/2025","$7.4M - $8.8M","Right","Fairly Strong","Very Strong","6'0""","171 lbs","158","85",120,130,8,10,14,13,12,12,10,6,5,5,8,14,6,12,11,14,12,13,9,9,15,13,12,13,8,12,11,10,14,13,13,12,13,14,12,12,11,10,12,8,8,9,11,11,8,11,10,13,10,3,2,1,1,2,2,1,3,1,2,3
"1022",23438962,"Mohamad Al-Hallak","11/26/1999 (23 years old)","AM (RL), ST (C)","Manama","Bahrain Premier League","SYR","No","7/1/2021","6/30/2025","$20K - $210K","Right","Fairly Strong","Very Strong","5'7""","138 lbs","47","9",105,130,9,11,13,13,12,8,8,11,6,7,12,9,7,11,8,8,9,10,9,8,20,10,8,9,12,11,10,11,14,11,8,8,12,13,11,8,12,11,13,15,12,11,5,10,6,10,10,18,12,3,2,3,3,2,2,2,1,1,3,1
"1023",23480893,"Mostafa Juneid","4/7/2000 (23 years old)","DM, M/AM (C)","Al-Fotuwa","Syrian Premier League","SYR","No","3/8/2023","6/30/2024","$650K - $1.4M","Right","Fairly Strong","Very Strong","5'7""","136 lbs","76","12",100,130,10,9,11,8,10,11,8,12,5,10,13,10,9,11,10,11,12,11,10,10,15,12,15,11,10,13,11,12,12,11,12,8,12,11,11,8,9,10,13,17,14,17,7,11,7,9,13,18,11,1,2,2,1,4,3,1,1,2,3,3
"1024",23167669,"Yasser Al-Shahrani","5/25/1992 (31 years old)","D/WB (RL)","Al-Hilal (KSA)","Saudi Professional League","KSA","No","1/13/2021","6/30/2024","$14.5M - $17.5M","Right","Strong","Very Strong","5'7""","136 lbs","256","8",125,135,8,13,12,10,11,10,6,12,13,9,11,7,12,13,10,12,12,12,9,11,12,12,11,13,11,12,11,13,16,15,12,7,13,14,14,6,14,13,12,14,12,14,13,14,9,7,12,14,17,2,1,1,2,1,4,1,3,2,2,2
"1025",68020557,"Anis Kassem","8/27/2004 (18 years old)","ST (C)","Tishreen","Syrian Premier League","SYR","No","6/13/2022","6/30/2024","$450K - $1.4M","Right","Reasonable","Very Strong","5'6""","127 lbs","4","-",65,130,8,7,10,11,9,6,9,8,3,4,9,10,5,9,8,10,11,9,8,7,17,10,7,8,10,9,8,8,12,9,7,8,14,11,11,8,8,7,10,12,11,11,6,8,1,7,8,15,8,1,1,2,3,2,3,3,2,1,3,1
"1026",23438988,"Mohammad Al-Marmour","9/17/1995 (27 years old)","M (C), AM (RC)","Ahed","Lebanese Premier League","SYR","No","5/26/2023","6/30/2024","$0 - $35K","Right","Fairly Strong","Very Strong","5'7""","143 lbs","57","26",99,130,9,10,12,13,10,11,9,11,4,7,11,12,8,12,11,12,17,10,8,10,16,12,13,11,12,11,12,11,12,9,7,9,14,11,12,7,11,8,10,12,14,13,5,11,9,10,13,15,12,2,3,1,2,3,1,3,3,2,2,2
"1027",93049259,"Hosam Aiesh","4/14/1995 (28 years old)","M/AM (R)","Seoul","Hana 1Q K LEAGUE 1","SYR","Yes","1/4/2023","6/30/2025","$20K - $210K","Right","Reasonable","Very Strong","5'11""","158 lbs","200","21",107,128,10,12,15,10,13,10,4,11,4,5,11,7,8,14,15,7,10,11,9,9,11,16,4,11,7,9,11,9,14,13,11,8,11,13,12,10,8,8,9,9,10,6,8,8,14,15,9,13,11,3,3,3,2,1,4,1,3,2,1,3
"1028",68020595,"Mustafa Abdullatif","12/15/2003 (19 years old)","M/AM (C)","Hertha","Bundesliga 2","SYR","Yes","7/1/2022","6/30/2024","$50K - $500K","Right Only","Weak","Very Strong","5'10""","154 lbs","28","9",89,126,7,6,10,12,15,4,7,7,1,8,10,5,10,12,15,10,9,9,7,15,6,14,10,6,10,9,13,13,10,14,9,10,13,14,9,6,14,11,12,9,13,10,12,5,13,6,9,9,9,2,1,1,3,1,3,2,2,3,3,3
"1029",68020492,"Fawaz Bawadekji","9/27/2001 (21 years old)","D (RL), WB (L), AM (RL)","Jableh","Syrian Premier League","SYR","No","6/12/2023","6/30/2024","$100K - $1M","Left","Very Strong","Reasonable","5'9""","143 lbs","30","3",82,125,7,9,13,9,12,7,7,9,4,4,12,4,9,12,11,6,8,10,9,14,17,11,10,9,9,9,11,9,9,10,9,8,13,10,6,5,12,9,17,13,11,13,7,3,5,8,20,16,15,1,1,3,2,1,4,3,2,2,3,3
"1030",23444994,"Kamel Hmeisheh","7/23/1998 (24 years old)","DM, M (C)","Al-Karkh","Iraqi Premier League","SYR","No","1/2/2022","6/30/2024","$35K - $350K","Right","Reasonable","Very Strong","5'9""","136 lbs","73","6",102,125,8,12,10,9,12,10,9,13,8,12,13,10,13,11,10,9,13,11,9,12,20,12,9,13,12,14,11,13,13,10,8,10,14,12,13,8,12,12,11,15,17,14,6,11,3,7,11,16,12,3,1,3,1,3,1,3,3,1,2,3
"1031",23480859,"Yousef Mohammad","6/27/1999 (23 years old)","D (LC), DM","Abahani KC (D)","Bangladeshi Premier League","SYR","No","11/1/2022","8/31/2023","$500 - $3K","Right","Reasonable","Very Strong","6'1""","176 lbs","50","2",90,125,5,8,7,4,12,8,12,10,4,11,10,2,16,7,11,12,11,12,12,12,15,6,6,10,12,11,5,12,10,10,11,15,15,8,10,6,15,10,12,15,12,12,5,18,5,10,9,16,11,3,2,2,2,1,2,1,3,3,3,2
"1032",23243644,"Moayad Al-Ajan","2/16/1993 (30 years old)","D (RL), WB (L)","East Riffa","Bahrain Premier League","SYR","No","1/24/2023","6/30/2024","$0 - $45K","Left","Very Strong","Reasonable","5'9""","154 lbs","40","4",93,125,6,12,7,5,10,1,8,2,3,9,7,5,10,10,11,10,10,10,10,14,17,12,3,8,8,9,10,10,14,14,9,6,12,14,8,8,12,14,11,13,10,7,7,10,5,1,9,8,16,1,3,1,2,3,3,1,1,2,2,1
"1033",23438970,"Omar Al-Midani","1/26/1994 (29 years old)","D (C)","Naser","Kuwaiti Premier League","SYR","No","10/5/2021","6/30/2024","$220K - $2.2M","Right","Reasonable","Very Strong","6'1""","180 lbs","77","3",103,125,8,8,9,5,8,9,12,8,6,11,12,11,14,13,10,13,15,12,8,11,11,15,12,8,11,12,10,11,10,11,13,14,15,10,13,11,4,7,8,12,5,10,8,14,6,12,10,8,13,2,4,4,1,3,3,3,1,3,2,3
"1034",23477433,"Milad Hamad","10/1/1997 (25 years old)","DM, M (C)","Al-Jaish (SYR)","Syrian Premier League","SYR","No","1/25/2023","6/30/2024","$0","Right","Fairly Strong","Very Strong","6'1""","171 lbs","47","9",80,125,8,11,10,8,10,9,11,8,5,13,11,7,13,11,10,10,9,10,9,7,16,10,9,8,10,11,9,8,10,9,8,11,13,9,11,8,8,11,15,11,12,13,3,10,6,8,9,13,11,1,1,1,3,2,2,3,2,2,2,3
"1035",2000114762,"Musab Al-Juwair","6/20/2003 (19 years old)","DM, M (C)","Al-Hilal (KSA)","Saudi Professional League","KSA","No","1/19/2022","6/30/2025","$12M - $18M","Right","Reasonable","Very Strong","5'10""","154 lbs","20","4",105,132,9,9,5,9,15,9,8,7,3,11,15,5,15,15,8,13,6,8,8,15,7,5,8,10,11,10,11,14,8,10,8,10,6,11,10,10,13,10,11,10,11,13,7,8,7,6,14,11,20,3,2,3,2,3,2,4,1,3,3,1
"1036",23439028,"Youssef Al-Hamwi","2/1/1997 (26 years old)","D (RC)","Al-Ahli SC (SYR)","Syrian Premier League","SYR","No","6/20/2022","6/30/2024","$0","Right","Fairly Strong","Very Strong","5'9""","154 lbs","48","1",86,125,8,11,7,4,9,7,10,7,7,12,6,2,12,4,12,11,9,8,8,14,15,7,9,6,10,7,6,8,14,14,8,6,10,14,13,7,16,15,12,11,11,8,6,12,5,5,10,13,11,3,1,2,3,1,4,3,3,1,1,3
"1037",93126622,"Antonio Yakoub","6/12/2002 (21 years old)","AM (RC), ST (C)","Gefle IF","Swedish First Division Elite","SYR","Yes","1/20/2023","12/31/2024","$16K - $160K","Right","Reasonable","Very Strong","5'11""","165 lbs","77","39",90,125,7,9,11,12,12,7,9,10,6,5,8,12,5,12,8,10,9,11,10,10,13,14,6,12,8,10,9,10,13,12,9,10,12,12,11,9,5,12,12,12,13,12,5,9,6,6,11,13,15,3,2,4,2,2,2,2,1,1,2,2
"1038",23444128,"Mahmoud Al-Baher","1/3/1994 (29 years old)","ST (C)","Jableh","Syrian Premier League","SYR","No","7/4/2022","6/30/2024","$0","Right","Reasonable","Very Strong","5'10""","165 lbs","26","22",93,125,7,4,13,14,11,7,10,8,4,7,4,8,4,13,5,13,9,8,8,12,19,13,12,12,8,7,6,8,13,9,8,7,12,13,13,5,10,20,9,14,11,14,7,17,12,5,19,9,17,1,1,2,2,2,3,3,1,2,1,2
"1039",23480930,"Mohamad Omar Malta","9/14/2000 (22 years old)","AM (RC), ST (C)","Tishreen","Syrian Premier League","SYR","No","7/1/2018","6/30/2026","$130K - $1.3M","Right","Fairly Strong","Very Strong","5'11""","154 lbs","85","17",90,125,8,10,13,9,14,8,9,10,6,6,9,7,9,14,7,10,9,7,9,13,15,13,10,12,9,13,11,10,10,9,14,9,14,9,6,4,13,10,11,14,12,10,7,9,8,12,13,17,11,1,2,3,3,1,2,3,1,3,2,1
"1040",23438963,"Ahmad Ashkar","1/18/1996 (27 years old)","DM, M/AM (C)","Al-Ahli SC (SYR)","Syrian Premier League","SYR","No","6/23/2022","6/30/2023","$1K - $10K","Right","Reasonable","Very Strong","5'11""","156 lbs","24","4",86,125,6,7,8,9,12,6,6,13,4,7,9,1,12,11,15,11,8,8,3,9,19,11,12,8,8,7,12,12,13,13,7,5,13,13,11,5,14,12,11,13,11,11,15,1,10,7,12,10,20,3,3,1,1,2,1,2,2,1,1,3
"1041",23438969,"Khaled Kurdaghli","1/31/1997 (26 years old)","D/WB/M/AM (L)","Naft Al-Wasat","Iraqi Premier League","SYR","No","8/8/2021","6/30/2024","$90K - $275K","Left","Very Strong","Weak","6'0""","165 lbs","49","1",105,125,5,12,10,7,11,9,10,8,6,13,12,10,13,9,10,11,14,8,12,11,16,13,8,9,12,13,11,11,14,10,8,10,14,13,13,8,7,9,10,13,11,19,8,10,9,8,10,16,13,1,2,3,1,3,1,1,3,1,1,2
"1042",93097994,"Elias Hadaya","8/31/1998 (24 years old)","GK","Utsiktens BK","Swedish First Division Elite","SYR","Yes","2/22/2023","12/31/2024","$50K - $500K","Right Only","Weak","Very Strong","6'4""","189 lbs","68","-",99,125,5,1,1,2,10,6,7,3,3,3,8,2,2,6,9,12,11,9,12,11,14,5,12,6,12,11,9,8,8,11,11,15,10,8,9,13,13,7,7,14,9,9,10,13,13,8,13,10,11,10,9,12,10,11,11,11,8,12,11,14
"1043",68020054,"Mazen Amarah","5/2/2000 (23 years old)","D (L), AM (RLC)","Al-Karamah","Syrian Premier League","SYR","No","7/25/2022","6/30/2024","$60K - $600K","Left","Very Strong","Fairly Strong","6'0""","160 lbs","30","3",78,125,5,8,7,7,13,6,2,7,6,7,11,1,8,10,14,8,8,8,8,13,12,13,7,13,7,8,7,8,13,12,8,9,12,10,7,4,11,12,11,9,11,11,5,3,7,8,6,12,13,3,2,1,1,1,1,2,2,2,2,1
"1044",23477340,"Ali Beshmani","12/14/2000 (22 years old)","AM (RC), ST (C)","Al-Zawra'a","Iraqi Premier League","SYR","No","2/4/2023","7/31/2024","$30K - $300K","Right","Reasonable","Very Strong","6'0""","167 lbs","57","11",88,125,7,9,14,14,9,5,9,9,3,7,7,9,3,12,8,9,5,8,8,14,12,11,11,14,8,8,10,9,14,14,3,6,12,13,10,9,12,12,10,11,11,11,11,13,5,7,11,10,11,2,2,2,3,1,4,2,4,3,1,3
"1045",43372959,"Ammar Ramadan","1/5/2001 (22 years old)","AM (RLC), ST (C)","Dun. Streda","Slovak First Division","SYR","Yes","7/22/2022","6/30/2026","$55K - $550K","Right","Reasonable","Very Strong","5'9""","149 lbs","67","12",108,125,10,8,15,9,13,12,5,11,8,3,12,3,4,15,12,13,9,9,11,12,16,13,4,12,11,9,12,9,12,13,11,6,16,12,10,6,15,17,8,10,12,13,13,5,6,2,11,13,7,2,3,2,3,3,2,1,1,2,1,1
"1046",23374866,"Sami Al-Najai","2/7/1997 (26 years old)","DM, M/AM (C)","Al-Nassr (KSA)","Saudi Professional League","KSA","No","1/14/2021","6/30/2024","$250K - $2.5M","Right","Fairly Strong","Very Strong","5'10""","152 lbs","112","12",110,130,11,7,13,12,9,11,3,11,12,6,13,10,9,12,13,8,11,11,10,13,12,13,13,12,12,12,13,12,12,11,12,9,12,11,12,11,12,8,8,9,11,10,7,11,11,5,10,12,12,3,1,2,1,3,1,2,1,3,3,2
"1047",68021912,"Ahmad Al-Dali","3/21/2002 (21 years old)","DM, M (C)","Tishreen","Syrian Premier League","SYR","No","6/30/2021","6/30/2023","$0 - $55K","Right","Strong","Very Strong","6'0""","145 lbs","36","3",95,125,8,8,13,6,13,8,8,9,3,10,11,4,9,13,14,6,9,8,7,14,17,6,11,9,13,9,10,13,14,14,9,8,13,12,10,7,13,12,10,15,13,10,14,4,11,10,14,18,13,1,2,4,1,3,3,2,2,3,2,1
"1048",23438960,"Osama Omari","1/10/1992 (31 years old)","AM (LC)","Al-Jaish (SYR)","Syrian Premier League","SYR","No","6/28/2022","6/30/2023","$0 - $22K","Left","Very Strong","Fairly Strong","5'8""","149 lbs","51","15",90,125,8,12,9,9,12,6,8,8,5,7,12,7,9,14,12,12,5,11,6,12,15,13,4,12,7,9,9,13,10,8,9,7,8,12,14,6,13,10,18,17,12,9,5,6,13,8,12,14,12,3,1,1,2,1,1,1,1,2,3,1
"1049",23230543,"Mahmoud Al-Mawas","1/1/1993 (30 years old)","M (R), AM (RC)","Al-Shorta","Iraqi Premier League","SYR","No","6/12/2023","7/31/2024","$18K - $180K","Right Only","Weak","Very Strong","5'8""","143 lbs","208","79",115,125,9,11,12,12,11,9,10,13,5,8,11,12,10,13,14,12,13,12,10,10,12,12,10,15,13,10,11,13,14,12,11,11,14,14,13,10,14,10,13,10,12,10,5,12,9,13,11,11,11,4,3,3,1,1,3,3,2,3,2,3
"1050",23433924,"Ward Al-Salama","7/15/1994 (28 years old)","M (C), AM (RLC)","Al-Qaisumah","Saudi First Division League","SYR","No","7/27/2022","6/30/2025","$210K - $2.1M","Right","Fairly Strong","Very Strong","5'9""","143 lbs","50","9",93,125,7,12,10,13,10,9,10,9,4,7,12,10,9,12,11,11,13,9,7,7,15,11,11,10,11,12,12,11,13,10,11,10,14,12,13,8,11,9,8,10,11,7,6,10,6,5,11,17,12,4,2,1,2,4,2,1,3,1,3,2
"1051",2000074327,"Zakaria Ramadan","2/1/2005 (18 years old)","AM (C), ST (C)","Al-Ahli SC (SYR)","Syrian Premier League","SYR","No","6/13/2022","6/30/2024","$0","Right","Reasonable","Very Strong","6'1""","167 lbs","22","3",71,125,7,6,8,13,7,6,11,8,6,5,11,9,6,12,10,7,10,8,11,8,15,12,9,7,11,9,10,12,11,12,10,12,11,13,12,8,11,8,10,12,9,8,8,9,7,5,8,17,11,3,3,2,1,2,1,2,3,3,1,1
"1052",23480847,"Diyaa Al-Haq Mohamad","12/13/1999 (23 years old)","D/WB/M/AM (L)","Al-Fotuwa","Syrian Premier League","SYR","No","6/16/2022","6/30/2024","$35K - $325K","Left","Very Strong","Fairly Strong","5'10""","163 lbs","64","-",83,125,8,12,7,11,11,6,7,4,4,8,13,1,8,7,13,6,8,8,9,11,7,9,2,12,7,7,6,8,13,13,7,6,12,13,9,5,16,15,10,10,9,13,6,4,8,4,12,11,8,2,2,3,3,2,2,1,3,1,3,1
"1053",23439006,"Zakaria Hanan","8/21/1997 (25 years old)","D (R), M (C), AM (R)","Al-Ahli SC (SYR)","Syrian Premier League","SYR","No","6/27/2022","6/30/2024","$40K - $375K","Right","Reasonable","Very Strong","5'7""","149 lbs","67","3",83,125,6,9,6,13,11,6,4,7,6,8,8,4,13,10,15,9,8,6,7,13,8,10,14,13,6,7,5,8,13,13,6,4,15,13,12,2,16,16,10,11,11,11,5,14,8,8,13,11,11,2,4,2,4,3,1,2,2,3,2,2
"1054",68020785,"Sultan Sultan","2/9/2000 (23 years old)","AM (C), ST (C)","Jableh","Syrian Premier League","SYR","No","7/1/2020","6/30/2024","$0","Right","Reasonable","Very Strong","6'2""","165 lbs","-","-",76,125,5,5,12,12,12,5,7,7,2,4,10,5,1,12,5,10,3,10,5,12,15,13,4,7,6,6,7,11,12,12,10,11,12,12,7,4,12,7,12,15,10,9,14,9,11,11,11,17,12,3,3,3,2,1,2,2,1,1,2,1
"1055",37041776,"Mohammed Osman","1/1/1994 (29 years old)","M/AM (C)","Lamphun","Thai League","SYR","Yes","6/28/2022","6/30/2024","$120K - $1.2M","Right","Reasonable","Very Strong","6'0""","167 lbs","153","28",108,124,5,10,10,8,12,9,7,12,7,8,13,10,8,15,9,12,12,11,11,12,10,11,10,12,9,14,14,12,11,12,12,11,11,11,13,11,11,15,11,10,10,8,10,7,7,7,11,11,18,2,2,2,1,1,3,3,4,2,3,3
"1056",93069516,"Simon Amin","11/13/1997 (25 years old)","DM, M (C)","Sandefjord","Norwegian Premier Division","SYR","Yes","1/9/2023","12/31/2024","$28K - $275K","Right","Reasonable","Very Strong","6'0""","149 lbs","148","8",99,123,9,12,12,11,13,9,7,11,6,9,12,8,9,13,7,12,6,11,11,10,14,12,5,11,11,12,12,12,11,12,9,10,12,11,12,9,6,11,8,8,14,8,10,9,6,11,11,12,8,2,3,1,1,2,3,3,3,1,1,2
"1057",23167995,"Salman Al-Faraj","8/1/1989 (33 years old)","DM, M (C)","Al-Hilal (KSA)","Saudi Professional League","KSA","No","1/14/2021","6/30/2025","$6.2M - $7.8M","Left","Very Strong","Reasonable","5'11""","152 lbs","219","16",125,130,13,12,12,7,13,13,7,12,10,8,16,13,8,15,10,12,8,14,11,12,15,12,16,12,13,15,15,14,11,13,12,10,15,11,13,10,16,16,16,15,15,16,14,12,3,7,14,15,12,3,2,2,3,1,2,2,2,3,2,2
"1058",2000290906,"Homam Mahmoud","4/8/2006 (17 years old)","ST (C)","VfB Stuttgart","Bundesliga","SYR","No","7/1/2021","6/30/2026","$0","Right","Fairly Strong","Very Strong","5'9""","143 lbs","-","-",62,122,4,5,7,12,8,4,12,5,2,1,5,8,4,8,5,12,6,11,2,8,10,9,10,11,4,4,3,5,12,11,5,6,6,12,2,5,8,20,11,10,13,11,9,8,12,1,10,13,13,2,1,1,1,2,1,2,3,3,2,1
"1059",14037057,"Ezequiel Ham","3/10/1994 (29 years old)","DM, M (C)","Independiente Rivadavia","Argentine Second Division","SYR","No","12/31/2022","12/31/2023","$275K - $800K","Right","Weak","Very Strong","5'8""","147 lbs","85","7",116,122,12,11,12,10,13,13,8,11,5,13,14,13,10,13,9,12,9,12,12,12,14,13,9,9,12,16,13,15,12,13,12,8,12,12,14,9,9,14,15,14,12,12,13,14,11,4,13,11,10,1,1,2,2,3,3,1,1,3,2,3
"1060",2000224834,"Idris Al-Ahmad","12/18/2002 (20 years old)","DM, M (C)","Al-Jihad","Syrian First Division Group C","SYR","No","6/13/2022","6/30/2024","$22K - $220K","Right Only","Weak","Very Strong","5'9""","149 lbs","-","-",65,122,3,4,5,6,14,1,6,6,1,8,8,6,14,12,11,7,7,7,8,14,10,5,12,7,7,7,8,11,14,10,7,4,14,13,6,7,11,11,11,13,9,9,12,16,8,8,9,10,18,1,2,1,1,1,2,3,3,3,2,2
"1061",2000110480,"Mohamad Al-Saraqebi","3/8/2004 (19 years old)","M/AM (C)","Al-Nawair","Syrian First Division Group D","SYR","No","7/1/2020","6/30/2024","$0","Left","Very Strong","Fairly Strong","6'1""","163 lbs","-","-",72,122,5,5,6,10,12,6,6,8,1,5,13,4,5,7,5,5,5,9,7,13,5,7,10,8,7,7,13,12,13,7,7,12,12,11,7,4,11,20,11,11,11,13,12,11,6,4,6,10,17,2,3,3,1,2,1,1,3,2,2,1
"1062",23477431,"Haitham Al-Louz","1/15/2001 (22 years old)","D (RC), WB (R)","Al-Karamah","Syrian Premier League","SYR","No","7/1/2019","6/30/2024","$40K - $400K","Left","Very Strong","Strong","5'11""","154 lbs","92","1",81,120,8,10,9,7,10,6,8,7,6,12,9,8,13,10,7,11,8,8,8,8,20,10,5,9,10,9,8,11,12,11,9,10,11,11,11,8,6,11,11,13,12,17,8,9,6,10,10,18,12,2,1,1,3,2,1,3,2,3,2,3
"1063",23444273,"Alaa Dali","1/3/1997 (26 years old)","ST (C)","Al-Fotuwa","Syrian Premier League","SYR","No","6/30/2022","6/30/2024","$0","Right","Reasonable","Very Strong","6'0""","167 lbs","50","18",103,120,9,8,11,11,13,8,12,10,3,5,11,12,6,11,11,10,12,9,11,10,18,12,7,12,14,13,12,11,14,11,10,11,13,14,12,9,12,12,13,14,11,12,5,11,3,8,11,15,11,3,2,2,1,2,3,1,2,3,1,2
"1064",2000211679,"Jeremy de León","3/18/2004 (19 years old)","AM (RL)","Castellón","Spanish Federation First Division B","PUR","No","7/1/2022","6/30/2025","$28K - $275K","Left","Very Strong","Reasonable","5'9""","147 lbs","28","1",102,145,8,12,14,12,11,8,6,6,8,6,13,8,9,12,13,8,8,12,6,14,4,11,2,14,8,9,10,9,14,14,9,4,10,14,7,6,12,16,13,11,11,9,9,11,12,1,15,13,10,1,1,2,2,2,1,1,2,1,2,3
"1065",20044645,"Devin Vega","12/11/1998 (24 years old)","AM (C)","Des Moines Menace","USSL D2 - Heartland Division","PUR","No","7/1/2022","-","$0","Right Only","Weak","Very Strong","5'6""","141 lbs","37","5",81,114,12,10,13,8,12,14,7,11,5,6,11,3,7,13,7,8,4,6,9,8,7,13,10,8,5,9,11,10,13,14,11,5,15,11,9,7,10,12,9,11,11,13,13,16,11,3,11,10,17,1,3,1,2,2,2,3,2,2,3,1
"1066",20048648,"Alec Diaz","12/7/2001 (21 years old)","ST (C)","Toronto FC II","MLS Next Pro Eastern Conference","PUR","No","3/30/2022","12/31/2023","$250K - $2.6M","Right Only","Weak","Very Strong","5'9""","154 lbs","73","14",81,112,7,4,13,12,14,7,8,8,1,6,5,4,7,10,10,8,8,11,5,14,7,9,12,13,6,7,9,12,12,14,9,8,11,13,10,8,11,14,11,14,13,10,5,10,9,4,11,10,11,1,3,3,3,2,4,1,3,3,2,3
"1067",72023347,"Zarek Valentin","8/6/1991 (31 years old)","D (RLC)","Minnesota","Major League Soccer","PUR","No","1/1/2023","12/31/2023","$28K - $275K","Right","Fairly Strong","Very Strong","6'0""","171 lbs","262","5",108,111,11,8,8,7,11,9,12,5,11,12,11,8,13,11,9,10,10,11,12,10,14,5,5,11,12,12,8,13,12,14,12,12,12,13,11,12,13,13,13,11,10,13,10,12,7,5,13,12,8,2,3,3,3,3,2,3,2,3,3,2
"1068",23248784,"Ahmed Sharahili","5/8/1994 (29 years old)","D (C)","Al-Ittihad","Saudi Professional League","KSA","No","7/1/2022","6/30/2025","$18M - $27M","Left","Very Strong","Reasonable","6'1""","165 lbs","127","8",125,130,4,5,8,7,10,4,15,2,8,15,12,6,15,9,13,11,14,10,11,13,11,6,11,8,14,14,8,14,12,10,13,13,12,13,14,15,8,9,10,12,12,12,8,13,11,5,12,10,9,3,1,1,3,1,2,1,3,2,3,1
"1069",2000084803,"Nicolás Cardona","2/11/1999 (24 years old)","D (C)","Chattanooga","United States Soccer Leagues Division One","PUR","No","2/22/2022","11/30/2023","$4.5K - $45K","Right","Weak","Very Strong","5'11""","165 lbs","43","2",81,108,7,3,6,6,10,9,11,5,4,10,8,2,13,9,7,11,10,13,9,10,17,5,13,9,11,9,4,10,10,11,11,10,15,11,11,11,11,19,11,11,10,11,13,3,5,6,10,12,12,1,1,2,1,3,1,3,2,1,2,2
"1070",2000033188,"Jaden Servania","7/16/2001 (21 years old)","M (R), AM (RL)","North Carolina","United States Soccer Leagues Division One","PUR","No","1/21/2022","11/30/2023","$55K - $550K","Left Only","Very Strong","Weak","5'10""","165 lbs","74","6",84,106,9,10,10,10,11,9,1,8,5,9,9,6,6,12,11,11,8,6,9,8,4,10,12,13,9,10,11,8,12,10,12,9,5,13,9,11,13,18,10,11,12,11,6,12,15,5,7,11,8,2,2,3,1,3,1,1,2,4,3,3
"1071",14239865,"Rodolfo Sulia","8/8/2001 (21 years old)","D (C), DM","Fort Wayne FC","USSL D2 - Valley Division","PUR","No","4/18/2023","11/30/2023","$85K - $250K","Right Only","Weak","Very Strong","6'2""","182 lbs","18","1",85,103,6,5,8,4,9,8,12,7,3,11,10,3,14,9,6,10,9,9,10,15,3,5,3,8,13,8,8,10,8,11,5,10,10,10,6,13,13,14,9,11,13,13,10,11,8,4,12,11,9,2,3,3,2,1,1,3,3,2,3,2
"1072",2000050342,"Wilfredo Rivera","10/14/2003 (19 years old)","M (R), AM (RL), ST (C)","Orlando City","Major League Soccer","PUR","No","3/22/2021","12/31/2023","$140K - $1.4M","Right Only","Weak","Very Strong","5'6""","149 lbs","53","6",81,102,9,9,10,9,9,7,7,10,6,5,9,5,7,10,8,8,5,6,9,7,2,14,5,9,5,10,10,10,13,12,11,6,15,13,9,8,9,16,10,9,10,10,13,10,6,2,16,13,15,1,3,3,2,1,2,1,1,2,1,2
"1073",2000202080,"Leandro Antonetti","1/13/2003 (20 years old)","AM (L), ST (C)","Lugo B","Spanish Federation Third Group 1","PUR","Yes","7/1/2019","6/30/2027","$30K - $300K","Left","Very Strong","Reasonable","6'0""","160 lbs","48","13",75,102,4,9,13,11,11,5,13,6,1,7,9,5,2,11,8,9,8,13,3,8,13,10,4,11,7,7,4,9,14,14,4,7,15,14,7,7,9,12,10,11,10,9,8,11,6,4,6,11,14,2,3,1,4,3,1,3,1,3,4,1
"1074",2000260405,"Aurie Echevarría-Briscoe","6/26/2001 (21 years old)","GK","Fort Wayne FC","USSL D2 - Valley Division","PUR","No","3/10/2023","-","$0","Right","Fairly Strong","Very Strong","6'6""","185 lbs","-","-",65,101,1,2,1,1,1,4,1,1,3,2,5,2,3,3,9,5,14,5,7,12,12,1,13,3,12,5,4,4,8,13,5,11,12,6,1,4,10,15,10,15,11,10,5,7,11,8,20,9,20,5,11,12,13,6,7,9,5,9,4,9
"1075",2000097962,"Joseph Villafañe","11/30/1999 (23 years old)","D (C), DM, M (C)","Metropolitan FA","Liga Puerto Rico","PUR","No","7/1/2021","12/31/2025","$0","Right","Reasonable","Very Strong","5'11""","149 lbs","-","-",68,100,1,4,1,4,6,4,7,7,1,8,4,1,13,7,9,10,6,7,8,11,14,5,8,5,11,7,7,11,13,13,6,8,15,13,6,4,14,20,9,9,12,11,11,6,9,6,13,8,15,3,2,2,2,1,1,2,1,3,3,1
"1076",20016329,"Héctor Ramos","5/4/1990 (33 years old)","ST (C)","Metropolitan FA","Liga Puerto Rico","PUR","No","6/30/2022","12/31/2024","Not for Sale","Right Only","Weak","Very Strong","6'1""","171 lbs","168","66",81,100,7,7,10,12,10,7,11,7,4,6,10,5,7,11,13,11,13,12,12,10,13,9,11,12,7,9,8,13,8,9,12,14,13,7,12,13,10,12,7,14,12,12,8,14,12,6,13,14,17,3,2,1,3,3,1,2,1,3,2,2
"1077",2000099836,"Kevin Hernández","7/17/1999 (23 years old)","ST (C)","Club de Lyon","National Independent Soccer Association","PUR","No","1/1/2023","11/30/2023","$50K - $475K","Right","Weak","Very Strong","6'0""","167 lbs","57","18",83,100,7,8,13,14,7,7,12,6,1,6,9,9,4,12,13,11,2,14,8,11,13,11,4,14,8,7,8,9,14,12,3,6,11,11,6,7,11,16,10,10,10,11,13,9,5,8,11,10,13,4,1,1,3,3,2,3,1,3,3,1
"1078",67199622,"Emmanuel D'Andrea","1/20/1995 (28 years old)","D (C), DM","Bayamón FC","Puerto Rican Soccer League 2nd Division","PUR","No","6/15/2020","12/31/2024","$0 - $3.5K","Right Only","Very Weak","Very Strong","5'11""","171 lbs","7","-",70,95,2,4,4,1,7,5,13,5,6,11,8,1,10,7,13,10,11,8,11,13,16,5,12,6,11,10,8,10,6,6,11,11,9,7,7,11,10,17,10,11,12,10,8,12,12,1,19,12,8,2,1,2,3,3,2,4,1,1,1,1
"1079",2000111433,"Zakaria Hawsawi","1/12/2001 (22 years old)","D/WB/M/AM (L)","Al-Ittihad","Saudi Professional League","KSA","No","12/31/2022","6/30/2026","$11.5M - $13.5M","Left Only","Very Strong","Weak","5'8""","154 lbs","52","-",115,130,9,11,12,7,11,8,9,6,13,9,11,7,12,12,13,11,13,9,8,11,13,11,6,12,9,13,11,14,15,14,12,7,13,15,14,9,10,8,10,12,13,9,8,12,12,2,11,12,16,2,2,1,1,3,1,3,1,3,2,2
"1080",20028747,"Andrés Pérez","5/10/1988 (35 years old)","DM, M (C)","Bayamón FC","Puerto Rican Soccer League 2nd Division","PUR","No","6/14/2021","12/31/2024","$0","Right Only","Weak","Very Strong","5'10""","171 lbs","2","-",75,92,6,4,6,7,7,7,2,7,1,7,14,4,13,10,10,11,7,8,9,14,12,5,9,7,11,8,11,11,8,9,8,5,7,7,7,6,12,19,11,13,11,10,12,14,5,3,8,9,7,1,4,3,4,1,1,3,1,2,1,2
"1081",2000053811,"Lester Hayes III","9/19/1993 (29 years old)","ST (C)","Middelfart","2. Division","PUR","No","9/22/2021","6/30/2024","$500 - $6K","Right","Weak","Very Strong","6'3""","178 lbs","143","39",75,90,4,3,9,7,10,5,12,5,2,5,4,5,2,8,9,11,7,12,4,10,17,9,2,12,6,5,11,7,12,11,6,13,17,12,12,11,9,19,12,18,11,12,6,2,10,2,9,10,11,1,3,3,2,2,1,3,3,3,1,1
"1082",20028746,"Jackie Marrero","4/9/1993 (30 years old)","M (R), AM (RC), ST (C)","Las Piedras","Puerto Rican Soccer League 2nd Division","PUR","No","7/1/2018","-","$0","Right Only","Weak","Very Strong","5'9""","160 lbs","56","9",84,90,7,8,13,11,14,7,9,6,7,7,14,6,2,9,11,10,6,7,8,10,5,8,9,11,7,8,7,9,14,13,11,8,12,13,9,10,12,20,14,14,10,12,9,17,6,7,10,10,9,1,2,1,1,2,3,3,1,3,2,2
"1083",2000099832,"Ángel Molinari","7/18/2000 (22 years old)","GK","Westchester United FC","United Premier Soccer League","PUR","No","8/13/2021","-","$0","Right Only","Weak","Very Strong","6'0""","171 lbs","-","-",75,90,4,2,3,3,1,6,1,3,1,3,10,2,3,2,7,8,15,7,8,13,6,1,2,2,12,7,6,4,12,7,7,7,15,13,1,5,10,10,11,10,12,12,5,1,7,5,20,9,10,7,5,13,10,10,7,13,5,10,6,11
"1084",2000130701,"Gerald Díaz","3/29/1999 (24 years old)","M/AM (C)","Buñol","Spanish Lliga Comunitat Valenciana 1","PUR","Yes","10/16/2022","-","$0","Right","Fairly Strong","Very Strong","5'8""","141 lbs","11","11",72,88,2,4,6,8,10,5,4,3,3,5,10,5,5,12,10,7,3,6,6,12,4,13,8,9,7,6,10,10,12,12,6,4,12,12,12,3,17,17,10,10,12,8,10,9,10,6,13,10,9,3,3,3,3,2,3,3,1,3,3,3
"1085",2000130707,"Ricardo Rivera","4/17/1997 (26 years old)","ST (C)","Buñol","Spanish Lliga Comunitat Valenciana 1","PUR","No","12/1/2022","-","$0","Left","Very Strong","Weak","5'10""","180 lbs","92","14",79,86,8,6,7,10,13,8,15,9,1,8,4,3,3,8,15,12,9,10,9,14,7,14,2,10,9,5,6,9,10,10,13,9,14,10,10,12,12,15,13,12,10,9,5,10,10,4,10,11,18,1,2,2,2,2,1,1,3,1,3,4
"1086",2000238031,"Esteban Espinosa","9/19/2002 (20 years old)","D (C)","BOT","Brazilian National First Division","PUR","No","10/1/2022","12/31/2027","$0","Right","Reasonable","Very Strong","6'3""","176 lbs","-","-",72,86,3,3,3,7,7,1,10,6,1,9,8,6,10,7,6,8,9,7,7,14,7,5,12,7,11,7,1,8,12,10,8,14,12,11,8,6,12,13,13,9,10,10,8,8,15,8,11,11,10,2,3,1,1,2,1,2,3,3,2,3
"1087",2000182127,"Jorge Bermúdez","4/12/2002 (21 years old)","ST (C)","Bayamón FC","Puerto Rican Soccer League 2nd Division","PUR","Yes","1/1/2022","12/31/2024","$0 - $1.5K","Right","Fairly Strong","Very Strong","5'9""","147 lbs","3","-",67,85,5,2,13,13,11,5,13,6,2,2,6,4,3,11,8,11,2,8,6,13,1,11,12,10,6,5,6,6,13,13,6,7,11,13,4,4,11,16,12,12,12,14,5,7,15,8,17,13,19,2,4,3,2,3,3,1,2,4,1,1
"1088",2000182122,"Agustín Ortega","6/24/2002 (20 years old)","M/AM (C), ST (C)","Bayamón FC","Puerto Rican Soccer League 2nd Division","PUR","No","6/13/2022","12/31/2024","$0 - $6K","Right","Reasonable","Very Strong","5'11""","160 lbs","2","1",75,84,6,3,10,9,13,6,8,8,1,6,8,3,6,10,10,8,8,9,5,12,13,11,5,10,8,7,11,8,13,9,7,9,16,9,9,9,9,12,13,11,11,11,10,15,10,7,12,11,9,2,1,3,1,2,1,3,3,3,3,3
"1089",981907,"Alexis Rivera","10/29/1982 (40 years old)","D (RLC)","Bayamón FC","Puerto Rican Soccer League 2nd Division","PUR","No","6/14/2021","12/31/2024","$0","Left Only","Very Strong","Weak","5'9""","178 lbs","150","2",70,82,8,7,9,8,8,5,6,4,9,8,9,8,9,9,11,8,11,9,8,8,10,8,7,8,8,9,6,12,12,11,9,9,11,11,11,11,8,13,7,10,11,8,6,7,12,3,10,6,8,2,2,2,1,3,4,1,1,3,2,4
"1090",23470691,"Turki Al-Ammar","9/23/1999 (23 years old)","M (C), AM (RLC)","Al-Shabab","Saudi Professional League","KSA","No","6/15/2020","6/30/2024","$0","Right","Fairly Strong","Very Strong","5'10""","149 lbs","95","7",105,130,10,15,13,13,12,10,9,12,10,6,12,8,7,13,9,12,9,10,9,10,12,13,7,11,7,10,12,10,13,12,10,9,6,12,11,8,15,19,10,10,11,11,11,16,13,2,10,11,20,1,1,2,3,1,1,2,2,2,1,3
"1091",33052679,"Alex Oikkonen","10/15/1994 (28 years old)","DM, M/AM (C)","PEPO","Finnish Second Division Group A","PUR","Yes","1/22/2023","11/15/2023","$2.5K - $26K","Right","Reasonable","Very Strong","6'0""","167 lbs","166","20",79,82,14,8,7,6,9,14,7,4,2,5,14,12,8,11,7,9,9,9,9,9,12,15,11,10,9,12,12,12,9,9,10,12,10,9,9,7,8,14,14,12,10,12,6,10,7,7,12,10,16,3,3,3,2,2,3,3,1,1,3,2
"1092",72044284,"Sidney Rivera","11/15/1993 (29 years old)","AM (R), ST (C)","Morris Elite","USSL D2 - Metropolitan Division","PUR","No","4/16/2021","-","$0","Right","Reasonable","Very Strong","6'2""","185 lbs","70","15",76,81,6,7,9,11,8,5,13,7,4,5,8,8,6,9,5,9,10,9,10,8,13,6,7,9,5,12,8,13,10,9,11,13,13,11,11,13,11,19,11,14,9,10,5,9,7,4,12,14,17,2,3,1,3,2,4,1,2,3,1,2
"1093",2000288731,"Joel Burgos","10/29/1999 (23 years old)","AM (RL), ST (C)","Verdes FC","Belizean Premier Football League","PUR","No","1/18/2023","6/30/2025","$2.5K - $24K","Right","Reasonable","Very Strong","5'9""","145 lbs","-","-",71,80,7,11,7,11,7,7,12,4,2,7,13,6,4,9,15,10,7,10,7,14,13,8,2,11,6,7,6,9,10,13,8,8,14,14,6,5,9,12,12,10,10,11,9,14,7,2,10,15,17,2,1,4,2,3,2,1,1,2,1,1
"1094",2000097957,"Marc Nieves","1/16/1999 (24 years old)","M/AM (C)","Metropolitan FA","Liga Puerto Rico","PUR","No","7/1/2021","12/31/2025","$0","Right","Fairly Strong","Very Strong","5'9""","145 lbs","-","-",68,80,4,4,6,6,7,4,1,9,1,6,9,4,4,10,7,6,5,6,5,12,6,11,7,4,6,5,12,4,12,12,5,7,16,12,9,5,8,14,11,11,12,11,14,6,5,8,10,11,13,1,3,4,3,3,2,2,3,3,2,1
"1095",2000130694,"Juan O'Neill","7/12/1998 (24 years old)","DM, M (C)","Project 51O","USSL D2 - Southwest Division","PUR","No","7/1/2022","-","$0","Right","Reasonable","Very Strong","5'7""","138 lbs","1","-",68,80,7,4,4,8,14,6,7,12,4,8,9,6,10,9,6,7,7,6,8,10,7,5,12,7,9,8,11,9,14,14,8,8,12,11,10,3,12,18,13,11,10,11,5,15,5,1,10,12,9,1,1,1,2,1,2,3,2,1,4,3
"1096",981905,"Saito Nieves","1/6/1982 (41 years old)","M/AM (RC)","Criollos de Caguas","Puerto Rican Soccer League 2nd Division","PUR","No","6/14/2021","12/31/2023","$0","Right","Reasonable","Very Strong","5'7""","152 lbs","46","-",60,80,6,8,10,5,10,4,3,3,7,5,8,6,5,11,9,8,8,8,8,6,8,9,9,8,5,7,6,9,12,10,8,7,15,12,8,8,8,20,12,10,12,12,6,10,12,6,8,11,11,2,1,1,1,1,1,3,4,3,2,3
"1097",2000202980,"Diego Alexander Rossi","5/19/2005 (18 years old)","M (C)","Parma","Italian Serie B","PUR","Yes","7/1/2022","6/30/2024","$0 - $35K","Right Only","Weak","Very Strong","5'9""","154 lbs","-","-",54,77,7,8,10,7,9,5,6,6,6,7,11,7,6,8,10,11,9,5,7,7,11,9,8,12,9,8,8,11,13,12,7,4,9,11,8,7,15,9,9,12,11,10,5,10,6,6,12,13,15,2,3,1,1,2,2,3,1,2,1,1
"1098",2000180121,"Carlos Rosario","1/30/1994 (29 years old)","D (C)","Bayamón FC","Puerto Rican Soccer League 2nd Division","PUR","No","6/15/2020","12/31/2024","$0","Right","Reasonable","Very Strong","5'11""","163 lbs","-","-",67,75,3,2,1,1,3,1,10,5,2,12,4,1,13,4,15,11,8,6,6,13,12,5,12,3,12,5,5,6,12,10,6,7,12,9,3,6,14,15,9,15,9,12,7,8,9,7,10,9,13,2,3,2,3,1,2,2,1,3,2,2
"1099",2000202861,"Dennis Beltré","1/29/1997 (26 years old)","ST (C)","CF Fraigcomar","Puerto Rican Soccer League 2nd Division","PUR","No","1/1/2022","12/31/2023","$0","Right","Reasonable","Very Strong","5'7""","141 lbs","-","-",74,75,6,5,8,13,9,6,13,7,1,5,6,10,1,10,8,10,5,10,7,10,14,10,7,11,7,6,3,8,13,13,7,1,9,13,13,4,10,12,9,13,11,10,8,3,13,4,4,11,8,3,1,1,1,3,3,1,3,1,3,2
"1100",27133233,"Anders Iversen","7/22/1999 (23 years old)","ST (C)","Holstebro","3. Division","PUR","Yes","12/28/2022","12/31/2024","$2.5K - $8K","Right Only","Weak","Very Strong","6'0""","176 lbs","89","12",65,75,6,6,4,10,9,5,14,5,1,6,8,1,1,7,5,11,6,6,7,8,10,9,1,12,7,6,8,8,13,11,7,12,7,14,7,7,10,13,11,11,13,11,9,3,9,8,11,9,20,2,1,3,1,4,1,1,2,2,2,2
"1101",2000098667,"Moteb Al-Harbi","2/19/2000 (23 years old)","D/WB (L)","Al-Shabab","Saudi Professional League","KSA","No","5/27/2021","6/30/2026","$8.4M - $10.5M","Left","Very Strong","Weak","5'10""","132 lbs","75","3",115,130,7,13,12,7,11,4,8,5,12,11,14,6,13,12,10,11,11,9,8,12,12,10,7,11,10,14,12,14,15,14,13,9,13,15,14,8,8,17,12,13,12,11,7,10,7,1,11,12,11,1,3,1,3,1,1,1,3,1,2,3
"1102",72007735,"Andrés Cabrero","1/4/1989 (34 years old)","M/AM (LC)","Bayamón FC","Puerto Rican Soccer League 2nd Division","PUR","No","7/1/2018","12/31/2024","$0","Left","Very Strong","Reasonable","6'0""","165 lbs","71","1",74,75,6,9,9,12,12,9,6,9,8,5,12,6,7,10,9,8,8,9,9,9,9,7,13,13,8,14,12,10,10,8,8,11,9,9,8,8,9,8,11,9,9,11,13,13,8,9,9,8,9,1,2,2,2,1,3,1,2,2,2,2
"1103",2000284523,"Julian Vivas","11/10/2004 (18 years old)","GK","Metropolitan FA","Liga Puerto Rico","PUR","No","6/12/2023","12/31/2025","$0","Right","Reasonable","Very Strong","5'11""","154 lbs","-","-",60,75,4,3,3,2,5,6,1,1,1,2,6,2,3,1,13,8,8,3,11,13,9,3,4,3,11,5,5,6,14,7,7,9,13,11,4,5,7,11,13,12,11,12,6,3,7,6,11,13,15,4,10,6,8,7,8,13,5,8,8,14
"1104",2000097944,"José Ferrer","6/16/1996 (26 years old)","D/WB (R)","Metropolitan FA","Liga Puerto Rico","PUR","No","7/1/2018","12/31/2024","$0","Right","Reasonable","Very Strong","5'10""","149 lbs","-","-",70,75,6,6,5,2,7,2,6,3,6,9,8,1,14,6,10,11,9,8,9,8,11,7,5,6,10,8,7,8,14,14,8,5,10,14,13,8,13,17,11,14,8,11,7,3,6,1,8,10,14,2,3,2,3,3,2,3,3,1,1,2
"1105",2000130686,"Giovanni Padrón","4/15/1998 (25 years old)","D (L)","Nashville Knights FC","United Premier Soccer League","PUR","No","1/1/2020","-","$0","Left","Very Strong","Weak","5'6""","138 lbs","-","-",65,75,6,12,3,2,9,3,7,3,6,8,7,1,11,5,15,9,5,7,7,11,4,5,5,6,8,7,7,7,14,14,7,1,5,14,11,4,8,12,12,9,12,11,8,10,11,6,18,10,13,1,1,2,3,1,4,2,1,3,1,1
"1106",2000230953,"Christopher Dilan","2/19/1999 (24 years old)","M (C)","NONA FC","USSL D2 - Southeast Division","PUR","No","1/1/2023","-","$0","Right","Weak","Very Strong","5'10""","156 lbs","14","2",60,74,4,3,4,5,9,4,4,7,1,6,10,1,5,10,7,6,6,6,5,12,5,5,5,7,5,6,10,11,12,12,5,2,7,12,12,4,12,19,10,11,12,10,5,7,9,7,10,11,17,1,1,1,3,1,1,1,1,1,3,1
"1107",2000284504,"Ricardo Bautista","10/8/2003 (19 years old)","AM (R)","Metropolitan FA","Liga Puerto Rico","PUR","No","6/13/2022","12/31/2025","$0","Right","Weak","Very Strong","5'11""","154 lbs","-","-",64,74,6,10,11,8,7,5,5,5,1,4,6,3,6,7,10,6,5,7,4,9,16,7,1,7,3,7,6,11,13,12,4,5,10,13,12,3,11,15,11,11,11,12,5,10,14,2,10,11,8,2,1,1,2,1,3,4,2,2,3,3
"1108",2000098083,"Karlos Ferrer","1/28/1998 (25 years old)","AM (L), ST (C)","Metropolitan FA","Liga Puerto Rico","PUR","No","6/15/2020","12/31/2024","$0","Right","Reasonable","Very Strong","5'9""","171 lbs","-","-",65,73,5,8,7,13,6,5,7,6,5,5,6,3,1,7,7,8,5,7,6,12,15,7,11,8,4,5,5,7,13,13,6,3,18,13,12,4,10,10,7,13,12,12,6,12,8,5,9,14,10,2,3,1,3,2,2,1,1,2,3,2
"1109",2000149662,"Adrián Colón","8/23/2004 (18 years old)","D (RL)","FCA Walldorf II","German Lower Division","PUR","No","6/12/2023","-","$0","Right Only","Weak","Very Strong","5'11""","160 lbs","12","1",61,72,6,9,5,6,8,1,8,7,5,4,7,1,10,7,7,6,8,8,6,13,2,7,9,7,7,8,7,8,15,15,8,7,6,14,8,6,12,15,9,13,10,8,10,10,10,3,14,14,11,1,3,3,3,1,3,4,1,3,2,3
"1110",2000283920,"Sebastian Díaz","12/15/2000 (22 years old)","D (C)","Metropolitan FA","Liga Puerto Rico","PUR","No","7/1/2019","12/31/2025","$0","Right","Reasonable","Very Strong","6'2""","187 lbs","-","-",60,72,2,5,7,4,8,1,10,5,1,8,8,4,10,6,9,8,11,9,9,8,15,5,6,8,8,8,6,9,9,9,9,13,8,9,8,12,10,19,9,10,13,11,13,4,14,8,19,11,17,1,3,3,2,3,2,1,2,3,3,3
"1111",2000099837,"Jan Mateo","1/31/2003 (20 years old)","ST (C)","San Cristóbal FC","Liga Dominicana de Fútbol","PUR","No","2/25/2022","12/31/2024","$0","Right Only","Weak","Very Strong","5'9""","152 lbs","-","-",67,71,7,4,13,15,12,7,11,7,2,7,4,9,4,9,11,9,6,14,7,9,6,13,7,11,6,7,7,9,8,12,5,5,12,13,8,7,11,18,12,11,10,9,8,11,8,7,7,10,11,3,3,2,2,1,4,2,2,3,1,2
"1112",1016634,"Mostafa Jalal","2/2/1983 (40 years old)","D (C)","Al-Shahaniya","Qatar League","QAT","No","6/14/2021","6/30/2024","$0 - $55K","Right","Reasonable","Very Strong","5'9""","138 lbs","386","5",77,110,7,5,7,3,11,2,14,5,8,14,8,3,16,6,9,13,10,8,13,10,4,5,12,9,13,9,10,11,7,7,7,11,12,7,7,7,9,15,11,11,9,12,6,7,11,5,13,10,8,4,3,1,2,2,4,1,3,3,2,3
"1113",23167067,"Fahad Al-Muwallad","9/14/1994 (28 years old)","M/AM (RL)","Al-Shabab","Saudi Professional League","KSA","No","8/28/2022","6/30/2025","$425K - $4.2M","Right","Reasonable","Very Strong","5'6""","130 lbs","198","54",105,130,7,9,12,11,12,8,3,10,9,4,11,12,5,13,12,12,10,8,8,7,14,12,10,12,5,9,11,11,15,16,10,6,12,15,9,7,9,9,9,6,12,12,12,12,11,7,12,11,11,2,1,2,3,2,1,2,3,1,1,2
"1114",20016344,"Juan Vélez","5/12/1989 (34 years old)","D (C)","Criollos de Caguas","Puerto Rican Soccer League 2nd Division","PUR","No","6/14/2021","12/31/2023","$0","Right","Reasonable","Very Strong","5'10""","171 lbs","-","-",67,70,2,2,1,1,5,1,9,2,2,9,7,1,8,5,6,12,8,7,7,14,16,5,13,6,8,6,1,5,11,11,7,9,15,11,9,7,10,18,10,12,11,12,6,7,12,7,15,13,20,2,1,3,3,3,1,2,2,2,1,3
"1115",2000182128,"Samuel Soto","8/11/1992 (30 years old)","M/AM (R)","Bayamón FC","Puerto Rican Soccer League 2nd Division","PUR","No","1/1/2020","12/31/2024","$0","Right","Fairly Strong","Very Strong","5'9""","147 lbs","-","-",70,70,7,10,10,7,12,5,5,2,4,3,7,3,5,7,9,6,4,7,5,9,12,8,8,11,5,6,6,11,12,12,3,2,15,12,12,4,17,12,13,10,11,13,10,8,10,2,9,12,12,3,1,3,3,3,1,2,3,3,3,3
"1116",2000130678,"Joel Serrano","5/17/1999 (24 years old)","GK","Bayamón FC","Puerto Rican Soccer League 2nd Division","PUR","No","1/1/2022","12/31/2023","$0","Right","Reasonable","Very Strong","5'10""","169 lbs","1","-",68,70,3,3,3,2,5,6,1,2,3,3,7,1,1,4,10,7,13,4,9,13,5,1,11,3,12,6,5,5,10,13,4,5,13,9,2,4,8,13,13,10,11,11,8,4,7,3,20,12,9,8,5,13,10,6,9,9,5,9,7,7
"1117",82076117,"Marcos Martínez","3/27/1992 (31 years old)","D/WB (R), DM, M/AM (R)","Metropolitan FA","Liga Puerto Rico","PUR","No","7/1/2020","12/31/2024","$0","Right","Reasonable","Very Strong","5'7""","138 lbs","-","-",68,70,7,10,9,12,12,7,6,5,6,7,10,6,13,10,5,11,6,9,9,13,5,10,7,6,4,8,7,9,11,7,8,6,13,8,13,3,8,5,6,12,10,10,13,2,13,12,10,12,11,2,1,1,3,1,2,3,3,2,3,3
"1118",2000283924,"Christian Vargas","4/7/1999 (24 years old)","M/AM (L)","Metropolitan FA","Liga Puerto Rico","PUR","No","7/1/2021","12/31/2025","$0","Left","Very Strong","Reasonable","5'10""","154 lbs","-","-",64,68,4,9,12,11,12,2,5,6,7,6,8,4,6,9,6,10,13,8,8,8,10,7,12,14,7,5,6,8,11,13,8,10,16,11,5,7,15,5,6,8,11,11,15,11,13,1,10,12,16,3,3,1,2,1,3,3,1,1,1,4
"1119",20016326,"Alexis Chaparro","2/24/1993 (30 years old)","M (C)","Bayamón FC","Puerto Rican Soccer League 2nd Division","PUR","No","1/1/2022","12/31/2024","$0","Left","Very Strong","Reasonable","5'4""","127 lbs","-","-",68,68,6,2,4,7,10,6,4,14,2,8,14,1,7,9,10,5,7,7,7,10,9,8,12,10,6,6,13,11,10,14,6,3,12,14,13,3,10,17,11,9,13,15,10,11,5,8,11,11,19,2,1,3,3,1,1,2,1,3,1,2
"1120",67236098,"Christian Joel Sánchez","7/9/1999 (23 years old)","GK","S. Gijón","Spanish Second Division","CUB","Yes","8/28/2021","6/30/2026","$210K - $2.1M","Left","Very Strong","Reasonable","6'4""","194 lbs","88","-",108,142,7,7,11,3,12,7,12,8,7,8,11,7,8,11,14,10,15,7,11,9,13,2,8,2,11,13,8,10,12,11,5,16,15,12,13,15,5,18,12,10,10,11,6,11,6,7,11,12,17,12,13,13,17,13,13,12,19,10,11,13
"1121",91100276,"Onel Hernández","2/1/1993 (30 years old)","M/AM (RL)","Norwich","Sky Bet Championship","CUB","Yes","4/21/2023","6/30/2025","$1.7M","Right","Reasonable","Very Strong","5'8""","158 lbs","362","32",117,138,9,11,14,8,12,8,6,10,5,5,12,9,5,12,12,9,9,10,9,8,14,15,5,12,7,13,11,15,16,14,13,6,12,15,12,10,14,11,12,15,12,18,11,12,11,9,10,14,12,2,2,1,2,3,2,3,2,3,3,2
"1122",72007461,"Osvaldo Alonso","11/11/1985 (37 years old)","DM, M (C)","Atlanta United","Major League Soccer","CUB","No","11/14/2022","12/31/2023","$80K - $230K","Right","Reasonable","Very Strong","5'11""","158 lbs","383","17",114,130,8,10,11,7,12,9,7,12,9,13,14,8,15,13,16,15,14,10,11,12,17,3,15,9,15,13,12,12,9,12,13,9,11,9,9,11,9,5,9,14,15,10,14,10,13,5,15,14,13,2,3,1,1,1,2,2,2,1,1,3
"1123",43486615,"Davide Incerti","6/22/2002 (20 years old)","D (C), DM, M (C)","Olbia","Italian Serie C/B","CUB","Yes","7/7/2022","6/30/2024","$14K - $140K","Right","Weak","Very Strong","6'2""","182 lbs","58","-",89,127,4,5,7,6,8,5,12,10,12,11,10,8,12,10,11,11,11,10,11,11,12,6,8,7,11,11,9,12,10,10,13,13,13,12,12,12,8,10,10,15,10,10,4,13,7,4,12,8,15,1,1,1,2,2,1,2,3,3,3,3
"1124",2000198695,"Salem Al-Najdi","1/27/2003 (20 years old)","D/WB (L)","Al-Fateh","Saudi Professional League","KSA","No","7/1/2020","6/30/2026","$425K - $4.3M","Left","Very Strong","Reasonable","5'10""","134 lbs","18","-",90,130,7,11,2,4,14,6,9,3,8,8,10,2,9,10,6,8,10,4,11,14,12,8,11,8,10,9,7,9,14,14,8,5,7,14,8,7,16,12,9,13,13,10,6,12,9,5,13,9,19,2,3,3,3,1,2,2,2,2,3,1
"1125",2000045860,"Frank Nodarse","12/6/2000 (22 years old)","D (RC)","Rio Grande Valley","USSL Championship Western Conference","CUB","No","3/12/2022","11/30/2023","$70K - $700K","Right","Reasonable","Very Strong","6'2""","165 lbs","37","2",82,118,6,8,6,1,9,9,11,5,4,11,9,2,12,7,7,11,10,9,10,8,14,5,4,9,13,9,6,10,13,11,7,13,10,12,9,11,12,18,11,11,11,12,6,10,12,6,10,10,18,1,1,3,4,1,3,1,1,2,2,4
"1126",67283147,"Cavafe","4/25/1999 (24 years old)","D (C)","FC Dornbirn","Austrian First Division","CUB","Yes","7/1/2022","6/30/2023","$1K - $9K","Right","Fairly Strong","Very Strong","6'1""","169 lbs","105","3",93,116,4,3,1,5,7,2,14,4,7,7,9,6,13,8,9,11,10,8,11,14,3,5,12,7,13,6,4,9,14,11,9,13,13,14,7,7,13,14,9,10,11,11,5,10,9,4,16,12,16,1,2,3,3,1,1,3,3,1,2,2
"1127",82050031,"Marcel Hernández","7/11/1989 (33 years old)","AM (C), ST (C)","Cartaginés","Primera División de Costa Rica","CUB","No","1/6/2022","6/30/2024","$6K - $60K","Right","Reasonable","Very Strong","6'0""","163 lbs","193","116",108,115,9,5,10,10,12,9,7,11,7,7,12,7,8,13,10,15,10,15,10,15,6,13,5,15,8,9,11,11,10,13,10,12,13,13,13,11,12,17,11,13,14,10,10,11,10,3,14,8,11,3,2,3,3,3,1,3,3,4,1,1
"1128",2000089204,"Karel Espino","10/27/2001 (21 years old)","D (C), DM, M (C)","Comunicaciones","Liga Nacional de Guatemala","CUB","No","7/1/2021","6/30/2025","$150K - $1.5M","Right","Reasonable","Very Strong","6'0""","171 lbs","87","3",83,113,5,7,8,10,9,7,11,9,4,10,11,6,12,10,12,12,14,10,9,9,4,5,9,10,12,11,12,12,10,10,12,11,12,10,7,10,15,11,11,12,12,12,10,10,8,7,12,10,19,2,1,1,2,1,2,1,1,4,3,2
"1129",2000205928,"Alvaro Ruiz Rente","6/14/2006 (16 years old)","M/AM (R)","Birmingham","Sky Bet Championship","CUB","No","8/2/2022","6/30/2024","$110K - $1.1M","Right","Reasonable","Very Strong","5'7""","130 lbs","-","-",70,111,7,8,8,9,9,7,7,6,6,7,9,6,7,9,15,6,8,10,8,14,18,9,2,10,3,8,12,13,11,12,8,4,14,11,14,8,9,16,12,11,11,10,6,16,11,7,8,12,14,1,1,3,1,3,2,2,1,2,2,2
"1130",19068189,"Ariel Martínez","5/9/1986 (37 years old)","M (R), AM (RL)","Tampa Bay","USSL Championship Eastern Conference","CUB","No","1/19/2023","11/30/2023","$18K - $55K","Left Only","Very Strong","Weak","5'11""","171 lbs","163","35",93,111,11,10,12,10,10,9,6,7,10,5,9,3,4,11,6,9,7,11,12,9,11,14,4,11,7,8,10,11,14,14,12,7,18,13,10,7,14,14,12,17,10,10,8,7,5,4,9,8,17,2,2,1,3,2,1,3,2,1,1,1
"1131",20030398,"Maikel Chang","4/18/1991 (32 years old)","M (R), AM (RL)","Real Salt Lake","Major League Soccer","CUB","No","1/12/2023","12/31/2023","$300K","Left","Very Strong","Fairly Strong","5'10""","165 lbs","283","39",109,110,12,13,11,10,11,12,7,8,10,6,12,3,7,13,10,9,12,8,10,10,4,13,7,12,10,11,13,14,13,12,12,9,16,12,13,11,15,17,12,9,12,10,9,11,6,2,11,9,15,1,2,3,4,1,2,3,1,1,1,1
"1132",2000088523,"Bruno Rendón","5/7/2000 (23 years old)","D (C), DM","Northern Colorado","United States Soccer Leagues Division One","CUB","No","2/1/2023","11/30/2023","$16K - $160K","Right Only","Weak","Very Strong","6'2""","176 lbs","15","3",88,109,4,5,4,4,10,7,11,6,5,10,10,5,13,8,15,15,10,9,11,15,7,5,1,4,9,8,7,10,11,11,9,13,16,11,10,10,12,20,8,12,11,10,14,14,13,4,10,9,11,2,1,1,3,2,2,1,1,2,3,1
"1133",2115756,"Mario Gil","10/17/1985 (37 years old)","ST (C)","La Habana","Cuban National League","CUB","No","6/14/2021","12/31/2024","$0","Right","Reasonable","Very Strong","6'0""","169 lbs","-","-",68,106,6,5,8,13,14,6,14,6,5,6,7,5,1,9,12,10,7,9,7,9,12,11,13,14,6,6,5,7,8,7,5,11,13,8,8,7,10,15,12,12,9,11,11,8,15,5,17,11,16,3,3,2,1,1,3,1,1,2,2,3
"1134",2000045858,"Modesto Méndez","1/6/1998 (25 years old)","D (C)","Inter Miami II","MLS Next Pro Eastern Conference","CUB","No","2/15/2020","12/31/2026","$0","Right","Reasonable","Very Strong","6'2""","171 lbs","39","2",91,105,5,2,6,7,8,3,12,9,2,10,8,9,16,7,7,12,11,15,11,9,15,5,12,9,10,10,10,11,12,12,8,13,13,12,12,12,14,14,8,11,13,12,9,1,8,8,13,11,11,2,2,2,3,2,3,2,3,1,1,3
"1135",23414228,"Firas Al-Buraikan","5/14/2000 (23 years old)","ST (C)","Al-Fateh","Saudi Professional League","KSA","No","6/3/2023","6/30/2028","$8.2M - $12.5M","Left","Very Strong","Reasonable","5'11""","165 lbs","85","32",120,130,6,8,11,15,12,10,12,10,8,9,11,14,9,12,8,13,11,14,12,12,11,12,9,13,10,11,12,12,13,13,12,10,11,14,12,10,10,13,13,12,9,6,6,11,7,8,11,12,13,3,3,2,1,2,2,3,3,1,3,3
"1136",20049602,"Luis Paradela","1/21/1997 (26 years old)","AM (LC), ST (C)","Saprissa","Primera División de Costa Rica","CUB","No","5/31/2022","5/31/2025","$0 - $100K","Right Only","Weak","Very Strong","5'8""","163 lbs","121","30",100,104,6,10,14,11,12,8,11,8,1,8,13,6,3,11,14,13,4,9,9,11,15,10,5,9,9,9,7,10,14,14,12,7,13,14,14,10,12,13,8,12,7,10,13,15,13,2,17,12,12,3,3,3,3,4,1,3,3,2,3,4
"1137",20046467,"Frank López","2/25/1995 (28 years old)","ST (C)","Rio Grande Valley","USSL Championship Western Conference","CUB","No","2/8/2022","11/30/2023","$18K - $180K","Right Only","Weak","Very Strong","5'9""","154 lbs","120","38",94,102,7,7,14,13,10,6,10,9,1,8,9,4,5,13,13,10,8,9,9,12,9,12,9,13,9,8,7,11,14,14,10,8,18,14,10,9,11,20,12,12,9,9,13,1,12,4,12,10,12,1,2,2,3,2,2,1,1,1,3,2
"1138",2000179043,"Aldair Ruiz","11/13/1997 (25 years old)","AM (RL), ST (C)","Europa FC","Gibraltar Football League","CUB","No","6/1/2023","6/30/2024","$0","Left","Very Strong","Reasonable","6'2""","171 lbs","83","26",80,100,4,8,8,12,10,5,8,7,1,6,8,3,3,7,15,5,4,9,7,10,15,7,8,13,6,7,6,8,13,13,7,13,12,13,13,6,9,10,11,13,10,11,6,13,5,5,10,9,15,3,2,3,3,2,2,1,3,2,3,2
"1139",82050350,"David Urgellés","4/25/1995 (28 years old)","D (RC), WB (R)","Camagüey","Cuban National League","CUB","No","6/15/2020","12/31/2024","$0 - $7K","Right","Reasonable","Very Strong","5'10""","156 lbs","31","1",77,99,4,11,7,6,5,3,8,6,7,7,9,1,12,9,9,9,9,6,7,12,8,5,1,6,10,8,8,9,14,9,8,7,12,13,14,7,15,13,10,10,12,12,7,9,10,6,16,11,16,2,3,1,3,3,3,3,2,1,4,2
"1140",82050008,"Jorge Luís Corrales","5/20/1991 (32 years old)","D/WB (L)","Tulsa","USSL Championship Eastern Conference","CUB","No","12/15/2022","11/30/2023","$35K - $325K","Left","Very Strong","Reasonable","5'9""","169 lbs","142","1",95,99,10,12,11,8,9,5,8,14,12,10,11,7,12,11,10,9,11,11,10,10,15,9,7,11,10,12,9,12,10,11,12,8,17,12,14,11,8,18,11,12,12,8,10,10,6,7,9,16,16,3,3,3,3,2,3,1,1,1,3,2
"1141",51074061,"Raiko Arozarena","3/27/1997 (26 years old)","GK","Tampa Bay","USSL Championship Eastern Conference","CUB","No","4/9/2021","11/30/2023","$75K - $220K","Right Only","Weak","Very Strong","5'11""","178 lbs","43","-",84,98,5,1,3,2,9,8,1,1,1,1,8,2,3,6,8,10,9,8,7,9,14,1,6,1,12,8,7,12,9,13,12,9,8,9,5,12,11,14,10,12,11,10,5,5,9,8,12,9,19,6,9,14,6,10,14,14,14,10,8,9
"1142",82081106,"Dusney Espinosa","3/6/1996 (27 years old)","AM (R), ST (C)","Camagüey","Cuban National League","CUB","No","6/15/2020","12/31/2024","$0 - $7K","Right","Reasonable","Very Strong","6'2""","171 lbs","26","12",75,98,6,11,10,13,13,4,9,7,3,5,8,5,1,9,12,9,2,8,7,8,12,13,12,13,7,6,8,8,13,10,7,10,11,11,13,5,8,15,11,12,12,9,5,7,11,7,10,11,20,4,1,3,3,3,3,2,1,2,3,2
"1143",82050006,"Aliannis Urgellés","6/25/1985 (37 years old)","D (RLC), WB (RL), DM","Mariendorf","German Lower Division","CUB","Yes","7/1/2019","-","$0","Right Only","Weak","Very Strong","6'0""","160 lbs","98","65",70,96,4,8,5,4,11,6,8,2,1,11,5,2,11,9,10,10,9,8,10,14,4,5,8,6,10,8,5,9,6,8,8,7,11,8,8,8,10,20,12,10,13,11,7,12,12,4,12,13,15,1,1,2,1,3,1,3,2,2,2,3
"1144",82070306,"Darío Suárez","8/8/1992 (30 years old)","M/AM (L)","Detroit City","USSL Championship Eastern Conference","CUB","No","6/6/2023","11/30/2023","$45K - $475K","Right","Reasonable","Very Strong","5'7""","145 lbs","118","48",93,95,10,9,9,11,10,10,7,13,10,10,10,6,5,11,7,12,9,13,8,12,11,12,12,16,10,11,10,15,12,12,10,7,15,12,10,7,12,17,8,11,8,12,11,2,12,1,19,12,15,1,3,3,2,1,1,3,1,3,3,3
"1145",2000129640,"Nelson Johnston","2/25/1990 (33 years old)","GK","Jicaral - Sercoba","Liga de Ascenso de Costa Rica","CUB","No","6/30/2022","6/30/2024","$14K - $140K","Right","Reasonable","Very Strong","6'0""","176 lbs","17","-",85,95,2,2,1,2,2,3,1,2,3,1,11,3,3,3,5,11,16,9,12,10,8,2,10,3,9,9,8,8,12,12,9,9,16,11,6,8,11,13,12,12,11,10,7,16,5,6,9,12,17,6,6,9,5,9,11,9,5,8,11,12
"1146",2000227406,"Jathob Muslet","9/9/2006 (16 years old)","M (C)","Al-Batin","Saudi First Division League","KSA","No","7/1/2021","6/30/2026","$275K - $2.7M","Right","Reasonable","Very Strong","5'9""","152 lbs","1","-",65,130,4,6,6,7,12,2,3,6,1,14,8,1,10,7,11,9,4,7,3,11,11,8,2,8,6,7,14,12,13,13,5,9,10,11,7,4,11,15,12,10,10,14,8,9,6,4,11,11,17,3,3,3,2,1,4,3,2,2,1,1
"1147",82050092,"Yosel Piedra","3/27/1994 (29 years old)","D (RLC), WB (RL)","San Carlos","Primera División de Costa Rica","CUB","No","12/31/2021","6/30/2024","$20K - $200K","Right","Strong","Very Strong","6'1""","163 lbs","124","5",87,95,3,9,8,3,5,1,10,2,5,11,8,1,8,8,11,7,9,6,8,11,16,5,10,6,10,7,6,8,11,10,7,13,15,10,13,9,11,16,10,10,11,10,11,8,5,6,12,6,15,3,1,2,1,1,1,3,1,2,2,2
"1148",8835065,"Alaín Cervantes","11/17/1983 (39 years old)","ST (C)","Ciego de Ávila","Cuban National League","CUB","No","6/14/2021","12/31/2024","$0","Right","Reasonable","Very Strong","5'6""","132 lbs","10","1",70,95,7,5,7,15,12,8,15,9,1,5,9,15,4,10,11,15,6,11,9,14,14,8,14,15,9,8,9,9,7,7,7,3,12,7,6,2,11,19,13,15,11,10,10,12,12,2,12,12,15,1,1,2,2,3,3,3,1,1,1,1
"1149",82050007,"Yoel Colomé","10/15/1982 (40 years old)","D/WB (R)","Hoppers","Antigua and Barbuda Premier Division","CUB","No","7/1/2018","6/30/2024","$0","Right Only","Very Weak","Very Strong","5'6""","152 lbs","-","-",71,93,7,11,4,8,11,2,9,3,8,9,10,6,9,8,5,12,10,9,9,15,5,7,12,8,9,13,5,13,7,11,6,4,12,12,9,12,8,10,11,7,11,13,13,10,12,5,20,6,12,3,4,1,2,3,2,3,3,2,1,1
"1150",2000297852,"Erick Rizo","3/7/1991 (32 years old)","D (RC), WB (R)","Ocotal","Primera Division Nicaraguense","CUB","No","6/12/2023","6/30/2025","Not for Sale","Right","Reasonable","Very Strong","5'11""","167 lbs","-","-",84,93,4,7,8,7,10,5,10,8,8,11,7,8,13,7,8,11,6,8,11,15,7,5,12,7,10,9,8,9,11,9,9,10,9,9,11,6,15,15,11,12,10,11,12,15,13,1,20,10,12,1,2,1,2,2,1,3,1,3,2,1
"1151",82050047,"Maikel Reyes","3/4/1993 (30 years old)","AM (R), ST (C)","Jalapa (NIC)","Primera Division Nicaraguense","CUB","No","1/1/2023","6/30/2024","$3.5K - $35K","Right","Reasonable","Very Strong","6'0""","167 lbs","60","13",90,92,8,10,14,11,8,8,10,10,7,5,7,5,7,11,5,9,5,10,9,11,11,8,12,9,7,8,9,10,13,14,9,10,11,13,10,8,11,18,12,12,13,11,8,14,8,8,11,7,11,3,2,3,1,1,1,2,1,2,2,2
"1152",53125232,"Willian Pozo-Venta","8/27/1997 (25 years old)","AM (RLC), ST (C)","FC KTP","Finnish Premier League","CUB","Yes","1/13/2023","11/15/2023","$0 - $120K","Right","Reasonable","Very Strong","6'0""","167 lbs","71","10",89,92,10,12,13,10,12,10,6,10,4,7,9,11,6,13,11,7,6,7,6,7,8,15,4,9,5,6,8,7,13,11,11,13,12,12,11,10,11,9,8,8,10,3,15,13,10,13,8,9,9,2,3,2,1,4,2,3,3,3,2,3
"1153",82050060,"Jordan Santa Cruz","10/7/1993 (29 years old)","M/AM (L), ST (C)","Cienfuegos","Cuban National League","CUB","No","6/15/2020","12/31/2024","$0","Right","Reasonable","Very Strong","5'10""","149 lbs","-","-",65,90,5,7,9,12,13,4,7,6,1,4,7,4,3,9,12,6,5,6,5,11,11,9,12,12,5,10,3,8,12,11,6,7,15,12,12,3,8,14,9,11,13,12,6,1,14,1,17,6,10,2,2,3,4,3,4,2,3,2,2,2
"1154",82050035,"Carlos Francisco","5/22/1990 (33 years old)","D/WB (L), DM, M (LC)","Santiago de Cuba","Cuban National League","CUB","No","6/14/2021","12/31/2024","Not for Sale","Right","Fairly Strong","Very Strong","5'11""","165 lbs","14","3",87,90,5,9,5,2,10,7,2,8,7,9,12,3,10,9,8,10,8,7,7,14,7,5,8,8,9,8,5,9,12,12,4,6,8,12,12,5,13,10,11,11,13,11,5,7,9,7,11,12,18,2,3,3,1,1,3,3,3,2,3,1
"1155",82050095,"Daniel Luis","5/11/1994 (29 years old)","DM, M (C)","PDX FC","USSL D2 - Northwest Division","CUB","No","4/28/2023","-","$0","Right","Reasonable","Very Strong","6'5""","180 lbs","43","1",89,90,6,7,2,7,11,7,8,15,3,10,12,1,14,11,10,12,5,9,9,7,10,5,9,8,9,8,11,13,14,13,7,15,12,14,12,12,12,13,11,12,11,10,13,2,5,1,20,6,14,1,1,1,1,3,2,1,2,3,1,4
"1156",2000297095,"Darío Ramos","2/2/1996 (27 years old)","D (C)","Universidad UNAM","Primera Division Nicaraguense","CUB","No","6/12/2023","6/30/2024","$1.5K - $16K","Right","Reasonable","Very Strong","5'10""","158 lbs","-","-",80,90,4,3,1,3,6,1,11,7,3,13,8,2,12,7,9,11,9,8,8,14,3,5,11,7,13,7,1,8,14,13,8,5,15,13,7,9,11,14,12,11,12,13,5,11,5,4,19,8,11,1,1,3,1,1,2,2,2,2,1,4
"1157",2000032859,"Haitham Asiri","7/1/2001 (21 years old)","M/AM (R), ST (C)","Al-Ahli (KSA)","Saudi Professional League","KSA","No","7/25/2022","6/30/2026","$9.6M - $12M","Right","Reasonable","Very Strong","5'8""","154 lbs","62","13",110,130,12,11,13,9,13,10,8,12,13,5,10,8,6,14,6,11,11,12,9,9,12,8,5,11,11,9,8,9,13,13,12,8,9,14,13,12,12,8,9,9,9,7,9,7,11,8,8,9,8,1,2,4,1,1,1,1,2,1,3,2
"1158",82070240,"Adrián Diz Pe","3/4/1994 (29 years old)","D (LC)","Indy Eleven","USSL Championship Eastern Conference","CUB","No","3/1/2023","11/30/2023","$30K - $300K","Right","Reasonable","Very Strong","6'4""","185 lbs","100","3",90,90,5,6,8,4,8,3,14,5,10,9,9,3,12,8,13,12,11,9,8,8,11,5,8,6,9,10,10,10,12,10,9,15,11,13,14,13,14,10,5,3,13,4,7,10,15,16,10,14,16,2,2,2,2,3,1,4,2,4,3,1
"1159",2000088519,"Brian Savigne","3/27/2000 (23 years old)","M/AM (R), ST (C)","Santiago de Cuba","Cuban National League","CUB","No","6/15/2020","12/31/2025","$0 - $1.5K","Right","Reasonable","Very Strong","5'4""","123 lbs","-","-",73,90,7,10,14,14,14,7,9,8,6,7,8,7,4,10,9,11,5,11,8,11,15,9,12,13,7,8,9,9,13,12,8,3,13,9,7,1,10,17,13,12,11,9,10,14,13,6,14,11,17,1,1,2,2,1,2,2,3,4,2,1
"1160",2000009145,"Sandro Cutiño","3/3/1995 (28 years old)","D (C)","Las Tunas","Cuban National League","CUB","No","1/1/2022","12/31/2024","$2.5K - $8K","Right","Reasonable","Very Strong","6'3""","152 lbs","20","-",77,90,2,2,2,5,6,1,14,1,4,14,3,1,8,7,5,13,9,5,5,10,19,6,9,7,14,7,7,8,8,10,8,15,13,12,5,8,11,11,11,12,12,10,7,11,14,6,13,13,20,3,3,1,4,1,1,2,3,2,1,3
"1161",2000204548,"Osniel Ramos","2/25/2002 (21 years old)","D/WB (R)","Artemisa","Cuban National League","CUB","No","1/1/2020","12/31/2025","$0 - $4K","Right","Fairly Strong","Very Strong","5'7""","136 lbs","-","-",76,90,7,12,7,1,12,2,5,4,6,10,7,2,12,7,7,11,10,9,7,9,8,5,9,4,6,9,4,9,13,15,9,7,9,14,11,2,15,20,10,10,10,11,7,6,11,7,10,11,16,1,3,3,2,3,2,4,3,1,1,1
"1162",2115753,"Julio Aldama","3/12/1981 (42 years old)","GK","Matanzas","Cuban National League","CUB","No","6/14/2021","12/31/2024","Not for Sale","Right","Reasonable","Very Strong","6'4""","182 lbs","-","-",75,88,4,2,1,3,5,7,2,1,3,1,10,2,3,3,7,10,10,9,13,15,13,3,13,3,13,9,8,4,5,10,5,12,13,5,5,5,11,17,10,12,12,11,6,11,8,1,10,10,11,10,10,5,7,12,10,12,6,8,10,11
"1163",2000271998,"Daniel Díaz","7/30/2002 (20 years old)","AM (RL), ST (C)","San Carlos","Primera División de Costa Rica","CUB","No","7/1/2022","6/30/2024","$30K - $300K","Right","Reasonable","Very Strong","6'0""","174 lbs","17","3",65,88,6,10,10,14,10,6,8,2,5,6,11,7,6,12,6,5,4,5,7,10,14,11,1,7,6,7,8,8,12,10,7,11,12,9,6,5,10,15,13,12,11,9,7,6,10,1,8,10,10,3,1,1,1,4,1,2,4,3,1,1
"1164",82080480,"Roberney Caballero","11/2/1995 (27 years old)","M/AM (RL)","La Habana","Cuban National League","CUB","No","1/1/2022","12/31/2025","$0","Right","Fairly Strong","Very Strong","5'7""","136 lbs","33","12",82,88,4,8,12,8,13,6,5,5,6,5,9,2,6,10,14,7,8,6,4,12,13,14,7,13,5,7,8,12,13,13,5,5,9,13,9,1,12,19,11,9,9,11,10,10,7,3,9,11,11,3,1,1,3,3,2,1,3,1,2,2
"1165",2000287867,"Eduardo Hernádez","2/18/2003 (20 years old)","D (C), DM, M (C)","Santiago de Cuba","Cuban National League","CUB","No","2/18/2021","-","$0","Right","Reasonable","Very Strong","6'2""","167 lbs","-","-",77,87,6,9,10,7,14,9,9,9,2,10,15,6,16,11,11,10,9,10,8,7,4,12,11,10,9,10,7,8,10,10,10,13,15,8,10,9,16,17,12,10,10,12,6,11,13,6,11,12,12,2,2,2,2,3,3,1,2,3,3,2
"1166",2000088513,"Miguel Coll","7/12/2000 (22 years old)","D (C)","Granma","Cuban National League","CUB","No","1/1/2020","12/31/2025","$1.5K - $4.5K","Right","Fairly Strong","Very Strong","5'11""","160 lbs","-","-",77,87,4,1,3,1,6,2,14,4,5,13,8,2,14,6,15,13,9,8,5,9,11,5,7,6,14,7,5,8,13,12,8,11,12,10,11,7,18,18,10,13,10,12,7,4,6,5,9,9,7,1,2,2,1,3,3,3,2,3,2,2
"1167",82080284,"Alejandro Portal","10/21/1995 (27 years old)","D (R), M/AM (C)","Simcoe County Rovers FC","League1 Ontario","CUB","No","12/31/2022","-","$0","Right","Weak","Very Strong","5'9""","156 lbs","65","5",82,87,9,10,11,8,10,7,8,7,10,10,11,4,9,11,8,9,7,11,9,9,14,14,10,9,11,9,9,10,12,11,10,8,10,12,12,10,13,11,10,12,11,9,5,15,5,4,10,8,12,1,2,2,1,3,2,2,1,2,3,4
"1168",2000106805,"Nawaf Al-Aqidi","5/10/2000 (23 years old)","GK","Al-Nassr (KSA)","Saudi Professional League","KSA","No","1/30/2022","6/30/2025","$2.7M - $5.4M","Right Only","Weak","Very Strong","6'2""","187 lbs","18","-",110,130,3,3,8,2,10,4,1,3,1,2,9,3,2,9,8,12,13,10,11,12,15,6,7,6,13,14,10,9,11,14,12,12,13,11,11,12,11,9,10,12,9,11,6,10,6,8,12,12,11,12,9,13,9,12,11,12,13,11,10,11
"1169",43459247,"Adrián Osorio","4/14/1998 (25 years old)","AM (RLC)","Virtus Bolzano","Italian Serie D Grp. C","CUB","No","1/1/2021","6/30/2024","$0","Right Only","Weak","Very Strong","5'11""","160 lbs","97","20",76,86,7,8,12,10,11,9,8,7,3,4,12,10,7,11,9,10,11,7,8,8,10,12,11,11,7,12,12,8,12,11,15,9,15,10,11,10,8,7,10,12,9,9,5,10,5,3,11,9,15,1,1,1,1,3,2,4,3,3,1,3
"1170",82090267,"Jorge Villalón","8/15/1991 (31 years old)","M/AM (C), ST (C)","Real Madriz","Liga de Ascenso de Nicaragua","CUB","No","1/1/2022","6/30/2024","$2K - $18K","Right Only","Weak","Very Strong","6'2""","174 lbs","60","23",78,85,7,6,6,13,14,7,8,8,1,7,9,4,4,11,14,11,4,10,8,14,7,10,10,13,7,8,12,9,8,9,7,14,11,8,7,6,10,11,10,12,9,11,8,11,5,4,9,8,17,1,2,3,4,2,4,3,2,1,3,1
"1171",82050100,"Yolexis Collado","2/21/1994 (29 years old)","D/WB/M/AM (R)","La Habana","Cuban National League","CUB","No","6/15/2020","12/31/2024","$0 - $3.5K","Right","Reasonable","Very Strong","5'7""","134 lbs","9","-",72,85,5,10,7,8,8,6,5,1,2,4,6,1,8,10,11,8,8,8,8,8,9,10,1,10,8,7,7,8,13,13,7,6,15,13,12,2,13,12,10,13,12,10,9,2,5,7,20,9,15,2,2,3,3,3,1,3,2,1,1,3
"1172",82080296,"Shatdrian Martell","6/25/1995 (27 years old)","M (R), AM (RL)","Matanzas","Cuban National League","CUB","No","6/15/2020","12/31/2024","$0 - $8K","Right","Fairly Strong","Very Strong","5'10""","149 lbs","-","-",72,85,7,10,11,10,10,5,1,6,3,1,8,2,6,5,12,9,7,8,6,10,7,13,9,11,5,6,6,11,12,12,6,5,15,12,12,3,11,12,11,12,13,9,9,1,10,1,13,10,20,2,2,1,3,2,3,1,3,3,3,3
"1173",82070267,"Andy Baquero","3/17/1994 (29 years old)","D (RLC), WB (R), DM, M (C)","Valour FC","Canadian Premier League","CUB","No","11/3/2022","11/30/2023","$3.5K - $35K","Right","Reasonable","Very Strong","5'8""","158 lbs","94","10",85,85,5,11,10,7,10,5,7,11,8,10,11,5,8,10,11,9,10,8,9,8,17,9,12,10,8,11,10,12,10,11,11,6,10,10,12,11,11,13,13,10,10,11,6,12,6,7,8,8,9,2,1,2,2,1,3,1,2,2,2,1
"1174",2000216317,"Óscar Sargen","7/26/2004 (18 years old)","M (R)","Mensajero","Spanish Federation Second Group 5","CUB","Yes","6/13/2022","6/30/2025","$6K - $18K","Right","Weak","Very Strong","5'8""","136 lbs","-","-",58,85,7,11,8,5,8,5,4,5,4,5,7,1,5,13,15,7,1,2,6,4,7,5,2,3,4,7,7,12,13,10,13,2,10,12,14,3,10,18,9,11,12,10,12,12,12,8,6,11,7,1,3,3,2,1,3,3,2,1,3,3
"1175",65032608,"Peter Shalulile","3/23/1993 (30 years old)","AM (RLC), ST (C)","Sundowns","South African Premier Soccer League","NAM","No","7/1/2020","6/30/2024","$80K - $800K","Right","Fairly Strong","Very Strong","5'8""","147 lbs","193","94",131,142,8,8,11,14,12,7,13,8,2,5,8,11,7,12,8,11,13,13,12,10,13,12,7,11,12,13,9,19,17,11,12,11,18,16,18,9,11,13,15,18,11,13,8,13,5,1,15,11,12,1,1,3,3,2,1,3,3,1,2,3
"1176",13139039,"Deon Hotto","10/29/1991 (31 years old)","M (L), AM (RL)","Orlando Pirates","South African Premier Soccer League","NAM","No","7/1/2020","6/30/2024","$2K - $20K","Left","Very Strong","Reasonable","5'7""","145 lbs","262","33",119,130,9,11,13,8,9,9,8,14,2,9,8,4,11,12,8,12,10,11,11,14,14,11,13,10,6,9,13,11,18,14,10,5,6,16,7,7,14,18,15,11,11,14,9,8,5,6,14,12,16,2,3,1,4,1,1,3,3,1,3,2
"1177",29142085,"Ryan Nyambe","12/4/1997 (25 years old)","D (RC), WB (R)","Wigan","Sky Bet League One","NAM","No","7/20/2022","6/30/2025","$1.8M - $3.8M","Right Only","Weak","Very Strong","6'0""","182 lbs","214","-",114,125,4,7,10,4,10,3,12,3,7,14,9,6,14,10,13,11,13,10,12,11,18,6,8,11,11,14,8,16,15,11,12,11,17,15,15,16,13,15,7,18,12,9,15,10,6,2,14,14,14,2,2,2,3,2,4,1,1,1,1,3
"1178",13104113,"Sidney Urikhob","1/20/1992 (31 years old)","ST (C)","North Bangkok Univ.","Thai League Three Bangkok Perimeter Region","NAM","No","8/27/2021","6/30/2024","$80K - $230K","Right","Reasonable","Very Strong","5'9""","154 lbs","78","25",97,112,7,7,14,14,14,6,11,9,4,6,9,11,4,11,8,13,9,12,7,11,14,10,14,14,8,8,9,9,9,13,5,7,15,10,10,9,12,14,9,11,11,12,10,9,7,4,10,12,18,1,4,1,1,1,2,2,3,1,3,1
"1179",2000045364,"Faisal Al-Ghamdi","8/13/2001 (21 years old)","DM, M (C)","Al-Ettifaq","Saudi Professional League","KSA","No","7/1/2019","6/30/2024","$8.8M - $13.5M","Right","Reasonable","Very Strong","6'0""","169 lbs","25","-",100,128,8,8,10,6,10,6,9,4,3,13,13,6,14,11,9,11,10,11,12,12,10,6,7,10,13,12,11,13,11,14,11,7,9,11,11,10,6,17,9,8,9,10,7,7,13,6,8,12,14,1,1,1,4,2,1,2,3,2,4,3
"1180",92018221,"Manfred Starke","2/21/1991 (32 years old)","AM (LC), ST (C)","VfB Oldenburg","German Regional Division North","NAM","Yes","7/1/2022","6/30/2024","$0","Left Only","Very Strong","Weak","5'10""","185 lbs","362","68",109,111,10,10,11,11,10,12,11,14,9,8,9,12,11,13,11,12,12,9,9,10,14,12,8,13,9,13,14,16,13,12,13,12,11,13,12,12,13,13,12,13,11,15,13,11,5,4,14,11,10,3,2,1,2,2,4,3,3,2,2,2
"1181",13201802,"Riaan Hanamub","2/8/1995 (28 years old)","D (L)","AmaZulu","South African Premier Soccer League","NAM","No","7/1/2022","6/30/2024","$16K - $160K","Left","Very Strong","Weak","5'7""","149 lbs","118","2",108,110,8,14,9,4,12,4,10,6,4,11,10,7,13,8,14,12,11,10,12,9,3,5,7,9,10,10,10,10,15,15,10,7,6,15,15,7,12,15,12,11,11,10,10,3,5,7,11,9,11,1,3,1,1,1,1,4,2,1,1,2
"1182",13104253,"Virgil Vries","3/29/1989 (34 years old)","GK","NB La Masia","South African National First Division Championship","NAM","No","6/1/2022","6/30/2024","$8K - $24K","Right Only","Very Weak","Very Strong","6'0""","163 lbs","151","-",100,105,4,2,2,1,4,7,2,2,3,3,11,3,3,8,5,12,12,10,10,15,10,2,10,1,13,8,9,9,11,7,7,9,8,12,7,7,12,11,12,12,11,11,9,17,11,7,12,8,18,9,7,7,10,10,11,12,5,13,13,15
"1183",12014099,"Rudolph Bester","9/17/1983 (39 years old)","AM (RLC), ST (C)","Alexandra Aces","SAFA Gauteng Division 2","NAM","No","6/14/2021","6/30/2024","$1K - $10K","Left","Very Strong","Reasonable","5'10""","154 lbs","133","20",99,105,10,10,13,10,12,8,9,12,8,6,11,9,8,13,12,10,12,10,9,11,2,14,9,12,9,10,12,11,13,11,10,7,16,13,11,7,11,15,10,13,11,10,8,13,10,7,11,10,19,2,1,2,3,3,3,3,2,2,1,3
"1184",13167772,"Ananias Gebhardt","9/8/1988 (34 years old)","D/WB/M/AM (L)","Baroka","South African National First Division Championship","NAM","No","6/16/2018","6/30/2024","$0 - $4.5K","Right","Fairly Strong","Very Strong","6'1""","169 lbs","138","8",99,100,8,12,7,13,12,6,7,7,9,10,8,7,11,12,7,12,10,11,11,11,10,10,6,14,9,10,8,8,12,11,9,15,15,8,10,8,12,16,11,8,9,10,7,13,5,2,20,10,16,2,2,3,1,2,1,3,3,3,3,2
"1185",13204222,"Aprocius Petrus","10/9/1999 (23 years old)","D (L)","Liria","Kosovan Superleague","NAM","No","10/4/2022","6/30/2024","$14K - $140K","Left","Very Strong","Fairly Strong","6'0""","158 lbs","-","-",77,100,5,9,7,5,8,1,8,4,6,11,10,3,14,9,11,9,9,8,9,12,8,5,1,7,10,8,8,13,9,11,8,9,13,11,10,4,12,10,10,12,11,12,12,16,7,6,11,11,16,3,3,3,3,2,2,1,1,3,3,1
"1186",13167762,"Tiberius Lombard","5/24/1989 (34 years old)","D (C)","City of Lusaka","Zambian First Division","NAM","No","7/1/2022","6/30/2024","$0","Right Only","Very Weak","Very Strong","5'10""","165 lbs","8","-",93,100,5,6,5,7,10,4,13,3,6,13,8,3,12,5,14,13,13,12,13,10,11,4,13,7,11,7,5,11,12,12,11,13,12,12,13,12,14,11,13,10,10,12,6,8,8,4,8,11,9,2,3,2,3,3,2,2,2,2,3,1
"1187",65030407,"Maximilian Mbaeva","4/14/1989 (34 years old)","GK","Milford FC","South African National First Division Championship","NAM","No","1/1/2023","6/30/2024","$1K - $10K","Right Only","Very Weak","Very Strong","5'11""","158 lbs","87","-",92,100,5,3,3,2,3,7,1,1,3,1,7,1,3,6,12,11,11,7,10,14,14,1,5,3,13,9,6,8,10,13,9,11,14,8,8,7,11,20,9,11,9,10,12,4,8,7,20,9,10,8,9,11,14,11,10,14,13,10,14,9
"1188",13204217,"Lubeni Haukongo","9/24/2000 (22 years old)","D (C)","Cape Town Spurs","South African Premier Soccer League","NAM","No","7/1/2022","6/30/2024","$35K - $110K","Right","Reasonable","Very Strong","6'2""","174 lbs","10","-",90,100,3,4,1,2,8,1,12,6,5,13,6,1,12,7,14,11,6,8,10,13,9,7,14,7,13,7,5,8,11,12,8,13,15,10,5,8,14,14,11,11,12,11,8,5,8,7,15,12,18,3,2,2,2,2,3,2,3,3,4,3
"1189",12014105,"Brian Brendell","9/7/1986 (36 years old)","M/AM (L)","Civics","Namibian Premier Division","NAM","No","6/14/2021","6/30/2024","$4.5K - $14K","Left","Very Strong","Weak","5'10""","156 lbs","-","-",75,100,7,12,8,4,13,6,7,11,6,6,13,1,7,11,12,8,11,12,7,11,9,12,11,9,5,7,3,8,13,12,9,11,10,13,11,7,10,10,13,11,9,11,10,1,8,5,6,11,15,3,1,3,2,1,2,2,1,3,3,1
"1190",2000114359,"Abdulaziz Al-Alewa","2/11/2004 (19 years old)","M/AM (C)","Al-Nassr (KSA)","Saudi Professional League","KSA","No","8/8/2021","6/30/2024","$800K - $5.6M","Right","Reasonable","Very Strong","6'0""","152 lbs","1","-",95,127,7,7,9,12,13,7,3,8,6,5,11,6,8,13,6,9,6,7,6,13,17,13,3,12,4,8,12,12,13,13,8,10,11,13,13,7,12,14,10,12,12,9,5,15,5,4,12,10,14,2,2,2,2,1,1,3,3,2,1,3
"1191",2000204622,"Bethuel Muzeu","2/22/2000 (23 years old)","ST (C)","Black Leopards","South African National First Division Championship","NAM","No","7/1/2022","6/30/2024","$0 - $35K","Right","Reasonable","Very Strong","6'0""","165 lbs","17","1",71,100,2,2,10,13,13,6,12,7,1,5,3,8,1,13,7,12,8,10,7,11,10,13,7,11,7,6,6,7,13,9,7,6,15,10,5,6,10,15,12,14,11,12,8,1,8,8,9,9,8,3,1,2,3,3,3,2,4,3,2,3
"1192",13104122,"Willy Stephanus","6/26/1991 (31 years old)","AM (RL)","African Stars","Namibian Premier Division","NAM","No","7/1/2022","6/30/2024","$14K - $140K","Right","Reasonable","Very Strong","5'10""","160 lbs","63","13",90,99,7,11,13,10,9,8,6,9,5,6,13,11,6,13,11,8,9,10,10,9,7,11,10,10,10,9,8,12,13,12,9,8,12,11,12,9,12,17,10,12,10,12,10,5,7,5,10,12,16,2,1,1,4,1,3,1,3,2,3,1
"1193",13201793,"Edward Maova","9/5/1994 (28 years old)","GK","AmaTuks","South African National First Division Championship","NAM","No","6/1/2023","6/30/2024","$18K - $55K","Right","Fairly Strong","Very Strong","6'4""","176 lbs","35","-",85,99,1,3,3,2,2,5,1,1,3,2,9,2,1,3,13,13,15,6,10,13,14,1,4,2,8,7,6,6,11,7,7,13,13,11,1,6,11,18,13,12,14,12,9,12,12,2,11,9,14,10,13,13,6,5,7,12,5,11,11,13
"1194",2000165496,"Eiliv Hoel Solheim","11/3/2003 (19 years old)","M (C), AM (RC), ST (C)","Strømmen","Norwegian Fourth Division Akershus","NAM","Yes","3/22/2022","12/31/2024","$0 - $5K","Right Only","Weak","Very Strong","6'1""","165 lbs","41","13",74,98,8,8,10,9,10,9,6,10,4,7,10,10,7,11,12,10,12,11,9,9,12,13,10,11,8,11,11,12,10,9,9,12,9,10,12,8,11,8,8,10,12,10,14,13,12,11,12,13,12,1,1,2,2,2,3,1,3,1,3,1
"1195",2000181855,"Ngazikue Kandetu","6/20/2001 (21 years old)","D (C)","Young African FC","Namibian Premier Division","NAM","No","7/1/2021","6/30/2024","$0","Right","Reasonable","Very Strong","6'4""","185 lbs","-","-",57,98,2,5,4,1,5,1,9,2,4,13,6,5,11,1,12,13,8,3,5,13,18,5,8,5,13,5,5,6,6,9,6,10,9,8,7,8,13,10,11,11,13,14,8,12,8,5,9,10,10,4,1,2,2,2,1,1,3,3,2,1
"1196",13104123,"Larry Horaeb","11/12/1991 (31 years old)","D/WB (R), DM","FC Ongos","Namibian Premier Division","NAM","No","7/1/2018","6/30/2024","$3.5K - $35K","Right","Reasonable","Very Strong","5'9""","158 lbs","16","-",82,95,7,9,6,5,11,7,7,8,6,9,9,5,13,9,5,9,8,8,9,10,6,5,3,7,10,9,8,9,11,12,9,8,7,10,14,7,10,11,10,12,10,10,10,10,10,8,12,8,11,2,1,3,3,4,2,3,1,1,3,3
"1197",13158688,"Joslin Kamatuka","7/22/1991 (31 years old)","AM (RLC), ST (C)","Baroka","South African National First Division Championship","NAM","No","8/31/2020","6/30/2024","$0","Right Only","Weak","Very Strong","5'9""","141 lbs","57","7",84,95,8,13,12,12,8,8,6,10,8,6,13,4,5,11,7,7,12,6,7,6,9,9,9,12,6,12,11,13,12,12,7,6,12,13,12,7,9,19,13,12,12,12,6,7,5,5,5,9,7,4,1,3,3,3,3,2,3,2,1,1
"1198",2000242200,"Carl Karuuombe","9/21/2001 (21 years old)","DM, M (C)","UNAM","Namibian Premier Division","NAM","No","4/6/2023","6/30/2024","$0 - $35K","Right","Reasonable","Very Strong","5'9""","156 lbs","1","-",65,90,6,4,5,7,13,6,7,8,6,9,6,4,14,8,12,7,4,8,8,14,10,5,12,7,10,7,8,12,10,9,7,6,8,8,9,6,11,16,8,10,14,12,7,10,7,5,10,10,7,4,3,2,3,1,1,3,1,1,3,1
"1199",13178174,"Absalom Iimbondi","10/11/1991 (31 years old)","M/AM (R), ST (C)","Tigers","Namibian Premier Division","NAM","No","6/14/2021","6/30/2024","$16K - $160K","Right","Reasonable","Very Strong","5'7""","136 lbs","-","-",85,90,7,7,14,14,10,8,7,10,1,8,7,9,8,12,14,9,6,12,9,15,13,10,14,10,8,9,8,10,9,8,9,6,12,12,14,3,11,14,11,11,10,14,10,10,11,3,9,11,10,1,2,3,1,3,3,3,3,1,1,2
"1200",13167743,"Lloyd Kazapua","3/25/1989 (34 years old)","GK","Chippa Utd","South African Premier Soccer League","NAM","No","7/1/2021","6/30/2024","$1K - $12K","Right","Reasonable","Very Strong","5'10""","152 lbs","54","-",80,90,2,2,2,1,1,5,1,3,2,2,10,2,3,1,15,8,14,8,8,14,9,1,12,2,12,8,7,7,11,6,3,7,11,11,6,5,11,20,13,12,10,12,8,10,8,5,13,12,9,11,10,11,7,8,11,14,5,8,12,12
"1201",2000227142,"Abdulmalik Al-Jaber","1/7/2004 (19 years old)","M/AM (C)","Ohod","Saudi First Division League","KSA","No","8/3/2022","6/30/2026","$0","Right","Fairly Strong","Very Strong","5'11""","156 lbs","-","-",77,127,3,4,8,13,13,5,6,6,1,7,11,6,8,13,14,6,8,7,7,12,4,13,5,9,8,7,13,11,11,13,7,10,9,13,9,4,10,13,12,11,13,11,5,5,10,1,11,10,14,1,4,3,3,4,2,1,3,1,2,3
"1202",2000024703,"Elmo Kambindu","5/26/1993 (30 years old)","ST (C)","Chippa Utd","South African Premier Soccer League","NAM","No","7/15/2022","6/30/2024","$2.5K - $24K","Right","Weak","Very Strong","6'0""","171 lbs","14","-",85,90,7,8,14,14,8,7,9,8,2,7,12,3,6,13,9,13,7,9,8,12,7,12,11,12,6,7,7,11,14,10,10,7,10,13,14,4,11,16,9,10,12,14,5,12,9,4,13,12,13,1,1,2,1,3,3,2,2,1,2,3
"1203",13226585,"Issaskar Gurirab","1/3/1998 (25 years old)","ST (C)","Orapa Utd","Botswanan Premier Division","NAM","No","10/1/2022","6/30/2025","$0","Right","Fairly Strong","Very Strong","6'1""","163 lbs","-","-",80,90,5,2,13,13,9,6,13,6,1,5,7,5,2,5,5,9,8,11,7,8,6,12,13,13,7,6,5,8,13,10,6,7,14,12,13,5,10,20,11,11,12,12,8,8,15,3,12,11,9,3,2,3,2,1,4,2,3,3,1,3
"1204",2000092097,"Kennedy Amutenya","7/15/1995 (27 years old)","D (C), DM","Gaborone Utd","Botswanan Premier Division","NAM","No","1/14/2022","6/30/2024","$30K - $100K","Right","Weak","Very Strong","6'4""","196 lbs","124","6",85,90,5,1,1,5,6,3,11,6,3,12,8,5,12,5,12,10,9,8,6,10,11,5,12,6,13,6,4,6,13,9,8,15,12,10,11,13,14,10,12,10,13,11,7,10,5,3,17,13,17,1,3,3,3,1,1,2,1,2,1,1
"1205",13204230,"Abraham Mbakondja Tjahikika","8/2/2000 (22 years old)","M/AM (L)","Eleven Arrows","Namibian Lower Divisions","NAM","No","7/1/2020","6/30/2024","$0","Left","Very Strong","Reasonable","5'10""","152 lbs","-","-",60,89,8,11,11,9,8,6,6,7,1,6,12,5,5,11,9,9,5,7,7,13,15,10,1,14,6,7,5,11,14,12,7,5,9,9,6,4,16,14,8,10,11,10,9,7,13,7,8,12,10,3,2,3,2,1,3,2,3,1,1,1
"1206",13204231,"Giovani Kaninab","4/16/2001 (22 years old)","M/AM (R), ST (C)","Civics","Namibian Premier Division","NAM","No","7/1/2021","6/30/2025","$2K - $22K","Either","Very Strong","Very Strong","6'0""","158 lbs","-","-",53,89,3,8,6,10,11,4,6,4,1,4,3,6,2,10,12,7,2,9,5,7,6,12,1,10,4,5,5,6,12,9,5,6,9,11,7,3,10,16,13,9,12,11,9,8,11,4,8,13,8,1,3,1,4,2,2,1,4,3,3,3
"1207",13211621,"Marcel Papama","4/28/1996 (27 years old)","M (C)","Jwaneng Galaxy","Botswanan Premier Division","NAM","No","2/1/2022","6/30/2024","$0","Right","Reasonable","Very Strong","5'7""","138 lbs","-","-",78,89,7,3,3,3,14,7,6,5,6,13,14,5,9,10,13,7,3,10,8,12,14,5,7,12,8,8,10,13,13,12,4,5,7,12,13,1,15,18,12,13,12,11,7,7,9,6,11,13,8,1,1,1,1,2,3,3,2,3,3,1
"1208",13226579,"Wesley Katjiteo","2/17/1990 (33 years old)","DM, M (C)","Black Africa","Namibian Lower Divisions","NAM","No","7/1/2020","6/30/2024","$2K - $22K","Right","Reasonable","Very Strong","5'7""","149 lbs","9","-",82,88,4,7,5,4,11,7,6,7,3,8,7,4,14,9,12,10,6,9,9,13,13,5,13,6,14,8,11,13,10,10,8,5,11,8,12,7,10,14,10,11,9,11,8,11,6,8,10,11,16,1,2,2,2,2,3,1,3,3,1,3
"1209",2000312288,"Romin Berndt","7/10/2002 (20 years old)","AM (L), ST (C)","Masitaoka","Botswanan Premier Division","NAM","No","6/12/2023","6/30/2025","$0","Left","Very Strong","Reasonable","5'7""","143 lbs","-","-",64,88,3,9,7,13,9,1,7,5,4,5,7,8,1,10,9,4,5,13,6,10,4,15,8,5,4,6,7,7,13,13,6,1,8,13,5,4,11,14,9,9,12,9,9,8,6,4,17,12,10,3,2,2,2,1,3,2,1,2,3,2
"1210",13204220,"Junior Petrus","4/17/2000 (23 years old)","ST (C)","Blue Waters","Namibian Premier Division","NAM","No","7/1/2021","6/30/2024","$0","Right","Weak","Very Strong","5'10""","167 lbs","-","-",65,87,4,1,13,13,13,5,13,6,4,5,5,7,2,11,8,9,7,11,6,10,1,11,7,8,3,5,5,6,10,12,6,7,14,10,5,13,8,10,12,7,10,13,13,11,5,7,11,12,10,2,2,2,4,1,3,3,3,2,1,3
"1211",2000181859,"Denzel Narib","1/16/2002 (21 years old)","DM, M (C)","Civics","Namibian Premier Division","NAM","No","7/1/2021","6/30/2025","$2K - $22K","Right","Reasonable","Very Strong","5'4""","125 lbs","-","-",55,87,2,4,3,4,12,5,1,7,1,5,12,2,11,7,13,6,7,7,7,13,8,5,13,6,11,6,11,10,13,13,6,1,6,10,6,1,14,14,13,11,12,13,12,7,9,2,10,10,12,4,1,3,1,1,2,1,3,1,4,3
"1212",2000198700,"Yazeed Jawshan","5/4/2003 (20 years old)","AM (R)","Al-Faisaly (KSA)","Saudi First Division League","KSA","No","7/1/2021","6/30/2025","$375K - $3.7M","Right","Fairly Strong","Very Strong","5'7""","143 lbs","-","-",85,126,9,14,15,14,14,8,7,9,5,8,13,5,5,12,5,9,8,5,7,15,10,10,12,8,8,9,10,8,11,11,5,6,12,11,6,5,11,11,10,11,14,15,13,3,8,6,6,10,13,2,3,2,2,2,2,2,2,4,3,3
"1213",13204227,"Augustinus Hobexab","3/20/1999 (24 years old)","M/AM (R)","Julinho Sporting","Namibian Premier Division","NAM","No","7/1/2019","6/30/2024","$1.5K - $14K","Right","Reasonable","Very Strong","5'10""","149 lbs","-","-",65,85,5,10,13,9,10,3,2,6,1,4,10,5,3,11,12,4,7,5,3,13,10,12,8,8,2,6,5,7,13,13,6,6,12,13,11,3,14,10,10,10,11,12,9,5,13,3,11,12,13,1,2,2,2,1,1,3,1,1,4,3
"1214",13201840,"Vitapi Ngaruka","10/16/1995 (27 years old)","D (RC)","Black Africa","Namibian Lower Divisions","NAM","No","6/15/2020","6/30/2024","$0 - $90K","Right","Reasonable","Very Strong","6'1""","178 lbs","-","-",78,85,4,8,7,4,9,1,9,7,7,12,8,4,13,8,12,7,9,8,8,11,17,5,6,7,11,8,4,9,14,12,8,12,6,14,8,11,12,13,9,10,11,11,5,6,14,2,9,10,19,1,2,3,2,3,1,2,2,2,2,2
"1215",13104114,"Alfeus Handura","8/1/1993 (29 years old)","M (C)","African Stars","Namibian Premier Division","NAM","No","7/1/2020","6/30/2024","$0 - $130K","Right Only","Weak","Very Strong","6'0""","165 lbs","-","-",77,85,6,6,5,2,13,6,6,7,3,13,13,5,11,8,12,8,6,11,5,7,17,5,12,10,6,6,11,11,13,13,7,7,15,13,10,9,14,15,12,12,11,13,14,10,13,3,11,13,18,3,3,1,2,2,2,3,2,2,1,3
"1216",13134573,"Roger Katjiteo","3/26/1993 (30 years old)","ST (C)","Black Africa","Namibian Lower Divisions","NAM","No","7/1/2021","6/30/2024","$40K - $120K","Right","Fairly Strong","Very Strong","6'1""","171 lbs","-","-",75,85,6,5,13,13,13,6,13,2,3,5,7,7,1,8,11,9,3,6,7,13,5,13,9,8,7,6,7,7,13,13,7,10,6,13,7,7,9,13,11,12,12,10,11,9,12,4,11,13,20,1,1,3,1,3,2,3,3,3,4,1
"1217",13209356,"Steven Damaseb","10/11/2002 (20 years old)","M (C)","Blue Waters","Namibian Premier Division","NAM","No","3/5/2021","6/30/2024","$0 - $90K","Right","Reasonable","Very Strong","5'8""","145 lbs","-","-",70,85,5,7,7,7,12,4,7,9,1,9,14,1,9,12,8,8,6,4,8,9,9,9,9,9,4,8,9,9,14,11,8,5,15,11,7,6,12,10,10,10,10,11,11,5,6,4,16,12,14,2,2,1,1,2,1,3,1,1,1,1
"1218",2000147603,"Wendell Rudath","7/10/1995 (27 years old)","AM (R), ST (C)","Jwaneng Galaxy","Botswanan Premier Division","NAM","No","8/1/2021","6/30/2025","$3.5K - $35K","Right","Fairly Strong","Very Strong","6'4""","178 lbs","-","-",84,85,6,11,11,12,11,6,8,4,6,6,12,7,6,12,7,9,7,7,6,13,18,12,10,13,5,7,9,8,13,10,7,10,14,11,13,7,12,10,10,10,12,9,9,1,9,1,10,13,19,2,2,2,2,2,1,3,3,1,3,1
"1219",13204219,"Stanley Ndjavera","2/28/2000 (23 years old)","D (C)","FC Ongos","Namibian Premier Division","NAM","No","6/15/2020","-","$0","Right","Reasonable","Very Strong","6'4""","185 lbs","-","-",65,85,1,1,1,1,5,1,8,1,1,12,3,1,12,4,8,10,8,3,5,12,5,5,6,2,12,4,4,6,12,7,5,13,12,7,11,6,12,15,13,11,10,10,8,1,5,4,9,10,14,3,4,3,4,3,2,1,2,2,3,2
"1220",13209361,"Gonzales Tsuseb","1/7/2002 (21 years old)","ST (C)","Police XI","Botswanan Premier Division","NAM","No","6/12/2023","6/30/2026","$0","Right","Reasonable","Very Strong","5'11""","158 lbs","-","-",60,85,4,2,12,12,12,4,7,5,1,4,3,3,1,7,14,8,6,7,1,12,4,8,12,11,2,4,2,6,10,12,5,4,8,12,11,4,11,19,12,10,14,11,14,8,12,8,10,10,16,4,1,3,2,3,1,2,3,1,4,3
"1221",13158684,"Charles Hambira","6/3/1990 (33 years old)","D (C)","FC Ongos","Namibian Premier Division","NAM","No","9/30/2020","6/30/2024","$0 - $40K","Right","Reasonable","Very Strong","5'11""","167 lbs","14","-",75,85,4,1,1,2,6,1,12,4,6,12,7,3,13,5,6,9,9,7,9,13,13,6,7,6,13,6,3,7,8,8,7,6,14,9,8,11,14,10,12,12,10,11,12,1,5,6,10,11,7,1,1,3,3,1,1,3,1,1,4,4
"1222",13204218,"Eric Naobeb","9/7/1999 (23 years old)","D/WB (R)","Julinho Sporting","Namibian Premier Division","NAM","No","7/1/2020","6/30/2024","$0","Right","Reasonable","Very Strong","5'8""","147 lbs","-","-",61,85,5,11,4,5,8,1,7,4,5,7,8,1,9,6,12,8,8,5,9,7,5,5,12,6,6,7,4,7,14,14,5,7,7,14,7,5,13,10,12,11,11,11,5,9,9,7,10,12,9,1,1,3,1,2,1,4,2,2,1,3
"1223",23442061,"Ahmed Al-Sebaie","1/6/1999 (24 years old)","M (C), AM (RC)","Al-Sailiya","Qatar League","QAT","No","9/1/2020","6/30/2025","$750K - $1.6M","Right","Reasonable","Very Strong","5'7""","149 lbs","48","1",90,110,12,11,11,12,11,10,5,9,5,6,12,7,7,12,10,11,8,10,9,9,11,11,7,10,8,11,12,11,11,13,11,6,12,11,11,6,11,14,12,12,10,11,10,8,9,8,9,14,13,1,1,1,3,2,3,3,3,2,2,2
"1224",2000147683,"Faisal Al-Sebyani","10/9/2003 (19 years old)","D (R), DM","Al-Ahli (KSA)","Saudi Professional League","KSA","No","7/1/2020","6/30/2024","$325K - $3.3M","Right","Reasonable","Very Strong","6'1""","169 lbs","-","-",80,126,5,10,8,6,10,7,8,9,5,9,10,1,14,9,13,7,8,7,10,14,11,5,12,7,9,8,9,11,10,13,5,13,12,12,7,6,13,18,12,9,13,12,12,13,13,8,10,10,9,3,1,1,2,1,3,2,3,2,3,3
"1225",13209357,"Prins Tjiueza","3/12/2002 (21 years old)","M/AM (C)","Liria","Kosovan Superleague","NAM","No","8/16/2022","6/30/2024","$26K - $80K","Right","Reasonable","Very Strong","5'7""","141 lbs","-","-",65,85,2,5,7,6,13,5,3,7,1,6,13,4,6,13,8,7,4,7,5,10,12,13,6,7,7,6,8,7,13,10,6,2,12,11,9,3,11,18,15,10,11,10,6,15,8,2,13,11,14,4,4,3,2,3,3,2,3,1,2,2
"1226",13226582,"Ivan Kamberipa","2/3/1994 (29 years old)","D (LC)","Masitaoka","Botswanan Premier Division","NAM","No","2/2/2022","6/30/2024","$0","Right","Reasonable","Very Strong","5'11""","167 lbs","-","-",80,80,3,9,1,7,9,1,12,4,4,10,8,3,11,5,15,12,9,6,8,11,10,5,10,6,13,7,2,8,14,13,8,7,13,12,13,12,13,15,12,12,10,10,12,6,5,7,11,11,12,2,1,2,3,3,2,1,4,2,2,3
"1227",13226577,"Ambrosius Amseb","5/26/1994 (29 years old)","ST (C)","Masitaoka","Botswanan Premier Division","NAM","No","1/2/2022","6/30/2024","$0","Right","Strong","Very Strong","6'0""","167 lbs","-","-",77,80,5,5,12,12,12,5,12,5,4,3,3,5,1,7,10,8,5,9,6,8,17,10,1,12,6,5,4,6,12,12,4,6,13,12,8,8,9,13,10,10,9,9,12,12,15,8,8,11,17,2,1,1,2,1,4,1,1,2,3,2
"1228",13218359,"Gustav Isaak","3/8/1989 (34 years old)","M/AM (C)","Orlando Pirates (NAM)","Namibian Premier Division","NAM","No","7/1/2021","6/30/2024","$500 - $4.5K","Right","Reasonable","Very Strong","6'0""","174 lbs","-","-",70,80,4,7,8,11,11,5,7,11,1,7,13,7,6,14,10,7,8,9,9,13,10,13,7,9,10,8,12,13,10,6,7,7,11,10,11,10,12,11,9,11,11,10,15,3,9,6,11,13,7,1,2,1,2,3,1,3,1,3,1,3
"1229",2000195314,"Lionel Routh","8/5/2000 (22 years old)","ST (C)","UNAM","Namibian Premier Division","NAM","No","7/1/2022","6/30/2024","$0 - $45K","Right","Weak","Very Strong","5'10""","149 lbs","-","-",65,80,5,6,13,13,7,5,13,2,2,4,6,3,3,8,15,7,7,8,4,10,3,12,14,13,1,5,4,6,12,9,6,3,18,11,10,6,10,20,13,13,12,12,12,11,14,7,20,10,15,1,1,2,3,1,1,2,3,4,2,2
"1230",13218346,"Uzuva-Vipua Tjimune","1/27/1999 (24 years old)","GK","Citizens","Namibian Lower Divisions","NAM","No","7/1/2021","6/30/2024","$0 - $30K","Right","Fairly Strong","Very Strong","6'4""","180 lbs","-","-",65,80,4,3,2,1,1,6,1,2,3,1,7,3,2,4,14,7,14,5,7,12,8,1,9,1,8,5,1,4,10,9,5,10,11,8,4,5,9,13,10,12,10,11,11,5,10,7,10,11,19,4,5,12,14,9,10,10,5,10,7,8
"1231",67245434,"Saúl Coco","2/9/1999 (24 years old)","D (C), DM","Las Palmas","Spanish First Division","EQG","Yes","6/15/2020","6/30/2025","$30K - $7.4M","Right","Reasonable","Very Strong","6'2""","178 lbs","91","1",126,142,5,7,10,9,12,12,12,11,3,13,13,7,13,13,11,14,13,13,14,14,14,9,11,6,12,13,12,13,12,13,11,12,17,14,14,12,11,12,13,15,13,11,8,12,10,7,13,13,13,1,4,1,3,1,1,3,3,2,3,3
"1232",43036651,"Pedro Obiang","3/27/1992 (31 years old)","DM, M (C)","Sassuolo","Italian Serie A","EQG","Yes","3/27/2023","6/30/2025","$80K - $800K","Right","Weak","Very Strong","6'1""","165 lbs","294","8",121,140,6,6,9,6,13,6,9,9,4,12,13,8,14,14,13,14,12,14,14,13,16,10,13,11,15,15,13,14,11,11,14,10,13,11,14,14,12,15,15,16,12,12,16,13,14,2,12,12,16,1,2,2,2,3,1,3,2,2,3,1
"1233",1504124,"Emilio Nsué","9/30/1989 (33 years old)","D/WB (R)","Intercity","Spanish Federation First Division B","EQG","Yes","7/1/2022","6/30/2024","$0 - $95K","Right","Reasonable","Very Strong","5'10""","165 lbs","477","74",105,140,10,11,12,9,13,8,10,10,7,11,12,12,12,12,9,12,12,11,9,10,12,12,12,8,11,12,11,13,13,12,12,8,16,12,12,12,11,7,10,8,9,11,7,14,7,9,10,10,13,2,2,4,2,3,1,3,2,2,2,1
"1234",67277847,"Jesús Owono","3/1/2001 (22 years old)","GK","Alavés","Spanish First Division","EQG","Yes","6/15/2020","6/30/2024","$220K - $2.2M","Right","Fairly Strong","Very Strong","5'11""","160 lbs","69","-",113,138,4,2,2,3,6,7,1,1,3,2,12,1,3,4,9,12,13,8,10,14,16,2,14,1,12,10,9,9,14,11,4,9,15,14,7,8,12,12,12,13,12,12,12,13,5,5,14,10,10,13,12,14,5,14,13,13,5,13,9,7
"1235",23248112,"Mohammed Kanno","9/22/1994 (28 years old)","DM, M (C)","Al-Hilal (KSA)","Saudi Professional League","KSA","No","1/6/2022","6/30/2025","$5.6M - $8.4M","Right","Reasonable","Very Strong","6'3""","160 lbs","194","27",120,125,9,6,10,6,12,9,9,12,11,11,14,8,13,14,12,12,10,14,11,12,9,9,9,10,14,14,15,13,11,11,13,16,12,12,14,14,12,13,11,10,9,7,6,11,13,6,10,10,11,3,4,3,1,2,1,4,2,3,3,1
"1236",67178095,"Carlos Akapo","3/12/1993 (30 years old)","D (R)","San Jose","Major League Soccer","EQG","Yes","8/5/2022","8/31/2023","$40K - $400K","Right","Reasonable","Very Strong","5'10""","154 lbs","219","1",124,132,7,9,8,7,7,5,12,7,14,13,11,8,14,11,13,12,13,10,12,11,13,6,10,13,14,16,9,15,14,12,12,13,16,15,17,14,12,18,8,10,12,11,11,12,7,7,13,11,10,1,3,3,4,1,1,2,1,3,1,3
"1237",67214616,"José Machín","8/14/1996 (26 years old)","DM, M/AM (C)","Brianza","Italian Serie A","EQG","Yes","7/1/2020","6/30/2024","$350K - $3.5M","Right","Weak","Very Strong","6'0""","163 lbs","165","16",121,128,12,11,13,13,13,10,10,12,6,12,12,10,12,12,12,11,12,11,13,13,16,12,11,14,12,12,12,12,13,12,13,10,15,13,13,14,12,12,16,16,8,14,2,13,4,1,15,16,18,1,3,2,3,3,1,1,2,3,3,1
"1238",67231887,"Jannyck Buyla","10/6/1998 (24 years old)","M (C)","Badajoz","Spanish Federation Second Group 5","EQG","Yes","6/30/2022","6/30/2023","$0 - $2.5K","Right","Weak","Very Strong","5'11""","174 lbs","133","9",90,125,7,10,10,7,10,9,10,9,7,7,11,8,9,11,12,10,11,11,9,9,10,10,12,12,10,10,10,11,11,9,14,11,13,10,13,13,14,20,8,11,11,9,5,4,8,2,10,14,16,1,2,2,2,3,1,2,1,2,3,4
"1239",67201235,"Ibán Salvador","12/11/1995 (27 years old)","AM (R), ST (C)","Fuenlabrada","Spanish Federation First Division A","EQG","Yes","7/5/2019","6/30/2024","$0","Left Only","Very Strong","Weak","5'8""","158 lbs","259","36",105,124,10,11,12,12,13,10,12,12,8,5,14,6,5,13,7,11,8,12,11,15,2,13,10,13,6,11,11,11,14,14,15,7,15,12,9,8,10,16,12,9,11,9,7,9,5,3,9,11,8,1,3,3,1,2,3,3,3,1,4,1
"1240",13178114,"Federico Bikoro","3/17/1996 (27 years old)","D (C), DM, M (C)","Sandefjord","Norwegian Premier Division","EQG","No","8/8/2022","12/31/2024","$240K - $2.4M","Left Only","Very Strong","Weak","6'2""","167 lbs","122","6",113,123,7,8,9,8,11,9,12,9,1,11,11,6,13,10,11,12,14,7,10,11,15,8,10,12,10,15,9,16,12,11,15,15,15,15,17,14,14,16,11,10,11,10,7,13,13,7,12,11,10,2,1,1,1,1,1,3,2,3,1,2
"1241",13203965,"Basilio","1/17/1999 (24 years old)","D/WB/M (L), AM (LC)","Universitatea Craiova","Romanian First League","EQG","No","1/25/2023","6/30/2026","$900K - $1.9M","Left","Very Strong","Reasonable","5'8""","154 lbs","96","1",111,120,9,12,12,7,12,8,6,6,16,10,11,4,9,11,6,5,8,9,9,9,13,13,3,8,8,13,9,13,14,10,11,8,12,13,15,13,15,18,12,13,10,7,10,8,5,5,9,13,20,4,3,2,3,3,3,2,4,1,2,1
"1242",76010826,"Yoiver González","11/22/1989 (33 years old)","D (C)","La Equidad","Colombian First Division","EQG","No","1/3/2022","12/31/2023","$0 - $90K","Right","Reasonable","Very Strong","5'10""","176 lbs","237","7",113,117,4,10,8,6,8,5,12,6,10,13,10,10,13,12,11,14,12,11,12,12,14,7,14,10,14,12,10,12,10,10,12,11,12,11,12,14,10,15,11,11,13,11,8,14,8,3,13,16,11,2,4,3,3,2,1,1,1,2,3,3
"1243",76001434,"Carlos Bejarano","1/29/1985 (38 years old)","GK","Unión Magdalena","Colombian First Division","EQG","No","1/4/2023","12/31/2023","$0 - $45K","Right","Weak","Very Strong","5'11""","176 lbs","314","-",113,117,6,3,3,1,10,7,7,2,3,1,9,2,3,10,8,13,12,13,12,12,13,7,15,8,13,11,10,12,10,11,12,12,12,10,12,12,10,12,11,13,11,11,12,12,8,7,12,11,11,14,13,12,9,11,13,11,5,13,12,12
"1244",67179848,"Pablo Ganet","11/4/1994 (28 years old)","M (C)","Murcia","Spanish Federation First Division B","EQG","Yes","7/1/2021","6/30/2024","$0","Right Only","Weak","Very Strong","6'0""","160 lbs","195","33",107,115,9,11,13,10,11,10,12,14,8,9,12,9,11,13,14,14,14,13,13,12,12,13,14,11,9,12,9,14,14,12,12,12,14,13,13,13,13,13,11,12,11,8,11,14,12,3,12,12,7,1,2,2,3,3,3,1,3,3,2,1
"1245",2000291357,"Martín Ela","6/4/2004 (19 years old)","ST (C)","Deportivo Mongomo","Premier Division - Continental","EQG","No","7/1/2022","6/30/2025","$14K - $45K","Right","Reasonable","Very Strong","5'11""","163 lbs","-","-",70,115,5,2,12,13,13,6,13,7,1,4,7,9,3,12,11,7,1,11,4,9,11,12,5,8,4,6,7,7,13,13,6,10,11,13,5,7,9,18,14,9,8,11,8,9,6,6,8,11,8,2,1,3,1,3,2,2,3,2,1,1
"1246",23167996,"Mohammed Al-Qarni","11/24/1989 (33 years old)","DM","Al-Wehda","Saudi Professional League","KSA","No","2/27/2019","6/30/2025","$75K - $750K","Right","Reasonable","Very Strong","5'9""","152 lbs","127","2",95,125,9,8,5,5,9,8,9,11,9,12,13,7,12,8,13,11,9,9,11,15,12,5,7,10,11,10,10,13,12,13,12,8,18,13,13,7,12,14,11,9,10,9,10,5,9,2,13,11,12,2,1,1,3,2,2,3,1,3,1,1
"1247",13203962,"Joaquin Obama Edu","9/21/2000 (22 years old)","M/AM (C)","Vegetarianos","Premier Division - Insular","EQG","No","7/1/2019","6/30/2025","$0 - $45K","Right","Reasonable","Very Strong","6'5""","180 lbs","-","-",83,114,7,6,9,13,14,7,5,9,4,8,12,8,6,11,11,9,2,9,8,13,10,13,11,7,9,8,13,9,11,9,8,14,13,9,6,6,16,13,10,10,10,11,5,9,8,2,18,10,9,3,3,3,1,1,1,2,3,1,3,3
"1248",19007970,"Jônatas Obina","12/18/1985 (37 years old)","AM (L), ST (C)","Boston City","USSL D2 - Northeast Division","EQG","No","4/28/2022","-","$0","Left","Very Strong","Weak","5'11""","187 lbs","97","21",78,113,1,9,9,11,11,3,11,3,3,4,6,12,3,7,10,10,12,11,10,10,12,10,10,11,11,11,9,10,11,9,11,11,12,11,11,14,11,10,11,13,9,12,5,11,10,9,10,12,11,2,2,1,3,1,2,3,2,2,2,2
"1249",2000110703,"Dorian Jr.","5/12/2001 (22 years old)","ST (C)","Leganés","Spanish Second Division","EQG","Yes","1/1/2022","6/30/2025","$12K - $120K","Right","Reasonable","Very Strong","6'2""","174 lbs","85","31",90,112,9,6,11,11,15,9,14,10,4,8,6,4,2,10,15,12,10,6,5,15,14,10,6,11,10,9,7,10,11,11,15,11,15,11,5,9,13,15,13,14,8,10,5,11,5,3,12,13,20,4,1,4,1,2,3,1,3,2,1,1
"1250",19191018,"Judson","5/6/1992 (31 years old)","M/AM (C)","Fluminense de Feira","Brazilian National Lower Division","EQG","No","5/26/2023","12/31/2023","$0 - $6K","Right","Reasonable","Very Strong","5'7""","132 lbs","21","1",85,110,9,9,10,10,11,7,5,5,7,7,11,7,5,11,5,11,9,10,10,11,10,11,13,10,8,10,10,9,12,13,13,4,12,12,11,4,12,10,11,13,10,10,5,12,8,4,13,13,11,4,1,4,1,3,3,1,1,1,2,3
"1251",2000010281,"José Ángel Efa Nchama","1/29/2002 (21 years old)","ST (C)","Vegetarianos","Premier Division - Insular","EQG","No","7/1/2019","6/30/2025","$65K - $200K","Right","Reasonable","Very Strong","6'1""","171 lbs","-","-",75,110,3,3,13,13,12,1,13,7,3,6,7,8,3,13,5,10,8,12,7,13,15,13,12,8,5,6,7,7,12,9,7,12,12,7,9,6,13,14,12,11,10,11,9,11,8,6,20,11,20,4,2,1,1,1,2,2,1,1,4,1
"1252",67293676,"Álex Balboa","3/6/2001 (22 years old)","M (RC), AM (R)","Alavés B","Spanish Federation Second Group 2","EQG","Yes","7/1/2020","6/30/2027","$0 - $70K","Right","Reasonable","Very Strong","5'11""","160 lbs","59","2",90,110,9,12,14,11,14,8,8,10,5,4,12,2,10,14,14,12,3,11,9,13,4,14,12,14,9,7,8,12,10,11,9,7,11,13,7,6,17,18,12,11,12,9,6,16,5,14,14,9,15,1,2,4,1,3,1,2,3,2,3,3
"1253",67215882,"Josete Miranda","7/22/1998 (24 years old)","AM (RLC)","Niki Volou","Greek Super League 2 North","EQG","Yes","8/5/2022","6/30/2024","$50K - $500K","Right","Weak","Very Strong","5'7""","147 lbs","146","33",100,110,14,11,12,13,12,15,4,10,2,8,13,12,10,13,12,9,7,11,9,10,10,12,11,14,7,9,12,13,14,12,10,6,10,11,10,9,11,20,9,11,10,10,13,3,12,7,13,12,13,1,3,4,1,1,2,3,3,2,3,1
"1254",67097150,"Rui","5/28/1985 (38 years old)","D (C)","Collado Villalba","Spanish Federation Third Group 7","EQG","Yes","7/1/2022","6/30/2023","$0","Right Only","Weak","Very Strong","6'4""","180 lbs","342","13",85,110,6,9,4,4,11,6,13,8,8,12,9,6,11,9,13,11,12,10,10,11,8,9,11,5,12,13,7,11,10,8,13,14,13,10,11,13,11,9,8,9,11,6,5,12,7,3,13,8,13,1,2,4,4,3,2,3,1,2,1,4
"1255",13117610,"Felipe Ovono","7/26/1993 (29 years old)","GK","Sidama Coffee","Ethiopian Premier Division","EQG","No","7/20/2022","6/30/2024","$0 - $45K","Right","Reasonable","Very Strong","6'1""","163 lbs","42","-",95,110,2,2,3,1,1,5,1,2,1,3,13,2,3,5,12,8,15,7,11,10,14,1,2,1,10,8,6,4,13,15,7,12,14,13,5,11,9,10,12,10,12,12,10,9,14,5,13,10,14,7,12,13,6,9,9,10,12,7,9,13
"1256",43316094,"Moises Eboko","1/2/2000 (23 years old)","ST (C)","Patacona","Spanish Federation Third Group 6","EQG","Yes","7/1/2022","-","$0","Right","Weak","Very Strong","6'0""","167 lbs","94","15",69,109,6,8,10,11,9,6,10,7,2,4,9,5,5,10,12,10,13,9,8,9,16,12,9,11,9,8,7,12,11,10,8,9,14,11,11,9,12,20,11,12,11,11,3,8,8,6,20,10,14,2,3,3,3,1,2,3,1,1,3,1
"1257",23374871,"Sultan Al-Ghanam","5/6/1994 (29 years old)","D/WB (R)","Al-Nassr (KSA)","Saudi Professional League","KSA","No","9/21/2021","6/30/2024","$15M - $19M","Right","Reasonable","Very Strong","5'8""","147 lbs","147","7",125,125,9,12,13,9,12,9,9,10,13,12,13,7,12,13,12,12,13,11,11,13,13,10,8,12,12,13,12,15,14,13,12,7,14,14,15,10,13,12,12,14,12,12,6,11,6,7,13,12,13,3,3,1,2,2,1,4,1,2,1,1
"1258",13104134,"Daniel Ekedo","9/19/1989 (33 years old)","DM, M (RC)","At. Porcuna","Spanish División Honor Andalucía Gr. 2","EQG","No","7/1/2022","-","$0","Right","Reasonable","Very Strong","6'2""","176 lbs","298","12",84,106,3,7,6,5,10,5,10,10,6,11,11,5,11,10,12,11,10,10,11,10,1,10,8,10,12,12,8,10,12,10,10,11,14,12,12,12,11,13,11,11,11,11,5,10,10,8,11,11,20,1,1,2,2,1,1,2,4,3,2,2
"1259",67276495,"Luis Meseguer","9/7/1999 (23 years old)","D (LC), WB (L)","U. Adarve","Spanish Federation Second Group 5","EQG","Yes","7/19/2022","6/30/2025","$6K - $55K","Left","Very Strong","Reasonable","5'10""","149 lbs","96","7",80,105,5,10,7,7,9,1,8,1,7,10,9,1,12,8,6,10,9,6,8,8,12,6,11,5,13,8,6,8,14,13,8,6,5,13,10,5,15,12,13,9,10,11,11,11,5,8,9,14,11,1,3,3,3,1,3,2,1,1,2,2
"1260",67258946,"Esteban","5/7/1998 (25 years old)","D (RC)","Chindia Târgovişte","Romanian Second League","EQG","Yes","8/18/2022","6/30/2024","$45K - $450K","Right","Weak","Very Strong","6'2""","187 lbs","118","5",94,105,12,13,11,7,11,6,13,8,13,11,9,8,12,11,7,9,10,9,9,9,15,8,10,11,11,8,8,9,12,11,12,14,13,11,11,13,13,19,11,11,11,11,5,10,5,3,10,14,14,3,2,1,2,3,4,2,3,2,1,1
"1261",67275378,"Sergi Perelló","12/16/1996 (26 years old)","M/AM (L)","Alcudia","Spanish Federation Third Group 11","EQG","Yes","6/30/2020","6/30/2024","$0 - $65K","Left","Very Strong","Reasonable","5'11""","152 lbs","106","34",75,105,8,11,9,10,13,4,6,6,6,6,10,6,7,13,7,9,3,6,7,13,13,13,9,11,6,7,9,11,13,10,7,5,13,11,6,4,12,16,9,10,10,11,12,4,15,2,10,11,9,1,1,2,2,1,3,2,1,3,2,4
"1262",67171793,"Kike Boula","7/17/1993 (29 years old)","M (L), AM (RL)","At. Porcuna","Spanish División Honor Andalucía Gr. 2","EQG","Yes","2/1/2023","-","$0","Right","Weak","Very Strong","5'9""","147 lbs","186","14",93,105,7,8,12,7,9,7,6,8,7,6,8,8,6,12,11,9,8,8,7,8,12,9,6,10,7,8,8,10,16,13,9,6,12,15,11,10,7,14,12,12,11,11,7,12,10,6,10,11,14,1,2,1,3,2,2,3,3,3,1,3
"1263",2000010277,"Luis Asué","7/9/2001 (21 years old)","AM (RL), ST (C)","BRG","Portuguese Premier League","EQG","No","1/3/2022","6/30/2024","$5K - $16K","Left","Very Strong","Weak","6'1""","187 lbs","18","2",76,105,7,12,13,13,9,6,8,5,3,6,12,2,4,12,8,4,8,7,6,12,5,12,6,12,6,7,11,8,12,8,7,9,5,12,13,6,10,12,11,10,10,10,9,3,8,3,13,10,20,2,2,2,2,2,3,2,2,2,2,2
"1264",2000054900,"Néstor Senra","1/4/2002 (21 years old)","D (RC), WB (R)","Sevilla B","Spanish Federation Second Group 4","EQG","Yes","6/13/2022","6/30/2023","$0 - $4.5K","Right Only","Weak","Very Strong","5'10""","158 lbs","70","2",80,105,3,9,7,5,12,1,10,5,1,13,6,6,15,9,7,6,9,10,13,15,5,5,2,6,7,9,9,10,13,11,9,8,11,14,7,8,10,18,11,10,11,9,9,14,9,3,20,11,20,4,3,3,4,2,2,1,1,1,2,2
"1265",2000212473,"José Elo","10/21/2000 (22 years old)","D (C)","Navalcarnero","Spanish Federation Second Group 5","EQG","Yes","7/15/2022","6/30/2025","$20K - $60K","Left","Very Strong","Weak","6'3""","185 lbs","59","2",76,105,4,2,1,2,8,1,13,3,5,14,8,1,14,7,5,8,9,7,8,7,18,5,13,7,14,7,6,8,7,10,8,12,13,8,5,10,14,19,12,9,14,11,5,13,5,4,15,10,13,3,3,3,3,1,3,1,1,2,3,1
"1266",67297245,"Juan Pedro Bonoha","4/26/2000 (23 years old)","D (C), DM","Fuenlabrada B","Spanish Preferente Madrid Gr. 2","EQG","Yes","1/15/2023","6/30/2024","$0","Right","Reasonable","Very Strong","6'0""","163 lbs","125","9",81,104,1,1,2,7,5,5,9,8,3,9,10,1,14,7,9,8,8,8,10,14,5,7,3,7,14,8,9,12,14,14,8,10,9,14,11,5,13,17,13,10,10,11,13,15,7,3,13,10,17,4,1,4,3,4,3,3,2,1,3,4
"1267",49053822,"Santiago Eneme-Bocari","9/29/2000 (22 years old)","M/AM (L)","FC Nantes","Ligue 1 Uber Eats","EQG","No","6/15/2020","6/30/2027","$10K - $110K","Right","Weak","Very Strong","6'0""","143 lbs","-","-",86,102,6,9,13,11,14,7,7,6,7,7,12,1,5,13,12,9,4,9,8,9,3,12,12,7,7,8,8,11,14,14,14,7,14,14,6,5,16,16,12,12,12,12,8,14,6,6,16,10,20,3,1,1,2,3,2,1,2,3,2,3
"1268",2000184407,"Islam Hawsawi","12/27/2001 (21 years old)","D/WB (L)","Al-Wehda","Saudi Professional League","KSA","No","7/1/2019","6/30/2026","$450K - $4.5M","Left Only","Very Strong","Weak","5'9""","147 lbs","22","1",100,125,5,10,11,4,10,3,8,7,12,9,11,4,9,11,11,11,12,9,11,11,12,9,6,10,10,12,9,13,14,13,9,8,13,14,13,8,15,16,10,11,10,8,9,6,10,3,12,10,16,1,3,1,4,1,3,1,3,2,3,2
"1269",19073638,"Willian Gomes","7/8/1989 (33 years old)","D (RL), WB (L)","FC Cascavel","Brazilian National Fourth Division","EQG","No","5/2/2023","4/30/2024","$0","Left Only","Very Strong","Weak","6'0""","171 lbs","52","4",84,101,6,13,8,1,14,4,8,5,8,10,10,6,11,10,13,9,10,9,10,12,12,7,6,8,9,9,8,9,13,13,9,10,14,12,13,8,13,12,10,7,12,11,5,4,10,2,16,10,12,2,4,3,1,1,1,1,2,1,3,3
"1270",83303790,"Jimmy Ekua","11/21/1999 (23 years old)","M/AM (C)","R. Bouzas","Spanish Federation Third Group 1","EQG","Yes","1/31/2023","6/30/2024","$0 - $65K","Right Only","Weak","Very Strong","5'11""","160 lbs","42","1",74,100,8,7,11,6,11,10,7,8,4,7,11,9,6,13,10,9,7,10,7,8,8,15,4,10,8,8,10,9,12,13,12,8,13,12,11,8,12,13,8,12,10,11,7,11,8,1,9,12,15,1,3,3,3,2,2,3,2,3,3,3
"1271",13117885,"Jean-Maxime Ndongo","11/8/1992 (30 years old)","DM, M (C)","Futuro Kings","Premier Division - Continental","EQG","No","7/1/2020","6/30/2025","$40K - $120K","Left","Very Strong","Reasonable","5'11""","163 lbs","-","-",90,100,8,10,4,7,14,8,5,10,2,10,12,7,14,11,15,12,7,10,10,14,7,6,11,8,8,9,8,13,14,14,9,6,8,13,9,7,15,13,10,12,12,9,8,11,7,3,12,12,17,2,3,1,3,1,2,1,2,3,2,3
"1272",67014276,"Ibán Iyanga Travieso","6/2/1987 (36 years old)","D/M (R), AM (RL)","Futuro Kings","Premier Division - Continental","EQG","Yes","6/14/2021","6/30/2024","$0 - $5K","Right Only","Weak","Very Strong","5'10""","154 lbs","273","31",80,100,11,9,12,6,10,9,6,8,6,7,11,11,6,12,8,9,9,8,8,8,9,11,7,12,6,11,12,10,11,11,11,8,10,11,8,9,13,14,13,14,8,8,11,10,8,12,9,11,12,2,1,3,1,3,3,1,1,1,2,1
"1273",67230993,"Marvin Anieboh","8/26/1997 (25 years old)","D (C)","Montijo","Spanish Federation Second Group 5","EQG","Yes","11/30/2022","6/30/2023","$0","Right","Weak","Very Strong","6'2""","185 lbs","132","3",75,100,5,7,7,6,9,7,11,8,7,8,9,7,10,9,10,8,9,8,9,8,10,7,7,9,8,10,9,9,12,8,13,14,12,12,12,13,6,10,10,10,10,10,5,7,8,5,9,10,12,3,2,3,2,3,3,1,1,2,3,2
"1274",13117886,"Viera Doualla","6/14/1987 (35 years old)","M/AM (C), ST (C)","Vegetarianos","Premier Division - Insular","EQG","No","1/1/2020","6/30/2024","$0 - $12K","Right","Weak","Very Strong","5'11""","167 lbs","77","16",90,100,9,9,10,11,12,8,12,12,7,8,12,12,7,13,10,11,8,12,9,10,9,12,11,12,8,9,11,12,9,10,12,11,10,9,9,11,16,13,14,12,13,13,8,9,4,8,12,12,13,3,1,3,1,2,1,1,3,2,1,2
"1275",67295753,"Joanet","3/1/1999 (24 years old)","M (R), AM (RL)","Sabadell","Spanish Federation First Division A","EQG","Yes","7/23/2022","6/30/2023","$1.5K - $4K","Right","Weak","Very Strong","5'10""","165 lbs","95","9",87,100,10,14,9,10,9,9,8,11,9,5,9,7,5,10,7,8,6,9,10,9,5,7,5,6,7,9,8,8,12,13,12,11,13,12,14,11,12,14,11,8,11,13,12,8,9,8,9,14,17,2,1,1,1,2,2,2,2,2,2,3
"1276",2000169752,"Mohamed Diakité","4/14/1999 (24 years old)","D (C)","Akonangui FC","Premier Division - Continental","EQG","No","7/1/2020","6/30/2025","$0 - $30K","Right","Reasonable","Very Strong","6'4""","178 lbs","-","-",75,100,2,1,1,1,7,1,9,2,5,13,5,1,13,4,15,9,7,7,10,12,7,5,11,4,9,6,6,7,13,13,7,14,12,13,4,5,15,14,12,9,10,12,8,16,8,2,11,10,16,1,3,3,1,2,3,3,2,3,3,1
"1277",67281885,"Marvin Kombé","8/5/2002 (20 years old)","AM (C), ST (C)","Zaragoza B","Spanish Federation Second Group 2","EQG","Yes","6/13/2022","6/30/2024","$7K - $22K","Right","Reasonable","Very Strong","5'7""","136 lbs","57","8",70,99,7,9,12,14,11,7,8,8,2,7,7,3,4,12,7,10,4,9,8,12,12,11,1,9,8,8,8,12,11,10,12,7,11,10,7,2,11,12,10,11,9,10,12,4,6,6,20,12,20,3,1,1,2,2,2,1,3,3,2,2
"1278",2000169177,"Gerardo Dougan","10/5/2001 (21 years old)","DM, M (C)","Futuro Kings","Premier Division - Continental","EQG","No","7/1/2020","6/30/2025","$16K - $45K","Right","Fairly Strong","Very Strong","5'10""","158 lbs","-","-",75,99,7,7,3,7,14,5,7,9,4,9,14,1,13,12,9,12,8,8,5,10,6,5,1,5,8,7,11,12,11,14,8,5,10,10,7,6,12,12,10,11,13,11,10,19,5,2,14,10,13,1,1,1,1,2,2,4,3,2,3,1
"1279",23470663,"Abdulelah Al-Amri","1/15/1997 (26 years old)","D (C)","Al-Nassr (KSA)","Saudi Professional League","KSA","No","1/27/2021","6/30/2024","$230K - $2.3M","Right","Reasonable","Very Strong","6'1""","176 lbs","91","7",115,125,6,7,9,9,10,9,14,10,12,13,12,10,12,12,14,11,14,11,11,11,13,8,10,9,12,12,10,11,12,12,13,13,12,12,13,15,9,9,9,10,10,12,7,10,10,1,11,12,12,4,2,3,3,3,1,2,2,1,2,1
"1280",2000246853,"Rafael Nsogo","8/3/2001 (21 years old)","AM (RLC)","Vegetarianos","Premier Division - Insular","EQG","No","7/1/2022","6/30/2025","$14K - $40K","Right","Reasonable","Very Strong","5'10""","149 lbs","-","-",73,97,6,9,10,11,12,6,5,8,1,6,12,1,8,12,6,8,4,7,7,12,15,12,7,12,6,7,7,12,13,10,7,5,14,10,12,4,12,20,12,9,10,10,6,13,6,8,13,10,19,4,4,2,2,1,2,3,3,1,1,3
"1281",2000059224,"Cristian Ebea","2/2/2001 (22 years old)","D/WB/M/AM (R), ST (C)","S. Gijón B","Spanish Federation Third Group 2","EQG","Yes","8/29/2022","6/30/2024","$0 - $12K","Right Only","Weak","Very Strong","5'5""","136 lbs","67","7",78,97,2,7,10,7,9,5,6,2,5,7,7,4,10,12,11,9,7,6,7,12,19,13,10,9,11,11,4,11,12,10,12,1,13,9,8,7,12,19,10,11,11,12,5,12,5,7,12,14,17,1,2,3,3,3,2,2,3,2,2,1
"1282",2000246868,"Leopoldo Koffi","4/17/2002 (21 years old)","GK","Deportivo Mongomo","Premier Division - Continental","EQG","No","7/1/2022","6/30/2025","$0 - $45K","Right","Reasonable","Very Strong","6'6""","189 lbs","-","-",63,97,2,2,2,3,1,6,1,3,2,2,10,2,1,3,10,8,10,6,5,13,12,2,11,3,9,6,1,5,12,7,6,13,6,11,2,6,10,14,8,13,9,13,8,16,12,4,6,11,9,9,5,13,5,10,7,9,5,6,10,8
"1283",67239886,"Niko Kata","1/15/1993 (30 years old)","AM (C), ST (C)","Cerdanyola","Spanish Federation Second Group 3","EQG","Yes","1/27/2023","6/30/2025","$0","Right","Weak","Very Strong","6'2""","171 lbs","226","37",93,96,8,10,14,13,13,6,10,6,2,5,7,7,8,14,11,9,7,9,9,14,18,13,10,11,8,9,7,10,14,11,9,11,10,14,9,9,11,17,12,12,11,11,7,5,13,1,12,11,17,2,4,2,2,2,2,3,2,2,3,2
"1284",67182719,"James Davis","7/5/1995 (27 years old)","M (L), AM (RL)","Llosetense","Spanish Federation Third Group 11","EQG","Yes","7/1/2021","6/30/2023","$0","Left","Very Strong","Reasonable","5'8""","143 lbs","158","19",75,95,2,7,10,10,13,6,6,5,6,5,12,1,8,11,7,8,5,8,8,12,8,11,3,10,7,8,6,8,13,13,8,2,12,13,12,4,12,12,14,11,11,10,11,14,10,3,19,13,13,1,2,1,1,4,1,1,2,3,3,3
"1285",2000311734,"Adrian Garrido","11/18/2001 (21 years old)","AM (L), ST (C)","Andratx","Spanish Federation Second Group 3","EQG","Yes","7/1/2022","6/30/2024","$0 - $90K","Left","Very Strong","Weak","5'9""","145 lbs","-","-",80,95,6,9,11,7,10,6,8,6,6,6,11,6,7,8,7,7,6,9,6,9,14,8,11,6,5,7,8,8,13,13,8,3,15,13,13,5,11,10,12,12,10,14,10,3,5,3,8,9,20,2,3,3,3,2,2,3,3,1,2,3
"1286",785678,"Ryang Yong Gi","1/7/1982 (41 years old)","M/AM (LC)","Sendai","J2 League","PRK","No","1/5/2022","1/31/2024","$12K","Right","Fairly Strong","Very Strong","5'8""","158 lbs","586","77",89,138,7,9,8,11,8,9,9,9,10,7,11,7,7,12,10,13,7,11,12,11,15,11,14,12,7,13,11,7,12,11,10,7,15,12,7,8,15,11,13,13,10,11,4,10,8,1,10,11,10,2,2,1,1,3,4,2,3,3,1,2
"1287",45077108,"An Byong-Jun","5/22/1990 (33 years old)","ST (C)","Suwon","Hana 1Q K LEAGUE 1","PRK","No","7/6/2022","12/31/2023","$16K - $160K","Right","Reasonable","Very Strong","6'0""","165 lbs","212","83",111,127,6,7,12,13,11,7,11,12,5,7,10,11,6,10,13,13,13,11,12,12,9,11,7,13,10,12,12,11,12,10,14,12,16,13,11,14,11,16,10,11,14,12,11,13,7,6,12,14,9,2,1,2,3,2,1,3,1,3,1,3
"1288",2000142440,"Ri Il-Song","1/14/2004 (19 years old)","AM (RLC), ST (C)","April 25","DPR Premier Football League","PRK","No","6/13/2022","12/31/2025","$0 - $24K","Right","Reasonable","Very Strong","5'10""","141 lbs","-","-",82,126,6,6,12,8,9,6,7,8,6,6,13,1,7,11,11,6,6,7,5,6,7,12,3,13,4,7,8,12,13,13,13,3,7,13,7,3,9,11,12,13,9,9,5,12,10,8,9,13,11,2,1,2,3,1,3,1,1,1,3,3
"1289",23113969,"Choe Kum-Chol","2/9/1987 (36 years old)","ST (C)","Rimyongsu","DPR Premier Football League","PRK","No","6/14/2021","12/31/2024","$0","Right","Reasonable","Very Strong","6'0""","165 lbs","-","-",82,124,8,8,10,13,12,8,11,9,7,8,9,8,5,12,12,12,6,13,9,13,13,14,5,14,9,8,9,13,10,7,5,12,8,8,10,8,10,16,8,13,10,11,9,2,15,8,16,13,9,2,2,1,1,2,3,1,1,1,3,2
"1290",2000014013,"Ayman Yahya","5/14/2001 (22 years old)","AM (RL)","Al-Nassr (KSA)","Saudi Professional League","KSA","No","7/1/2019","6/30/2024","$3M - $6M","Right","Fairly Strong","Very Strong","5'8""","154 lbs","61","7",105,125,10,12,14,9,9,7,4,9,3,4,12,10,6,11,8,7,8,11,7,7,10,11,6,8,9,8,12,10,15,13,9,7,11,14,13,10,10,20,10,9,9,10,9,10,8,1,8,12,7,3,3,3,3,3,3,2,1,2,1,3
"1291",1042739,"Kim Kwang-Hyok","8/27/1985 (37 years old)","M/AM (C), ST (C)","Kyonggongop","DPR Premier Football League","PRK","No","6/14/2021","12/31/2024","Not for Sale","Right","Reasonable","Very Strong","5'8""","141 lbs","-","-",76,122,7,4,8,10,14,7,9,9,2,8,10,4,8,12,11,9,5,10,8,13,10,11,13,12,7,8,14,9,8,8,8,4,14,8,8,6,9,10,15,11,13,10,9,1,8,5,12,10,19,1,1,4,1,1,2,2,2,1,3,4
"1292",23425649,"Kim Kuk-Bom","2/19/1995 (28 years old)","M (C)","Ryomyong","DPR Premier Football League","PRK","No","1/1/2019","12/31/2024","$24K - $75K","Right","Reasonable","Very Strong","5'10""","149 lbs","-","-",104,121,8,7,6,7,13,8,8,7,6,10,14,6,9,8,9,10,7,10,7,14,4,5,9,10,9,9,13,11,14,14,9,6,15,14,14,6,12,16,10,11,11,9,14,8,5,1,13,12,14,2,1,2,2,1,1,3,4,3,1,2
"1293",23036065,"Pak Song-Chol","9/24/1987 (35 years old)","M/AM (C)","Rimyongsu","DPR Premier Football League","PRK","No","6/14/2021","12/31/2024","Not for Sale","Right","Reasonable","Very Strong","5'8""","143 lbs","-","-",96,121,7,10,7,15,11,10,9,8,5,9,13,8,12,12,8,14,7,13,11,13,6,9,12,12,11,11,13,14,12,12,6,6,11,12,9,8,13,16,8,9,8,12,5,11,5,2,15,11,17,2,1,3,4,3,3,2,1,3,3,2
"1294",23036049,"Ju Kwang-Min","5/20/1990 (33 years old)","GK","Kigwancha","DPR Premier Football League","PRK","No","6/14/2021","12/31/2024","Not for Sale","Right","Reasonable","Very Strong","6'2""","154 lbs","-","-",99,119,3,1,3,3,1,6,1,1,1,1,11,1,3,3,12,11,15,8,10,14,12,2,5,2,14,9,8,8,11,13,9,9,11,9,8,7,12,14,11,13,13,13,11,14,5,5,12,11,16,8,8,12,9,9,10,14,5,13,12,11
"1295",23425644,"Kim Chol-Bom","7/16/1994 (28 years old)","D (LC)","April 25","DPR Premier Football League","PRK","No","6/15/2020","12/31/2024","$0 - $55K","Left","Very Strong","Reasonable","5'10""","158 lbs","-","-",100,119,6,10,6,3,10,1,10,3,4,11,9,3,12,7,11,11,10,9,13,13,20,7,13,8,14,8,4,9,14,14,9,6,15,14,11,7,16,15,14,9,12,9,8,12,5,7,20,11,9,1,1,4,1,2,1,3,1,1,3,3
"1296",23036075,"Jon Kwang-Ik","4/5/1988 (35 years old)","D/WB (L)","Amrokkang","DPR Premier Football League","PRK","No","6/14/2021","12/31/2024","Not for Sale","Left","Very Strong","Reasonable","5'7""","141 lbs","-","-",94,119,8,11,8,4,11,5,6,9,6,10,11,3,16,9,9,14,11,11,10,13,6,5,12,10,11,11,9,11,11,12,11,8,11,12,11,5,15,18,8,11,11,11,5,11,8,1,13,13,11,3,3,3,1,1,1,1,4,2,1,2
"1297",1042767,"An Chol-Hyok","6/27/1985 (37 years old)","AM (R), ST (C)","Rimyongsu","DPR Premier Football League","PRK","No","6/14/2021","12/31/2024","$0","Right","Fairly Strong","Very Strong","5'10""","156 lbs","-","-",82,119,7,11,8,14,14,7,13,7,5,5,11,6,7,12,13,13,4,12,6,11,9,11,10,14,8,7,9,9,8,8,8,7,12,8,8,6,10,20,12,12,9,12,8,11,14,4,12,13,18,3,2,3,3,2,2,3,2,3,3,2
"1298",23035960,"Ri Chol-Myong","2/18/1988 (35 years old)","M/AM (C)","Pyongyang City","DPR Premier Football League","PRK","No","6/14/2021","12/31/2023","$0","Right","Reasonable","Very Strong","5'8""","141 lbs","-","-",94,119,9,8,6,11,15,9,5,15,2,10,12,6,9,14,14,11,10,11,6,12,12,14,9,11,10,10,11,14,10,10,10,6,8,9,9,7,11,10,11,10,12,11,5,15,11,3,18,12,14,1,1,1,2,1,1,1,1,4,1,1
"1299",23325478,"Ri Hyok-Chol","8/27/1991 (31 years old)","AM (LC), ST (C)","Rimyongsu","DPR Premier Football League","PRK","No","6/14/2021","12/31/2024","Not for Sale","Left","Very Strong","Reasonable","5'7""","158 lbs","-","-",94,118,8,11,8,15,13,8,11,9,9,9,11,10,8,9,8,13,10,10,6,14,12,12,11,15,10,10,10,11,11,10,10,7,8,10,13,5,13,20,14,11,12,10,5,11,8,5,11,11,15,3,2,1,2,2,1,3,2,1,2,3
"1300",1042765,"Pak Chol-Jin","9/5/1985 (37 years old)","D (C)","Amrokkang","DPR Premier Football League","PRK","No","6/14/2021","12/31/2024","$0","Right","Reasonable","Very Strong","6'1""","174 lbs","-","-",80,118,4,1,2,3,7,6,14,4,7,14,8,4,12,7,15,10,9,8,8,14,9,5,9,6,12,7,1,8,7,8,8,8,12,8,8,7,12,15,9,10,12,11,13,7,9,6,11,12,18,2,3,4,3,1,4,1,3,3,4,1
"1301",2000014016,"Khalid Al-Ghannam","11/7/2000 (22 years old)","AM (L)","Al-Fateh","Saudi Professional League","KSA","No","1/29/2020","6/30/2025","$80K - $8M","Right","Fairly Strong","Very Strong","5'7""","145 lbs","85","11",105,125,6,10,14,8,12,5,6,6,4,4,11,9,4,13,4,7,6,11,8,9,11,14,7,7,8,11,10,9,15,15,13,7,8,14,12,9,9,11,15,12,14,8,14,10,5,4,9,9,18,1,2,1,3,2,4,2,2,1,1,3
"1302",23425628,"Ju Jong-Chol","10/20/1994 (28 years old)","M/AM (C)","Amrokkang","DPR Premier Football League","PRK","No","6/15/2020","12/31/2024","$0 - $55K","Right","Reasonable","Very Strong","5'10""","149 lbs","-","-",98,118,8,8,10,11,14,8,8,6,4,9,14,5,11,9,15,10,8,10,9,14,13,8,13,10,10,10,9,13,13,11,10,9,17,12,14,11,16,18,13,10,12,12,5,5,6,7,10,13,9,1,3,2,2,3,1,3,3,1,3,2
"1303",23036051,"Ri Yong-Chol","2/24/1991 (32 years old)","D (LC)","Sonbong","DPR Premier Football League","PRK","No","6/14/2021","12/31/2023","$500 - $5K","Left","Very Strong","Reasonable","6'2""","194 lbs","-","-",102,118,7,11,5,4,11,9,9,8,9,15,9,8,15,9,11,12,11,10,10,12,3,7,5,6,13,10,10,8,11,10,10,14,10,8,7,9,15,19,13,11,12,10,8,7,8,8,20,14,8,3,1,1,2,3,2,3,2,1,1,1
"1304",23325480,"Sim Hyon-Jin","1/1/1991 (32 years old)","D (RLC), WB (RL), DM","April 25","DPR Premier Football League","PRK","No","6/14/2021","12/31/2024","Not for Sale","Right","Strong","Very Strong","5'9""","149 lbs","-","-",101,118,8,12,5,5,9,9,11,8,9,12,10,7,12,7,15,8,10,10,9,15,7,5,4,8,12,10,10,11,10,10,10,10,12,12,11,8,13,10,11,11,9,10,9,13,5,6,8,10,10,3,4,2,4,1,3,3,4,3,3,2
"1305",23425658,"Kim Ju-Song","11/13/1999 (23 years old)","GK","Sobaeksu","DPR Premier Football League","PRK","No","6/15/2020","7/1/2023","$0","Right","Reasonable","Very Strong","5'11""","176 lbs","-","-",90,118,2,2,1,2,3,5,1,1,2,1,12,3,1,1,8,11,14,9,10,14,16,2,1,3,10,7,6,8,11,11,9,7,5,12,8,6,11,19,11,10,11,10,9,9,11,5,9,8,18,8,13,13,9,10,11,11,5,12,12,12
"1306",23094743,"An Il-Bom","12/2/1990 (32 years old)","AM (LC), ST (C)","April 25","DPR Premier Football League","PRK","No","6/14/2021","12/31/2024","Not for Sale","Left","Very Strong","Fairly Strong","5'7""","143 lbs","-","-",98,118,7,11,9,16,14,9,8,9,8,9,12,11,10,12,9,12,8,12,11,14,18,12,5,14,11,11,9,12,10,12,7,7,15,10,11,9,13,13,9,13,12,13,7,6,7,1,13,9,8,1,2,2,1,2,3,1,1,3,1,1
"1307",98038300,"Kim Yu-Song","1/24/1995 (28 years old)","AM (R), ST (C)","April 25","DPR Premier Football League","PRK","No","6/15/2020","12/31/2024","$0 - $60K","Right","Reasonable","Very Strong","5'10""","163 lbs","22","9",103,118,8,10,14,14,14,8,12,8,8,7,12,8,6,12,5,12,7,13,9,13,2,13,6,9,9,8,10,9,14,14,9,7,12,14,6,8,12,19,12,11,10,14,12,4,12,5,10,12,12,1,2,1,2,3,3,2,2,3,2,2
"1308",23425696,"Pak Myong-Song","3/31/1994 (29 years old)","D (RLC), WB (RL)","April 25","DPR Premier Football League","PRK","No","6/15/2020","12/31/2024","$0 - $65K","Right","Fairly Strong","Very Strong","6'1""","163 lbs","-","-",100,117,5,10,7,6,10,3,10,6,6,10,4,6,10,8,11,10,10,10,12,8,6,5,9,8,8,9,9,10,14,14,10,13,8,14,14,6,13,18,9,10,11,10,13,14,10,7,19,12,9,1,2,3,3,1,2,3,4,3,3,3
"1309",23325474,"So Kyong-Jin","1/8/1994 (29 years old)","M/AM (C)","Sobaeksu","DPR Premier Football League","PRK","No","6/15/2020","7/1/2023","$0","Right","Reasonable","Very Strong","5'11""","160 lbs","-","-",98,117,7,8,7,12,14,8,8,8,1,9,14,6,10,10,10,10,9,8,7,9,13,15,10,12,8,9,13,10,14,13,9,8,12,14,9,7,10,10,10,10,9,12,12,6,11,7,20,13,17,2,3,2,2,2,2,1,2,2,1,2
"1310",23425758,"Sin Tae-Song","5/30/2000 (23 years old)","GK","April 25","DPR Premier Football League","PRK","No","3/25/2019","12/31/2025","$0 - $45K","Right","Reasonable","Very Strong","6'4""","187 lbs","-","-",94,116,6,3,3,3,1,9,1,3,2,1,11,3,3,4,8,12,12,8,10,14,8,2,7,3,9,9,8,8,12,14,5,13,8,10,5,7,12,17,10,11,10,9,9,11,9,6,10,11,18,11,8,14,7,10,14,14,5,7,11,9
"1311",23425699,"Pak Yong-Gwan","12/26/1998 (24 years old)","WB (L), DM, M (LC), AM (L)","Ryomyong","DPR Premier Football League","PRK","No","12/31/2018","12/31/2025","$1.5K - $16K","Left","Very Strong","Reasonable","5'8""","141 lbs","-","-",96,116,8,12,10,10,14,5,8,10,4,9,12,7,14,12,5,10,9,10,4,14,4,11,4,12,10,9,9,12,13,12,8,4,9,12,10,7,17,10,12,11,12,11,9,2,5,1,11,12,13,2,3,2,2,2,3,1,2,1,2,3
"1312",84000059,"Rayyan Bilal Mahmoud","10/4/1988 (34 years old)","ST (C)","Al-Anwar","Saudi Third Division Group B","KSA","No","8/1/2021","6/30/2024","$500 - $7K","Right","Fairly Strong","Very Strong","5'11""","163 lbs","95","38",70,125,6,9,9,12,11,3,12,7,2,4,10,6,4,10,5,11,2,10,4,13,12,10,9,9,5,8,7,8,10,8,6,6,11,10,10,6,12,18,9,13,10,10,5,2,7,7,10,17,14,2,2,3,1,1,2,4,2,1,2,3
"1313",23425540,"Choe Ju-Song","1/27/1996 (27 years old)","M/AM (L), ST (C)","Amrokkang","DPR Premier Football League","PRK","No","6/15/2020","12/31/2023","$0 - $24K","Left","Very Strong","Reasonable","5'10""","149 lbs","-","-",100,116,7,12,13,12,13,7,13,8,5,7,9,6,4,9,13,10,6,6,8,13,12,9,13,11,7,8,9,9,13,13,8,6,11,13,7,6,10,11,12,14,12,10,5,9,11,6,10,12,19,1,1,2,1,1,1,4,1,3,2,3
"1314",23425679,"Myong Cha-Hyon","3/20/1990 (33 years old)","D/WB (L), DM, M (LC)","Sobaeksu","DPR Premier Football League","PRK","No","6/14/2021","12/31/2024","Not for Sale","Left","Very Strong","Reasonable","6'0""","167 lbs","-","-",97,116,9,10,7,9,14,8,9,8,9,10,11,4,15,10,11,8,10,9,11,12,4,5,10,7,13,10,13,11,11,11,8,10,12,11,7,7,12,20,10,12,11,12,14,7,6,3,20,12,13,1,3,3,3,3,2,1,2,1,4,3
"1315",23425665,"Kim Pom-Hyok","4/15/2000 (23 years old)","D (C), DM, M (C)","Ryomyong","DPR Premier Football League","PRK","No","1/1/2019","12/31/2025","$16K - $45K","Right","Reasonable","Very Strong","5'8""","149 lbs","-","-",94,116,5,8,7,9,13,7,10,10,4,12,8,3,10,10,14,11,9,10,11,14,12,5,17,9,10,9,10,8,13,14,9,5,10,14,7,7,12,11,9,14,12,11,10,10,7,7,12,13,20,3,4,2,3,3,2,2,1,1,1,3
"1316",47014894,"Hong Kum-Song","6/3/1990 (33 years old)","M/AM (C)","Sobaeksu","DPR Premier Football League","PRK","No","6/14/2021","7/1/2023","$0","Right","Reasonable","Very Strong","5'9""","154 lbs","21","3",94,116,7,7,4,10,13,8,8,10,8,9,10,8,10,14,11,12,9,12,9,11,5,13,14,12,7,9,14,10,12,10,10,9,15,10,9,6,16,16,11,10,13,10,9,15,5,8,15,13,15,3,3,3,1,1,2,3,3,1,3,1
"1317",23035958,"Kim Myong-Won","7/15/1983 (39 years old)","ST (C)","Amrokkang","DPR Premier Football League","PRK","No","6/14/2021","12/31/2024","$0","Right","Reasonable","Very Strong","5'10""","158 lbs","-","-",82,115,5,4,5,9,13,6,13,7,1,6,6,12,3,8,9,13,6,9,7,10,5,8,9,11,6,6,3,7,17,12,5,3,14,17,5,5,10,13,10,11,14,12,14,5,7,7,12,11,11,1,1,14,3,1,1,9,2,2,3,9
"1318",23325475,"Ri Sang-Chol","12/26/1990 (32 years old)","M/AM (LC)","Amrokkang","DPR Premier Football League","PRK","No","6/14/2021","12/31/2024","Not for Sale","Left","Very Strong","Reasonable","5'6""","141 lbs","-","-",96,114,9,12,14,12,12,9,9,8,9,7,14,4,9,10,7,11,10,9,10,14,3,14,12,15,8,10,13,12,11,10,10,6,8,11,9,5,18,16,11,11,13,11,5,6,7,8,11,10,7,1,1,2,2,1,2,1,3,3,1,3
"1319",23425705,"Ri Chol-Song","3/13/1998 (25 years old)","GK","Ryomyong","DPR Premier Football League","PRK","No","6/15/2020","12/31/2024","$14K - $40K","Right","Reasonable","Very Strong","6'1""","169 lbs","-","-",96,114,4,2,3,3,5,5,1,1,2,3,11,2,3,5,13,9,12,7,13,13,4,1,4,3,10,8,7,7,9,15,8,12,9,11,4,7,11,16,10,11,9,12,9,13,7,7,20,10,9,5,8,13,12,9,10,7,5,9,10,13
"1320",23425762,"Yun Min","7/3/2000 (22 years old)","D/WB/M/AM (L)","Ryomyong","DPR Premier Football League","PRK","No","6/15/2020","12/31/2025","$0 - $30K","Left","Very Strong","Fairly Strong","5'7""","149 lbs","-","-",92,114,7,9,7,11,8,5,8,9,4,9,10,7,10,12,7,9,9,10,10,11,11,11,11,12,6,10,9,10,14,13,5,5,15,14,7,3,14,19,11,11,11,13,9,12,8,4,11,11,9,1,1,2,2,4,4,3,3,2,3,2
"1321",23425590,"Choe Jin-Nam","11/20/1998 (24 years old)","D/WB (L)","Ryomyong","DPR Premier Football League","PRK","No","1/1/2019","12/31/2025","$0 - $45K","Left","Very Strong","Reasonable","5'6""","143 lbs","-","-",96,114,5,11,8,4,10,1,9,1,8,10,10,2,14,10,10,7,10,9,10,14,12,5,9,8,7,9,9,9,14,14,9,1,16,14,14,3,14,20,11,11,12,11,10,17,12,8,15,12,11,2,1,2,3,1,3,1,2,2,3,1
"1322",23425751,"Kye Tam","10/6/2000 (22 years old)","DM, M (RC)","Ryomyong","DPR Premier Football League","PRK","No","1/1/2019","12/31/2025","$1K - $12K","Right","Reasonable","Very Strong","5'8""","138 lbs","-","-",92,114,4,8,10,8,14,8,8,5,8,7,9,3,13,14,14,10,9,9,10,14,7,5,6,9,11,9,7,13,14,12,6,5,14,13,8,7,12,13,11,13,7,13,10,1,6,6,12,10,18,2,3,3,1,1,4,1,1,1,2,2
"1323",2000152517,"Salem Barayan","2/10/2002 (21 years old)","D/WB (R)","Al-Ittihad","Saudi Professional League","KSA","No","6/30/2022","6/30/2025","$2.2M - $4.6M","Right","Fairly Strong","Very Strong","5'7""","152 lbs","10","-",80,125,5,10,9,4,10,3,10,7,8,10,10,7,14,10,13,9,9,10,8,12,3,5,14,8,10,14,9,12,11,14,15,7,13,10,10,5,13,18,10,10,9,9,9,6,6,6,18,11,9,2,2,1,1,3,2,2,3,1,2,3
"1324",23036079,"Ri Kwang-Hyok","8/17/1987 (35 years old)","D (C)","Rimyongsu","DPR Premier Football League","PRK","No","6/14/2021","12/31/2024","Not for Sale","Right","Reasonable","Very Strong","5'10""","154 lbs","-","-",92,114,9,6,3,5,11,6,15,5,6,16,6,6,13,10,5,14,11,11,14,10,4,5,5,10,12,10,7,11,12,11,11,6,12,11,12,8,13,16,11,11,13,11,11,13,12,7,20,13,12,1,1,1,2,2,3,1,2,3,2,2
"1325",1042763,"Cha Jong-Hyok","9/25/1985 (37 years old)","D/WB (R)","Amrokkang","DPR Premier Football League","PRK","No","6/14/2021","7/1/2023","$0","Right","Reasonable","Very Strong","5'10""","169 lbs","113","2",84,114,6,15,6,8,12,4,9,8,4,10,11,6,14,11,10,10,10,8,13,14,16,8,13,9,11,10,11,11,10,10,10,9,12,10,10,8,13,16,14,10,11,12,11,15,5,2,8,13,13,2,2,2,3,1,3,1,1,1,2,1
"1326",23036083,"Kim Kyong-Il","12/11/1988 (34 years old)","M/AM (RL)","Rimyongsu","DPR Premier Football League","PRK","No","6/14/2021","12/31/2024","$0 - $1.5K","Right","Strong","Very Strong","5'8""","141 lbs","-","-",88,114,8,12,7,13,13,6,8,9,1,8,9,6,7,15,7,12,8,14,9,10,14,13,13,15,8,9,9,14,10,9,8,4,12,9,12,7,15,11,9,11,10,12,12,9,5,5,12,10,12,2,3,2,1,3,1,1,1,2,2,2
"1327",1042770,"Kim Chol-Ho","10/15/1985 (37 years old)","D/WB (R)","Amrokkang","DPR Premier Football League","PRK","No","6/14/2021","12/31/2024","$0","Right","Reasonable","Very Strong","5'7""","160 lbs","-","-",71,113,5,11,9,3,12,3,10,4,9,11,8,5,12,11,8,10,10,10,10,13,15,5,8,9,9,10,5,10,9,10,10,6,16,9,8,9,13,13,11,12,11,13,12,14,9,1,13,11,9,3,2,2,1,3,1,1,3,3,2,1
"1328",58011586,"Choe Myong-Ho","7/3/1988 (34 years old)","M (LC)","Kyonggongop","DPR Premier Football League","PRK","No","6/14/2021","12/31/2023","$0","Right","Reasonable","Very Strong","5'11""","165 lbs","1","-",92,113,8,10,10,5,13,7,8,9,2,10,13,8,5,13,14,13,2,9,9,12,5,5,11,9,7,9,12,13,11,11,9,8,12,11,11,8,13,14,10,12,15,10,5,6,7,1,13,12,19,2,2,3,2,1,1,1,2,4,3,2
"1329",23114000,"Kim Myong-Gyu","1/8/1985 (38 years old)","D (C)","Rimyongsu","DPR Premier Football League","PRK","No","6/14/2021","12/31/2024","$0","Right","Reasonable","Very Strong","6'0""","165 lbs","-","-",72,113,5,4,4,6,6,6,11,5,5,14,8,3,14,6,8,13,9,8,10,14,12,5,7,7,14,7,5,8,6,7,7,8,7,7,7,7,15,12,9,9,12,12,12,16,7,5,15,12,20,2,2,1,2,2,3,1,2,2,2,3
"1330",23133766,"Jong Il-Gwan","10/30/1992 (30 years old)","AM (C), ST (C)","Rimyongsu","DPR Premier Football League","PRK","No","7/1/2019","12/31/2024","$0 - $75K","Right","Reasonable","Very Strong","5'9""","158 lbs","10","1",104,113,8,10,14,9,14,8,14,6,8,7,8,4,6,13,12,12,6,10,7,11,10,12,9,14,9,9,8,10,14,14,9,4,12,14,14,9,10,17,11,9,8,10,8,14,6,1,9,12,12,1,1,3,1,4,3,2,1,3,2,2
"1331",23325472,"Kang Kuk-Chol","7/1/1990 (32 years old)","D (C)","Pyongyang City","DPR Premier Football League","PRK","No","6/14/2021","12/31/2023","$0 - $12K","Right","Reasonable","Very Strong","6'0""","154 lbs","-","-",98,112,4,5,4,5,9,1,11,5,7,14,9,3,11,6,15,13,9,9,11,14,13,5,10,6,14,8,5,9,13,10,9,10,11,9,7,9,13,11,11,12,11,11,15,9,10,3,16,12,14,3,2,4,3,4,2,1,1,3,1,2
"1332",23325469,"Jang Kuk-Chol","2/16/1994 (29 years old)","D (C)","Hwaebul","DPR Premier Football League","PRK","No","6/15/2020","12/31/2024","$24K - $70K","Right","Reasonable","Very Strong","6'0""","158 lbs","-","-",104,112,3,1,1,3,9,6,13,4,4,14,8,1,14,7,7,12,10,9,9,14,11,5,14,7,14,8,4,9,14,12,9,9,10,11,14,12,12,10,8,8,10,11,7,14,8,1,19,13,18,3,2,1,2,1,3,1,1,1,4,3
"1333",23425549,"Yun Il-Gwang","4/1/1993 (30 years old)","M/AM (RC)","April 25","DPR Premier Football League","PRK","No","6/14/2021","12/31/2024","$16K - $45K","Right","Reasonable","Very Strong","5'9""","145 lbs","-","-",96,112,5,9,12,10,13,8,8,7,8,7,14,5,7,13,6,9,9,10,5,12,15,12,4,12,9,9,12,10,14,14,9,6,10,14,10,6,13,12,12,12,12,11,10,1,8,4,17,12,16,2,2,2,3,1,1,4,3,3,2,1
"1334",23359978,"Adel Bader Mousa","1/17/1997 (26 years old)","M/AM (C)","Al-Sailiya","Qatar League","QAT","No","7/1/2021","6/30/2025","$0","Right","Fairly Strong","Very Strong","5'8""","147 lbs","67","1",90,110,7,8,9,9,14,3,8,9,5,10,13,6,10,12,13,8,8,9,9,9,13,11,10,10,10,7,8,12,14,14,9,3,12,14,14,7,16,19,10,10,12,12,6,12,11,6,17,10,9,2,3,2,1,4,1,1,2,3,3,3
"1335",23334538,"Hassan Al-Amri","4/21/1994 (29 years old)","AM (RL)","Al-Taawoun","Saudi Professional League","KSA","No","8/8/2021","6/30/2024","$160K - $1.6M","Right","Reasonable","Very Strong","5'8""","147 lbs","136","16",95,125,10,10,13,11,12,10,4,4,10,5,13,15,5,14,10,11,9,9,10,10,11,13,7,13,5,9,9,12,13,13,10,7,15,12,10,7,13,13,8,10,11,10,5,5,9,2,12,10,20,1,2,2,2,2,2,3,1,1,1,2
"1336",23425545,"An Tae-Song","10/21/1993 (29 years old)","GK","April 25","DPR Premier Football League","PRK","No","6/15/2020","12/31/2024","$18K - $55K","Right","Reasonable","Very Strong","5'11""","163 lbs","-","-",102,112,3,3,2,1,1,8,1,1,2,1,10,3,2,3,8,8,15,8,10,14,17,3,10,1,12,9,8,8,12,11,9,6,13,13,6,7,11,18,12,11,11,12,6,5,8,7,12,10,12,8,5,14,12,11,13,14,5,8,14,9
"1337",23325471,"Ro Hak-Su","1/19/1990 (33 years old)","D/WB (R)","Rimyongsu","DPR Premier Football League","PRK","No","6/14/2021","12/31/2024","Not for Sale","Right","Reasonable","Very Strong","5'10""","154 lbs","-","-",94,111,9,12,9,4,12,7,9,4,9,11,9,1,14,9,11,9,11,6,13,15,17,5,10,9,10,10,8,10,13,10,10,10,13,10,9,10,16,10,10,10,11,12,8,2,7,6,11,10,11,3,1,2,2,1,2,2,2,2,3,2
"1338",23425579,"Rim Kwang-Hyok","8/5/1992 (30 years old)","M/AM (C), ST (C)","Kigwancha","DPR Premier Football League","PRK","No","6/14/2021","12/31/2024","$1.5K - $16K","Left","Very Strong","Fairly Strong","5'9""","149 lbs","-","-",96,111,7,8,14,10,9,5,9,10,5,8,12,3,8,13,14,11,4,11,9,14,14,13,5,13,10,9,9,10,14,14,9,6,14,14,7,12,10,18,9,7,12,10,6,6,10,1,11,10,11,1,1,2,2,1,2,3,3,3,3,3
"1339",23425664,"Kim Kyong-Hun","5/12/1990 (33 years old)","D/WB/M/AM (RL)","Kyonggongop","DPR Premier Football League","PRK","No","6/14/2021","12/31/2023","$0 - $8K","Right","Reasonable","Very Strong","5'6""","134 lbs","-","-",93,111,8,13,6,12,12,7,8,6,4,9,12,3,10,10,12,11,9,10,8,11,13,9,13,14,10,9,8,10,9,12,9,1,7,11,12,3,12,16,10,9,10,10,13,14,11,1,10,9,20,3,2,2,2,4,3,3,2,1,2,1
"1340",23036071,"Kim Kuk-Jin","1/5/1989 (34 years old)","M/AM (RL)","Pyongyang City","DPR Premier Football League","PRK","No","6/14/2021","12/31/2024","Not for Sale","Right","Strong","Very Strong","5'8""","143 lbs","40","2",93,111,8,8,10,12,13,8,5,7,8,8,11,8,6,8,13,9,9,11,9,14,15,14,7,11,6,5,5,10,15,11,9,6,10,14,11,6,14,20,14,12,9,9,12,15,7,6,11,9,7,3,1,2,1,2,4,4,1,2,2,2
"1341",23114004,"Pak Yong-Jin","4/18/1986 (37 years old)","D (C)","Rimyongsu","DPR Premier Football League","PRK","No","6/14/2021","12/31/2024","$0","Right","Reasonable","Very Strong","6'0""","169 lbs","-","-",68,111,6,4,1,2,8,4,9,4,4,10,8,7,15,5,11,7,8,8,10,15,16,5,13,7,14,7,6,8,7,6,8,8,13,5,9,9,12,16,11,10,10,12,9,4,7,6,18,13,15,2,1,1,2,2,4,1,1,1,3,3
"1342",859598,"Vurnon Anita","4/4/1989 (34 years old)","D (RL), DM, M (C)","RKC Waalwijk","Eredivisie","CUW","Yes","7/1/2020","6/30/2024","$70K - $700K","Right","Reasonable","Very Strong","5'6""","145 lbs","383","10",110,140,6,9,10,6,12,2,6,8,8,13,12,8,14,12,7,12,13,12,12,12,13,6,11,11,15,14,9,13,12,12,13,4,15,11,10,7,15,16,14,14,13,14,4,13,8,5,14,12,13,2,1,2,1,1,3,3,1,1,3,1
"1343",37056755,"Nigel Robertha","2/13/1998 (25 years old)","ST (C)","D.C. United","Major League Soccer","CUW","Yes","3/25/2021","12/31/2023","$55K - $550K","Right","Reasonable","Very Strong","6'0""","169 lbs","137","40",110,140,7,9,12,12,11,12,11,9,6,4,10,13,6,12,9,12,8,13,11,8,9,13,9,13,4,10,12,12,15,13,13,13,12,15,12,13,9,9,12,12,12,11,9,13,7,8,12,13,8,1,3,1,2,1,2,4,2,1,3,2
"1344",2000199278,"Nazjir Held","9/2/2005 (17 years old)","D/WB (L)","FC Utrecht","Eredivisie","CUW","Yes","6/13/2022","6/30/2026","$325K - $9.6M","Left","Very Strong","Reasonable","5'9""","134 lbs","3","-",96,139,5,10,9,7,9,2,10,4,9,8,11,5,13,11,13,11,11,10,10,11,12,8,1,7,12,14,10,13,13,14,15,8,12,14,11,6,11,14,9,14,12,9,6,16,7,2,8,12,14,1,2,2,4,4,3,2,1,3,1,3
"1345",37019516,"Jürgen Locadia","11/7/1993 (29 years old)","AM (L), ST (C)","CZ Mighty Lions","Chinese Super League","CUW","Yes","2/20/2023","12/31/2023","$250K - $2.5M","Right","Fairly Strong","Very Strong","6'1""","191 lbs","224","63",122,138,8,7,10,13,12,12,14,11,10,6,11,15,7,13,13,12,11,11,9,12,10,14,7,12,7,11,12,11,13,14,13,14,12,13,12,15,14,13,14,14,14,10,11,8,5,8,12,14,9,1,1,1,3,3,1,3,3,1,3,2
"1346",23167217,"Ahmed Al-Kassar","5/8/1991 (32 years old)","GK","Al-Faisaly (KSA)","Saudi First Division League","KSA","No","6/14/2021","6/30/2024","$950K - $2M","Right","Reasonable","Very Strong","5'10""","167 lbs","143","-",95,125,2,3,2,1,3,4,1,1,2,2,9,3,1,5,10,14,13,9,13,14,4,2,10,3,13,9,8,8,10,7,9,8,15,11,4,7,12,19,13,10,12,10,13,12,6,8,16,13,7,10,8,14,6,12,6,12,5,8,11,10
"1347",37041086,"Brandley Kuwas","9/19/1992 (30 years old)","AM (RC)","Giresunspor","Turkish 1. League","CUW","Yes","9/5/2022","6/30/2023","$0 - $35K","Left","Very Strong","Fairly Strong","6'0""","171 lbs","330","52",95,136,10,12,12,10,12,13,7,14,8,3,13,10,4,12,12,11,10,9,10,11,5,14,6,12,5,8,9,8,12,12,13,9,11,10,11,13,13,12,11,8,7,6,7,11,7,8,11,7,10,1,2,2,2,2,4,1,3,1,1,1
"1348",37046963,"Juninho Bacuna","8/7/1997 (25 years old)","M/AM (RC)","Birmingham","Sky Bet Championship","CUW","Yes","1/27/2022","6/30/2025","$400K - $3.9M","Right","Reasonable","Very Strong","5'10""","163 lbs","253","20",118,135,11,13,11,10,13,12,8,12,4,9,13,14,13,14,13,13,11,12,9,10,12,14,8,11,12,9,12,13,12,14,12,8,14,12,15,11,15,9,7,12,12,14,2,11,13,9,10,12,15,1,3,1,2,4,1,1,3,2,2,3
"1349",860472,"Eloy Room","2/6/1989 (34 years old)","GK","Columbus","Major League Soccer","CUW","Yes","7/7/2019","12/31/2024","Not for Sale","Right Only","Weak","Very Strong","6'3""","180 lbs","287","-",124,132,5,1,9,1,10,7,3,1,7,5,11,1,8,10,8,12,13,15,13,13,8,3,11,3,13,11,7,14,11,12,12,14,12,11,10,12,14,14,12,10,6,14,8,6,7,7,12,16,13,12,11,14,12,14,13,14,8,12,12,12
"1350",37012868,"Quenten Martinus","3/7/1991 (32 years old)","AM (RLC), ST (C)","Kyoto","J1 League","CUW","Yes","1/7/2022","1/31/2024","$0","Left","Very Strong","Weak","6'0""","152 lbs","264","31",102,130,10,12,13,10,12,11,9,11,10,3,11,12,3,14,9,10,8,11,13,10,15,13,8,14,8,8,11,12,12,11,11,8,11,13,11,8,12,19,12,12,13,10,8,13,8,7,13,11,17,3,2,3,1,1,2,3,1,2,1,2
"1351",2000030956,"Xander Severina","4/12/2001 (22 years old)","AM (RL)","ADO Den Haag","Keuken Kampioen Divisie","CUW","Yes","7/1/2020","6/30/2026","$170K - $1.7M","Left Only","Very Strong","Weak","6'1""","165 lbs","55","6",116,130,11,12,14,11,12,13,8,12,5,6,11,11,7,13,8,11,9,11,10,10,11,13,5,12,6,9,9,10,15,13,12,10,12,16,11,10,11,11,11,11,10,10,8,11,7,7,11,12,11,3,3,1,1,3,3,3,2,4,4,1
"1352",37071912,"Kevin Felida","11/11/1999 (23 years old)","DM, M (C)","RKC Waalwijk","Eredivisie","CUW","Yes","7/1/2022","6/30/2025","$400K - $4M","Right","Weak","Very Strong","5'9""","145 lbs","139","6",106,129,9,6,5,8,11,9,9,7,4,11,13,7,11,11,10,14,12,11,12,13,12,7,8,10,11,13,8,13,15,12,13,10,11,13,12,13,15,12,9,12,13,13,5,6,5,6,14,8,13,3,2,1,2,2,2,1,2,3,1,1
"1353",37078348,"Jeremy Antonisse","3/29/2002 (21 years old)","AM (L), ST (C)","FC Emmen","Keuken Kampioen Divisie","CUW","Yes","8/23/2021","6/30/2024","$0","Right","Weak","Very Strong","6'0""","154 lbs","75","6",107,128,10,13,12,9,10,10,7,12,9,5,11,11,4,12,11,8,10,15,11,15,12,9,11,13,5,10,10,12,12,11,9,9,11,13,10,11,13,20,11,12,10,10,13,13,12,5,11,10,7,1,1,3,1,1,2,2,3,2,1,1
"1354",37013420,"Cuco Martina","9/25/1989 (33 years old)","D (RLC), WB (R)","NAC Breda","Keuken Kampioen Divisie","CUW","Yes","5/10/2023","6/30/2024","$35K - $350K","Right","Reasonable","Very Strong","6'0""","171 lbs","278","8",103,126,8,13,11,6,11,9,12,9,12,10,10,9,13,13,9,11,11,11,10,11,11,9,10,12,10,12,11,12,9,8,14,13,10,11,12,13,13,12,12,13,8,8,5,9,7,5,12,5,13,1,2,2,3,2,1,2,1,3,3,1
"1355",37007249,"Charlison Benschop","8/21/1989 (33 years old)","ST (C)","De Graafschap","Keuken Kampioen Divisie","CUW","Yes","8/1/2022","6/30/2024","$240K - $700K","Right","Reasonable","Very Strong","6'3""","198 lbs","353","80",108,125,7,8,11,10,11,10,12,9,7,7,9,13,6,11,12,11,14,11,12,12,14,11,7,13,7,13,9,14,12,10,15,15,12,12,12,15,8,12,14,11,11,9,11,14,8,6,14,15,12,3,2,1,2,4,2,1,1,3,2,3
"1356",28058332,"Kenji Gorré","9/29/1994 (28 years old)","AM (RL)","BVT","Portuguese Premier League","CUW","Yes","7/22/2021","6/30/2025","$220K - $2.2M","Right","Reasonable","Very Strong","5'10""","160 lbs","153","16",120,125,8,10,15,12,14,11,5,12,3,4,11,12,6,15,10,11,9,13,9,8,13,18,5,12,6,8,11,10,15,16,12,9,13,14,12,10,10,12,10,12,11,10,5,9,12,6,11,15,11,2,2,3,1,2,3,1,1,2,2,1
"1357",23208514,"Abdulfattah Asiri","2/26/1994 (29 years old)","AM (RC)","IFK Mariehamn","Finnish Premier League","KSA","No","4/27/2023","11/30/2024","$45K - $425K","Left","Very Strong","Strong","5'6""","141 lbs","163","29",105,125,10,11,14,12,12,8,4,12,2,3,16,11,3,13,8,8,6,10,9,9,8,13,8,12,5,10,15,9,12,14,12,3,10,12,11,5,10,14,11,13,10,9,8,12,15,1,12,12,10,2,1,2,2,2,2,2,3,2,3,1
"1358",37019044,"Leandro Bacuna","8/21/1991 (31 years old)","DM, M (C)","Watford","Sky Bet Championship","CUW","Yes","12/14/2022","6/30/2025","$0 - $50K","Right Only","Weak","Very Strong","6'2""","169 lbs","407","29",107,125,14,12,11,8,12,13,10,11,11,8,11,14,11,12,14,12,12,10,10,12,14,7,10,12,11,12,12,10,13,13,11,12,15,13,13,14,16,12,11,8,12,8,7,13,14,16,7,15,12,2,1,3,1,4,1,3,2,1,1,3
"1359",37004936,"Guyon Fernandez","4/18/1986 (37 years old)","AM (RL), ST (C)","Smitshoek","Dutch Vierde Divisie B","CUW","Yes","7/1/2020","-","$0","Right","Weak","Very Strong","6'0""","174 lbs","196","58",79,122,7,8,10,10,11,9,11,8,8,3,9,11,3,12,16,11,12,10,11,6,12,13,5,14,5,9,9,7,11,9,13,12,9,10,8,12,10,8,5,10,12,11,12,6,11,7,4,12,7,3,1,1,2,3,1,1,3,3,1,2
"1360",37005660,"Roly Bonevacia","10/8/1991 (31 years old)","M/AM (C)","Tadamun (KUW)","Kuwaiti First Division","CUW","Yes","8/11/2022","6/30/2023","$0 - $100K","Right","Reasonable","Very Strong","5'9""","158 lbs","216","27",112,122,9,9,12,8,13,9,9,13,12,8,14,9,10,13,14,11,15,11,12,12,8,11,8,10,10,12,12,13,13,14,13,7,13,13,12,13,14,19,14,10,9,11,5,11,10,6,12,11,15,2,1,3,2,1,1,2,4,1,3,1
"1361",37017297,"Rangelo Janga","4/16/1992 (31 years old)","ST (C)","CFR Cluj","Romanian First League","CUW","Yes","8/31/2022","6/30/2024","$0","Right","Reasonable","Very Strong","6'4""","182 lbs","348","100",113,120,3,6,10,13,7,4,14,7,4,5,10,7,6,10,12,15,7,10,10,12,12,6,7,16,6,12,8,13,13,11,12,15,15,14,12,15,6,17,15,16,13,14,5,12,5,6,11,13,13,3,2,2,1,2,1,3,1,1,1,2
"1362",37042017,"Richairo Živković","9/5/1996 (26 years old)","AM (RL), ST (C)","FC Emmen","Keuken Kampioen Divisie","CUW","Yes","7/22/2022","6/30/2025","$1.6M - $3.4M","Right","Weak","Very Strong","6'2""","163 lbs","259","81",115,120,10,11,13,12,12,9,13,11,5,3,11,13,6,13,10,12,9,11,12,11,10,15,6,13,8,12,12,10,14,13,11,13,9,14,11,11,10,9,9,8,12,5,14,9,6,10,7,13,7,1,1,3,3,3,2,4,2,3,1,1
"1363",37070212,"Jearl Margaritha","4/10/2000 (23 years old)","M (R), AM (RL)","TOP Oss","Keuken Kampioen Divisie","CUW","Yes","8/4/2021","6/30/2025","$0","Right Only","Weak","Very Strong","5'11""","158 lbs","86","29",104,120,10,11,12,11,11,10,7,11,7,5,12,4,5,12,6,10,9,10,11,16,13,12,5,8,5,8,7,9,15,14,10,8,12,16,10,7,15,18,11,10,11,9,5,8,5,5,10,12,13,3,1,3,1,4,3,1,3,1,2,3
"1364",37005635,"Darryl Lachman","11/11/1989 (33 years old)","D (RC), WB (R), DM","Perth Glory","Isuzu UTE A-League","CUW","Yes","5/20/2022","6/30/2024","$10K - $110K","Right Only","Weak","Very Strong","6'2""","224 lbs","309","4",109,119,8,8,9,6,9,7,13,8,8,12,11,7,12,12,5,12,13,12,11,12,11,7,7,13,11,12,9,8,11,12,14,14,7,11,10,15,9,14,12,12,12,11,7,12,8,12,12,9,6,1,3,4,2,1,2,3,2,1,2,1
"1365",37060620,"Godfried Roemeratoe","8/19/1999 (23 years old)","DM, M (C)","Hapoel Tel-Aviv","Israeli Premier League","CUW","Yes","7/1/2022","5/31/2024","$0","Right","Reasonable","Very Strong","5'10""","149 lbs","93","1",106,118,10,11,12,5,12,10,6,12,4,9,12,5,10,11,5,13,11,11,11,12,13,5,5,12,12,14,11,14,13,12,12,9,14,10,14,9,12,10,12,12,10,10,7,11,11,4,12,12,13,2,3,1,1,2,1,1,2,3,1,1
"1366",37058054,"Sherel Floranus","8/23/1998 (24 years old)","D/WB (RL)","Antalyaspor","Turkish Super League","CUW","Yes","7/1/2021","6/30/2025","$0","Right","Fairly Strong","Very Strong","5'11""","163 lbs","164","3",110,116,8,12,11,5,12,5,10,9,12,11,9,3,11,11,11,9,11,10,11,10,12,11,6,12,11,13,9,12,12,13,11,11,13,11,13,12,12,14,11,11,12,11,13,10,10,6,12,11,11,2,3,1,3,1,1,2,1,2,3,1
"1367",37019509,"Anthony van den Hurk","1/9/1993 (30 years old)","AM (C), ST (C)","Górnik","PKO Bank Polski Ekstraklasa","CUW","Yes","8/18/2022","6/30/2024","$0","Right","Reasonable","Very Strong","5'11""","171 lbs","272","111",105,116,7,10,11,12,11,9,12,8,6,6,11,12,7,11,13,12,11,11,12,12,11,12,12,12,7,11,11,11,12,10,13,12,12,13,12,13,7,10,12,7,12,5,8,11,11,15,12,11,13,3,2,1,2,4,1,3,2,1,1,2
"1368",23167325,"Omar Hawsawi","9/27/1985 (37 years old)","D (C)","Al-Ittihad","Saudi Professional League","KSA","No","5/30/2023","6/30/2024","$100K - $300K","Right Only","Weak","Very Strong","6'0""","163 lbs","226","12",105,125,4,4,5,5,9,5,15,3,6,14,9,5,16,8,16,11,16,10,10,10,14,6,13,5,13,14,7,9,9,8,13,15,14,9,11,15,6,12,11,18,11,7,8,10,8,5,11,14,11,1,3,2,2,3,3,3,3,3,3,1
"1369",37084941,"Daijiro Chirino","1/24/2002 (21 years old)","D (RC), WB (R), DM","PEC Zwolle","Eredivisie","CUW","Yes","9/20/2022","6/30/2025","$0","Right","Weak","Very Strong","6'1""","180 lbs","30","1",96,116,12,12,12,10,10,10,8,10,6,8,10,8,10,10,12,10,10,10,10,9,10,8,6,7,9,10,8,10,13,14,11,4,6,13,12,12,6,19,12,13,8,10,6,8,8,5,10,11,10,3,3,2,1,3,2,3,3,4,3,3
"1370",860297,"Kemy Agustien","8/20/1986 (36 years old)","DM, M (C)","Gresley","English Northern Premier League Division One Mids","CUW","Yes","6/12/2023","-","$0","Right","Weak","Very Strong","5'10""","165 lbs","313","11",55,115,11,11,10,7,10,9,7,8,6,5,12,7,6,12,10,9,9,10,10,9,7,13,6,9,8,8,12,6,7,7,9,7,6,8,7,12,11,14,10,7,10,7,14,8,12,8,10,7,15,2,2,4,1,2,3,3,1,3,3,4
"1371",37065572,"Nathan Markelo","1/7/1999 (24 years old)","D/WB (R), DM","Excelsior","Eredivisie","CUW","Yes","7/1/2022","6/30/2025","$0","Right","Reasonable","Very Strong","6'0""","171 lbs","61","-",106,115,10,13,8,8,10,10,11,10,5,11,8,5,11,10,11,8,12,9,8,9,12,7,13,7,10,10,8,13,15,10,8,11,13,14,12,12,13,11,10,10,12,11,7,13,15,5,12,11,20,1,3,1,4,2,2,4,2,3,2,4
"1372",37064803,"Jeremy Cijntje","1/8/1998 (25 years old)","AM (RL)","Jerv","Norwegian First Division","CUW","Yes","9/6/2022","12/31/2023","$4K - $40K","Right Only","Weak","Very Strong","6'0""","158 lbs","98","10",102,115,8,11,14,8,11,8,12,10,3,5,11,9,5,12,6,11,11,10,11,12,10,8,7,11,5,12,8,13,13,11,13,14,14,14,11,11,10,9,12,11,8,9,5,11,4,10,11,9,11,2,1,1,1,4,3,2,2,3,1,2
"1373",2000199436,"Calvin Gustina","11/19/2004 (18 years old)","M/AM (C)","ADO Den Haag","Keuken Kampioen Divisie","CUW","Yes","5/19/2023","6/30/2025","$140K - $1.4M","Right","Weak","Very Strong","5'9""","145 lbs","-","-",83,114,7,5,9,11,11,7,2,7,4,4,12,4,6,12,10,7,8,12,5,13,5,11,7,9,9,12,14,9,14,13,12,4,13,12,9,6,13,20,12,12,9,10,5,3,6,7,10,12,17,1,2,1,3,1,4,1,1,2,1,1
"1374",37005640,"Jarchinio Antonia","12/27/1990 (32 years old)","M (R), AM (RL)","NAC Breda","Keuken Kampioen Divisie","CUW","Yes","8/25/2021","6/30/2023","$0","Right Only","Weak","Very Strong","5'7""","143 lbs","315","43",80,114,10,11,11,6,11,3,2,4,5,2,11,8,3,12,12,11,9,10,8,9,13,12,3,10,3,10,10,7,13,12,6,5,11,12,9,5,13,12,11,8,12,7,8,11,5,6,8,13,14,1,2,1,2,2,3,1,1,2,2,1
"1375",37052313,"Giovanni Troupée","3/20/1998 (25 years old)","D/WB (R)","Lokomotiv Plovdiv","Bulgarian First League","CUW","Yes","1/1/2023","6/30/2024","$250K - $750K","Right","Weak","Very Strong","5'11""","143 lbs","136","5",107,112,10,8,9,5,12,7,10,7,12,12,11,7,12,12,9,11,15,11,11,10,13,9,11,11,11,14,10,15,14,13,12,10,14,13,14,8,8,20,11,13,13,13,5,9,7,5,10,11,10,2,3,1,2,4,3,1,2,1,1,1
"1376",37085283,"Juruël Bernadina","5/11/2003 (20 years old)","M/AM (R)","Go Ahead Eagles","Eredivisie","CUW","Yes","9/1/2022","6/30/2024","$30K - $325K","Right Only","Weak","Very Strong","5'10""","154 lbs","-","-",82,111,8,11,7,9,13,6,7,7,6,6,7,5,3,10,15,8,8,8,6,8,9,10,2,13,7,7,5,11,15,12,12,6,11,13,6,13,13,15,14,11,10,12,6,6,5,6,11,11,12,2,1,3,2,1,2,1,3,3,2,1
"1377",2000144946,"Rayvian Job","4/25/2004 (19 years old)","ST (C)","Excelsior","Eredivisie","CUW","Yes","6/13/2022","6/30/2024","$75K - $750K","Right","Reasonable","Very Strong","5'11""","158 lbs","-","-",77,111,6,3,7,10,13,6,11,7,5,4,6,6,1,13,8,13,3,9,5,9,2,13,1,13,6,6,3,3,13,13,7,8,11,13,8,5,10,11,9,9,13,11,12,13,13,7,15,13,12,2,1,2,1,2,1,3,2,1,3,3
"1378",37025770,"Gevaro Nepomuceno","11/10/1992 (30 years old)","D/WB/M/AM (L)","Melbourne Knights","National Premier Leagues - Victoria","CUW","Yes","1/11/2023","9/30/2023","$0 - $70K","Left Only","Very Strong","Weak","5'9""","152 lbs","270","21",95,110,8,9,11,9,10,8,5,7,6,5,10,6,4,11,11,10,10,9,9,8,8,10,4,11,7,9,10,11,13,14,10,7,12,13,10,9,11,13,7,10,9,9,10,8,7,2,9,8,6,3,3,2,3,3,3,1,2,2,2,1
"1379",23311460,"Faisal Masrahi","1/24/1993 (30 years old)","GK","Al-Fayha","Saudi Professional League","KSA","No","7/1/2022","6/30/2024","$85K - $850K","Left","Very Strong","Reasonable","5'11""","205 lbs","101","-",90,125,4,1,3,2,3,7,1,1,2,2,11,2,3,5,12,11,12,4,10,14,3,3,10,1,12,9,8,7,13,12,9,6,9,13,2,7,9,20,12,10,11,11,5,2,8,6,9,10,7,11,12,14,6,12,6,12,5,7,11,12
"1380",37010009,"Romero Regales","11/7/1986 (36 years old)","ST (C)","EVV","Dutch Vierde Divisie C","CUW","Yes","1/31/2023","-","$0","Left","Very Strong","Reasonable","6'2""","211 lbs","218","106",93,110,8,7,8,10,11,10,14,10,8,6,8,7,6,8,15,11,13,12,13,12,15,8,12,13,6,12,11,12,8,11,14,14,15,8,10,16,13,16,12,11,12,12,6,9,14,2,14,14,20,2,2,1,2,3,3,2,4,3,3,3
"1381",37071207,"Justin Ogenia","2/5/1999 (24 years old)","D/WB/M (R)","FC Eindhoven","Keuken Kampioen Divisie","CUW","Yes","5/3/2022","6/30/2024","$14K - $140K","Right","Reasonable","Very Strong","5'11""","160 lbs","41","1",107,109,10,12,10,6,11,10,6,10,10,11,12,9,12,14,11,10,10,9,9,16,11,5,9,11,10,11,6,11,13,9,11,10,13,13,10,8,12,17,9,10,10,7,11,7,8,4,8,12,10,3,1,1,3,1,3,2,3,3,4,1
"1382",216444,"Juriën Gaari","12/23/1993 (29 years old)","D/WB (R)","RKC Waalwijk","Eredivisie","CUW","Yes","6/1/2023","6/30/2024","$65K - $650K","Right Only","Weak","Very Strong","5'11""","167 lbs","241","6",100,109,10,10,10,4,11,7,13,5,10,11,12,4,11,11,5,11,12,10,10,9,10,8,9,10,11,12,8,14,13,12,12,13,13,14,13,11,15,18,9,11,9,11,6,8,13,6,12,12,13,1,2,4,3,2,3,1,1,3,3,1
"1383",37057992,"Shaquille Woudstra","2/26/1997 (26 years old)","D/WB (RL)","ROHDA","Dutch Vierde Divisie D","CUW","Yes","7/1/2020","-","$0","Right","Reasonable","Very Strong","5'11""","163 lbs","27","-",86,108,5,11,5,2,10,3,9,1,8,10,10,2,9,9,11,11,10,9,8,8,13,7,10,8,10,9,9,9,15,10,9,12,12,11,14,8,13,12,12,12,11,12,8,9,10,3,10,11,20,2,1,2,1,3,3,3,1,2,3,1
"1384",37064749,"Joshua Zimmerman","5/23/2001 (22 years old)","AM (RL)","OH Leuven","Jupiler Pro League","CUW","Yes","5/23/2023","6/30/2024","$0","Right Only","Weak","Very Strong","5'9""","154 lbs","53","19",92,108,5,7,12,10,10,8,7,8,6,8,12,1,6,11,13,11,10,9,10,15,8,13,11,15,9,11,11,11,12,15,7,6,10,13,7,7,11,14,12,12,12,11,13,18,13,2,18,11,16,1,1,3,2,1,3,3,1,1,3,1
"1385",2000014253,"Dylan Timber","4/15/2000 (23 years old)","D (RC), WB (R)","FC Utrecht","Eredivisie","CUW","Yes","7/1/2021","6/30/2027","$40K - $130K","Right Only","Weak","Very Strong","6'1""","169 lbs","19","-",87,108,4,9,8,6,8,2,11,5,5,12,10,4,13,9,15,8,7,12,13,12,5,5,8,7,12,11,8,13,14,13,11,14,8,12,7,6,12,19,10,11,13,11,9,4,11,2,10,11,10,2,2,3,2,1,3,3,3,3,2,2
"1386",2000044198,"Rayvien Rosario","4/11/2004 (19 years old)","AM (C), ST (C)","Sparta Rotterdam","Dutch Tweede Divisie","CUW","Yes","4/11/2023","6/30/2026","$160K - $1.6M","Right","Weak","Very Strong","5'11""","163 lbs","32","3",83,108,9,11,9,9,10,7,10,8,6,8,11,8,10,9,10,10,7,15,9,13,8,10,1,10,7,7,11,11,11,13,11,8,12,13,11,7,11,10,10,8,13,12,10,5,11,7,8,11,11,2,2,1,1,1,3,1,1,1,3,3
"1387",37043805,"Ayrton Statie","7/22/1994 (28 years old)","D/WB/M/AM (L)","CHC","Dutch Tweede Klasse Zondag C","CUW","Yes","7/1/2022","-","$0","Left","Very Strong","Reasonable","5'9""","160 lbs","125","3",91,107,7,8,11,7,9,10,7,8,10,9,11,8,10,12,12,8,11,9,9,8,10,9,5,12,10,8,9,11,13,12,11,7,14,12,9,10,12,15,11,11,12,14,5,12,9,6,15,9,13,3,4,3,3,1,1,1,1,3,2,2
"1388",860434,"Rihairo Meulens","6/3/1988 (35 years old)","AM (R), ST (C)","ASV Dronten","Dutch Eerste Klasse G","CUW","Yes","7/1/2020","-","$0","Right Only","Weak","Very Strong","6'1""","174 lbs","279","48",81,106,8,9,11,8,11,8,7,8,8,4,10,8,5,12,11,10,12,12,11,9,9,15,4,12,6,8,9,11,11,12,8,10,11,13,8,9,12,14,9,6,11,12,10,10,11,6,7,11,16,2,1,1,2,3,3,3,1,2,2,1
"1389",2000274113,"Carlos Seintje","1/20/2007 (16 years old)","ST (C)","Feyenoord","Eredivisie","CUW","Yes","6/13/2022","6/30/2027","$350K - $1.1M","Right","Fairly Strong","Very Strong","5'8""","138 lbs","-","-",70,106,5,2,12,11,12,5,12,1,2,3,5,5,2,7,8,7,7,7,6,10,7,8,6,11,4,5,3,6,12,12,6,7,5,12,8,7,8,12,11,11,10,12,6,7,10,2,12,8,20,2,3,3,3,2,3,2,1,3,3,4
"1390",2000150364,"Abbas Al-Hassan","2/22/2004 (19 years old)","DM, M (C)","Al-Fateh","Saudi Professional League","KSA","No","7/1/2020","6/30/2026","$350K - $7.8M","Right","Reasonable","Very Strong","5'9""","147 lbs","12","-",90,125,6,8,6,4,14,8,8,10,6,8,9,4,14,13,7,8,9,4,6,14,5,7,9,9,12,9,8,13,12,10,9,4,14,10,12,6,11,10,8,10,9,11,11,7,10,8,19,13,12,1,1,3,2,3,3,3,2,1,1,3
"1391",168204,"Elson Hooi","10/1/1991 (31 years old)","M/AM (RL)","Al-Mina'a","Iraqi First Division Group B","CUW","Yes","9/2/2022","7/31/2023","$0 - $26K","Right","Reasonable","Very Strong","5'5""","141 lbs","173","16",100,105,9,9,14,6,9,6,6,8,5,3,12,9,4,12,11,10,13,11,12,9,8,15,6,14,5,12,7,15,15,14,9,5,12,14,11,5,13,12,12,12,9,11,7,11,6,2,10,9,12,3,3,2,3,4,2,4,1,2,3,2
"1392",37006831,"Charlton Vicento","1/19/1991 (32 years old)","AM (RL)","Oosterhout","Dutch Derde Klasse Zondag B Zuid 1","CUW","Yes","7/1/2021","-","$0","Right","Reasonable","Very Strong","5'11""","169 lbs","199","33",85,105,7,11,12,9,9,8,9,7,5,2,9,9,3,11,10,10,12,10,10,7,11,14,5,12,4,7,8,9,12,12,10,9,11,13,11,9,10,7,7,10,8,12,9,7,10,10,6,14,6,3,1,3,3,1,1,3,2,3,2,2
"1393",2000005990,"Tyrese Noslin","9/11/2002 (20 years old)","D (C)","Almere City","Dutch Tweede Divisie","CUW","Yes","6/13/2022","6/30/2023","$35K - $350K","Left","Very Strong","Reasonable","5'11""","160 lbs","1","-",80,105,3,3,3,1,7,1,13,3,3,13,7,1,13,2,14,10,9,6,10,13,14,5,7,3,11,6,2,7,13,12,7,5,15,11,7,9,11,10,10,12,11,12,12,8,10,3,11,11,19,3,1,3,1,2,1,2,2,3,2,1
"1394",37041863,"Gervane Kastaneer","6/9/1996 (27 years old)","M (RL), AM (RLC), ST (C)","PEC Zwolle","Eredivisie","CUW","Yes","7/22/2021","6/30/2025","$35K - $375K","Right Only","Weak","Very Strong","6'2""","187 lbs","150","15",99,105,9,9,13,8,12,8,10,11,8,5,10,10,5,12,12,10,12,8,10,5,9,14,5,13,6,9,11,7,13,12,15,13,12,13,11,14,15,12,14,7,8,10,13,10,6,12,11,12,9,2,3,1,3,2,3,3,1,2,2,3
"1395",37080536,"Nathan Holder","5/2/2002 (21 years old)","D (C), DM","Spartak Varna","Bulgarian Second League","CUW","Yes","6/30/2022","6/30/2025","$0 - $65K","Right","Weak","Very Strong","6'2""","171 lbs","7","-",74,105,9,9,7,6,12,4,11,7,9,9,12,7,15,10,7,10,9,8,9,7,9,8,7,9,10,12,9,11,8,9,10,14,10,8,11,12,16,11,10,10,13,11,5,17,8,1,8,9,16,2,4,2,2,3,3,2,2,3,1,1
"1396",37061236,"Trevor Doornbusch","7/6/1999 (23 years old)","GK","FC Dordrecht","Keuken Kampioen Divisie","CUW","Yes","8/3/2022","6/30/2024","$35K - $350K","Right Only","Very Weak","Very Strong","6'2""","176 lbs","15","-",90,105,2,1,2,1,5,4,1,3,1,1,11,1,3,8,7,11,11,9,8,14,5,1,5,1,12,9,8,8,14,12,9,10,14,11,6,11,12,11,10,10,11,9,7,3,13,4,9,10,20,6,5,12,11,12,11,12,5,10,11,12
"1397",17034939,"Max Ebong","8/26/1999 (23 years old)","DM, M (C)","Astana","Kazakhstan Premier League","BLR","No","1/24/2020","12/31/2023","$90K - $900K","Left","Very Strong","Weak","5'11""","158 lbs","94","9",120,140,4,6,14,6,14,4,9,6,3,14,14,6,14,14,12,15,15,13,12,14,5,5,10,13,13,13,12,13,12,11,13,10,14,11,14,14,10,12,10,11,14,10,5,10,10,6,14,13,16,2,2,2,1,2,2,2,1,3,1,1
"1398",17001262,"Alexandr Martynovich","8/26/1987 (35 years old)","D (C)","Rubin","Russian Premier League","BLR","No","7/1/2022","6/10/2024","$16K - $170K","Right","Reasonable","Very Strong","6'4""","191 lbs","381","9",110,132,5,5,6,6,7,6,14,7,9,11,12,10,14,7,13,15,14,13,14,12,11,12,16,10,13,12,6,10,8,8,10,15,15,10,10,15,12,12,12,13,10,14,6,10,8,3,20,8,13,3,1,3,2,3,2,2,2,3,3,1
"1399",17035427,"Ilya Shkurin","8/17/1999 (23 years old)","ST (C)","CSKA Moscow","Russian Premier League","BLR","No","1/9/2020","6/30/2024","$45K - $425K","Right","Reasonable","Very Strong","6'2""","176 lbs","90","37",114,130,7,6,9,14,12,8,9,10,4,8,11,13,4,13,15,11,14,14,9,12,11,11,7,12,5,12,14,13,12,12,13,15,13,15,14,15,9,18,13,15,12,13,9,13,9,5,12,9,15,1,2,1,3,1,2,1,2,3,1,2
"1400",58141373,"Kirill Kaplenko","6/15/1999 (23 years old)","DM, M (C)","Orenburg","Russian Premier League","BLR","No","6/14/2022","6/30/2026","$1.5M - $3.1M","Right","Reasonable","Very Strong","6'2""","171 lbs","126","4",113,130,10,12,14,8,10,10,13,8,5,11,13,9,10,11,9,14,11,10,12,11,13,8,12,8,11,13,9,15,12,11,14,13,12,13,14,11,11,20,10,10,10,12,9,8,8,6,14,12,17,3,2,2,2,1,2,3,2,2,2,3
"1401",2000215480,"Muath Faqeehi","11/3/2001 (21 years old)","D/WB (L)","Al-Hilal (KSA)","Saudi Professional League","KSA","No","7/1/2020","6/30/2024","$425K - $4.3M","Left","Very Strong","Weak","5'11""","163 lbs","4","-",105,125,9,9,13,9,12,6,12,6,13,10,13,5,12,12,15,11,11,12,9,13,10,10,13,10,10,14,14,14,14,13,11,10,12,15,13,8,16,17,11,10,11,11,10,4,15,2,13,10,19,3,2,2,2,1,1,1,3,4,2,3
"1402",2000124516,"Egor Karpitskiy","11/27/2003 (19 years old)","AM (LC), ST (C)","Shakhter Soligorsk","Belarusian Highest League","BLR","No","1/1/2021","12/31/2024","$45K - $475K","Right","Weak","Very Strong","6'2""","171 lbs","38","25",105,130,6,9,14,14,11,8,10,8,8,4,10,12,6,14,8,12,8,10,10,13,3,8,8,13,13,12,9,10,13,12,8,13,12,13,10,11,12,12,13,12,13,13,8,10,8,2,12,12,7,3,2,3,2,4,2,2,2,2,2,2
"1403",17041184,"Kirill Zinovich","3/5/2003 (20 years old)","M/AM (C)","VTSC B","Portugal Championship - Group B","BLR","No","9/1/2022","6/30/2025","$120K - $1.2M","Right","Reasonable","Very Strong","6'4""","174 lbs","56","4",83,129,9,9,12,11,10,9,13,11,8,7,11,3,8,12,12,7,9,8,8,10,13,9,14,9,11,11,10,11,13,9,11,15,14,10,12,10,12,18,9,12,12,12,14,12,11,3,12,14,13,1,2,1,3,2,1,3,3,2,1,3
"1404",317511,"Renan Bressan","11/3/1988 (34 years old)","M/AM (C)","Hercílio Luz","Brazilian National Fourth Division","BLR","No","2/22/2023","12/31/2024","Not for Sale","Right","Reasonable","Very Strong","6'0""","169 lbs","383","79",106,129,13,13,14,10,14,14,7,13,7,7,14,12,8,15,9,12,9,14,12,13,15,14,13,14,8,12,14,10,11,11,13,10,11,10,9,9,12,12,11,16,15,14,13,12,5,6,12,12,14,1,3,1,3,1,3,1,1,2,2,4
"1405",7485622,"Mikhail Sivakov","1/16/1988 (35 years old)","D (C)","Orenburg","Russian Premier League","BLR","No","7/25/2018","6/30/2024","$18K - $180K","Right Only","Weak","Very Strong","6'2""","176 lbs","346","16",108,126,9,8,8,10,10,9,13,11,9,12,10,12,12,10,12,12,13,13,11,11,13,10,14,10,13,12,9,12,11,10,12,14,15,11,12,12,13,10,11,12,11,10,4,9,4,6,18,12,20,1,2,2,2,1,2,2,3,1,3,1
"1406",17038627,"Valeriy Bocherov","8/10/2000 (22 years old)","D (L), DM","BATE","Belarusian Highest League","BLR","No","3/1/2022","12/31/2023","$12K - $120K","Left","Very Strong","Reasonable","5'10""","158 lbs","60","2",102,125,13,12,8,6,12,15,8,14,8,10,12,8,14,8,12,10,12,10,10,12,13,10,10,6,9,14,6,14,10,12,14,8,14,10,14,12,8,20,12,12,11,10,10,10,12,2,13,10,18,4,2,1,2,1,1,3,3,1,1,1
"1407",17033352,"Vitaliy Lisakovich","2/8/1998 (25 years old)","AM (L), ST (C)","Rubin","Russian Premier League","BLR","No","1/21/2022","5/31/2025","$450K - $4.4M","Right","Strong","Very Strong","5'10""","169 lbs","163","40",115,125,10,10,11,11,12,12,11,10,6,8,10,14,8,13,10,12,12,10,9,11,12,14,7,13,7,11,13,11,13,14,10,9,14,14,14,10,12,18,5,5,12,10,13,11,8,7,9,18,11,2,3,3,1,4,2,3,1,3,4,3
"1408",2000273798,"Stanislav Lapkes","3/3/2006 (17 years old)","GK","Columbus 2","MLS Next Pro Eastern Conference","BLR","No","6/12/2023","12/31/2025","$275K - $2.8M","Right Only","Weak","Very Strong","6'4""","167 lbs","-","-",75,125,2,2,3,2,4,6,1,1,3,3,9,3,1,7,6,11,8,8,8,14,8,2,5,3,10,8,7,7,9,6,8,13,5,9,3,5,8,19,11,12,9,9,14,11,8,5,10,13,13,8,12,14,13,9,11,14,15,12,7,13
"1409",2000016874,"Yuliy Kuznetsov","8/2/2003 (19 years old)","DM, M (C)","Minsk","Belarusian Highest League","BLR","No","7/22/2021","12/31/2024","$26K - $250K","Right","Reasonable","Very Strong","5'10""","143 lbs","33","2",88,124,7,7,4,8,14,6,9,10,6,9,10,6,12,14,14,9,7,6,4,14,12,5,9,8,9,6,12,11,10,13,9,9,13,14,7,9,11,12,12,11,10,11,6,3,10,3,8,9,10,3,2,1,1,3,3,2,2,1,3,3
"1410",2000081251,"Daniil Dushevskiy","3/1/2004 (19 years old)","DM, M/AM (C)","Minsk","Belarusian Highest League","BLR","No","10/10/2020","12/31/2023","$8K - $75K","Left","Very Strong","Reasonable","6'1""","167 lbs","29","2",95,123,10,11,7,12,9,10,12,11,8,10,11,13,11,9,8,9,12,11,11,12,15,9,15,7,11,11,12,9,12,10,9,11,14,11,12,11,11,12,13,14,12,13,3,13,6,6,16,13,17,2,2,2,3,1,4,2,3,1,3,3
"1411",17003817,"Denis Polyakov","4/17/1991 (32 years old)","D (RLC), DM","Hapoel Haifa","Israeli Premier League","BLR","No","1/3/2023","5/31/2024","$450K - $1.3M","Left","Very Strong","Fairly Strong","6'0""","171 lbs","302","11",110,121,10,8,6,5,8,9,12,3,12,12,11,11,14,12,12,10,13,10,13,10,17,9,11,10,12,14,8,14,12,12,13,11,12,13,14,12,13,17,9,10,10,8,4,12,8,6,9,11,7,1,3,3,3,3,2,2,3,3,3,1
"1412",1024752,"Mustafa Malayekah","5/21/1986 (37 years old)","GK","Al-Fateh","Saudi Professional League","KSA","No","7/12/2022","6/30/2024","$26K - $250K","Right","Reasonable","Very Strong","6'0""","169 lbs","225","1",100,125,3,1,2,1,5,6,1,1,2,1,13,2,3,5,9,13,12,9,10,14,14,3,12,3,12,9,8,8,8,12,6,7,11,8,8,8,14,17,12,13,10,10,9,16,11,3,9,10,15,8,11,14,13,14,10,11,5,7,12,10
"1413",7485429,"Anton Putsilo","6/23/1987 (35 years old)","AM (C)","Dinamo Minsk","Belarusian Highest League","BLR","No","2/10/2023","12/31/2023","$0","Right","Reasonable","Very Strong","5'11""","163 lbs","359","36",90,120,14,12,16,6,14,14,8,11,6,4,14,13,6,16,6,14,6,12,10,14,14,15,6,10,6,6,14,6,8,14,8,7,12,8,6,6,13,14,11,16,14,11,4,10,7,11,12,11,11,2,2,1,1,1,1,2,3,1,3,3
"1414",17035081,"Vladislav Morozov","10/12/2000 (22 years old)","ST (C)","Dinamo Minsk","Belarusian Highest League","BLR","No","1/18/2023","1/30/2024","$110K - $350K","Left","Very Strong","Reasonable","6'2""","185 lbs","83","17",104,120,4,6,12,13,12,9,13,10,8,4,8,8,12,14,10,12,10,10,10,12,15,16,10,12,12,8,6,12,12,8,14,13,12,12,12,12,4,17,11,12,12,10,6,12,13,4,13,12,9,1,2,3,1,1,3,1,3,1,1,2
"1415",2000023877,"Andrey Rylach","6/5/2002 (21 years old)","WB (R), DM, M (RC)","Dinamo Minsk","Belarusian Highest League","BLR","No","12/20/2022","12/31/2025","$110K - $325K","Right","Reasonable","Very Strong","5'9""","143 lbs","75","2",97,120,8,12,6,4,10,8,6,10,6,6,10,12,10,10,7,10,8,11,10,11,14,8,11,10,9,13,12,12,13,12,10,6,12,13,13,9,9,19,14,9,13,14,8,12,5,1,12,12,11,3,1,3,4,1,2,3,2,2,1,1
"1416",7485948,"Igor Stasevich","10/21/1985 (37 years old)","M/AM (RL)","Atyraý","Kazakhstan Premier League","BLR","No","1/25/2023","12/31/2023","$0 - $12K","Right","Reasonable","Very Strong","5'11""","165 lbs","432","70",89,120,14,13,13,6,12,13,8,12,12,5,14,12,10,13,9,10,12,12,11,12,13,15,14,13,10,12,13,8,10,10,12,10,15,9,8,10,7,8,11,15,14,12,3,15,8,11,12,10,12,4,2,3,2,3,2,2,3,3,1,1
"1417",17041149,"Vladislav Kalinin","1/14/2002 (21 years old)","D (RC)","Dinamo Minsk","Belarusian Highest League","BLR","No","1/10/2023","11/30/2023","$35K - $100K","Right","Reasonable","Very Strong","6'1""","167 lbs","15","-",84,120,3,6,7,4,9,5,9,2,2,14,5,2,14,7,8,9,9,4,9,14,12,5,12,7,8,7,5,8,13,11,8,10,16,11,12,8,14,11,12,10,10,11,7,19,12,2,9,11,9,3,2,3,2,3,2,1,1,1,1,3
"1418",2000011583,"Mikhail Kozakevich","5/19/2002 (21 years old)","GK","Dinamo Brest","Belarusian Highest League","BLR","No","12/9/2022","12/31/2023","$6K - $55K","Right Only","Weak","Very Strong","6'2""","182 lbs","24","-",84,120,3,1,3,2,8,5,6,2,1,3,8,2,3,8,9,12,12,8,8,10,2,3,12,2,10,8,8,8,10,13,8,13,12,10,8,12,13,8,12,14,10,9,8,7,6,4,12,10,20,11,6,13,7,12,10,10,4,8,12,8
"1419",2000067580,"Artem Shumanskiy","11/25/2004 (18 years old)","AM (RL), ST (C)","Aris Limassol","Cypriot First Division","BLR","No","1/2/2023","12/31/2026","$110K - $1.1M","Left","Very Strong","Strong","6'1""","165 lbs","25","4",88,119,4,7,12,10,10,6,10,10,5,3,8,6,3,12,8,8,8,8,8,11,6,13,12,10,6,8,8,8,14,12,8,10,10,14,6,6,14,14,12,12,12,10,3,12,5,5,10,8,10,2,2,2,2,1,3,2,1,2,3,3
"1420",2000237103,"Timofey Simanenka","11/27/2006 (16 years old)","AM (R), ST (C)","Minsk","Belarusian Highest League","BLR","No","8/1/2022","12/31/2025","$5K - $55K","Right","Reasonable","Very Strong","6'1""","134 lbs","1","-",70,119,7,11,9,13,8,6,6,7,3,3,10,10,4,8,14,6,6,13,7,9,13,8,9,4,2,6,8,8,13,13,7,10,12,13,7,5,9,12,13,13,9,10,13,12,11,7,9,10,10,2,3,2,3,2,1,1,1,2,3,3
"1421",2000134002,"Artem Turich","1/23/2005 (18 years old)","M (C)","TF Brest","Belarusian Second League","BLR","No","1/11/2022","11/30/2024","$0 - $28K","Right","Reasonable","Very Strong","6'1""","154 lbs","15","1",75,118,6,6,5,7,13,6,6,13,2,7,13,4,8,13,5,7,8,8,3,13,7,5,13,8,4,8,11,12,13,10,8,9,13,12,7,5,13,14,11,8,10,10,7,17,13,6,5,12,16,1,2,3,2,1,2,2,3,2,4,2
"1422",2000264399,"Nikita Neskoromniy","11/25/2005 (17 years old)","D/WB (R)","BATE","Belarusian Highest League","BLR","No","1/1/2023","12/31/2025","$4.5K - $45K","Right","Reasonable","Very Strong","5'11""","136 lbs","-","-",70,117,7,12,6,5,8,2,7,5,8,9,8,6,13,10,9,8,9,10,6,13,5,7,10,7,6,10,10,10,14,12,10,10,13,11,7,7,13,17,11,12,12,11,9,16,10,7,10,11,11,2,1,2,1,1,3,3,2,2,1,2
"1423",2000040500,"Fahad Maghrashi","11/6/2001 (21 years old)","M/AM (L)","Ohod","Saudi First Division League","KSA","No","7/23/2022","6/30/2024","$0","Left","Very Strong","Reasonable","5'8""","141 lbs","19","1",80,124,6,10,10,11,11,6,6,6,6,6,12,3,7,12,8,10,7,4,7,13,9,12,9,5,6,7,8,12,12,11,7,4,16,13,10,4,16,16,13,9,12,11,11,9,11,1,11,14,14,1,3,2,1,1,4,2,2,1,2,1
"1424",17011226,"Alexandr Karnitskiy","2/14/1989 (34 years old)","DM, M/AM (C)","Mezőkövesd","Hungarian Division I","BLR","No","8/1/2019","6/30/2024","$16K - $150K","Right","Reasonable","Very Strong","6'2""","169 lbs","367","34",104,117,10,8,10,10,8,10,14,13,6,13,12,10,12,11,14,12,12,11,13,12,4,8,9,11,12,15,9,14,9,10,13,13,14,10,12,11,10,19,11,12,11,11,12,9,8,3,11,10,8,3,4,1,2,1,1,2,2,1,3,2
"1425",2000127285,"Rodion Pechura","3/24/2004 (19 years old)","AM (RC)","Minsk","Belarusian Highest League","BLR","No","2/20/2021","12/31/2023","$75K - $230K","Right","Reasonable","Very Strong","5'8""","149 lbs","19","2",85,116,9,11,9,11,13,9,7,9,4,7,12,4,10,8,5,7,8,9,9,10,13,9,6,12,9,10,12,11,10,13,10,9,11,12,9,7,9,10,10,10,10,9,10,9,10,8,12,12,18,2,2,2,2,3,1,3,3,2,3,1
"1426",2000134382,"Leo Mascaró","8/2/2003 (19 years old)","D (C)","Sevilla C","Spanish Federation Third Group 10","BLR","Yes","1/1/2022","6/30/2025","$90K - $900K","Right","Strong","Very Strong","6'3""","178 lbs","29","2",95,115,3,2,4,7,4,2,14,7,7,14,9,4,14,6,8,10,10,6,8,8,9,5,3,5,14,8,7,9,14,11,9,15,13,12,10,8,10,13,13,11,13,13,9,10,8,1,11,11,12,1,1,1,2,3,1,3,3,4,3,3
"1427",17039487,"Danila Nechaev","10/30/1999 (23 years old)","D/WB/M (R)","BATE","Belarusian Highest League","BLR","No","1/15/2021","12/31/2026","$8K - $80K","Right","Weak","Very Strong","6'2""","174 lbs","97","4",103,115,10,14,12,6,12,6,12,9,10,12,12,8,12,10,10,12,10,12,11,11,12,8,8,8,8,12,10,12,12,12,12,12,10,12,13,11,8,20,10,12,13,12,6,13,10,2,13,11,13,1,1,2,3,2,1,3,2,2,2,2
"1428",17041017,"Gleb Gurban","8/15/2001 (21 years old)","D/WB (R), M (RL)","Minsk","Belarusian Highest League","BLR","No","1/12/2023","12/31/2023","$75K - $220K","Right","Reasonable","Very Strong","5'10""","154 lbs","38","1",90,115,10,11,9,9,10,6,8,8,11,10,8,8,12,12,8,10,8,9,9,10,12,7,7,8,8,8,8,12,12,12,10,7,6,12,12,10,13,17,11,11,13,11,12,11,8,6,12,13,9,1,2,4,3,3,1,3,1,3,1,2
"1429",17038349,"Dmitriy Prischepa","6/21/2001 (21 years old)","D (LC), WB (L)","Rotor","Russian Second Division A Gold","BLR","No","6/10/2023","6/30/2025","$275K - $850K","Left","Very Strong","Fairly Strong","6'0""","158 lbs","85","1",91,115,8,9,10,7,10,8,6,13,10,8,8,10,12,10,8,7,8,8,10,11,12,8,10,6,8,12,12,13,12,12,12,11,8,13,12,9,12,10,12,14,11,10,6,7,7,1,15,12,7,2,2,1,3,2,1,1,1,3,4,2
"1430",2000273177,"Denis Ovsyannikov","3/1/2007 (16 years old)","AM (R), ST (C)","RGUOR","-","BLR","No","1/1/2023","12/31/2025","$6K - $18K","Right","Reasonable","Very Strong","5'9""","121 lbs","-","-",65,115,6,10,13,11,12,5,7,7,4,4,11,4,5,9,5,7,6,5,6,11,17,9,3,9,2,6,7,7,12,9,7,6,14,12,6,5,8,14,10,9,13,10,11,2,6,7,7,10,13,2,2,2,1,2,2,2,2,2,3,3
"1431",2000017242,"Ilya Zhukov","5/5/2002 (21 years old)","D (C)","Smorgon","Belarusian Highest League","BLR","No","2/10/2023","11/30/2023","$0 - $65K","Right","Reasonable","Very Strong","6'1""","171 lbs","21","-",79,115,4,4,4,4,10,4,13,6,6,9,6,6,13,10,8,12,8,6,6,10,16,6,6,6,10,10,4,10,11,10,12,13,12,12,10,13,6,10,13,14,11,14,8,6,8,2,6,8,16,1,2,2,1,2,2,1,1,3,1,1
"1432",17038935,"Vadim Pigas","8/8/2001 (21 years old)","D (R)","Isloch","Belarusian Highest League","BLR","No","10/1/2021","12/31/2023","$7K - $75K","Right Only","Weak","Very Strong","6'0""","167 lbs","47","1",90,115,8,10,10,4,12,5,11,10,4,10,6,10,12,12,14,6,14,8,8,10,4,8,6,10,10,12,6,12,13,12,12,11,12,13,14,12,6,10,9,11,11,11,12,7,14,4,12,11,15,1,3,1,3,3,1,2,1,1,2,3
"1433",17039803,"Nikita Gribov","5/25/2002 (21 years old)","D (C)","Belshina Bobruisk","Belarusian Highest League","BLR","No","3/1/2023","12/31/2023","$3K - $28K","Right","Reasonable","Very Strong","5'9""","141 lbs","1","-",79,115,3,2,5,4,8,1,10,6,3,14,7,4,10,3,15,9,9,8,11,14,13,5,1,7,13,7,3,7,13,13,8,7,11,12,5,5,13,12,12,10,9,10,6,14,8,1,13,10,16,2,3,2,1,2,1,1,2,1,3,3
"1434",2000182357,"Suwailem Al-Menhali","4/17/2004 (19 years old)","D (C)","Al-Ittihad","Saudi Professional League","KSA","No","6/10/2022","6/30/2027","$4.2M - $8.2M","Right","Fairly Strong","Very Strong","5'11""","165 lbs","2","-",90,124,6,5,1,6,6,1,9,4,1,6,9,2,12,6,11,8,10,9,6,14,15,5,1,9,14,8,3,9,14,13,9,10,12,14,9,9,12,10,13,8,13,8,9,14,8,1,13,12,14,3,1,1,2,2,2,1,2,2,2,1
"1435",17004688,"Mikhail Gordeychuk","10/23/1989 (33 years old)","M (R), AM (L), ST (C)","Dinamo Brest","Belarusian Highest League","BLR","No","12/30/2022","12/31/2024","Not for Sale","Right","Fairly Strong","Very Strong","5'9""","163 lbs","389","108",100,115,12,8,12,14,10,8,7,12,10,6,10,12,6,13,13,14,13,13,8,10,10,14,8,13,8,12,12,8,12,13,8,8,12,12,8,8,15,10,10,11,12,10,8,13,7,7,15,10,8,3,2,3,3,3,4,3,2,3,3,4
"1436",7485614,"Egor Filipenko","4/10/1988 (35 years old)","D (C)","Ural","Russian Premier League","BLR","No","9/8/2022","6/10/2024","$20K - $200K","Right Only","Weak","Very Strong","6'4""","189 lbs","277","15",111,115,4,4,4,8,8,6,16,5,9,13,8,10,14,8,15,17,16,12,10,13,13,11,14,8,15,8,8,11,6,8,11,15,10,10,9,14,12,9,11,12,14,12,6,14,9,13,18,11,5,2,1,3,1,1,3,3,1,2,4,2
"1437",17032658,"Kirill Pechenin","3/18/1997 (26 years old)","D/WB (L)","Orenburg","Russian Premier League","BLR","No","12/1/2021","6/30/2025","$120K - $1.2M","Left","Very Strong","Reasonable","5'9""","152 lbs","161","9",107,114,11,12,11,6,12,11,10,11,13,10,10,5,10,12,12,12,11,10,10,11,14,6,5,8,10,12,14,10,13,13,11,10,12,12,14,8,12,17,11,13,13,11,2,14,2,3,12,13,8,3,3,2,3,3,2,2,1,2,3,1
"1438",7485417,"Andrey Klimovich","8/27/1988 (34 years old)","GK","Volga Uljanovsk","Russian Second Division A Gold","BLR","No","6/10/2023","6/10/2024","$110K - $350K","Right Only","Weak","Very Strong","6'4""","182 lbs","340","-",99,113,3,3,2,3,2,8,1,1,1,2,13,4,3,6,12,13,10,14,10,11,13,2,13,1,10,11,12,10,9,10,12,15,15,9,10,13,13,13,14,12,10,7,13,11,14,1,16,8,18,11,12,11,11,12,12,11,5,10,12,13
"1439",2000156277,"Arseniy Skopets","6/10/2005 (18 years old)","GK","BATE","Belarusian Highest League","BLR","No","6/13/2022","12/31/2023","$45K - $130K","Right","Reasonable","Very Strong","6'4""","176 lbs","-","-",75,113,3,3,3,3,1,6,1,3,3,3,6,1,1,6,6,8,14,2,6,13,9,3,10,1,7,6,6,6,10,9,4,14,13,9,1,5,8,15,9,9,10,10,12,11,13,1,11,8,10,10,15,13,6,8,7,13,5,8,6,12
"1440",17029506,"Nikolay Zolotov","11/11/1994 (28 years old)","D (RL), WB (L)","Kolos","Ukrainian Premier League","BLR","No","2/5/2021","6/30/2025","$65K - $650K","Right","Fairly Strong","Very Strong","5'8""","143 lbs","193","3",107,111,7,10,10,6,9,6,6,12,13,12,11,5,14,10,5,10,12,12,11,10,13,5,11,9,10,12,8,11,14,13,13,9,14,13,11,11,12,15,11,12,9,16,3,13,8,8,12,9,8,1,1,3,3,1,3,1,1,4,3,3
"1441",2000189789,"Gleb Kuchko","6/3/2005 (18 years old)","M (L), AM (RLC), ST (C)","Wisła Płock","Polish First Division","BLR","No","7/18/2022","6/30/2025","$150K - $450K","Right","Weak","Very Strong","5'11""","158 lbs","-","-",74,111,6,7,13,8,11,10,6,6,4,4,8,8,4,11,10,5,8,6,7,7,16,16,6,10,5,12,10,11,12,10,7,10,12,11,8,7,10,14,16,15,10,14,6,10,8,4,10,14,17,3,4,3,2,1,3,3,3,3,4,3
"1442",2000012647,"Gleb Vershinin","1/11/2002 (21 years old)","D (C)","Dnepr-Mogilev","Belarusian First League","BLR","No","1/30/2020","12/31/2023","$2.5K - $24K","Right","Reasonable","Very Strong","6'3""","176 lbs","40","1",74,110,4,4,4,3,8,1,12,5,3,12,6,1,10,3,5,10,9,8,7,13,15,5,11,7,12,4,2,7,12,13,7,14,10,11,5,4,15,11,9,11,10,11,15,9,11,1,7,11,17,3,1,3,3,2,2,3,2,2,3,2
"1443",17038732,"Daniil Silinskiy","1/6/2000 (23 years old)","DM, M (C)","Energetik-BGU","Belarusian Highest League","BLR","No","2/15/2022","12/31/2025","$16K - $160K","Right","Reasonable","Very Strong","5'11""","171 lbs","119","-",96,110,4,6,6,4,13,10,9,12,8,8,12,6,10,12,10,12,10,12,12,10,11,10,12,8,10,14,10,14,10,12,14,9,12,11,14,12,8,13,10,12,10,11,10,10,12,1,10,10,14,3,3,2,2,3,3,1,3,3,1,4
"1444",2000014251,"Dmitriy Shulyak","1/8/2002 (21 years old)","D (RC), WB (R)","Volna Pinsk","Belarusian First League","BLR","No","1/1/2020","1/23/2024","$2K - $22K","Right","Reasonable","Very Strong","5'11""","154 lbs","18","1",74,110,4,10,8,4,8,6,12,6,6,10,4,4,11,10,10,10,10,6,6,8,10,8,8,10,10,10,4,12,11,12,8,12,12,11,12,12,6,20,12,13,14,11,6,7,10,6,6,11,17,4,1,2,3,2,3,4,3,2,3,2
"1445",2000051224,"Mahmoud Abunada","2/5/2000 (23 years old)","GK","Al-Arabi","Qatar Stars League","QAT","No","6/15/2020","6/30/2026","$50K - $6.2M","Left Only","Very Strong","Weak","5'11""","171 lbs","55","-",100,110,3,3,3,2,6,6,1,1,3,2,9,3,2,9,12,10,13,11,9,10,13,5,10,5,12,13,8,8,9,13,11,12,11,10,10,11,12,15,9,11,11,10,8,4,10,1,20,10,16,11,5,13,10,12,11,12,15,11,11,12
"1446",23248103,"Majed Al-Khaybari","9/24/1991 (31 years old)","D (L)","Al-Shoulla","Saudi Second Division Group A","KSA","No","10/22/2020","6/30/2025","$6K - $60K","Left","Very Strong","Reasonable","5'6""","132 lbs","85","3",90,122,8,12,5,4,6,3,8,7,10,11,6,8,13,6,10,9,11,10,7,8,13,5,15,8,10,11,5,13,13,14,9,6,7,15,13,7,17,12,13,10,12,10,9,13,5,1,9,10,11,1,1,2,1,3,3,1,3,1,3,3
"1447",2000008934,"Alexey Shalashnikov","3/22/2002 (21 years old)","D (C)","Slavia Mozyr","Belarusian Highest League","BLR","No","9/26/2019","12/31/2023","$16K - $160K","Right","Reasonable","Very Strong","6'2""","163 lbs","40","-",82,110,2,2,1,3,9,1,10,7,3,14,11,4,12,4,12,7,10,8,6,14,4,5,5,5,14,7,4,9,11,13,8,14,15,13,5,7,11,19,13,13,13,11,5,12,8,8,10,10,10,3,3,3,1,3,1,1,2,3,4,3
"1448",2000107446,"Osama Al-Mermesh","7/6/2003 (19 years old)","GK","Al-Ittihad","Saudi Professional League","KSA","No","7/19/2021","6/30/2025","$40K - $6.4M","Right","Reasonable","Very Strong","6'0""","147 lbs","-","-",85,122,2,3,3,2,5,5,1,3,1,3,10,3,1,2,13,9,12,6,7,14,15,2,4,2,11,8,7,7,11,7,8,9,12,11,2,5,12,10,13,13,9,12,12,15,5,4,11,12,18,8,10,14,5,13,12,12,5,8,8,13
"1449",1025045,"Mohammed Kaddadi","12/18/1982 (40 years old)","D (C)","Al-Salam","Saudi Third Division Group D","KSA","No","1/16/2021","6/30/2024","$7K - $20K","Right","Reasonable","Very Strong","5'11""","156 lbs","-","-",66,121,2,2,5,2,7,1,9,5,5,8,6,2,11,5,12,12,8,6,7,13,13,6,9,5,9,5,4,7,11,9,9,11,13,9,14,9,10,17,9,11,10,10,11,13,13,6,10,12,9,1,1,4,3,1,2,3,1,3,3,2
"1450",23227502,"Abdullah Madu","7/15/1993 (29 years old)","D (C)","Al-Nassr (KSA)","Saudi Professional League","KSA","No","7/28/2022","6/30/2025","$450K - $4.6M","Left","Very Strong","Reasonable","6'2""","169 lbs","90","2",115,120,6,6,7,6,10,6,14,7,10,13,10,8,14,11,12,12,15,9,10,13,13,6,15,7,13,15,7,12,9,9,14,14,11,10,13,16,6,13,13,14,11,16,8,10,7,7,12,12,7,3,3,3,3,1,3,3,3,1,2,2
"1451",23339730,"Riyadh Sharahili","4/28/1993 (30 years old)","DM, M (C)","Al-Shabab","Saudi Professional League","KSA","No","1/28/2023","6/30/2027","$6.6M - $10M","Right","Reasonable","Very Strong","6'0""","169 lbs","147","8",115,120,8,9,9,9,12,7,10,10,8,10,13,8,15,9,13,13,12,11,10,13,12,6,11,11,15,14,10,15,10,8,13,11,12,10,14,16,10,8,8,8,11,7,8,9,9,8,8,12,12,4,1,2,1,3,1,1,2,3,3,2
"1452",2000073461,"Waleed Al-Ahmed","5/3/1999 (24 years old)","D (C)","Al-Faisaly (KSA)","Saudi First Division League","KSA","No","10/10/2020","6/30/2026","$3.4M - $6.8M","Right Only","Weak","Very Strong","6'3""","182 lbs","65","2",110,120,6,4,6,10,10,1,13,10,8,13,12,3,13,5,14,12,13,9,8,12,12,5,4,11,11,12,10,12,16,16,12,11,8,16,16,10,14,18,11,11,13,11,11,7,9,2,20,8,7,1,3,1,4,3,3,3,2,3,2,1
"1453",37027194,"Sheraldo Becker","2/9/1995 (28 years old)","M (R), AM (RL), ST (C)","Union Berlin","Bundesliga","SUR","Yes","6/29/2022","6/30/2024","$13M - $19.5M","Right","Reasonable","Very Strong","5'11""","154 lbs","226","36",140,145,9,13,12,12,12,11,7,12,6,4,12,8,4,13,14,13,10,11,10,12,12,14,10,15,4,11,12,10,18,13,12,9,14,18,11,11,11,8,9,14,12,8,10,13,6,10,10,17,15,3,2,1,1,1,2,1,4,1,1,4
"1454",2000287900,"Lebron Campagne","8/16/2007 (15 years old)","DM, M (C)","FC Utrecht","Eredivisie","SUR","Yes","7/1/2022","6/30/2028","$240K - $6.8M","Right","Reasonable","Very Strong","5'9""","130 lbs","-","-",75,140,7,9,5,10,11,9,9,11,7,8,11,7,14,11,15,9,14,11,11,9,6,5,1,10,9,11,9,14,9,12,5,9,16,12,9,7,8,14,10,14,10,11,9,14,11,8,6,12,9,1,1,1,3,1,3,2,3,2,1,1
"1455",37000496,"Tjaronn Chery","6/24/1988 (34 years old)","M (R), AM (RLC)","Maccabi Haifa","Israeli Premier League","SUR","Yes","1/5/2023","5/31/2025","Not for Sale","Left","Very Strong","Fairly Strong","5'7""","149 lbs","467","107",131,140,12,13,15,13,16,14,8,15,6,5,15,17,4,15,6,12,10,15,12,12,15,16,14,13,5,13,15,13,11,12,13,6,16,12,14,9,15,12,14,15,12,16,8,16,5,7,13,12,13,1,3,1,3,2,2,1,2,1,3,3
"1456",37064804,"Shaquille Pinas","3/19/1998 (25 years old)","D (LC)","Hammarby IF","Swedish Premier Division","SUR","Yes","7/15/2022","12/31/2025","$180K - $1.8M","Left Only","Very Strong","Weak","6'0""","165 lbs","114","7",113,137,7,11,10,8,11,9,12,9,12,13,12,12,13,12,13,12,14,12,12,12,13,10,11,12,12,12,11,12,12,10,13,12,14,12,14,13,14,12,12,13,13,9,8,12,9,5,12,12,14,4,4,3,2,2,3,3,2,3,3,3
"1457",23168001,"Salem Al-Dawsari","8/19/1991 (31 years old)","M/AM (RL)","Al-Hilal (KSA)","Saudi Professional League","KSA","No","12/15/2021","6/30/2025","$53M - $64M","Right","Fairly Strong","Very Strong","5'8""","158 lbs","216","50",140,145,13,11,17,14,15,12,7,13,8,5,13,13,6,16,10,13,11,13,9,12,14,16,14,14,9,11,14,14,13,15,15,7,12,14,14,12,11,12,11,15,10,16,9,14,9,12,12,14,9,1,1,3,2,2,3,2,3,1,1,2
"1458",37071555,"Djevencio van der Kust","4/30/2001 (22 years old)","D/WB (L)","FC Utrecht","Eredivisie","SUR","Yes","6/15/2020","6/30/2026","$0","Left","Very Strong","Weak","5'6""","134 lbs","73","3",117,137,7,8,11,7,11,10,8,7,12,12,10,6,13,12,15,12,15,10,11,10,12,11,7,11,13,12,12,14,14,14,14,8,15,14,14,10,14,15,13,7,14,14,7,6,9,5,12,12,19,2,1,1,2,3,2,3,2,3,1,2
"1459",37020712,"Ridgeciano Haps","6/12/1993 (30 years old)","D/WB/M/AM (L)","Genoa","Italian Serie A","SUR","Yes","8/31/2021","6/30/2024","$170K - $1.7M","Left","Very Strong","Reasonable","5'9""","163 lbs","206","10",120,136,12,12,12,10,11,9,8,9,11,10,12,8,12,14,9,12,11,10,10,10,13,11,9,13,11,14,11,16,13,12,13,8,14,14,13,12,13,13,15,16,16,15,16,11,11,8,13,13,11,3,1,1,4,1,2,1,3,2,3,2
"1460",37012864,"Florian Jozefzoon","2/9/1991 (32 years old)","M/AM (RL)","RKC Waalwijk","Eredivisie","SUR","Yes","8/4/2022","6/30/2024","$150K - $1.5M","Right","Reasonable","Very Strong","6'0""","158 lbs","289","33",107,135,9,10,13,7,12,9,7,8,6,5,10,12,7,13,9,10,8,8,9,8,10,15,6,11,7,10,9,10,15,12,12,10,15,15,12,11,12,13,15,15,11,14,9,12,6,3,11,12,13,1,1,2,2,3,2,1,3,3,2,2
"1461",29164971,"Anfernee Dijksteel","10/27/1996 (26 years old)","D (RC), WB (R), DM","Middlesbrough","Sky Bet Championship","SUR","Yes","11/16/2020","6/30/2025","$325K - $3.2M","Right","Weak","Very Strong","6'0""","171 lbs","140","1",117,132,8,9,11,6,11,8,14,7,11,13,12,6,14,9,11,13,12,15,14,13,12,4,9,8,13,12,10,14,12,11,9,12,12,12,14,13,13,12,12,13,11,10,13,10,7,6,13,11,13,1,1,3,2,2,2,2,2,1,2,2
"1462",37028465,"Sean Klaiber","7/31/1994 (28 years old)","D/WB (R), DM, M (RC)","FC Utrecht","Eredivisie","SUR","Yes","8/30/2022","6/30/2025","$1.2M - $2.5M","Right Only","Weak","Very Strong","6'0""","167 lbs","186","12",123,131,10,14,11,7,12,8,10,10,11,11,12,9,12,13,11,12,12,14,10,11,13,11,10,13,12,13,13,15,13,12,13,10,11,14,13,12,16,12,16,14,10,10,13,11,7,5,12,15,13,3,2,2,4,3,3,1,1,2,2,1
"1463",37059723,"Daishawn Redan","2/2/2001 (22 years old)","ST (C)","Venezia","Italian Serie B","SUR","Yes","1/31/2023","6/30/2026","$12K - $130K","Right","Reasonable","Very Strong","5'10""","149 lbs","66","12",106,131,7,8,12,12,10,7,10,9,4,5,9,15,6,11,9,14,9,13,10,11,11,11,6,13,7,13,9,12,15,13,10,8,14,15,10,8,8,9,12,10,15,5,8,14,5,12,9,17,14,2,4,1,2,2,2,1,3,2,3,1
"1464",859602,"Diego Biseswar","3/8/1988 (35 years old)","AM (LC)","PAOK","Greek Super League 1","SUR","Yes","6/14/2021","6/30/2024","$10K - $110K","Right","Fairly Strong","Very Strong","5'9""","174 lbs","422","50",100,130,13,13,15,12,15,12,8,12,7,3,15,13,6,16,7,12,8,12,9,11,9,16,10,13,6,12,16,11,8,7,15,7,8,8,8,10,9,16,10,11,10,15,8,15,8,3,10,9,12,1,2,3,4,2,4,3,1,2,2,1
"1465",29129460,"Kenneth Paal","6/24/1997 (25 years old)","D/WB (L), DM, M (C)","QPR","Sky Bet Championship","SUR","Yes","6/19/2022","6/30/2025","$45K - $5.8M","Left","Very Strong","Reasonable","5'9""","152 lbs","234","9",118,130,12,12,11,7,11,12,10,9,10,9,13,8,10,12,11,10,12,10,11,10,12,14,6,11,12,10,13,11,13,12,10,10,14,12,14,11,17,20,11,12,11,11,8,12,5,7,8,11,15,2,1,3,1,4,1,1,2,3,1,3
"1466",37018392,"Stefano Denswil","5/7/1993 (30 years old)","D (LC)","Trabzonspor","Turkish Super League","SUR","Yes","7/1/2022","6/30/2025","$300K - $3.1M","Left","Very Strong","Reasonable","6'2""","178 lbs","266","7",120,130,11,9,11,6,12,11,14,6,10,14,13,12,14,13,15,12,14,11,12,11,12,9,14,8,12,14,11,12,11,11,14,13,14,10,13,14,7,10,12,13,11,8,2,11,11,9,10,13,10,1,3,3,3,2,2,3,2,2,3,3
"1467",37018389,"Warner Hahn","6/15/1992 (30 years old)","GK","Kyoto","J1 League","SUR","Yes","1/9/2023","1/31/2025","$2.4M - $5M","Right Only","Weak","Very Strong","6'3""","194 lbs","235","-",126,128,1,3,2,1,8,4,3,3,2,2,12,2,1,11,13,11,12,12,13,10,10,3,14,2,13,12,10,14,10,12,13,17,14,10,12,14,15,14,16,12,12,8,5,13,5,5,13,11,15,15,7,13,3,15,11,13,4,14,15,12
"1468",2000147695,"Abdulmalik Al-Oyayari","12/10/2003 (19 years old)","D (R), DM, M (C)","Al-Taawoun","Saudi Professional League","KSA","No","10/8/2021","6/30/2024","$9.4M - $11.5M","Right","Reasonable","Very Strong","5'7""","147 lbs","24","1",100,144,8,10,6,6,14,8,8,9,7,11,10,1,13,10,10,13,9,10,7,14,5,8,12,7,12,9,8,13,14,14,9,2,15,14,9,7,14,19,13,12,11,10,7,12,8,3,11,13,17,3,2,1,2,1,4,2,1,3,2,3
"1469",37076778,"Dhoraso Klas","1/30/2001 (22 years old)","D (C), DM, M (C)","ADO Den Haag","Keuken Kampioen Divisie","SUR","Yes","7/1/2021","6/30/2024","$425K - $4.2M","Right","Weak","Very Strong","5'11""","171 lbs","98","8",105,128,13,8,9,8,12,12,13,12,7,10,12,5,11,12,13,11,13,9,11,10,10,9,11,12,11,12,10,13,12,13,13,11,14,11,12,12,15,19,8,10,13,13,6,10,10,3,11,11,19,2,3,1,3,3,4,1,4,2,2,1
"1470",37024062,"Yanic Wildschut","11/1/1991 (31 years old)","M/AM (RL)","Oxford United","Sky Bet League One","SUR","Yes","7/22/2022","6/30/2024","$0 - $75K","Right","Fairly Strong","Very Strong","6'2""","189 lbs","349","37",96,126,10,12,11,8,11,10,8,9,7,5,11,10,7,12,11,10,12,9,9,9,13,12,8,10,8,11,10,11,11,12,12,12,14,13,8,15,13,10,11,11,12,6,8,8,8,6,8,12,13,2,1,4,1,1,2,1,1,2,3,2
"1471",863702,"Kelvin Leerdam","6/24/1990 (32 years old)","D/WB (R), DM, M (C)","LA Galaxy","Major League Soccer","SUR","Yes","1/6/2022","12/31/2023","$120K - $1.2M","Right","Weak","Very Strong","5'10""","174 lbs","339","26",114,125,8,10,10,11,13,7,12,7,14,14,12,7,12,13,12,11,12,11,11,11,13,5,7,13,14,13,12,11,11,13,14,12,15,11,12,12,17,14,12,9,12,14,9,10,9,8,10,14,12,2,2,1,4,3,2,1,2,2,1,3
"1472",37028457,"Myenty Abena","12/12/1994 (28 years old)","D (C)","Ferencváros","Hungarian Division I","SUR","Yes","1/21/2023","6/30/2026","$1M - $2.1M","Right Only","Weak","Very Strong","6'3""","191 lbs","153","5",120,125,11,9,7,10,7,9,14,11,4,12,13,5,15,8,15,10,12,13,11,14,15,12,11,11,12,12,9,14,12,11,13,15,14,11,13,16,9,10,12,15,12,12,2,9,12,1,14,11,17,3,1,3,2,4,1,2,1,3,3,4
"1473",861887,"Ryan Koolwijk","8/8/1985 (37 years old)","DM, M (C)","Smitshoek","Dutch Vierde Divisie B","SUR","Yes","7/1/2022","-","$0","Left","Very Strong","Weak","6'4""","165 lbs","412","33",104,125,9,8,11,7,12,13,13,10,8,10,13,9,11,11,14,12,13,13,10,12,12,13,15,13,12,14,15,14,8,12,12,17,14,8,12,10,10,14,13,15,14,12,10,15,10,6,13,9,19,3,1,3,3,4,2,3,3,3,1,2
"1474",37049345,"Damil Dankerlui","8/24/1996 (26 years old)","D/WB (RL), M/AM (R)","FC Groningen","Keuken Kampioen Divisie","SUR","Yes","7/1/2020","6/30/2025","$0","Right Only","Weak","Very Strong","5'8""","141 lbs","209","7",110,125,10,11,10,7,11,9,8,8,10,9,12,11,11,11,13,11,10,10,10,9,9,11,8,12,12,12,10,13,14,12,11,8,12,14,11,10,16,8,12,11,8,11,6,10,4,3,11,13,11,3,1,3,1,4,1,3,2,3,3,1
"1475",37039836,"Djavan Anderson","4/21/1995 (28 years old)","D/WB/M/AM (R)","Oxford United","Sky Bet League One","SUR","Yes","9/1/2022","6/30/2025","$160K - $1.6M","Right","Reasonable","Very Strong","5'11""","154 lbs","128","5",112,123,5,11,12,6,11,5,7,5,5,10,12,6,9,12,11,11,11,12,11,11,12,13,9,12,8,12,7,12,15,15,11,10,14,14,11,9,15,9,11,14,12,11,10,11,7,4,12,12,12,4,3,2,2,3,1,1,3,2,1,3
"1476",2000014563,"Jayen Gerold","6/30/2004 (18 years old)","AM (RLC), ST (C)","AZ","Keuken Kampioen Divisie","SUR","Yes","6/13/2022","6/30/2025","$65K - $650K","Right","Reasonable","Very Strong","5'5""","123 lbs","3","-",85,121,5,10,13,10,12,6,7,8,3,6,13,3,7,13,7,9,8,4,4,8,10,13,8,8,6,7,8,8,13,16,7,4,11,13,8,1,11,13,12,8,10,11,7,3,15,2,11,10,19,3,3,3,2,3,1,4,3,3,3,4
"1477",37017204,"Leandro Kappel","11/14/1989 (33 years old)","AM (RL)","Pendikspor","Turkish Super League","SUR","Yes","8/10/2022","6/30/2024","$95K - $950K","Right Only","Weak","Very Strong","6'0""","169 lbs","366","79",115,120,9,12,13,12,12,9,9,11,7,6,12,12,7,14,11,10,9,10,10,11,8,16,5,13,8,9,12,10,14,13,13,11,14,14,14,8,8,10,8,7,11,12,6,12,12,13,11,12,11,3,3,3,1,1,2,2,1,3,3,4
"1478",37024801,"Luciano Slagveer","10/5/1993 (29 years old)","M/AM (RL)","Puskás Akadémia","Hungarian Division I","SUR","Yes","1/21/2020","6/30/2024","$700K - $1.6M","Right Only","Weak","Very Strong","5'10""","163 lbs","259","41",113,119,8,12,12,9,14,10,8,9,8,4,10,11,4,13,11,11,9,10,12,12,12,14,3,13,4,9,10,11,15,14,9,10,12,14,12,12,14,20,13,13,12,13,9,10,6,4,13,12,18,3,2,2,3,1,1,1,4,3,1,1
"1479",2000042460,"Saud Abdulhamid","7/18/1999 (23 years old)","D/WB (R)","Al-Hilal (KSA)","Saudi Professional League","KSA","No","1/22/2022","6/30/2025","$34M - $52M","Right","Reasonable","Very Strong","5'7""","152 lbs","113","2",135,140,10,13,13,8,12,9,11,11,13,12,13,7,12,12,12,11,12,12,10,12,16,12,9,13,12,12,13,15,16,14,12,7,14,15,15,11,11,11,15,16,13,10,10,12,8,7,13,15,18,1,2,1,1,2,1,4,2,2,1,1
"1480",37009931,"Dion Malone","2/13/1989 (34 years old)","D/WB (R), DM","Karmiotissa","Cypriot First Division","SUR","Yes","7/19/2022","6/30/2024","$3K - $28K","Right Only","Weak","Very Strong","6'1""","187 lbs","373","12",100,119,8,10,11,4,11,8,13,9,11,12,12,8,13,11,15,11,12,10,10,11,15,7,14,5,10,13,11,15,10,12,11,12,12,11,12,12,14,12,12,13,11,13,8,7,12,5,8,12,11,3,4,1,2,2,3,1,1,1,1,3
"1481",37055839,"Navajo Bakboord","1/29/1999 (24 years old)","D (RC)","Heracles Almelo","Eredivisie","SUR","Yes","3/31/2022","6/30/2024","$45K - $450K","Right","Reasonable","Very Strong","5'10""","158 lbs","63","-",103,118,4,9,11,5,12,8,10,6,9,12,12,6,12,11,17,11,13,10,11,11,17,9,9,11,12,12,10,13,13,13,13,9,13,13,13,8,11,7,9,14,14,13,7,9,10,8,11,11,11,2,1,1,2,2,4,3,2,3,3,2
"1482",2000314081,"Tyron Chaar","8/10/2007 (15 years old)","GK","FC Volendam","Eredivisie","SUR","Yes","7/1/2022","6/30/2025","$850K - $1.9M","Right","Fairly Strong","Very Strong","6'0""","143 lbs","-","-",65,118,5,3,1,1,1,9,1,1,2,3,12,2,2,1,11,6,12,5,3,12,11,1,7,3,4,5,4,4,11,11,3,10,8,12,1,4,7,13,12,10,12,12,9,9,10,6,11,12,12,10,8,8,11,10,12,12,5,8,12,12
"1483",37059546,"Jeredy Hilterman","6/20/1998 (24 years old)","ST (C)","Almere City","Eredivisie","SUR","Yes","7/12/2022","6/30/2024","$160K - $1.6M","Right","Reasonable","Very Strong","6'1""","185 lbs","170","51",107,118,9,7,8,12,10,4,11,6,6,5,11,14,5,12,12,12,12,11,8,9,13,12,12,12,5,14,8,13,13,12,14,12,11,14,12,14,12,19,13,13,15,13,13,9,6,14,11,12,8,1,2,1,3,1,3,3,2,3,1,2
"1484",37070616,"Yahcuroo Roemer","7/22/2001 (21 years old)","AM (RL)","VVV-Venlo","Keuken Kampioen Divisie","SUR","Yes","6/13/2022","6/30/2026","$80K - $800K","Right","Fairly Strong","Very Strong","5'11""","154 lbs","64","2",95,115,10,8,13,7,10,7,8,8,9,4,10,4,5,11,11,11,12,7,8,7,10,13,5,11,4,8,7,8,15,13,8,8,14,14,11,8,15,11,9,13,12,11,7,9,14,3,8,11,11,3,1,1,1,1,3,2,1,2,3,1
"1485",37028397,"Danzell Gravenberch","2/13/1994 (29 years old)","D (C), ST (C)","Karmiotissa","Cypriot First Division","SUR","Yes","1/31/2023","6/30/2025","$0","Right Only","Weak","Very Strong","6'1""","220 lbs","192","17",103,115,6,6,9,10,9,9,15,8,9,13,10,13,12,9,9,12,11,10,6,8,12,7,7,9,11,9,8,8,9,8,14,15,13,9,11,18,11,7,10,10,10,9,4,11,7,10,10,11,16,3,1,2,1,3,2,1,3,1,2,3
"1486",82090223,"Demelcio Fer","10/13/2002 (20 years old)","GK","PVV","SVB Eerste Divisie","SUR","No","10/30/2019","6/30/2024","$2K - $20K","Right","Reasonable","Very Strong","6'2""","169 lbs","-","-",70,114,4,2,2,3,2,6,1,2,2,2,12,4,3,2,11,7,12,7,9,13,10,2,9,1,10,7,6,5,13,5,2,10,13,12,1,5,11,13,13,10,9,12,5,2,13,6,19,10,9,8,14,13,10,11,10,13,5,8,7,9
"1487",37017669,"Mitchell te Vrede","8/7/1991 (31 years old)","ST (C)","Gol Gohar","Persian Gulf Premier League","SUR","Yes","6/12/2023","6/30/2025","Not for Sale","Right","Reasonable","Very Strong","6'3""","191 lbs","231","75",110,110,11,8,11,11,11,9,15,10,9,4,12,4,5,13,5,11,14,12,11,11,18,12,8,17,5,12,10,9,9,11,14,15,8,10,11,15,8,13,11,12,14,8,12,10,9,8,12,13,7,3,2,3,2,2,1,1,2,1,1,1
"1488",2000224679,"Jahlani Fonteni","5/15/2006 (17 years old)","D/WB (R)","FC Utrecht","Eredivisie","SUR","Yes","6/13/2022","6/30/2026","$35K - $375K","Right","Reasonable","Very Strong","5'9""","141 lbs","-","-",78,108,5,13,14,2,13,3,7,5,4,10,12,6,14,10,11,6,9,8,8,8,19,7,8,8,5,13,9,12,14,14,14,5,11,14,7,4,12,15,12,10,10,13,8,9,10,5,8,12,16,2,3,3,1,1,3,3,3,2,2,1
"1489",37059527,"Joshua Sanches","7/8/1998 (24 years old)","DM, M/AM (RC)","TOP Oss","Keuken Kampioen Divisie","SUR","Yes","7/1/2020","6/30/2024","$22K - $220K","Left","Very Strong","Fairly Strong","6'0""","171 lbs","124","9",98,108,8,10,10,14,12,8,9,7,6,6,9,9,9,12,15,12,9,10,10,14,4,13,7,12,6,12,9,12,9,12,12,8,15,11,12,11,15,18,12,12,11,13,7,8,13,5,8,13,16,1,2,2,3,3,3,3,1,3,1,2
"1490",2000042454,"Awad Al-Nashri","3/15/2002 (21 years old)","DM, M (C)","Al-Ittihad","Saudi Professional League","KSA","No","10/5/2020","6/30/2024","$10.5M - $15.5M","Right","Reasonable","Very Strong","5'9""","163 lbs","37","-",115,140,9,10,10,11,13,10,10,11,12,14,13,11,13,13,12,12,14,14,13,13,4,7,7,11,10,13,12,13,13,12,12,9,10,12,13,12,15,17,11,9,13,11,10,11,7,5,12,11,16,1,3,1,1,1,3,2,2,3,3,3
"1491",37084982,"Eja Dakriet","11/8/2003 (19 years old)","D (RC), WB (R)","Almere City","Dutch Tweede Divisie","SUR","Yes","8/1/2022","6/30/2023","$35K - $350K","Right","Reasonable","Very Strong","5'7""","149 lbs","-","-",80,106,5,9,5,4,9,1,6,5,6,8,6,6,9,11,15,10,10,10,11,11,13,5,6,11,10,12,8,13,11,10,9,6,9,11,11,8,12,19,11,12,13,9,12,7,10,5,11,13,7,3,1,2,4,2,3,1,1,3,2,3
"1492",82088906,"Shaquille Cairo","10/16/2001 (21 years old)","M/AM (R), ST (C)","Robinhood","SVB Eerste Divisie","SUR","No","6/13/2022","6/30/2024","$0 - $100K","Right","Reasonable","Very Strong","6'2""","182 lbs","-","-",92,105,9,13,11,10,11,9,9,9,9,9,13,4,9,14,11,13,4,10,9,9,12,11,13,11,9,10,13,11,11,10,9,14,13,9,11,12,13,13,8,11,10,11,10,14,9,5,11,9,18,2,4,2,2,2,1,1,3,2,1,2
"1493",30001636,"Dimitrie Apai","7/19/1994 (28 years old)","M/AM (R), ST (C)","W Connection","TT Premier Football League Tier 1","SUR","No","7/1/2020","6/30/2024","$0 - $22K","Right","Reasonable","Very Strong","5'9""","141 lbs","12","12",90,105,8,8,12,10,13,8,13,9,8,7,13,1,7,10,11,9,6,9,9,8,9,13,14,11,8,9,8,10,11,13,9,4,14,11,13,7,13,15,11,12,12,13,11,10,5,1,13,11,14,1,3,2,1,2,1,1,1,3,1,3
"1494",37005412,"Lorenzo Piqué","9/17/1990 (32 years old)","D (RLC), WB (RL)","TOP Oss","Keuken Kampioen Divisie","SUR","Yes","6/14/2021","6/30/2024","$0 - $55K","Right Only","Weak","Very Strong","6'0""","187 lbs","342","4",85,105,8,7,7,3,10,6,11,6,9,11,10,6,11,12,5,8,13,11,9,10,13,5,6,12,12,12,10,14,10,11,11,10,9,10,9,11,12,15,12,13,12,9,8,11,13,6,13,11,16,1,2,3,3,3,3,3,1,3,4,2
"1495",82088190,"Shorano Mawie","10/17/1997 (25 years old)","ST (C)","Voorwaarts (SUR)","SVB Eerste Divisie","SUR","No","6/15/2020","6/30/2024","$0 - $85K","Right","Fairly Strong","Very Strong","6'0""","160 lbs","-","-",73,105,5,2,9,12,12,5,12,6,1,5,3,5,2,8,13,12,5,12,6,9,4,9,13,12,5,5,6,6,12,10,6,7,12,12,6,4,12,19,9,12,14,13,9,11,5,4,16,11,10,1,1,3,3,2,2,2,2,3,3,2
"1496",2000250138,"Mano Olfers","8/2/2006 (16 years old)","D (C), DM","Telstar","Keuken Kampioen Divisie","SUR","Yes","4/11/2023","6/30/2025","$75K - $750K","Right","Reasonable","Very Strong","5'10""","152 lbs","-","-",70,105,4,5,6,3,11,7,9,9,7,14,9,2,10,9,14,11,7,4,5,14,5,7,9,7,12,8,7,5,8,10,8,8,8,9,5,7,9,17,13,11,13,9,11,6,6,5,11,14,8,1,2,2,2,3,2,3,3,1,2,1
"1497",27135737,"Alvaro Verwey","1/12/1999 (24 years old)","M (RL), AM (RLC), ST (C)","Voorwaarts (SUR)","SVB Eerste Divisie","SUR","No","7/1/2018","6/30/2024","$30K - $90K","Right","Reasonable","Very Strong","5'9""","156 lbs","-","-",75,105,7,10,9,12,12,5,4,6,2,5,9,6,4,12,10,9,1,6,5,8,8,13,5,6,5,6,6,7,12,12,6,7,9,12,6,7,8,11,12,10,10,13,9,7,5,8,20,10,14,3,2,3,2,3,3,2,1,3,1,2
"1498",861947,"Calvin Mac-Intosch","8/9/1989 (33 years old)","D (RC)","SC Cambuur","Keuken Kampioen Divisie","SUR","Yes","7/1/2019","6/30/2024","$4K - $40K","Right","Weak","Very Strong","5'11""","171 lbs","330","15",101,103,6,7,8,6,7,7,11,6,7,12,10,7,12,12,10,11,11,12,10,10,15,5,12,10,12,13,9,13,12,12,12,13,14,12,13,15,12,16,11,13,12,13,5,11,9,7,12,11,8,2,2,2,1,3,1,3,1,1,2,1
"1499",2000022822,"Didi Naarendorp","6/15/2004 (18 years old)","D/WB (L), DM","N.E.C. Nijmegen","Eredivisie","SUR","Yes","7/1/2022","6/30/2025","$20K - $200K","Left","Very Strong","Reasonable","5'11""","154 lbs","-","-",78,101,8,12,9,2,11,8,8,14,7,7,10,5,13,10,11,7,8,6,8,12,9,5,4,6,7,9,10,10,15,15,9,10,12,12,8,6,12,12,13,11,13,9,8,10,12,3,11,12,12,2,2,1,1,1,1,2,3,3,1,1
"1500",2000089620,"Rievaldo Doorson","4/21/2000 (23 years old)","AM (R), ST (C)","Inter Moengotapoe","SVB Eerste Divisie","SUR","No","4/9/2021","6/30/2025","$0 - $85K","Right","Reasonable","Very Strong","5'7""","134 lbs","-","-",80,100,4,7,13,14,10,7,10,6,8,7,15,9,5,12,8,14,1,11,9,11,10,10,13,11,8,14,12,10,13,13,15,3,15,11,7,2,13,18,12,10,10,12,6,9,10,5,12,12,10,1,3,2,1,3,3,2,3,4,2,3
"1501",17001310,"Alexandr Gutor","4/18/1989 (34 years old)","GK","Aqsý","Kazakhstan Premier League","BLR","No","3/31/2023","12/31/2023","$0","Right Only","Weak","Very Strong","6'3""","180 lbs","259","-",82,110,4,3,1,3,11,8,7,1,3,1,9,10,1,7,9,9,14,10,9,11,17,8,13,8,9,11,5,9,7,10,11,13,12,8,9,11,11,11,9,16,13,16,5,8,8,9,12,11,9,10,13,13,15,12,12,11,11,14,9,7
"1502",93060130,"Mohamed Buya Turay","1/10/1995 (28 years old)","AM (L), ST (C)","OB","3F Superliga","SLE","No","5/24/2023","6/30/2025","$170K - $1.7M","Right","Reasonable","Very Strong","5'10""","165 lbs","171","87",109,126,7,8,13,12,12,7,11,8,5,5,9,6,5,11,14,11,11,11,10,10,11,13,6,14,7,11,8,12,15,15,11,11,10,14,9,11,9,8,6,6,9,5,11,10,15,17,11,11,9,2,1,2,2,4,3,2,4,1,1,3
"1503",23370254,"Chatmongkol Thongkiri","5/5/1997 (26 years old)","DM, M (C)","BG Pathum Utd","Thai League","THA","No","4/21/2021","6/30/2024","$22K - $220K","Right","Reasonable","Very Strong","5'9""","154 lbs","110","-",85,109,4,6,10,8,11,5,9,10,6,10,11,7,8,10,9,13,10,10,9,13,11,5,5,7,11,11,10,12,12,11,7,9,12,11,12,10,12,13,15,11,13,10,11,11,8,4,12,10,11,1,3,1,1,1,3,1,2,3,2,3
"1504",23307099,"Chaiyawat Buran","10/22/1995 (27 years old)","WB/M/AM (L)","Lamphun","Thai League","THA","No","7/7/2022","6/30/2024","$12K - $120K","Left","Very Strong","Reasonable","5'8""","134 lbs","183","15",86,109,6,11,12,7,11,4,7,5,8,7,7,5,6,11,14,10,13,8,10,10,11,12,7,6,4,12,10,12,13,12,7,7,11,12,11,7,11,11,12,10,12,11,8,10,11,4,12,11,12,2,1,1,3,1,2,1,1,3,3,1
"1505",23281109,"Pansa Hemviboon","7/8/1990 (32 years old)","D (C)","Buriram Utd","Thai League","THA","No","6/14/2021","6/30/2025","$140K - $425K","Right","Reasonable","Very Strong","6'3""","178 lbs","188","13",105,109,4,4,8,10,11,3,14,8,7,13,11,4,12,7,12,14,11,12,13,13,14,12,5,3,13,8,5,11,12,11,9,13,13,11,13,11,10,11,7,14,12,9,8,13,7,8,14,13,8,3,2,1,3,3,2,2,2,4,3,1
"1506",69004239,"Charyl Chappuis","1/12/1992 (31 years old)","DM, M (C)","Port","Thai League","THA","Yes","2/7/2020","6/30/2025","$6K - $60K","Right","Fairly Strong","Very Strong","5'10""","156 lbs","248","16",88,109,8,11,10,6,12,10,7,9,6,12,12,11,10,8,9,12,8,11,12,11,14,13,10,6,10,12,12,10,11,10,9,6,13,10,12,9,10,15,14,11,13,9,9,12,6,4,13,10,13,4,1,3,1,1,3,1,3,1,1,3
"1507",23280785,"Pathomphon Charoenrattanaphirom","4/21/1994 (29 years old)","M/AM (RL)","Port","Thai League","THA","No","6/1/2023","6/30/2024","$1.1M - $2.4M","Right","Reasonable","Very Strong","5'8""","143 lbs","167","18",96,108,5,10,12,11,10,5,8,9,7,8,11,6,7,12,13,10,11,10,10,10,11,12,5,12,6,10,12,12,13,13,8,6,11,12,12,10,12,14,14,11,14,11,5,1,5,3,12,10,16,1,3,1,1,2,1,3,1,1,1,2
"1508",93053880,"Elias Dolah","4/21/1993 (30 years old)","D (C)","Bali United","Indonesian League One","THA","Yes","6/6/2023","5/31/2024","$14K - $140K","Right","Reasonable","Very Strong","6'5""","194 lbs","180","9",94,107,3,5,5,8,11,4,13,4,9,13,11,3,14,5,13,13,12,11,11,12,11,5,4,2,12,8,3,10,11,8,10,13,12,9,12,12,12,12,13,11,13,10,9,10,9,3,14,11,13,2,3,3,3,1,2,1,2,3,2,2
"1509",49033030,"Teddy Teuma","9/30/1993 (29 years old)","DM, M/AM (C)","Union SG","Jupiler Pro League","MLT","Yes","6/15/2020","6/30/2025","$650K - $9.8M","Left Only","Very Strong","Weak","5'9""","160 lbs","328","42",133,140,14,12,11,10,12,14,9,13,9,9,15,14,11,14,14,14,17,14,14,15,16,8,19,13,11,14,15,14,11,14,13,8,14,11,15,11,8,10,10,14,12,13,8,12,12,12,15,13,14,2,2,2,4,1,2,3,2,3,3,1
"1510",29139359,"Jodi Jones","10/22/1997 (25 years old)","WB/M (L), AM (RLC)","Notts Co","Sky Bet League Two","MLT","Yes","7/29/2022","6/30/2023","$500 - $6K","Left Only","Very Strong","Weak","5'10""","160 lbs","126","11",103,135,6,13,14,10,12,11,3,8,1,5,12,7,5,13,8,8,7,11,10,12,18,17,6,10,8,11,7,14,14,11,10,6,13,13,11,9,12,10,11,14,10,11,14,11,5,5,10,16,9,3,1,2,2,2,1,2,1,1,3,2
"1511",47037410,"Zach Muscat","8/22/1993 (29 years old)","D (C)","Farense","Portuguese Premier League","MLT","Yes","8/19/2022","6/30/2025","$170K - $1.7M","Right Only","Weak","Very Strong","6'0""","167 lbs","291","18",113,125,5,7,6,5,9,5,13,5,9,13,10,6,11,12,16,13,15,11,13,12,15,7,14,8,14,13,10,13,12,11,12,13,14,12,13,13,15,16,16,17,14,13,4,11,15,3,14,14,18,3,2,2,3,2,1,1,3,2,2,4
"1512",47056937,"Kurt Shaw","4/1/1999 (24 years old)","D (C)","Hibernians","Maltese Premier League","MLT","Yes","6/23/2022","5/31/2024","$95K - $275K","Right","Reasonable","Very Strong","6'2""","187 lbs","108","9",82,122,6,3,6,3,9,3,13,3,2,11,10,9,11,10,11,9,10,12,9,10,13,3,11,4,8,10,7,10,12,10,11,14,13,10,12,13,12,15,14,16,11,13,4,10,5,4,11,14,15,2,1,2,1,1,2,2,2,3,3,1
"1513",29087449,"Sullay Kaikai","8/26/1995 (27 years old)","M (L), AM (LC), ST (C)","MK Dons","Sky Bet League Two","SLE","No","1/25/2023","6/30/2024","$140K - $400K","Right Only","Weak","Very Strong","6'0""","160 lbs","194","35",99,125,11,12,14,12,13,11,7,11,5,6,13,11,7,13,6,10,8,12,10,10,13,13,5,12,4,10,13,10,12,12,10,10,12,12,10,10,14,14,13,12,11,10,13,9,5,4,6,16,16,1,3,2,3,3,2,3,2,2,2,2
"1514",47047174,"Matthew Guillaumier","4/9/1998 (25 years old)","DM, M (C)","Ħamrun S.","Maltese Premier League","MLT","Yes","9/28/2020","6/30/2024","$50K - $500K","Right","Reasonable","Very Strong","6'0""","171 lbs","190","14",95,111,9,10,10,9,12,9,11,10,6,5,12,5,6,12,5,10,8,12,11,11,12,9,10,10,12,13,11,12,10,11,10,9,12,11,13,10,10,15,12,17,13,12,11,11,5,4,11,12,9,3,1,2,2,2,3,1,1,3,1,4
"1515",47044915,"Jake Grech","11/18/1997 (25 years old)","M/AM (C)","Hibernians","Maltese Premier League","MLT","Yes","1/28/2019","6/30/2024","$0","Right","Reasonable","Very Strong","6'1""","174 lbs","240","97",81,110,9,6,8,11,7,9,9,10,4,9,9,17,6,8,8,11,9,11,9,10,13,8,11,13,7,12,8,13,11,11,10,12,12,12,14,10,11,13,12,13,10,13,4,12,8,6,12,13,10,1,1,1,2,1,1,1,3,1,2,2
"1516",47015200,"Rowen Muscat","6/5/1991 (32 years old)","DM, M (C)","Valletta","Maltese Premier League","MLT","Yes","9/16/2021","6/30/2024","$0 - $95K","Right Only","Weak","Very Strong","6'0""","174 lbs","264","7",66,110,4,6,8,7,10,6,9,5,3,8,10,8,10,10,11,9,12,8,9,10,10,7,10,10,8,9,9,11,8,10,9,7,13,8,12,11,8,10,8,10,10,9,8,9,9,7,9,13,14,2,2,3,2,2,2,2,1,2,3,2
"1517",47091996,"Paul Mbong","9/2/2001 (21 years old)","M (R), AM (RLC)","Birkirkara","Maltese Premier League","MLT","Yes","5/6/2020","5/31/2025","$40K - $400K","Right","Fairly Strong","Very Strong","5'9""","160 lbs","79","9",78,108,8,5,8,7,7,9,8,9,8,2,7,7,3,7,5,7,6,6,6,7,11,7,9,8,9,10,6,11,13,12,13,10,14,13,13,12,11,13,11,11,9,10,5,15,3,5,9,10,13,2,2,1,2,3,1,2,1,1,3,1
"1518",47044636,"Joseph Mbong","7/15/1997 (25 years old)","D/WB/M/AM (R)","Ħamrun S.","Maltese Premier League","MLT","Yes","7/29/2020","5/31/2025","$50K - $475K","Right","Reasonable","Very Strong","5'8""","174 lbs","190","16",88,107,8,9,11,7,6,8,5,8,4,3,7,4,6,7,8,5,9,7,8,7,12,10,8,8,5,10,8,12,13,12,12,5,16,12,14,10,10,10,12,13,11,11,3,4,6,6,13,13,9,2,2,1,4,1,1,3,2,4,2,1
"1519",29156525,"James Brown","1/12/1998 (25 years old)","D/WB (RL)","St Johnstone","cinch Premiership","MLT","Yes","7/1/2021","5/31/2025","$130K - $375K","Right","Fairly Strong","Very Strong","5'11""","165 lbs","82","1",97,107,5,10,11,7,10,9,12,9,4,11,10,10,12,12,9,11,12,10,10,11,12,11,9,10,11,12,9,14,11,8,9,10,14,10,14,13,10,11,12,11,10,9,5,8,6,8,11,8,11,2,4,2,1,1,3,3,3,1,1,2
"1520",28044100,"Sam Magri","3/30/1994 (29 years old)","D (RC), WB (R)","Totton","English Southern League Premier South","MLT","Yes","6/2/2023","5/30/2024","$0 - $80K","Right","Strong","Very Strong","6'0""","174 lbs","228","10",63,105,4,8,8,5,6,6,10,5,6,10,9,11,11,9,9,7,9,10,10,9,12,3,11,6,11,11,8,10,7,8,9,9,12,7,10,9,12,14,12,15,13,12,12,13,8,4,12,12,7,2,3,3,2,3,1,1,1,3,1,2
"1521",47074067,"Alexander Satariano","10/25/2001 (21 years old)","WB/M/AM (L), ST (C)","Frosinone","Italian Serie A","MLT","Yes","7/3/2021","6/30/2027","$3K - $30K","Left","Very Strong","Reasonable","6'0""","169 lbs","83","9",72,105,10,8,7,8,8,8,11,8,7,5,8,9,6,8,7,7,8,7,7,9,12,9,7,9,7,13,7,13,12,10,8,13,10,11,12,8,12,13,13,12,11,10,5,10,6,6,8,11,15,2,1,1,2,2,3,2,2,3,3,2
"1522",138901,"Clayton Failla","1/8/1986 (37 years old)","D/WB/M/AM (L)","Mosta","Maltese Premier League","MLT","Yes","6/19/2020","6/30/2024","$7K - $20K","Left Only","Very Strong","Weak","5'9""","149 lbs","463","107",66,102,10,12,9,8,13,13,7,10,7,7,13,14,9,8,13,7,7,9,9,13,14,6,11,13,5,9,6,9,9,9,9,8,13,10,9,5,13,16,8,12,11,11,5,1,10,3,13,10,18,2,3,2,2,3,1,1,1,1,1,2
"1523",47070736,"Shaun Dimech","8/8/2001 (21 years old)","M (C), AM (RLC)","Valletta","Maltese Premier League","MLT","Yes","8/4/2020","5/31/2025","$30K - $325K","Right Only","Weak","Very Strong","6'0""","163 lbs","86","10",68,100,6,8,8,8,14,6,5,4,5,6,8,6,7,11,8,10,7,9,2,8,12,9,12,7,7,7,7,13,11,11,13,8,13,13,12,7,15,10,7,10,13,10,6,7,15,4,8,12,13,3,2,3,3,2,1,1,3,1,3,2
"1524",72000038,"Kei Kamara","9/1/1984 (38 years old)","ST (C)","Chicago","Major League Soccer","SLE","No","2/24/2023","12/31/2023","$60K - $600K","Right","Reasonable","Very Strong","6'3""","191 lbs","486","170",108,122,5,11,11,14,12,8,17,12,5,6,10,14,3,11,15,10,12,9,10,9,14,16,8,13,11,11,12,10,9,12,12,17,18,11,9,15,10,10,8,8,11,6,9,10,10,13,11,11,18,1,1,3,1,1,2,2,1,1,1,1
"1525",29074485,"Luke Gambin","3/16/1993 (30 years old)","M (RL), AM (RLC)","Sutton","Sky Bet League Two","MLT","Yes","7/16/2022","6/30/2024","$8K - $22K","Left","Very Strong","Reasonable","5'5""","145 lbs","265","25",72,100,11,11,10,8,10,11,4,9,1,4,10,6,7,10,8,8,11,9,9,8,12,12,5,9,7,12,10,13,12,12,7,4,10,10,10,3,10,10,11,12,10,11,13,10,8,2,9,8,9,3,3,1,3,2,3,3,1,3,4,2
"1526",47102658,"Andrea Zammit","4/5/2003 (20 years old)","AM (L), ST (C)","Valletta","Maltese Premier League","MLT","Yes","1/14/2022","5/31/2025","$26K - $250K","Right","Fairly Strong","Very Strong","5'10""","147 lbs","78","30",64,97,7,10,8,8,9,7,7,5,1,3,9,11,3,10,7,9,2,10,8,9,12,12,11,8,5,10,9,10,9,11,6,6,12,10,11,5,7,12,9,11,10,10,11,4,4,2,8,13,8,1,3,1,1,1,3,3,3,2,2,3
"1527",47055164,"Myles Beerman","3/13/1999 (24 years old)","D/WB (L)","Sliema W.","Maltese Premier League","MLT","Yes","8/2/2021","5/31/2026","$0 - $110K","Left Only","Very Strong","Weak","5'9""","138 lbs","109","1",59,95,9,9,9,7,8,10,5,8,8,9,9,3,6,8,3,6,5,6,6,6,14,7,6,9,6,12,9,5,12,11,9,6,14,12,12,7,13,10,5,6,9,6,6,5,6,4,6,12,12,3,2,3,2,1,1,1,3,2,2,2
"1528",27043589,"Bjorn Kristensen","4/5/1993 (30 years old)","DM, M (RC)","Hibernians","Maltese Premier League","MLT","Yes","10/15/2019","5/31/2024","$75K - $220K","Right Only","Weak","Very Strong","6'3""","171 lbs","310","25",80,95,5,8,9,8,13,7,7,10,6,9,8,3,11,8,14,6,8,9,9,14,5,5,12,9,9,9,10,15,14,10,9,10,13,12,14,10,13,8,5,12,11,11,7,17,12,5,8,11,17,1,3,1,3,3,2,1,2,1,1,2
"1529",43021130,"Enrico Pepe","11/12/1989 (33 years old)","D (C)","Birkirkara","Maltese Premier League","MLT","Yes","6/5/2023","5/31/2024","$0 - $80K","Right Only","Very Weak","Very Strong","6'0""","180 lbs","313","3",82,95,5,5,2,4,7,2,11,9,4,11,9,3,13,4,11,11,11,9,12,10,14,3,12,9,10,9,3,10,9,9,12,13,12,10,11,14,8,14,8,13,12,11,6,15,10,6,13,12,15,4,3,2,4,2,4,2,1,4,2,2
"1530",47039496,"Jurgen Degabriele","10/10/1996 (26 years old)","AM (RLC), ST (C)","Hibernians","Maltese Premier League","MLT","Yes","6/15/2020","6/30/2024","$35K - $375K","Right","Reasonable","Very Strong","5'8""","149 lbs","219","86",82,95,5,8,9,11,12,1,6,8,4,9,8,7,4,11,6,11,7,9,10,10,12,10,8,11,8,10,7,12,11,12,11,6,11,12,10,8,8,15,11,13,12,14,11,11,7,3,12,12,8,3,1,3,3,2,2,2,1,2,1,1
"1531",14148252,"Brandon Paiber","6/5/1995 (28 years old)","M/AM (C)","Valletta","Maltese Premier League","MLT","Yes","5/24/2023","5/31/2028","$28K - $275K","Right","Weak","Very Strong","5'11""","163 lbs","131","18",73,95,13,11,9,9,12,13,6,13,5,5,12,5,6,12,6,10,6,11,9,11,11,10,6,12,9,10,10,9,10,11,9,8,13,10,12,5,12,12,4,11,11,11,9,5,5,7,11,13,14,2,3,1,1,3,3,3,1,3,1,1
"1532",14135111,"Matías García","7/22/1996 (26 years old)","DM, M (C)","Floriana","Maltese Premier League","MLT","Yes","12/24/2021","5/31/2025","$10K - $95K","Right","Weak","Very Strong","5'10""","165 lbs","113","10",79,93,8,8,9,7,11,6,5,7,5,7,11,8,8,11,12,12,8,11,11,10,13,8,12,11,8,11,10,13,10,12,11,9,12,10,14,10,13,13,12,16,12,13,7,8,8,6,12,10,15,2,1,3,3,2,4,2,3,3,2,1
"1533",47022124,"Ryan Camenzuli","9/8/1994 (28 years old)","D/WB (L)","Ħamrun S.","Maltese Premier League","MLT","Yes","5/31/2022","5/31/2027","$30K - $325K","Left Only","Very Strong","Weak","5'11""","169 lbs","260","31",87,92,9,11,8,6,10,9,8,6,9,7,10,4,10,10,8,9,9,8,10,11,14,5,8,9,11,13,7,14,11,10,12,7,14,12,16,8,8,15,14,15,11,13,5,6,9,5,14,13,7,2,3,3,2,2,2,1,2,1,1,4
"1534",47000786,"Steve Borg","5/15/1988 (35 years old)","D (RC)","Ħamrun S.","Maltese Premier League","MLT","Yes","1/3/2022","5/31/2025","Not for Sale","Right Only","Weak","Very Strong","6'0""","182 lbs","326","17",81,92,1,5,5,9,6,1,12,1,13,12,6,5,13,6,14,11,14,8,11,11,14,2,14,2,11,14,2,10,9,8,7,11,13,10,13,13,13,10,10,11,14,11,6,14,12,10,14,13,11,3,3,2,3,3,3,3,2,3,3,2
"1535",43037061,"Rodney Strasser","3/30/1990 (33 years old)","DM, M (C)","Favl Cimini Viterbo","Italian Eccellenza Lazio Grp.A","SLE","No","1/31/2023","6/30/2023","$0","Right Only","Weak","Very Strong","5'10""","176 lbs","111","3",75,120,4,6,5,6,8,4,10,7,13,11,10,8,12,10,14,10,12,9,10,10,15,2,6,9,12,10,10,9,11,10,14,8,11,11,13,13,10,16,15,14,12,15,14,6,15,3,10,13,16,3,2,1,1,2,1,3,3,3,3,3
"1536",47061736,"Jan Busuttil","3/6/1999 (24 years old)","AM (RC)","Floriana","Maltese Premier League","MLT","Yes","8/6/2022","5/31/2026","$30K - $325K","Left","Very Strong","Reasonable","5'9""","134 lbs","151","22",75,92,6,9,9,6,10,4,6,7,6,6,6,2,8,10,13,8,8,7,7,8,18,13,10,9,4,7,10,12,11,11,5,5,14,12,12,6,16,10,10,10,10,11,6,16,8,6,18,11,13,1,2,3,1,1,2,2,4,3,3,3
"1537",43094336,"Luke Montebello","8/13/1995 (27 years old)","AM (L), ST (C)","Ħamrun S.","Maltese Premier League","MLT","Yes","7/29/2022","5/31/2024","$22K - $220K","Right","Reasonable","Very Strong","6'3""","200 lbs","189","67",79,91,2,5,11,9,11,2,10,7,5,3,9,6,3,11,7,9,11,9,10,9,11,8,10,9,7,10,8,11,10,9,12,12,12,10,12,12,8,13,10,10,13,10,5,7,5,3,10,12,8,2,1,1,1,2,2,3,1,4,2,2
"1538",47066128,"Marcus Grima","7/22/2000 (22 years old)","M/AM (C)","Balzan","Maltese Premier League","MLT","Yes","8/28/2019","6/30/2025","$0 - $40K","Right","Reasonable","Very Strong","5'10""","169 lbs","93","1",50,90,4,1,9,5,13,5,3,8,1,5,9,3,7,10,8,7,7,7,5,7,6,12,1,10,7,6,10,11,9,8,13,6,8,7,11,3,15,18,9,11,14,9,9,4,7,6,10,12,18,3,2,3,1,1,3,1,2,1,3,1
"1539",147530,"Paul Fenech","12/20/1986 (36 years old)","DM, M (C)","Balzan","Maltese Premier League","MLT","Yes","6/9/2023","5/31/2024","$0 - $12K","Right Only","Weak","Very Strong","5'5""","147 lbs","464","34",63,90,8,8,4,9,10,6,8,9,3,11,8,4,12,10,12,12,9,10,9,9,14,5,15,9,10,14,10,14,7,7,8,7,13,7,14,5,10,13,10,13,10,11,5,13,8,4,11,11,11,1,3,2,3,1,2,3,3,2,4,1
"1540",149057,"Henry Bonello","10/13/1988 (34 years old)","GK","Ħamrun S.","Maltese Premier League","MLT","Yes","7/16/2021","5/31/2026","Not for Sale","Right Only","Very Weak","Very Strong","6'2""","185 lbs","306","-",82,90,3,2,2,3,5,7,3,1,3,1,5,3,2,5,12,9,10,6,12,12,13,1,10,2,10,10,3,9,8,11,10,13,8,10,10,12,11,14,11,12,11,8,14,13,12,6,13,12,9,9,6,11,10,13,7,12,5,12,12,13
"1541",47079421,"Adam Magri Overend","5/3/2000 (23 years old)","D/WB (RL), M (R)","Floriana","Maltese Premier League","MLT","Yes","6/30/2021","5/31/2024","$55K - $170K","Right","Reasonable","Very Strong","5'10""","154 lbs","77","3",71,90,6,8,2,5,8,6,2,2,6,8,8,4,13,7,10,8,7,8,7,10,12,5,9,7,8,10,8,8,12,10,13,4,14,12,15,3,13,13,9,9,11,11,14,9,10,6,6,12,15,4,2,1,1,1,1,3,2,2,3,2
"1542",2000212939,"Sean Gatt","8/25/2005 (17 years old)","ST (C)","BVT","Portuguese Premier League","MLT","Yes","8/31/2022","6/30/2026","$0","Right Only","Very Weak","Very Strong","6'1""","176 lbs","-","-",53,89,5,5,10,13,9,5,13,6,1,3,6,8,1,7,14,9,7,8,4,7,7,7,2,12,5,5,4,6,12,9,1,10,8,10,5,7,10,9,6,10,10,12,13,7,7,7,7,9,20,2,3,3,2,2,3,1,3,1,1,2
"1543",47059426,"Yannick Yankam","12/12/1997 (25 years old)","M (C)","Birkirkara","Maltese Premier League","MLT","Yes","6/5/2023","5/31/2026","$26K - $250K","Right","Reasonable","Very Strong","6'2""","182 lbs","170","17",75,88,9,7,7,6,8,9,8,5,7,6,9,12,9,8,15,8,8,7,8,9,13,7,10,9,8,10,7,16,10,13,11,12,12,11,16,10,15,13,10,11,11,10,8,3,10,3,12,12,19,1,2,3,3,4,4,4,1,1,1,2
"1544",47079351,"Mattia Veselji","3/14/2002 (21 years old)","AM (L), ST (C)","Floriana","Maltese Premier League","MLT","Yes","6/9/2022","5/31/2025","$7K - $65K","Right","Weak","Very Strong","5'11""","156 lbs","48","11",63,87,5,6,13,8,12,4,8,6,2,5,8,1,1,8,8,4,6,4,5,12,16,8,11,8,6,5,7,7,13,10,1,6,11,13,6,6,10,19,9,8,11,11,10,11,6,3,9,12,13,1,2,2,3,3,2,2,1,3,3,3
"1545",47015329,"Jean Paul Farrugia","3/21/1992 (31 years old)","AM (C), ST (C)","Sliema W.","Maltese Premier League","MLT","Yes","9/22/2021","5/31/2025","$35K - $100K","Right","Weak","Very Strong","6'1""","182 lbs","248","72",57,87,7,8,7,9,11,7,10,6,3,7,9,3,4,10,14,10,5,9,9,11,10,9,7,8,8,7,10,9,10,9,10,10,17,10,11,9,11,15,11,16,12,11,13,12,5,3,12,12,12,1,2,2,1,3,3,3,3,3,1,2
"1546",93049270,"Alhaji Kamara","4/16/1994 (29 years old)","ST (C)","Randers FC","3F Superliga","SLE","No","11/7/2021","6/30/2024","$160K - $1.6M","Right Only","Weak","Very Strong","5'11""","160 lbs","223","79",112,120,6,7,11,12,13,7,15,12,7,3,8,9,4,12,15,9,16,10,9,11,15,11,4,14,7,12,9,13,14,13,16,13,16,14,12,17,4,11,9,8,12,7,13,11,14,8,9,14,14,3,3,4,2,2,1,2,1,4,2,1
"1547",2000065692,"Alfie Bridgman","4/11/2004 (19 years old)","DM, M (C)","Portsmouth","Sky Bet League One","MLT","Yes","3/31/2020","6/30/2026","$0","Left Only","Very Strong","Weak","6'6""","187 lbs","33","8",59,86,6,6,10,9,9,9,6,8,3,5,8,3,7,12,9,6,9,7,8,7,13,5,7,8,9,10,9,8,12,10,7,16,9,13,10,8,10,11,9,10,12,12,5,4,6,6,9,10,14,3,2,3,1,2,2,3,2,2,2,2
"1548",47039330,"Juan Corbalan","1/3/1997 (26 years old)","D/WB/AM (RL)","Ħamrun S.","Maltese Premier League","MLT","Yes","6/26/2020","5/31/2025","$18K - $190K","Right","Fairly Strong","Very Strong","5'8""","143 lbs","152","7",73,85,6,8,6,8,6,6,6,1,6,6,11,3,8,8,6,9,4,7,6,13,12,12,14,8,8,12,5,12,10,8,8,4,12,10,11,3,13,14,9,8,8,13,11,14,14,4,12,13,19,2,1,2,3,2,3,3,3,2,3,3
"1549",47045059,"Michael Johnson","5/11/1994 (29 years old)","D (C)","Sta Luċia","Maltese Premier League","MLT","Yes","8/5/2022","5/31/2024","$4.5K - $45K","Right","Weak","Very Strong","6'3""","194 lbs","183","18",59,85,3,4,1,4,6,1,9,2,2,8,8,3,14,6,10,8,5,6,11,12,2,5,10,6,8,6,3,8,12,9,7,12,17,11,9,7,16,12,13,11,12,9,11,2,8,2,9,11,13,3,2,2,2,3,3,2,2,1,3,3
"1550",47045225,"Kyrian Nwoko","7/4/1997 (25 years old)","ST (C)","Floriana","Maltese Premier League","MLT","Yes","4/24/2023","5/31/2025","$80K - $240K","Right","Reasonable","Very Strong","6'2""","198 lbs","194","30",68,85,2,6,7,9,9,3,10,3,2,6,8,2,3,8,8,8,12,8,11,10,10,6,6,8,6,12,6,14,10,9,11,13,12,11,12,12,5,14,13,12,7,12,7,10,4,10,11,13,17,3,2,3,3,1,2,1,1,1,2,2
"1551",47078966,"Ayrton Attard","11/5/2000 (22 years old)","M (LC), AM (L)","Hibernians","Maltese Premier League","MLT","Yes","8/15/2022","5/31/2025","$12K - $120K","Left Only","Very Strong","Weak","5'10""","165 lbs","72","7",57,85,6,3,4,8,13,6,6,14,6,2,11,4,7,13,13,10,5,7,8,12,11,12,11,12,7,8,8,13,11,9,12,9,13,9,9,3,12,15,10,9,11,11,10,15,12,2,10,11,10,2,1,3,3,2,2,2,1,1,1,1
"1552",47021010,"Steve Pisani","8/7/1992 (30 years old)","M (RC)","Gżira Utd","Maltese Premier League","MLT","Yes","1/31/2021","6/30/2024","$0","Right Only","Weak","Very Strong","5'11""","158 lbs","297","26",68,85,9,10,8,8,10,12,8,8,8,9,11,6,10,10,11,9,7,11,9,10,13,8,11,8,10,9,10,12,10,10,10,10,11,10,12,9,14,15,13,14,12,12,10,10,7,8,9,12,8,3,4,2,3,4,3,1,2,2,1,3
"1553",47044640,"Dunstan Vella","4/27/1996 (27 years old)","DM, M (C)","Floriana","Maltese Premier League","MLT","Yes","5/3/2023","5/31/2026","$20K - $200K","Right Only","Weak","Very Strong","5'11""","165 lbs","163","13",74,84,8,7,5,9,7,8,9,5,1,13,8,1,9,9,15,10,13,10,12,10,11,6,11,9,9,14,5,13,11,12,9,10,16,12,13,10,11,10,7,10,8,11,6,1,10,6,8,9,7,1,1,2,1,2,1,3,3,1,2,3
"1554",47019057,"Ryan Scicluna","7/30/1993 (29 years old)","DM, M (RC), AM (C)","Marsaxlokk","Maltese Premier League","MLT","Yes","1/12/2023","6/30/2024","$55K - $160K","Right Only","Weak","Very Strong","5'10""","154 lbs","236","13",61,83,6,6,13,14,13,6,6,5,5,6,6,2,10,12,15,9,7,8,8,6,11,11,11,9,9,9,4,12,14,9,14,7,12,13,12,5,11,13,12,9,12,12,8,5,8,3,8,10,16,3,1,1,2,2,2,3,1,3,1,2
"1555",47022052,"Samir Arab","3/25/1994 (29 years old)","D (RLC)","Balzan","Maltese Premier League","MLT","Yes","4/28/2021","5/31/2024","$0 - $130K","Right","Reasonable","Very Strong","5'10""","165 lbs","185","4",66,82,6,10,3,4,2,5,10,8,6,10,2,3,15,7,12,10,10,7,10,10,4,5,11,8,11,9,6,10,10,10,10,7,17,10,10,9,15,12,6,13,12,12,12,8,13,3,6,11,15,4,1,1,1,1,2,2,3,2,2,3
"1556",47007112,"Triston Caruana","9/15/1991 (31 years old)","D (C), DM, M (C)","Balzan","Maltese Premier League","MLT","Yes","6/9/2023","5/31/2025","$14K - $130K","Right","Weak","Very Strong","6'2""","180 lbs","331","25",69,81,5,7,3,3,9,7,11,9,2,7,14,2,8,9,6,10,16,10,10,11,7,5,15,8,10,14,8,14,9,7,8,12,10,6,10,6,14,12,9,10,11,10,5,13,8,5,16,10,17,3,3,2,1,3,3,1,1,3,1,3
"1557",94042182,"Mustapha Bundu","2/28/1997 (26 years old)","AM (RL), ST (C)","RSC Anderlecht","Jupiler Pro League","SLE","No","8/7/2020","6/30/2024","$130K - $1.3M","Right","Reasonable","Very Strong","6'2""","176 lbs","192","43",107,120,9,10,12,11,11,10,7,10,8,3,8,9,4,11,6,9,9,10,8,7,7,15,5,11,3,9,7,8,14,14,14,15,12,15,10,14,14,14,13,7,7,10,8,10,5,4,8,11,12,1,3,1,2,2,4,1,2,2,1,1
"1558",47044656,"Aidan Friggieri","4/28/1998 (25 years old)","AM (RLC)","Sliema W.","Maltese Premier League","MLT","Yes","8/31/2022","6/30/2024","$14K - $140K","Left","Very Strong","Reasonable","5'7""","149 lbs","172","19",61,81,6,8,12,13,11,5,6,8,4,6,14,8,3,11,6,8,6,8,7,10,7,11,1,8,6,7,7,6,13,12,8,6,13,10,3,6,12,9,9,10,12,10,7,10,9,3,9,12,12,3,3,1,3,1,2,1,2,2,1,1
"1559",47057255,"James Scicluna","3/4/1998 (25 years old)","M/AM (RL)","Floriana","Maltese Premier League","MLT","Yes","7/1/2022","5/31/2025","$4.5K - $45K","Left","Very Strong","Weak","5'8""","145 lbs","124","24",56,81,2,6,12,11,4,3,4,7,1,1,11,1,5,9,12,6,3,6,2,6,4,13,12,9,2,6,5,10,12,11,12,3,11,12,12,4,9,14,11,9,11,11,9,6,13,5,20,12,14,4,1,1,1,3,1,1,3,1,3,2
"1560",47002193,"Mark Scerri","1/16/1990 (33 years old)","DM, M (C)","Sliema W.","Maltese Premier League","MLT","Yes","6/14/2021","6/30/2024","$12K - $35K","Right","Weak","Very Strong","5'9""","171 lbs","309","23",55,81,6,5,4,6,6,4,6,7,1,9,12,1,14,8,14,10,11,6,12,12,15,5,11,7,13,13,8,13,6,5,2,5,16,5,7,5,12,7,16,16,11,18,15,8,12,3,11,13,8,2,2,2,1,1,1,1,1,2,1,3
"1561",47049130,"Jake Galea","4/15/1996 (27 years old)","GK","Etzella Ettelbruck","Luxembourg Division of Honour","MLT","Yes","7/11/2022","6/30/2023","$0","Right","Reasonable","Very Strong","5'11""","180 lbs","167","-",68,80,2,3,3,3,6,6,1,2,1,2,6,3,2,6,11,12,10,7,12,8,12,1,9,2,7,9,8,8,13,12,9,10,11,11,3,7,7,19,12,12,12,12,8,7,11,6,10,11,18,8,10,12,12,10,6,9,6,12,7,7
"1562",47063803,"Zach Cassar","11/2/1998 (24 years old)","D (LC)","Floriana","Maltese Premier League","MLT","Yes","6/28/2021","5/31/2024","$3.5K - $35K","Left","Very Strong","Reasonable","5'8""","145 lbs","99","1",60,80,6,9,1,4,8,2,12,6,6,8,7,1,14,6,12,9,8,7,10,11,10,5,9,6,11,6,6,7,14,14,7,6,14,14,5,4,13,16,7,12,12,11,12,10,11,7,9,12,16,3,2,3,3,1,1,2,2,1,3,1
"1563",47081798,"Cain Formosa","11/30/2000 (22 years old)","GK","Valletta","Maltese Premier League","MLT","Yes","8/31/2021","6/30/2025","$0 - $130K","Right","Weak","Very Strong","6'1""","160 lbs","83","-",54,80,4,2,1,3,1,6,1,2,2,3,5,3,3,3,6,9,7,5,7,11,14,3,9,3,9,5,4,4,12,9,5,12,10,10,1,3,12,9,7,12,11,12,7,6,5,3,14,8,12,6,13,7,10,5,12,12,5,7,12,12
"1564",2000190785,"Sultan Saleem","11/28/2004 (18 years old)","M/AM (L)","Al-Wasl","UAE Professional League","UAE","No","7/1/2022","6/30/2024","$3.7M - $7.2M","Either","Very Strong","Very Strong","5'9""","121 lbs","-","-",75,140,6,8,9,10,13,6,6,14,6,6,12,2,6,13,15,7,12,4,5,8,20,14,8,8,6,5,8,9,13,10,13,7,14,11,5,3,11,17,11,20,13,9,9,20,14,1,15,13,15,3,3,3,3,2,4,3,2,1,1,2
"1565",2000190828,"Atiq Esam","5/24/2005 (18 years old)","AM (L)","Al-Wasl","UAE Professional League","UAE","No","6/9/2023","5/31/2028","$5.2M - $8M","Either","Very Strong","Very Strong","5'11""","160 lbs","-","-",85,140,6,8,13,10,13,6,7,8,4,6,9,7,4,11,9,5,8,11,8,6,9,11,7,12,5,7,8,9,13,12,13,8,10,12,7,4,13,16,11,12,10,12,5,4,11,6,10,12,10,1,1,3,3,3,1,3,1,1,3,2
"1566",23108543,"Omar Abdulrahman","9/20/1991 (31 years old)","AM (RC)","Al-Wasl","UAE Professional League","UAE","No","6/10/2022","5/31/2024","$450K - $4.6M","Left Only","Very Strong","Weak","5'8""","149 lbs","183","42",125,140,13,14,16,11,15,13,6,13,6,7,17,13,6,17,8,12,9,14,12,16,15,19,14,11,8,12,17,9,12,14,12,8,11,11,10,8,6,8,11,12,12,9,14,15,8,10,11,14,8,1,2,2,2,2,2,1,2,3,1,1
"1567",2000062194,"Rabee Salmin","4/25/2003 (20 years old)","AM (C), ST (C)","Al-Wasl","UAE Professional League","UAE","No","7/1/2018","5/31/2028","$650K - $6.6M","Right","Reasonable","Very Strong","5'7""","138 lbs","1","-",80,136,7,6,14,9,10,7,14,8,4,6,9,3,7,12,8,8,8,13,8,9,15,11,11,12,8,9,4,13,14,14,14,4,15,14,13,2,13,11,9,15,12,10,9,3,14,6,12,9,16,3,1,3,2,3,1,1,3,2,1,2
"1568",12079869,"Umaru Samura","8/11/1998 (24 years old)","AM (C), ST (C)","Dangkor Senchey","Cambodian Premier League","SLE","No","1/21/2023","12/31/2023","$8K - $24K","Right","Reasonable","Very Strong","5'7""","143 lbs","25","16",92,118,5,8,10,14,12,7,11,9,5,7,10,8,5,13,7,11,9,8,8,14,6,14,3,14,9,8,7,10,14,14,9,3,14,14,14,3,11,19,11,11,9,11,11,3,13,2,11,13,18,2,2,2,1,3,3,1,2,2,3,2
"1569",19054417,"Caio Canedo","8/9/1990 (32 years old)","AM (RL), ST (C)","Al-Ain","UAE Professional League","UAE","No","6/1/2019","6/30/2025","$5.4M - $10M","Right","Reasonable","Very Strong","5'9""","163 lbs","308","107",120,135,7,12,14,13,15,9,4,10,8,7,13,13,6,15,10,12,12,12,11,12,15,13,12,14,6,12,12,13,14,14,13,8,12,14,12,8,14,7,7,11,12,10,12,12,12,14,10,13,15,2,2,1,2,2,2,1,4,1,3,1
"1570",19165124,"Fabio Lima","6/30/1993 (29 years old)","AM (RC), ST (C)","Al-Wasl","UAE Professional League","UAE","No","8/7/2021","5/31/2025","$9.2M - $14M","Left","Very Strong","Reasonable","5'9""","180 lbs","213","150",125,135,13,12,14,14,14,12,6,12,6,7,13,15,7,16,9,13,9,13,12,13,11,14,12,14,8,12,13,11,13,14,12,9,15,13,12,8,13,12,10,14,11,15,9,14,11,3,12,11,13,1,2,2,3,3,3,2,3,2,3,1
"1571",23106089,"Ali Mabkhout","10/5/1990 (32 years old)","AM (C), ST (C)","Al-Jazira (UAE)","UAE Professional League","UAE","No","8/5/2021","5/31/2026","Not for Sale","Right","Fairly Strong","Very Strong","5'10""","165 lbs","278","208",125,130,8,9,13,14,11,9,12,14,7,5,10,15,6,12,11,12,10,14,10,12,12,13,12,14,7,12,10,10,14,14,14,10,13,14,12,13,8,13,13,15,13,18,7,12,8,7,13,15,8,1,2,2,1,2,1,2,2,1,3,2
"1572",2000042706,"Harib Abdalla","11/26/2002 (20 years old)","AM (RL)","Shabab Al-Ahli","UAE Professional League","UAE","No","7/1/2018","6/30/2024","$9.4M - $14M","Left","Very Strong","Fairly Strong","5'7""","141 lbs","58","5",120,130,8,11,15,10,13,8,8,10,7,8,11,9,7,13,11,12,9,10,9,10,16,15,8,13,7,9,12,11,14,15,13,6,13,14,14,7,14,12,8,15,11,8,12,12,12,7,12,15,11,1,2,3,3,1,2,1,2,3,1,3
"1573",23072864,"Ahmed Khalil","6/8/1991 (32 years old)","ST (C)","Al-Bataeh","UAE Professional League","UAE","No","8/21/2022","6/30/2024","$240K - $2.4M","Right","Fairly Strong","Very Strong","5'10""","165 lbs","250","92",100,130,10,8,11,13,10,9,9,10,7,3,9,12,6,11,15,10,10,11,10,10,13,14,10,12,6,7,11,9,14,13,12,11,12,14,12,12,5,14,14,14,12,16,8,14,11,8,12,19,9,2,3,3,1,2,3,2,1,1,3,1
"1574",2000190797,"Rashed Abdulla","9/10/2005 (17 years old)","DM, M (C)","Al-Wasl","UAE Professional League","UAE","No","7/1/2022","6/30/2025","$2.1M - $4.4M","Right Only","Weak","Very Strong","5'8""","141 lbs","-","-",65,130,7,7,3,8,9,7,7,9,4,11,9,6,15,9,15,13,14,9,7,9,12,5,11,9,6,12,9,12,9,9,8,3,15,8,10,6,13,17,13,12,10,11,5,15,14,2,15,11,14,4,1,3,2,2,3,1,4,1,1,1
"1575",7880431,"Ismael Matar","4/7/1983 (40 years old)","AM (C), ST (C)","Al-Wahda (UAE)","UAE Professional League","UAE","No","2/16/2022","6/30/2024","$9K - $90K","Right","Reasonable","Very Strong","5'6""","154 lbs","387","101",95,130,8,9,15,12,13,13,8,13,4,6,12,14,6,13,7,8,11,11,10,12,10,14,15,12,6,10,13,8,11,11,13,6,12,10,10,7,11,15,13,14,11,20,10,12,8,6,7,10,14,1,3,1,2,1,1,2,1,3,2,2
"1576",23402469,"Ali Saleh","1/22/2000 (23 years old)","M/AM (L)","Al-Wasl","UAE Professional League","UAE","No","12/18/2022","5/31/2027","$11M - $13.5M","Right","Strong","Very Strong","5'9""","152 lbs","121","23",120,130,11,11,13,9,12,12,8,12,5,7,12,11,8,12,10,12,11,10,9,10,12,15,12,12,6,9,13,11,14,14,13,8,12,14,12,9,12,11,12,12,11,10,8,12,6,5,10,12,19,4,1,4,1,2,2,2,3,2,2,2
"1577",2000192250,"Saud Mohammad","1/11/2004 (19 years old)","M/AM (C)","Al-Wasl","UAE Professional League","UAE","No","7/1/2021","6/30/2026","$220K - $2.2M","Either","Very Strong","Very Strong","5'9""","154 lbs","-","-",65,130,3,5,7,7,12,4,1,5,4,4,8,2,6,12,15,6,6,7,5,11,5,14,11,7,5,11,6,11,11,6,11,2,11,10,8,5,11,15,13,10,9,11,5,10,5,7,10,10,16,3,1,3,1,2,3,2,3,3,1,2
"1578",2000064572,"Sultan Adil","5/4/2004 (19 years old)","ST (C)","Ittihad Kalba","UAE Professional League","UAE","No","7/1/2019","5/31/2026","$0","Right Only","Very Weak","Very Strong","6'0""","152 lbs","35","4",80,129,7,4,12,13,11,7,14,7,2,6,8,2,1,6,11,11,6,7,6,14,4,13,11,13,4,7,8,8,13,12,8,6,13,14,10,7,11,11,10,9,12,10,15,14,9,2,8,14,19,2,1,3,1,1,3,3,1,4,1,3
"1579",28103242,"Osman Kakay","8/25/1997 (25 years old)","D/WB (R)","QPR","Sky Bet Championship","SLE","No","10/17/2020","6/30/2024","$40K - $400K","Right Only","Weak","Very Strong","5'11""","158 lbs","104","1",106,118,6,10,12,6,10,5,9,10,7,10,8,6,13,9,12,11,15,13,10,11,13,5,7,11,10,15,9,17,13,12,11,12,14,13,15,10,8,7,13,15,7,14,9,16,9,5,10,12,15,2,4,2,4,3,1,3,3,3,1,2
"1580",23418384,"Suhail Abdulla","8/26/1999 (23 years old)","GK","Al-Wasl","UAE Professional League","UAE","No","6/15/2020","5/31/2027","$65K - $650K","Right","Reasonable","Very Strong","6'1""","171 lbs","14","-",90,126,3,2,2,3,6,8,1,2,1,2,10,3,2,6,7,10,9,8,13,8,10,2,14,1,11,9,8,8,10,10,9,10,14,10,3,4,13,12,10,9,12,11,11,2,8,8,7,10,9,9,12,13,11,10,12,7,5,13,14,14
"1581",23416804,"Tahnoon Hamdan","4/10/1999 (24 years old)","M (R), AM (RL)","Al-Wahda (UAE)","UAE Professional League","UAE","No","2/4/2022","5/31/2026","$800K - $9.4M","Left","Very Strong","Weak","5'6""","143 lbs","87","5",105,125,11,11,12,9,11,11,8,11,3,7,14,7,7,14,11,10,9,10,10,13,10,11,9,13,10,11,12,13,13,12,13,6,10,12,12,7,12,11,10,11,11,12,9,11,9,2,9,12,7,2,2,1,1,3,1,2,2,3,2,1
"1582",23103108,"Hamdan Al-Kamali","5/2/1989 (34 years old)","D (C)","Al-Nasr (UAE)","UAE Professional League","UAE","No","6/1/2023","6/30/2025","$160K - $1.6M","Right Only","Weak","Very Strong","6'0""","160 lbs","239","17",100,125,5,6,10,7,12,11,13,13,6,11,12,12,11,12,10,11,11,12,10,12,18,8,12,8,12,14,11,13,9,12,13,11,11,9,12,9,8,15,15,13,10,13,8,14,10,5,14,16,10,1,1,3,3,2,1,1,2,2,3,3
"1583",23464197,"Yahya Al-Ghassani","4/18/1998 (25 years old)","AM (RL)","Shabab Al-Ahli","UAE Professional League","UAE","No","1/4/2021","6/30/2025","$12M - $14.5M","Left","Very Strong","Strong","5'10""","156 lbs","84","16",120,125,10,12,14,10,12,7,8,8,8,8,12,8,9,13,10,12,10,11,9,10,14,14,7,12,7,10,12,11,14,14,11,9,14,14,13,8,15,11,10,12,12,11,14,12,11,3,12,13,14,2,3,2,3,4,4,1,2,3,3,1
"1584",13230280,"Alaeddine Zouhir","3/7/2000 (23 years old)","D (C)","Al-Wahda (UAE)","UAE Professional League","UAE","No","2/12/2022","5/31/2026","$6.2M - $9.4M","Right Only","Weak","Very Strong","6'2""","182 lbs","67","5",115,125,5,8,8,7,11,6,13,6,8,12,12,7,13,10,12,13,15,11,13,11,14,7,6,7,13,12,11,13,12,11,14,15,13,13,12,12,8,11,12,12,9,11,7,13,14,3,13,10,19,2,3,3,3,2,1,1,2,3,2,2
"1585",2000289715,"Mahboob","1/3/2006 (17 years old)","M/AM (RL)","Al-Wasl","UAE Professional League","UAE","No","6/12/2023","6/30/2026","$240K - $2.4M","Right","Reasonable","Very Strong","5'6""","136 lbs","-","-",70,122,6,10,13,8,11,7,7,10,6,7,12,4,8,11,8,5,8,14,3,11,6,10,3,11,6,4,10,7,12,12,14,1,15,11,7,3,9,10,12,9,11,10,13,14,12,7,9,9,10,3,1,1,3,1,2,3,1,3,2,2
"1586",2000190790,"Mohammad Fuad","9/10/2004 (18 years old)","M (C)","Al-Wasl","UAE Professional League","UAE","No","7/1/2021","6/30/2024","$425K - $9M","Right","Reasonable","Very Strong","6'0""","165 lbs","-","-",85,122,6,4,10,9,11,8,8,8,8,12,11,5,10,14,10,12,8,11,12,6,17,5,6,6,12,15,9,15,8,13,10,12,6,13,15,8,13,14,9,14,10,9,9,5,9,1,12,12,13,1,2,3,2,2,2,1,1,1,3,3
"1587",23158014,"Saeed Salem","3/28/1988 (35 years old)","AM (RL), ST (C)","Al-Dhafra","UAE First Division","UAE","No","6/14/2021","6/30/2024","$14K - $140K","Right","Fairly Strong","Very Strong","6'0""","174 lbs","187","34",90,120,7,10,10,10,14,8,12,9,4,8,12,5,5,12,8,10,8,8,7,10,10,14,10,12,8,9,9,10,10,10,9,9,10,10,8,7,12,19,10,11,12,11,12,1,8,1,20,13,12,3,1,2,3,3,3,1,2,1,2,4
"1588",2000092724,"Abdulla Hamad","9/18/2001 (21 years old)","DM, M (C)","Al-Wahda (UAE)","UAE Professional League","UAE","No","5/4/2021","5/31/2026","$90K - $6.4M","Right","Reasonable","Very Strong","5'7""","132 lbs","42","3",90,120,6,7,6,11,8,10,9,12,2,13,12,4,12,11,12,9,12,9,12,8,15,5,5,9,12,12,12,12,12,12,10,6,12,11,12,6,15,11,10,13,13,11,7,8,7,7,19,10,11,1,2,2,3,3,1,3,1,1,1,1
"1589",23034972,"Walid Abbas","6/11/1985 (38 years old)","D (C)","Shabab Al-Ahli","UAE Professional League","UAE","No","6/14/2021","6/30/2024","$190K - $1.9M","Left","Very Strong","Weak","5'11""","152 lbs","364","19",110,120,6,7,10,8,11,8,12,8,8,13,10,8,12,11,13,12,14,12,11,13,14,9,15,8,13,13,9,12,11,10,12,12,16,11,12,13,13,11,12,19,13,7,10,15,12,3,13,15,19,1,1,3,1,3,2,2,1,4,3,2
"1590",43407893,"Augustus Kargbo","8/24/1999 (23 years old)","AM (LC), ST (C)","Crotone","Italian Serie C/C","SLE","No","6/15/2020","6/30/2024","$0","Right Only","Weak","Very Strong","5'8""","149 lbs","149","25",104,118,8,8,10,11,9,6,8,8,9,3,9,6,6,9,12,10,9,8,9,9,9,7,8,10,7,11,7,10,16,16,8,10,13,15,14,13,11,18,15,13,10,11,5,9,8,5,8,13,15,3,2,2,3,3,3,2,1,3,2,1
"1591",23241687,"Khalid Bawazir","8/5/1995 (27 years old)","M/AM (RL)","Sharjah","UAE Professional League","UAE","No","6/1/2020","6/30/2025","$475K - $4.9M","Left","Very Strong","Reasonable","5'9""","138 lbs","123","9",110,120,12,13,13,11,12,10,9,6,8,8,13,10,6,13,8,11,12,10,10,10,10,12,11,12,6,13,12,14,12,14,12,8,10,13,13,7,13,13,15,15,14,11,12,6,8,8,9,13,13,2,1,2,3,2,3,3,2,2,3,2
"1592",23310828,"Mohammed Al-Shamsi","1/4/1997 (26 years old)","GK","Al-Wahda (UAE)","UAE Professional League","UAE","No","1/19/2021","5/31/2025","$550K - $5.4M","Right","Reasonable","Very Strong","6'0""","160 lbs","119","-",100,120,2,2,1,3,1,7,1,1,2,2,10,3,1,3,5,10,12,8,10,13,15,2,9,1,10,8,7,7,11,16,8,9,11,11,4,9,10,18,12,13,12,12,5,8,5,4,10,11,10,10,6,12,5,7,11,10,5,9,10,12
"1593",23106093,"Mohammed Ahmed","4/16/1989 (34 years old)","D (C)","Al-Ain","UAE Professional League","UAE","No","6/14/2021","5/31/2024","$0","Right Only","Weak","Very Strong","6'0""","171 lbs","179","7",85,120,4,2,3,1,8,1,14,6,3,13,7,1,11,6,15,9,9,7,10,14,12,7,12,7,11,7,2,8,10,9,8,12,14,11,11,12,16,15,11,12,10,13,8,7,5,7,8,12,17,3,1,3,2,3,3,3,2,2,1,3
"1594",2000190805,"Salim Tariq","6/30/2004 (18 years old)","DM, M (C)","Al-Wasl","UAE Professional League","UAE","No","7/1/2021","6/30/2026","$0","Right Only","Weak","Very Strong","5'9""","145 lbs","-","-",85,120,8,5,8,9,11,8,8,10,3,10,10,8,10,11,15,9,9,13,13,12,4,5,8,8,11,15,15,12,10,10,15,10,9,10,6,6,11,12,11,20,12,9,13,14,6,3,11,11,15,3,4,1,1,1,2,3,1,1,2,2
"1595",2000190809,"Saif Nasser","12/25/2005 (17 years old)","M/AM (C)","Al-Wasl","UAE Professional League","UAE","No","7/1/2021","6/30/2025","$75K - $220K","Left Only","Very Strong","Very Weak","5'7""","136 lbs","-","-",65,119,8,4,8,10,15,8,3,10,6,7,11,6,10,12,10,10,5,9,5,15,8,15,11,7,7,15,10,10,10,11,8,7,11,10,5,5,11,12,10,11,10,8,7,5,11,2,8,9,14,3,3,3,2,4,3,2,3,2,3,3
"1596",2000062186,"Mohammed Matar","7/6/2003 (19 years old)","AM (C), ST (C)","Al-Wasl","UAE Professional League","UAE","No","7/1/2019","5/31/2028","$600K - $5.8M","Right Only","Weak","Very Strong","5'10""","152 lbs","1","-",85,119,8,9,11,12,15,8,10,15,3,8,11,10,4,15,7,13,6,14,9,11,4,14,8,15,9,8,12,8,14,14,15,6,9,10,5,5,9,13,11,11,11,9,5,3,8,1,11,8,16,1,2,3,1,3,4,2,3,2,2,2
"1597",2000192533,"Hussain Mahmood","3/20/2006 (17 years old)","D (C)","Al-Wasl","UAE Professional League","UAE","No","7/1/2022","6/30/2025","$900K - $1.9M","Right Only","Weak","Very Strong","5'10""","143 lbs","-","-",60,118,4,4,5,5,10,2,10,4,5,9,14,8,13,10,7,9,9,9,10,8,10,5,8,6,14,8,11,9,6,10,9,11,13,9,7,5,10,18,13,11,12,10,5,11,13,4,18,12,9,3,1,2,1,4,3,3,2,3,4,1
"1598",2000046110,"Mohammed Jumaa","1/28/1997 (26 years old)","AM (RL)","Shabab Al-Ahli","UAE Professional League","UAE","No","12/23/2022","6/30/2024","$160K - $1.6M","Right","Weak","Very Strong","5'7""","127 lbs","85","11",95,115,7,11,12,8,12,8,6,7,7,11,10,7,9,12,10,10,11,11,10,10,11,12,8,10,8,8,10,9,13,14,11,6,11,13,11,6,14,7,5,13,9,8,11,14,10,6,9,13,13,1,3,1,3,2,1,1,1,1,3,2
"1599",7880513,"Yousif Jaber","2/25/1985 (38 years old)","D/WB (L)","Shabab Al-Ahli","UAE Professional League","UAE","No","6/10/2022","6/30/2024","$110K - $325K","Left","Very Strong","Reasonable","5'11""","163 lbs","383","58",100,115,10,12,11,8,11,13,8,11,13,10,12,11,9,10,11,9,12,9,10,10,15,11,12,12,11,12,10,14,12,12,9,11,13,13,12,11,12,12,13,13,14,13,7,11,8,7,13,14,13,2,3,2,2,1,2,1,2,2,1,2
"1600",23402454,"Khaled Al-Bloushi","3/22/1999 (24 years old)","DM, M/AM (C)","Al-Ain","UAE Professional League","UAE","No","7/8/2022","5/31/2026","$750K - $10.5M","Right","Reasonable","Very Strong","5'7""","154 lbs","57","2",105,115,10,10,13,8,12,10,8,10,5,8,13,7,8,13,11,12,10,11,11,11,12,13,7,12,9,12,14,13,12,13,12,6,12,12,13,7,12,20,10,13,12,12,8,8,8,4,11,12,10,3,3,3,3,2,2,2,3,3,3,2
"1601",37041779,"Issa Kallon","1/3/1996 (27 years old)","AM (RL), ST (C)","SH Port","Chinese Super League","SLE","Yes","6/30/2022","12/31/2023","$170K","Right","Weak","Very Strong","5'4""","145 lbs","204","29",112,118,11,10,14,8,13,11,6,5,11,3,11,6,3,12,12,10,8,11,8,10,11,14,3,13,5,9,9,11,16,12,8,6,15,16,9,9,13,14,10,9,10,10,4,11,6,8,11,13,14,3,3,1,2,2,2,3,3,3,2,1
"1602",2000162094,"Nawaf Dhawi","9/4/2002 (20 years old)","WB (L)","Al-Jazira (UAE)","UAE Professional League","UAE","No","7/1/2019","6/30/2025","$425K - $4.2M","Left Only","Very Strong","Very Weak","5'10""","154 lbs","3","-",70,115,6,12,6,2,11,3,8,8,4,7,12,3,9,9,11,12,6,9,9,14,4,5,9,8,6,9,9,9,13,10,9,5,17,12,11,9,15,20,13,9,11,13,8,2,6,4,13,10,11,3,2,3,3,1,1,2,3,1,3,2
"1603",54200931,"Abdullah Ramadan","3/7/1998 (25 years old)","DM, M (C)","Al-Jazira (UAE)","UAE Professional League","UAE","No","6/15/2020","5/31/2028","$750K - $5.4M","Left","Very Strong","Weak","5'9""","152 lbs","111","13",105,115,12,11,11,11,12,8,9,12,6,8,13,7,8,14,9,12,9,12,11,12,10,10,8,12,11,15,13,12,12,12,12,8,12,12,12,8,8,14,13,12,11,12,8,11,6,3,11,12,18,2,1,3,2,2,1,3,2,3,1,3
"1604",2000306932,"Ali Al-Hadidi","12/2/2002 (20 years old)","WB (L)","Sharjah","UAE Professional League","UAE","No","6/1/2021","6/30/2025","$250K - $2.5M","Left","Very Strong","Fairly Strong","5'11""","163 lbs","-","-",65,115,5,9,8,4,15,1,4,4,7,8,10,7,10,15,7,7,6,7,9,11,10,5,12,6,8,8,8,8,11,13,4,8,12,13,6,8,13,13,11,11,11,9,8,14,7,2,11,10,16,1,2,3,1,1,1,2,3,1,2,1
"1605",23158081,"Khalid Eisa","9/15/1989 (33 years old)","GK","Al-Ain","UAE Professional League","UAE","No","5/10/2019","5/31/2024","$2.1M - $4.3M","Right","Weak","Very Strong","5'9""","165 lbs","242","-",110,115,3,1,9,3,9,1,1,3,1,3,10,3,2,9,11,12,13,11,12,12,11,5,14,5,12,14,9,6,11,13,10,11,14,10,10,12,1,10,11,15,10,13,7,1,7,6,12,10,20,12,10,14,9,12,12,13,8,12,12,6
"1606",23416750,"Eid Khamis","5/20/1999 (24 years old)","DM, M/AM (C)","Shabab Al-Ahli","UAE Professional League","UAE","No","9/13/2021","5/31/2027","$70K - $700K","Right","Strong","Very Strong","5'10""","171 lbs","38","1",80,115,4,6,8,12,13,6,6,6,1,8,13,4,7,12,6,9,8,8,7,11,10,14,2,8,9,7,12,12,9,8,7,10,7,8,11,11,10,8,8,8,12,11,7,15,12,6,9,11,10,1,2,2,4,1,1,3,2,1,1,3
"1607",1010391,"Majed Naser","4/1/1984 (39 years old)","GK","Shabab Al-Ahli","UAE Professional League","UAE","No","6/14/2021","6/30/2024","$35K - $325K","Right Only","Weak","Very Strong","5'10""","180 lbs","332","-",105,115,3,1,8,2,9,5,3,1,3,2,10,5,1,9,12,12,13,9,12,11,17,5,14,6,12,13,8,8,8,12,12,10,14,9,8,13,11,1,5,15,8,7,9,12,18,20,13,17,10,9,11,13,15,12,11,14,11,13,12,8
"1608",23305975,"Abdullrahman Al-Ameri","4/30/1998 (25 years old)","GK","Al-Jazira (UAE)","UAE Professional League","UAE","No","2/7/2021","5/31/2025","$40K - $425K","Right","Fairly Strong","Very Strong","6'2""","191 lbs","15","-",90,115,5,3,2,3,6,9,1,3,2,3,11,5,2,2,9,11,15,9,10,13,16,1,5,2,10,9,8,8,13,9,9,12,12,9,5,7,13,15,10,9,13,9,9,12,8,5,20,12,11,12,10,14,13,9,12,13,5,11,9,6
"1609",23241583,"Khalfan Mubarak","5/9/1995 (28 years old)","AM (RC)","Al-Jazira (UAE)","UAE Professional League","UAE","No","2/28/2022","5/31/2026","$950K - $5.8M","Left","Very Strong","Reasonable","5'5""","125 lbs","151","32",105,115,12,13,13,8,12,10,6,9,9,6,13,3,5,14,8,11,8,12,10,11,4,12,8,12,7,12,13,12,13,14,12,4,12,11,11,5,9,10,12,11,10,14,9,16,6,7,9,13,15,2,3,1,2,1,1,2,3,2,1,2
"1610",2000306839,"Mansour Al-Shamsi","9/19/2001 (21 years old)","WB (L)","Al-Ain","UAE Professional League","UAE","No","6/1/2022","6/30/2024","$70K - $700K","Left","Very Strong","Reasonable","5'9""","145 lbs","-","-",65,115,6,10,7,4,13,2,5,4,7,7,13,1,10,14,6,11,7,8,7,9,4,5,11,8,11,8,6,8,11,9,8,7,8,10,10,5,14,19,12,11,10,11,9,14,7,7,7,9,14,1,1,1,2,1,2,1,2,1,3,2
"1611",23375082,"Majid Rashid","5/16/2000 (23 years old)","DM, M (C)","Sharjah","UAE Professional League","UAE","No","6/1/2021","5/31/2024","$240K - $2.4M","Right","Reasonable","Very Strong","5'11""","158 lbs","138","3",100,115,7,8,9,9,10,6,10,12,10,12,11,6,13,11,14,11,13,12,11,12,11,9,8,9,12,14,9,13,11,11,12,9,12,11,12,11,12,10,9,8,11,11,9,18,13,5,13,13,17,3,3,3,3,1,1,3,1,3,2,1
"1612",2000037595,"Nikita Tarbyakov","6/2/2002 (21 years old)","D (C)","Baranovichi","Belarusian First League","BLR","No","1/1/2023","11/30/2024","$1K - $8K","Right","Reasonable","Very Strong","6'4""","178 lbs","11","1",74,110,7,6,6,2,9,8,10,8,2,11,9,6,13,8,11,7,9,9,11,15,15,5,5,7,10,8,6,10,11,8,9,13,15,9,6,9,13,18,12,13,12,9,8,10,12,5,10,10,15,3,3,1,2,2,2,2,1,3,3,2
"1613",2000079920,"John Thomas Kamara","5/10/2002 (21 years old)","AM (RC), ST (C)","Ljungskile SK","Swedish First Division South","SLE","No","3/29/2023","12/31/2023","$10K - $100K","Left Only","Very Strong","Weak","5'3""","136 lbs","39","6",91,117,11,10,14,9,10,8,5,11,5,5,11,8,4,11,8,10,6,9,8,8,10,15,6,11,9,7,11,9,13,14,9,4,12,13,12,6,9,12,10,10,10,9,9,13,7,5,11,12,12,1,2,2,3,2,2,3,2,2,1,4
"1614",2000190764,"Abdulla Anwar","7/13/2005 (17 years old)","GK","Al-Wasl","UAE Professional League","UAE","No","7/1/2021","6/30/2025","$210K - $7.2M","Right Only","Weak","Very Strong","6'0""","165 lbs","-","-",80,114,3,3,2,2,6,5,2,3,2,3,9,1,3,2,9,9,10,7,11,6,18,1,7,3,8,5,6,8,6,15,9,7,12,10,2,5,9,13,13,11,11,12,9,16,11,7,3,12,19,9,15,15,9,11,12,15,5,9,14,10
"1615",2000162100,"Zayed Sultan","4/11/2001 (22 years old)","D/WB (R)","Al-Jazira (UAE)","UAE Professional League","UAE","No","7/1/2018","6/30/2026","$300K - $3.1M","Right","Reasonable","Very Strong","5'9""","138 lbs","46","-",85,114,8,15,9,7,10,4,10,7,11,8,9,5,9,10,12,9,10,9,8,9,4,9,6,10,9,11,9,12,12,12,10,8,7,12,12,8,16,12,10,10,13,12,14,2,5,4,12,11,10,1,1,3,1,3,2,2,1,1,3,3
"1616",2000047941,"Ahmed Fawzi","11/26/2001 (21 years old)","AM (C), ST (C)","Al-Jazira (UAE)","UAE Professional League","UAE","No","6/13/2022","5/31/2024","$2.3M - $4.7M","Right","Reasonable","Very Strong","5'7""","136 lbs","17","3",80,113,7,5,11,13,13,7,9,8,1,7,12,7,7,14,9,11,6,11,8,11,8,13,10,13,7,8,9,9,12,11,8,6,13,10,7,7,13,12,12,11,10,11,5,1,6,5,17,10,18,1,3,2,1,3,2,2,2,3,2,3
"1617",2000063875,"Mohamed Abdelrahman","1/16/2001 (22 years old)","WB (L)","Hatta","UAE Professional League","UAE","No","7/1/2018","6/30/2026","$65K - $650K","Right","Reasonable","Very Strong","5'10""","145 lbs","25","-",75,113,5,10,8,6,10,1,4,7,7,8,13,2,6,8,6,7,8,8,8,9,11,8,10,8,10,8,8,8,14,14,8,8,9,14,11,6,15,14,11,13,10,13,9,11,8,2,9,11,15,2,1,3,3,2,1,3,1,3,1,3
"1618",2000164262,"Abdulla Ahmed","6/13/2004 (18 years old)","DM, M (C)","Al-Wahda (UAE)","UAE Professional League","UAE","No","7/1/2020","6/30/2025","$220K - $2.2M","Right","Reasonable","Very Strong","5'9""","132 lbs","-","-",70,113,6,6,3,7,13,6,6,8,1,4,13,3,7,10,5,9,8,3,8,9,10,5,11,8,9,7,11,12,13,13,4,5,12,13,7,6,13,14,14,11,11,11,12,8,10,8,18,12,13,2,2,3,3,3,3,1,1,2,2,3
"1619",2000063857,"Naser Salem","4/2/1999 (24 years old)","M/AM (LC)","Al-Wasl","UAE Professional League","UAE","No","6/12/2022","6/30/2025","$120K - $350K","Right","Reasonable","Very Strong","5'9""","167 lbs","19","-",75,111,6,8,10,9,10,6,6,5,6,7,9,5,8,11,9,6,8,8,6,13,10,11,10,11,7,7,10,12,13,13,5,7,11,13,7,5,12,17,11,10,10,9,7,12,9,8,11,13,10,3,2,1,3,3,3,2,3,1,4,3
"1620",82060853,"Levi Garcia","11/20/1997 (25 years old)","AM (RL), ST (C)","AEK","Greek Super League 1","TRI","No","9/16/2020","6/30/2025","$12.5M - $15M","Left","Very Strong","Fairly Strong","6'0""","171 lbs","203","45",135,140,12,12,13,11,10,11,12,9,3,7,10,12,6,13,11,11,10,10,10,10,12,14,5,13,5,11,11,12,17,14,15,15,12,16,11,16,13,16,17,14,12,14,12,13,3,6,10,12,15,1,1,3,1,1,1,2,1,3,3,3
"1621",29075076,"Joevin Jones","8/3/1991 (31 years old)","D/WB/M/AM (L)","Police (TRI)","TT Premier Football League Tier 1","TRI","No","5/17/2023","6/30/2024","$0 - $70K","Left Only","Very Strong","Weak","5'11""","160 lbs","249","40",116,130,9,12,14,9,12,10,7,11,10,9,12,11,10,14,13,10,8,14,12,11,8,14,8,14,9,9,11,8,14,13,13,8,16,14,13,9,15,12,12,7,14,7,9,13,9,15,9,15,13,2,2,3,2,1,1,1,2,1,2,3
"1622",2000251489,"Lyshaun Morris","2/8/2007 (16 years old)","D/WB (L), DM, M (LC), AM (L)","Point Fortin","TT Premier Football League Tier 1","TRI","No","3/1/2023","6/30/2026","$7K - $20K","Left","Very Strong","Reasonable","5'9""","141 lbs","-","-",70,129,7,10,9,11,13,7,7,4,6,9,10,3,13,10,10,8,8,4,7,12,2,12,3,14,7,8,5,9,10,8,8,7,11,10,14,7,9,12,14,13,10,13,7,10,5,6,7,13,7,1,2,2,1,2,2,1,3,1,2,1
"1623",20042045,"Noah Powder","10/27/1998 (24 years old)","D/WB (L)","Northern Colorado","United States Soccer Leagues Division One","TRI","No","6/12/2023","11/30/2024","$900K - $1.9M","Left Only","Very Strong","Weak","5'11""","160 lbs","135","12",99,128,13,12,12,8,10,14,8,13,10,12,10,5,9,12,10,9,15,8,9,8,6,13,12,10,8,9,8,14,14,12,9,11,6,13,15,10,10,20,13,10,8,10,5,8,5,2,20,10,8,1,1,2,2,1,1,4,2,1,1,1
"1624",2000205381,"Moses Turay","2/11/2004 (19 years old)","AM (R)","Troyes","French National 3 - Group I","SLE","No","7/1/2022","6/30/2027","$55K - $160K","Left","Very Strong","Reasonable","5'11""","163 lbs","-","-",72,117,9,10,11,9,9,8,7,7,4,4,9,10,5,11,9,9,9,8,8,9,10,8,7,8,7,10,9,9,12,9,9,7,11,12,9,9,10,10,10,10,10,9,9,8,8,10,8,10,12,1,1,3,3,3,3,3,3,3,2,1
"1625",14244916,"Michel Poon-Angeron","4/19/2001 (22 years old)","DM, M (C)","AC PoS","TT Premier Football League Tier 1","TRI","No","7/1/2022","6/30/2024","$0 - $55K","Right","Reasonable","Very Strong","5'10""","149 lbs","-","-",90,126,8,8,4,9,14,8,8,14,8,10,9,6,11,13,10,14,9,10,5,14,6,6,4,10,12,10,10,12,13,10,8,4,10,12,7,7,15,17,9,9,13,11,13,4,6,4,14,11,8,1,3,3,4,2,3,2,2,2,3,3
"1626",2000110617,"Jesse Williams","5/18/2001 (22 years old)","D (RC)","Des Moines Menace","USSL D2 - Heartland Division","TRI","No","5/5/2023","-","$0","Right","Weak","Very Strong","5'10""","185 lbs","8","-",90,126,7,11,7,7,11,9,11,8,5,12,8,4,15,6,11,12,11,11,5,9,13,5,12,9,9,10,4,14,11,11,14,10,13,9,13,13,13,17,10,10,11,12,7,6,7,6,12,9,10,1,2,1,3,2,1,2,3,2,1,3
"1627",5104418,"Justin Hoyte","11/20/1984 (38 years old)","D (RC)","Miami Beach CF","NPSL South Region","TRI","No","1/1/2020","-","$0","Right","Reasonable","Very Strong","5'10""","174 lbs","303","6",85,124,6,10,9,5,8,5,11,5,12,11,10,7,12,10,11,11,10,10,10,9,10,5,12,8,10,11,9,13,14,13,9,10,11,11,12,8,14,13,13,14,8,18,6,11,7,3,10,10,10,1,2,3,2,1,2,1,4,4,1,2
"1628",82088456,"Jaheim Faustin","10/1/2004 (18 years old)","ST (C)","Jabloteh","TT Premier Football League Tier 1","TRI","No","3/1/2022","6/30/2024","$0 - $45K","Right","Reasonable","Very Strong","5'10""","147 lbs","2","1",75,121,8,5,10,10,9,8,15,9,1,6,9,2,3,11,6,14,9,9,8,6,15,9,8,10,9,8,7,9,11,11,9,10,10,11,9,7,8,14,11,13,11,11,10,13,11,1,20,12,13,1,1,2,3,2,1,3,1,1,2,1
"1629",28115992,"Daniel Phillips","1/18/2001 (22 years old)","DM, M (C)","St Johnstone","cinch Premiership","TRI","No","8/10/2022","5/31/2024","$170K - $1.7M","Right","Reasonable","Very Strong","5'9""","156 lbs","54","1",102,120,11,5,9,7,13,8,9,10,1,10,13,7,14,11,15,12,13,12,10,9,14,12,8,9,11,10,9,14,13,9,10,8,14,13,14,14,9,8,10,11,12,12,11,9,13,4,11,8,12,3,1,1,1,1,1,1,2,2,4,2
"1630",72004152,"Darryl Roberts","9/26/1983 (39 years old)","M/AM (C), ST (C)","HPC","UAE Second Division","TRI","No","7/1/2020","-","$0","Right","Weak","Very Strong","6'1""","154 lbs","246","72",66,120,7,10,9,8,8,7,10,10,3,1,12,12,2,9,7,11,9,11,10,11,10,13,6,10,6,10,12,12,8,8,9,10,14,8,7,8,12,10,14,13,8,13,12,11,7,6,12,13,12,2,3,3,3,3,3,3,2,2,1,2
"1631",82001425,"Sheldon Bateau","1/29/1991 (32 years old)","D (RC), DM","Samsunspor","Turkish Super League","TRI","No","1/12/2022","6/30/2025","Not for Sale","Right","Weak","Very Strong","6'1""","187 lbs","270","12",104,120,9,7,7,6,12,9,12,9,10,12,10,10,10,9,14,12,12,12,8,10,14,12,14,8,12,14,6,12,10,12,13,14,14,10,12,14,13,10,10,12,11,10,11,12,12,14,12,11,11,3,1,1,1,1,2,1,1,3,3,3
"1632",82002871,"Kevin Molino","6/17/1990 (32 years old)","M (L), AM (LC)","Columbus","Major League Soccer","TRI","No","1/7/2021","12/31/2023","$24K - $250K","Right","Weak","Very Strong","5'8""","156 lbs","240","63",109,118,12,13,14,12,13,12,9,10,6,8,14,11,9,12,8,11,8,11,11,10,15,14,7,13,7,12,12,13,12,12,14,8,13,13,10,8,13,18,12,18,7,18,15,15,6,5,12,13,13,2,4,1,3,1,3,1,2,1,3,2
"1633",82073011,"Jamille Boatswain","9/30/1993 (29 years old)","ST (C)","Defence Force","TT Premier Football League Tier 1","TRI","No","3/1/2022","6/30/2024","$1K - $10K","Right Only","Weak","Very Strong","5'11""","167 lbs","18","6",92,116,2,6,12,13,11,2,10,13,3,2,10,11,5,11,15,13,17,13,11,11,16,8,11,13,4,13,8,14,12,10,13,11,13,11,10,14,4,14,13,12,14,11,3,13,3,4,13,13,14,3,1,1,3,3,1,2,2,1,1,2
"1634",2000025185,"Kaïle Auvray","5/27/2004 (19 years old)","AM (L)","Mount Pleasant FC","Jamaican Premier League","TRI","Yes","6/12/2023","6/30/2025","$1.5K - $4K","Right Only","Weak","Very Strong","5'4""","114 lbs","-","-",73,116,8,8,12,8,10,8,3,8,4,6,14,6,9,10,7,5,8,7,9,7,4,12,1,6,8,9,7,13,12,11,15,4,15,12,13,1,12,12,14,10,11,12,5,11,7,7,11,13,7,3,3,1,2,1,2,2,3,2,2,1
"1635",2000069186,"John Peter Sesay","5/8/2003 (20 years old)","M (C), AM (RC)","Darmstadt 98","Bundesliga","SLE","Yes","7/1/2018","6/30/2024","$18K - $170K","Left Only","Very Strong","Weak","5'10""","156 lbs","14","2",81,115,5,7,12,10,10,5,6,7,3,6,10,10,6,11,13,7,11,7,7,6,13,12,4,11,6,11,10,12,14,11,7,7,12,13,10,7,14,9,10,12,10,12,9,12,7,8,10,10,12,3,1,3,1,3,1,2,2,3,1,1
"1636",2000008387,"Shaqkeem Joseph","12/22/1999 (23 years old)","WB/M (L), AM (RL), ST (C)","Club Sando","TT Premier Football League Tier 1","TRI","No","7/1/2019","6/30/2025","$500 - $7K","Right","Reasonable","Very Strong","6'2""","145 lbs","17","12",90,116,4,9,9,7,8,7,6,7,6,5,9,4,7,9,12,12,10,8,9,11,3,15,11,9,8,8,5,10,16,12,7,9,14,14,8,5,10,13,9,11,12,11,13,12,5,1,8,13,18,2,3,1,2,3,3,1,1,1,2,2
"1637",82065350,"Shannon Gomez","10/5/1996 (26 years old)","D/WB/M/AM (R)","San Antonio","USSL Championship Western Conference","TRI","No","1/13/2022","11/30/2023","$40K - $400K","Right Only","Weak","Very Strong","5'7""","141 lbs","123","2",92,115,7,9,9,6,9,7,7,7,8,9,9,10,10,9,14,7,13,8,8,7,14,12,9,8,9,13,7,15,15,12,11,8,12,14,14,8,12,11,10,14,14,9,11,10,11,3,10,13,10,3,3,2,3,2,4,1,2,4,1,1
"1638",2000060159,"Justin Araujo Wilson","8/26/2002 (20 years old)","ST (C)","Jihlava","Czech Lower Division","TRI","No","8/26/2020","6/30/2024","$22K - $210K","Right","Weak","Very Strong","6'3""","180 lbs","45","8",69,115,5,5,13,13,10,5,13,4,4,3,6,9,1,12,10,8,2,12,4,13,13,13,10,7,5,5,5,6,12,10,6,14,12,11,8,6,9,10,9,13,12,11,12,7,12,5,10,10,19,3,2,2,2,3,3,2,3,1,1,1
"1639",2000111586,"Ajani Fortune","12/30/2002 (20 years old)","M (C)","Atlanta United","Major League Soccer","TRI","No","8/27/2021","12/31/2024","$230K - $2.3M","Right","Reasonable","Very Strong","5'9""","165 lbs","58","3",90,114,10,10,10,13,11,10,8,11,9,12,11,8,13,10,15,10,12,11,10,9,12,7,8,11,9,11,12,13,10,11,11,8,9,11,12,8,14,11,9,11,9,11,12,3,8,3,8,10,19,1,2,2,2,4,1,3,3,2,2,3
"1640",82002885,"Daneil Cyrus","12/15/1990 (32 years old)","D (RC)","TLH Rangers","TT Premier Football League Tier 1","TRI","No","4/1/2023","6/30/2024","$3K - $9K","Right Only","Very Weak","Very Strong","6'3""","152 lbs","94","3",90,113,2,9,8,4,7,3,14,5,6,11,9,4,13,9,15,13,11,11,9,12,7,5,11,9,13,12,8,13,10,8,12,14,14,11,13,14,8,10,14,11,12,14,7,11,12,7,11,14,7,1,1,3,3,1,1,3,4,1,1,2
"1641",45024803,"Mekeil Williams","7/24/1990 (32 years old)","D (RLC)","Chattanooga","United States Soccer Leagues Division One","TRI","No","3/2/2023","11/30/2023","$7K - $70K","Left","Very Strong","Fairly Strong","6'1""","180 lbs","230","4",98,113,7,11,12,6,10,7,12,6,9,12,12,8,13,11,14,11,14,10,12,8,12,7,13,9,12,12,9,13,11,9,10,13,14,14,13,13,12,14,8,12,13,9,5,5,12,2,12,12,9,3,2,1,1,3,3,4,3,1,1,3
"1642",82077603,"Isaiah Lee","9/21/1999 (23 years old)","AM (RLC), ST (C)","TLH Rangers","TT Premier Football League Tier 1","TRI","No","1/1/2021","6/30/2025","$1K - $9K","Right","Reasonable","Very Strong","6'0""","149 lbs","8","6",90,110,9,7,11,10,11,7,10,12,8,9,8,9,10,10,6,11,8,10,8,9,13,15,7,11,10,10,8,12,12,13,11,13,13,11,12,10,10,9,9,13,12,13,5,14,12,4,13,12,18,2,2,2,3,3,2,1,4,1,3,2
"1643",82065290,"Nicholas Dillon","3/25/1997 (26 years old)","AM (RL), ST (C)","Club Sando","TT Premier Football League Tier 1","TRI","No","3/1/2023","6/30/2025","$0 - $35K","Right","Reasonable","Very Strong","6'2""","213 lbs","12","1",92,110,7,9,7,10,12,8,14,9,1,7,9,5,6,10,7,8,10,12,9,13,14,9,8,11,8,9,10,10,10,11,13,11,11,11,14,14,10,19,11,8,10,7,5,16,7,4,19,11,20,3,1,1,1,2,1,2,3,2,1,1
"1644",29003722,"Gavin Hoyte","6/6/1990 (33 years old)","D (R)","Maidstone","Vanarama National League South","TRI","No","6/1/2023","6/30/2024","$0 - $9K","Right Only","Weak","Very Strong","6'0""","154 lbs","319","5",65,110,5,9,8,5,9,7,10,5,9,11,8,7,11,8,11,8,9,8,9,7,12,11,11,9,11,13,6,12,10,11,9,9,12,11,11,9,12,11,11,11,11,15,8,7,8,6,7,12,13,3,1,2,2,2,2,1,1,1,1,1
"1645",82076852,"Isaiah Hudson","7/27/2000 (22 years old)","M/AM (R), ST (C)","W Connection","TT Premier Football League Tier 1","TRI","No","3/1/2023","6/30/2024","$0 - $35K","Right","Fairly Strong","Very Strong","6'0""","154 lbs","-","-",89,110,7,12,13,10,12,7,9,5,7,7,10,3,6,7,12,9,6,10,9,11,10,6,8,11,7,10,9,11,14,12,8,11,15,11,11,6,12,14,11,12,12,13,13,12,6,1,13,11,7,2,1,2,1,2,3,3,1,2,1,3
"1646",67293838,"Alhassan Koroma","6/9/2000 (23 years old)","M (L), AM (RL)","Linense","Spanish Federation Second Group 4","SLE","No","7/1/2020","6/30/2024","$22K - $220K","Left Only","Very Strong","Weak","6'0""","152 lbs","103","14",95,115,9,12,14,14,9,8,8,10,6,6,13,7,8,10,15,8,8,10,8,14,16,9,5,14,8,9,10,13,13,12,9,8,12,11,14,6,12,20,12,11,13,12,8,7,9,3,13,11,14,3,1,3,3,2,2,2,3,3,3,2
"1647",82083268,"Judah Garcia","10/24/2000 (22 years old)","AM (RLC)","AEK","Greek Super League 1","TRI","No","8/3/2021","6/30/2024","$0 - $24K","Right","Reasonable","Very Strong","6'0""","156 lbs","54","9",85,110,9,10,12,9,11,9,8,11,6,7,12,10,6,12,9,9,9,9,8,8,11,12,7,11,7,11,12,10,13,13,8,10,13,12,10,7,11,12,12,12,10,12,7,8,5,7,10,13,12,1,1,2,2,2,3,3,4,2,4,3
"1648",82073901,"Keston Julien","10/26/1998 (24 years old)","D/WB/M/AM (L)","Sheriff Tiraspol","Moldovan Divizia Naţională","TRI","No","8/1/2020","6/30/2023","$90K - $275K","Left","Very Strong","Reasonable","5'10""","174 lbs","74","5",107,110,8,13,12,8,11,10,11,11,11,12,13,7,9,12,13,12,7,7,10,9,17,13,12,15,11,9,13,10,13,13,11,8,15,13,12,10,15,13,12,12,11,10,5,9,9,7,6,11,9,3,2,1,2,2,2,3,2,3,3,4
"1649",29160386,"Andre Fortune","7/3/1996 (26 years old)","M/AM (C)","Kalju","Estonian Premier League","TRI","No","2/7/2022","12/31/2024","$50K - $475K","Right Only","Weak","Very Strong","5'11""","156 lbs","126","20",93,110,6,7,11,12,10,3,6,8,6,10,14,5,8,12,15,9,8,10,7,12,15,11,11,14,8,13,9,13,14,12,8,11,14,13,10,9,16,18,9,11,12,8,5,7,12,3,20,10,7,1,2,2,2,1,1,3,2,2,2,1
"1650",82060704,"Alvin Jones","7/9/1994 (28 years old)","D/WB (R), DM, M (R)","Club Sando","TT Premier Football League Tier 1","TRI","No","4/1/2023","6/30/2025","$0 - $35K","Right","Reasonable","Very Strong","6'2""","171 lbs","43","5",95,110,9,10,8,5,8,13,7,11,7,9,11,1,12,7,7,9,9,8,8,13,14,12,9,8,12,8,6,13,13,13,10,8,8,13,13,10,17,13,10,13,11,12,5,13,11,1,14,11,7,3,1,2,2,3,4,3,1,1,2,2
"1651",82089521,"Jokiah Leacock","12/11/1998 (24 years old)","D (C), DM","AC PoS","TT Premier Football League Tier 1","TRI","No","7/1/2020","6/30/2024","$2.5K - $7K","Right","Reasonable","Very Strong","6'6""","185 lbs","-","-",80,109,1,1,6,2,8,5,13,4,3,13,8,1,13,3,6,9,9,6,11,8,15,5,12,4,13,6,4,8,13,10,7,14,9,12,10,10,12,14,13,9,9,12,11,8,14,8,13,10,12,3,3,3,2,3,3,3,3,1,1,1
"1652",82002877,"Marcus Joseph","4/29/1991 (32 years old)","M (L), AM (RLC), ST (C)","Point Fortin","TT Premier Football League Tier 1","TRI","No","4/1/2023","6/30/2024","$0","Left","Very Strong","Reasonable","5'10""","134 lbs","132","105",102,108,10,7,7,13,9,11,11,11,10,8,6,9,7,13,12,11,10,9,8,8,13,11,15,10,10,11,11,15,10,13,10,12,9,11,11,13,13,12,11,15,10,12,11,10,8,3,13,14,18,1,2,3,1,3,1,2,4,3,1,1
"1653",20046849,"Leland Archer","1/8/1996 (27 years old)","D (C)","Charleston","USSL Championship Eastern Conference","TRI","No","12/23/2020","11/30/2023","$180K - $550K","Right","Reasonable","Very Strong","6'4""","185 lbs","115","2",94,107,8,3,7,5,8,5,12,7,6,9,9,6,12,8,9,9,11,13,12,8,9,4,10,10,9,8,5,11,9,8,10,16,7,10,13,15,15,15,11,10,11,10,15,10,7,2,11,12,19,3,2,3,2,2,2,1,1,3,2,3
"1654",82002866,"Aubrey David","10/11/1990 (32 years old)","D (C)","Aucas","Ecuadorian Serie A","TRI","No","12/3/2022","12/31/2024","$0 - $100K","Right","Reasonable","Very Strong","6'3""","169 lbs","333","13",97,106,3,8,7,4,11,5,13,5,12,14,8,5,11,5,14,10,9,8,9,11,3,10,6,7,12,10,5,13,11,7,14,15,15,10,10,15,14,15,10,12,13,11,5,5,16,2,14,12,16,3,1,2,1,2,3,2,1,2,2,1
"1655",2000005995,"Nathaniel James","6/17/2004 (18 years old)","M (C), AM (LC), ST (C)","Intercity","Spanish Federation First Division B","TRI","No","1/2/2023","6/30/2023","$0 - $1.5K","Right","Reasonable","Very Strong","5'8""","154 lbs","3","1",80,106,7,7,9,10,9,12,8,5,4,7,13,5,3,10,5,7,8,10,6,10,8,13,8,10,7,9,7,11,14,14,7,7,12,13,11,5,9,13,13,13,15,10,6,13,5,2,11,12,9,3,1,2,3,1,2,1,1,2,2,2
"1656",82065548,"Aikim Andrews","6/20/1996 (26 years old)","D/WB/M/AM (R)","TLH Rangers","TT Premier Football League Tier 1","TRI","No","6/1/2019","6/30/2024","$0 - $24K","Right Only","Weak","Very Strong","5'9""","167 lbs","32","3",92,106,8,11,10,10,8,4,7,7,2,8,14,4,10,11,6,12,9,4,4,14,10,10,12,12,10,4,10,9,14,13,10,7,11,13,11,8,16,14,13,13,13,11,9,7,8,4,17,11,9,3,1,1,3,1,4,2,1,1,3,1
"1657",20042305,"Augustine Williams","8/3/1997 (25 years old)","AM (RL), ST (C)","Charleston","USSL Championship Eastern Conference","SLE","No","2/9/2022","11/30/2023","$190K - $550K","Right","Reasonable","Very Strong","6'2""","165 lbs","176","57",98,114,8,9,10,12,10,7,12,9,7,5,9,10,4,11,6,8,12,11,9,8,11,8,7,12,8,11,8,12,12,11,8,14,12,14,14,11,9,12,12,10,11,9,10,10,7,5,10,11,14,2,1,2,2,3,2,1,1,2,2,1
"1658",82003129,"Carlyle Mitchell","8/8/1987 (35 years old)","D (C)","Caledonia Utd","TT Premier Football League Tier 1","TRI","No","1/1/2023","6/30/2024","$1.5K - $4K","Right","Fairly Strong","Very Strong","6'1""","176 lbs","129","11",96,106,8,5,8,4,8,3,13,5,7,11,8,7,13,9,10,9,11,10,10,8,18,6,15,6,11,12,9,14,13,9,10,14,15,13,14,11,15,17,12,10,11,11,14,16,8,8,9,12,8,2,2,1,3,2,1,2,2,1,1,3
"1659",82070057,"Triston Hodge","10/9/1994 (28 years old)","D (LC), WB (L), DM","Hartford","USSL Championship Eastern Conference","TRI","No","12/19/2022","11/30/2023","$170K - $500K","Left","Very Strong","Reasonable","6'0""","171 lbs","74","3",93,105,5,7,8,6,8,8,14,8,3,14,5,5,11,4,14,13,12,9,11,9,14,5,10,6,14,11,8,10,8,9,11,12,15,6,10,12,12,14,9,9,11,10,7,3,6,7,20,12,20,3,1,3,4,2,3,4,1,1,2,3
"1660",20045110,"Ryan Telfer","3/4/1994 (29 years old)","M/AM (L)","Miami FC","USSL Championship Eastern Conference","TRI","No","1/5/2023","11/30/2024","$120K - $1.2M","Left Only","Very Strong","Weak","5'11""","180 lbs","100","9",92,105,10,11,12,10,11,11,8,9,9,8,10,11,8,10,7,8,11,6,9,8,11,7,9,11,8,8,9,10,12,12,12,11,14,13,12,14,12,5,8,12,13,11,6,13,6,12,10,12,10,1,3,4,4,2,3,1,1,3,2,3
"1661",82076856,"Kathon St. Hillaire","11/5/1997 (25 years old)","M/AM (RL), ST (C)","Defence Force","TT Premier Football League Tier 1","TRI","No","8/1/2021","6/30/2024","$0 - $9K","Left","Very Strong","Reasonable","6'0""","158 lbs","41","6",85,105,8,10,11,13,15,8,8,6,2,8,13,7,7,10,8,7,9,7,7,7,6,13,9,8,8,7,9,9,11,10,9,11,15,11,14,12,12,16,10,12,10,12,12,10,8,3,10,11,7,3,3,3,2,1,1,1,1,2,3,2
"1662",82070206,"Keron Cummings","5/28/1988 (35 years old)","WB (L), M/AM (LC)","Central (TRI)","TT Premier Football League Tier 1","TRI","No","3/1/2023","6/30/2024","$0","Left","Very Strong","Fairly Strong","5'6""","143 lbs","16","4",88,105,13,10,10,8,7,14,4,14,7,7,10,3,8,10,16,9,14,9,9,11,12,17,13,12,8,8,12,14,11,12,6,2,13,11,12,10,12,18,11,8,8,6,5,15,8,12,7,15,11,1,3,2,2,2,3,1,4,1,1,2
"1663",82089565,"Rivaldo Coryat","4/20/2001 (22 years old)","DM, M (C), AM (RLC)","Defence Force","TT Premier Football League Tier 1","TRI","No","3/1/2023","6/30/2024","$12K - $40K","Left","Very Strong","Fairly Strong","5'6""","145 lbs","-","-",95,105,11,10,9,8,10,12,6,10,2,9,11,5,10,11,8,11,9,9,10,14,9,15,10,13,10,9,12,13,10,11,9,1,7,10,10,9,13,10,13,12,11,12,8,12,8,6,11,10,18,2,1,1,2,3,1,3,1,3,4,1
"1664",147976,"Andre Toussaint","8/26/1981 (41 years old)","ST (C)","W Connection","TT Premier Football League Tier 1","TRI","No","6/14/2021","6/30/2024","$0","Right","Strong","Very Strong","5'5""","152 lbs","-","-",78,105,7,6,10,11,10,8,14,7,4,7,9,6,4,13,14,9,13,15,9,11,13,10,10,14,9,8,9,11,9,11,9,3,8,9,10,3,8,8,4,6,12,9,11,17,9,16,11,15,10,3,3,1,1,1,1,1,2,3,1,2
"1665",45024787,"Keston Williams","7/2/1997 (25 years old)","M (C)","Defence Force","TT Premier Football League Tier 1","TRI","No","6/15/2020","6/30/2024","$500 - $3.5K","Right","Fairly Strong","Very Strong","5'9""","149 lbs","-","-",99,105,7,2,4,6,14,8,8,8,1,12,11,5,8,9,12,8,7,8,9,14,6,5,13,13,11,9,10,12,13,13,9,4,15,13,14,7,15,20,10,11,9,9,8,11,8,8,20,10,16,2,1,2,2,1,3,2,1,2,2,4
"1666",82065136,"Jabari Mitchell","5/1/1997 (26 years old)","M/AM (C), ST (C)","Police (TRI)","TT Premier Football League Tier 1","TRI","No","7/1/2019","6/30/2024","$0 - $45K","Right","Strong","Very Strong","5'9""","143 lbs","9","2",95,105,10,8,10,13,9,11,5,8,3,8,11,6,6,10,12,11,6,10,8,10,5,17,12,13,9,8,8,9,13,13,8,3,15,13,8,6,11,15,12,11,12,12,5,6,5,6,20,15,14,2,2,1,2,2,1,3,3,1,3,3
"1667",2000251120,"Acelino Medford","10/11/2002 (20 years old)","D (C)","Club Sando","TT Premier Football League Tier 1","TRI","No","3/1/2023","6/30/2025","$0 - $5K","Right","Reasonable","Very Strong","6'1""","167 lbs","-","-",77,104,4,3,4,2,6,1,14,2,3,14,8,5,12,1,13,9,9,8,7,14,12,5,12,7,12,7,5,8,10,8,8,9,12,10,10,10,12,12,8,15,11,10,14,12,11,7,6,14,15,1,3,2,1,1,2,3,3,2,1,1
"1668",13129827,"George Davies","11/16/1996 (26 years old)","M (RL), AM (L)","FC Admira Wacker Mödling","Austrian First Division","SLE","No","1/1/2023","6/30/2024","$45K - $425K","Left","Very Strong","Reasonable","5'7""","141 lbs","145","13",101,113,8,8,9,6,8,8,3,11,5,9,12,7,9,11,6,9,11,10,9,9,11,10,6,13,6,12,9,12,16,13,10,5,12,14,12,9,10,13,12,11,10,8,6,7,5,6,10,9,15,2,2,2,3,1,4,3,1,4,3,4
"1669",2000273564,"Lindell Sween","9/27/2006 (16 years old)","M (C), AM (RLC), ST (C)","Jabloteh","TT Premier Football League Tier 1","TRI","No","7/1/2022","6/30/2026","$0 - $20K","Left","Very Strong","Fairly Strong","5'11""","143 lbs","-","-",78,104,9,8,10,9,11,10,7,8,6,4,9,4,6,6,11,9,1,9,9,5,4,9,10,10,5,7,10,11,10,10,5,5,14,12,13,5,8,10,11,11,9,11,11,9,12,5,8,12,11,2,3,3,1,3,1,2,3,2,2,1
"1670",2000216077,"Rio Cardines","7/1/2006 (16 years old)","D/WB/M (R), AM (RL)","Crystal Palace","English Premier Division","TRI","No","7/1/2022","6/30/2024","$325K - $950K","Right","Fairly Strong","Very Strong","5'11""","141 lbs","-","-",70,104,6,10,6,10,9,8,8,6,8,7,10,2,10,8,15,8,9,6,6,14,18,6,8,9,6,14,8,14,9,8,9,8,9,7,10,5,18,15,12,11,11,8,5,12,12,5,8,12,13,2,2,2,3,1,2,3,3,2,1,2
"1671",82000158,"Ataullah Guerra","11/14/1987 (35 years old)","AM (RC)","TLH Rangers","TT Premier Football League Tier 1","TRI","No","3/1/2021","6/30/2024","$0","Left","Very Strong","Fairly Strong","6'2""","187 lbs","188","69",90,104,10,9,13,11,12,10,4,6,1,3,12,13,2,12,8,9,8,8,11,8,11,14,12,10,6,9,10,8,12,11,9,9,12,11,12,7,9,16,12,6,12,10,5,14,8,14,8,9,8,2,2,2,1,1,2,2,1,1,1,2
"1672",2000181886,"Luke Phillip","8/21/2004 (18 years old)","WB (L), DM, M (RLC), AM (L)","Point Fortin","TT Premier Football League Tier 1","TRI","No","3/1/2023","6/30/2024","$0","Right","Reasonable","Very Strong","6'0""","167 lbs","-","-",86,104,7,10,9,7,10,7,7,13,7,8,8,4,9,9,11,9,8,4,9,10,10,13,10,11,9,8,10,9,12,9,11,12,15,11,6,11,10,13,12,11,13,11,8,13,5,8,11,11,19,3,3,2,3,3,2,1,3,2,2,3
"1673",82060635,"Rundell Winchester","12/16/1993 (29 years old)","AM (RL), ST (C)","Al-Rayan","Saudi Second Division Group A","TRI","No","6/4/2023","6/30/2024","$10K - $110K","Right","Fairly Strong","Very Strong","6'2""","182 lbs","191","84",75,104,6,8,8,8,8,10,6,10,6,4,8,8,5,8,9,7,12,8,7,7,12,13,8,8,7,9,9,12,12,8,11,12,11,13,9,11,8,17,13,13,12,11,6,11,5,6,11,12,12,2,2,3,1,1,3,2,3,1,3,1
"1674",82089615,"Shem Clauzel","4/22/1999 (24 years old)","DM, M/AM (C)","AC PoS","TT Premier Football League Tier 1","TRI","No","12/1/2019","6/30/2024","$0 - $2K","Right","Weak","Very Strong","5'5""","136 lbs","6","-",80,103,6,4,9,11,11,7,4,9,1,9,10,5,13,14,8,9,8,8,9,13,16,13,8,9,9,8,11,12,11,11,8,5,12,10,7,5,14,13,10,9,11,11,7,11,13,6,17,11,11,1,3,3,2,2,3,2,1,1,1,3
"1675",85096091,"Mickaël Malsa","10/12/1995 (27 years old)","DM, M (C)","Valladolid","Spanish Second Division","MTQ","Yes","8/12/2022","6/30/2026","$2.5M","Right","Reasonable","Very Strong","5'10""","156 lbs","193","5",125,140,8,11,12,8,13,9,9,8,6,12,14,10,13,13,13,14,13,14,14,13,13,9,9,12,13,14,13,15,13,14,12,9,14,12,15,12,11,7,13,13,14,12,9,12,12,8,13,13,12,2,1,2,2,3,2,3,1,1,3,3
"1676",8441455,"Jean-Sylvain Babin","10/14/1986 (36 years old)","D (C)","Alcorcón","Spanish Second Division","MTQ","Yes","7/1/2022","6/30/2024","$14K - $140K","Right","Weak","Very Strong","6'0""","196 lbs","541","30",123,137,7,7,7,8,10,8,14,7,7,14,10,7,14,10,12,13,15,11,14,10,14,6,12,8,17,13,8,13,9,10,10,13,13,10,15,17,8,12,10,16,12,15,9,13,12,12,12,12,15,2,3,1,2,2,3,2,3,3,2,2
"1677",85141644,"Kévin Appin","1/20/1998 (25 years old)","DM, M (C)","Ibiza","Spanish Federation First Division B","MTQ","Yes","6/30/2021","6/30/2024","$0","Right","Reasonable","Very Strong","5'10""","156 lbs","91","1",108,129,8,9,10,8,12,8,8,11,8,11,10,8,12,11,13,12,14,9,9,11,12,14,12,10,11,12,11,13,14,13,11,9,12,14,14,12,12,12,13,13,12,14,7,10,12,7,11,12,10,2,3,3,3,1,2,2,1,1,1,3
"1678",49046529,"Théo De Percin","2/2/2001 (22 years old)","GK","AJ Auxerre","Ligue 2 BKT","MTQ","Yes","3/17/2021","6/30/2024","$35K - $100K","Right","Reasonable","Very Strong","6'1""","178 lbs","-","-",90,126,3,3,3,3,1,4,1,3,1,2,9,3,2,1,10,9,15,7,9,13,13,2,12,1,7,8,7,7,13,14,8,11,15,11,4,6,12,15,12,12,11,10,15,6,9,2,15,12,8,8,5,13,11,8,13,13,11,9,8,13
"1679",2000158497,"Ibrahim Sesay","10/18/2004 (18 years old)","GK","Bo Rangers","Sierra Leonean Premier Division","SLE","No","7/1/2021","6/30/2024","$1.5K - $4K","Right","Fairly Strong","Very Strong","6'2""","160 lbs","-","-",80,112,3,2,3,2,3,7,1,1,3,3,9,1,1,7,9,9,10,5,11,14,7,2,7,3,9,8,7,6,9,10,6,10,15,9,1,4,11,17,12,13,9,11,8,13,10,1,10,10,17,11,11,14,7,12,14,11,5,7,13,8
"1680",48036808,"Patrick Burner","4/11/1996 (27 years old)","D/WB/M/AM (R)","Nîmes","French National","MTQ","Yes","9/25/2020","6/30/2024","$140K - $1.4M","Right","Weak","Very Strong","5'7""","143 lbs","140","1",110,125,8,13,10,6,13,9,7,10,10,10,12,10,13,12,10,12,12,10,12,11,12,10,7,12,10,13,11,13,13,14,12,5,13,13,13,7,15,14,10,13,10,10,5,10,12,5,11,13,11,1,3,2,4,2,2,2,4,2,1,3
"1681",49048564,"Samuel Renel","11/3/2001 (21 years old)","M (C), AM (RLC)","Niort","French National","MTQ","Yes","6/24/2021","6/30/2024","$210K - $2.1M","Right","Fairly Strong","Very Strong","5'10""","149 lbs","51","4",105,125,10,11,12,12,14,10,6,10,4,5,13,9,3,13,7,8,9,13,12,13,10,13,6,12,8,12,13,8,13,13,11,8,9,13,9,7,7,16,8,11,9,9,10,9,6,2,13,10,18,2,1,1,3,1,1,3,1,2,3,4
"1682",85084447,"Kévin Fortuné","8/6/1989 (33 years old)","AM (RL), ST (C)","US Orléans","French National","MTQ","Yes","7/1/2022","6/30/2024","$7K - $70K","Right Only","Weak","Very Strong","6'0""","180 lbs","330","85",105,124,10,10,13,12,12,12,10,11,5,5,11,10,6,13,10,11,14,12,12,11,15,12,8,12,5,12,11,12,12,12,13,11,15,12,12,13,12,15,13,12,13,12,2,13,8,6,11,14,12,1,3,2,2,3,2,2,4,2,3,1
"1683",48044394,"Yannis Clementia","7/5/1997 (25 years old)","GK","SM Caen","Ligue 2 BKT","MTQ","Yes","7/13/2022","6/30/2025","$35K - $325K","Right Only","Weak","Very Strong","6'2""","176 lbs","3","-",98,124,4,3,3,1,6,6,1,1,3,2,13,2,1,4,12,10,12,10,12,10,10,1,12,3,11,10,9,9,8,12,10,14,14,8,7,14,12,16,10,12,12,11,6,4,13,1,11,10,13,10,6,13,8,11,13,14,12,10,11,12
"1684",8448675,"Christopher Glombard","6/5/1989 (34 years old)","D (RC)","FC Bassin Arcachon","French Regional 1 - Nouvelle Aquitaine - Group C","MTQ","Yes","7/1/2021","-","$0","Right Only","Weak","Very Strong","5'10""","171 lbs","195","6",83,122,6,9,10,7,11,6,11,7,8,12,10,6,12,10,12,10,14,11,11,10,13,9,8,5,10,12,6,11,10,9,13,12,13,10,12,11,13,14,14,14,12,14,11,12,10,6,12,12,9,2,3,3,3,1,3,2,1,4,2,2
"1685",8437660,"Joan Hartock","2/17/1987 (36 years old)","GK","US Fougères","French National 3 - Group E","MTQ","Yes","7/1/2022","6/30/2024","$0 - $12K","Right Only","Weak","Very Strong","6'2""","182 lbs","128","-",80,121,4,1,1,1,7,8,7,2,3,2,7,3,1,7,8,10,12,10,12,9,11,5,9,1,11,11,6,8,9,11,11,12,13,9,11,12,1,15,15,13,9,14,8,11,8,6,12,12,10,10,13,10,13,11,10,9,14,11,11,12
"1686",85136806,"Brighton Labeau","1/1/1996 (27 years old)","AM (R), ST (C)","Lausanne","Swiss Super League","MTQ","Yes","6/30/2022","6/30/2025","$190K - $1.9M","Right","Fairly Strong","Very Strong","6'0""","187 lbs","149","49",114,120,6,7,10,13,11,7,11,11,3,5,11,10,4,11,8,12,11,12,11,13,11,11,7,13,8,12,11,13,13,10,15,12,11,13,13,15,5,10,11,10,12,10,5,7,7,5,11,11,8,3,1,1,3,1,1,3,1,1,2,3
"1687",49048744,"Yannick Etilé","3/8/2001 (22 years old)","GK","Blois Foot 41","French National 2 - B","MTQ","Yes","7/1/2022","6/30/2025","$14K - $140K","Right Only","Weak","Very Strong","6'4""","198 lbs","31","-",84,120,5,2,3,1,10,7,9,3,3,3,10,3,3,9,6,5,15,8,8,14,11,1,6,1,11,8,7,7,10,12,10,15,13,9,10,7,11,10,11,10,13,10,5,9,5,4,15,10,11,10,10,9,10,11,11,10,9,10,11,11
"1688",914342,"Steeve Elana","7/11/1980 (42 years old)","GK","Salon Bel Air","French Regional Divisions","MTQ","Yes","7/1/2022","-","$0","Right Only","Weak","Very Strong","6'2""","187 lbs","485","-",85,119,5,1,3,3,7,7,2,3,2,3,6,3,2,7,6,11,14,12,12,11,14,6,12,1,12,10,6,7,7,10,12,14,16,8,11,13,1,18,18,15,14,14,5,14,6,6,12,10,10,9,12,8,8,11,8,12,8,12,10,11
"1689",85046329,"Wesley Jobello","1/23/1994 (29 years old)","AM (L)","FC Argeş","Romanian Second League","MTQ","Yes","2/9/2023","6/30/2024","$500K - $1.5M","Right","Weak","Very Strong","6'0""","149 lbs","170","9",102,117,6,13,11,10,12,10,8,10,6,5,10,9,4,12,9,11,10,12,10,11,11,12,10,13,6,11,12,11,12,14,12,12,13,13,11,11,11,11,13,12,13,12,6,14,10,10,10,14,12,1,1,1,1,2,3,3,3,2,1,1
"1690",72011154,"Ibrahim Koroma","5/17/1989 (34 years old)","D (C), DM","ADAS United","Swedish Third Division Northeast Götaland","SLE","No","5/4/2023","11/30/2023","$0","Right Only","Weak","Very Strong","6'2""","174 lbs","215","18",60,110,6,6,7,6,9,7,11,8,7,9,9,6,9,9,13,9,13,8,8,8,9,5,8,5,9,7,8,7,7,6,13,15,12,8,10,13,5,12,15,15,10,13,6,7,13,9,10,8,13,1,3,1,1,2,2,3,2,3,1,3
"1691",34012768,"Steeven Langil","3/4/1988 (35 years old)","AM (RL)","Uthai Thani","Thai League","MTQ","Yes","1/5/2023","6/30/2024","$0","Right","Weak","Very Strong","5'10""","147 lbs","345","54",109,115,10,7,12,10,10,8,9,11,6,5,8,10,6,10,7,11,10,10,8,11,13,12,8,12,6,10,6,7,17,14,11,10,12,17,11,12,10,7,11,4,11,7,13,13,7,13,9,16,5,4,2,2,2,1,3,1,2,3,3,1
"1692",85055657,"Jonathan Rivierez","5/18/1989 (34 years old)","D (RC)","Bourg en B.","French National 2 - D","MTQ","Yes","7/26/2022","6/30/2024","$65K - $200K","Right","Weak","Very Strong","6'0""","180 lbs","329","4",108,115,5,12,11,5,10,6,13,7,8,12,9,7,14,11,13,13,15,13,11,10,12,10,7,9,12,13,10,14,12,12,13,10,13,12,14,14,10,14,14,14,10,15,6,8,13,5,12,12,16,1,1,4,1,1,1,2,1,1,3,3
"1693",49030791,"Cyril Mandouki","8/21/1991 (31 years old)","M (C)","Paris FC","Ligue 2 BKT","MTQ","Yes","4/4/2020","6/30/2024","$50K - $500K","Right Only","Weak","Very Strong","5'10""","167 lbs","315","18",110,115,10,7,10,7,11,11,8,7,4,13,13,9,12,11,14,12,14,11,13,12,14,8,12,10,12,14,10,15,12,13,14,11,15,13,15,14,14,16,10,12,10,12,6,7,10,1,12,13,14,1,2,2,2,3,1,1,4,2,2,2
"1694",50086027,"Mickaël Biron","8/26/1997 (25 years old)","AM (RL), ST (C)","RWD Molenbeek","Jupiler Pro League","MTQ","Yes","7/15/2022","6/30/2025","$230K - $2.3M","Right Only","Weak","Very Strong","5'7""","143 lbs","105","38",113,113,9,10,13,15,12,11,10,12,5,9,12,11,8,13,5,11,12,12,12,12,8,13,7,10,10,13,11,11,14,13,10,9,13,13,14,10,14,12,12,12,11,13,5,12,11,1,14,14,11,3,3,2,2,3,2,1,2,2,1,2
"1695",85007653,"Mathias Coureur","3/22/1988 (35 years old)","M (R), AM (RLC), ST (C)","Golden Lion","Martinican Trophee Gerard Janvion R1","MTQ","Yes","12/3/2022","6/30/2024","$0","Right","Reasonable","Very Strong","5'10""","149 lbs","353","88",90,110,10,9,12,13,11,10,9,10,6,3,10,9,6,12,6,13,7,11,13,11,13,13,11,13,7,9,11,8,9,10,11,8,11,9,7,9,8,9,10,14,11,13,9,13,6,10,13,12,10,3,1,3,1,2,3,3,1,2,3,3
"1696",85111783,"Rosario Latouchent","3/21/1996 (27 years old)","D/WB/M (L)","Kauno Žalgiris","Lithuanian A League","MTQ","Yes","2/13/2023","12/31/2023","$0","Right","Weak","Very Strong","5'11""","160 lbs","191","2",100,110,6,12,11,5,11,6,9,12,8,12,12,7,12,12,11,10,11,9,8,10,12,11,6,11,7,12,10,13,13,12,12,10,13,13,13,9,12,19,12,10,9,10,7,10,10,2,9,12,7,2,1,2,2,3,3,2,2,3,1,1
"1697",34007769,"Kevin Parsemain","2/13/1988 (35 years old)","ST (C)","Golden Lion","Martinican Trophee Gerard Janvion R1","MTQ","Yes","12/20/2019","6/30/2024","$3.5K - $12K","Right Only","Weak","Very Strong","5'10""","165 lbs","39","25",90,110,13,10,12,12,13,15,8,12,5,2,9,8,2,14,8,11,10,12,10,10,13,12,11,13,5,9,11,11,12,11,12,9,13,10,12,9,8,14,14,11,9,12,11,15,8,7,13,12,13,2,3,2,2,3,2,1,1,1,3,3
"1698",67282687,"Florent Poulolo","1/2/1997 (26 years old)","D (C)","Sigma Olomouc","Czech First Division","MTQ","Yes","9/9/2020","6/30/2025","$0","Right","Reasonable","Very Strong","6'2""","187 lbs","168","7",98,110,5,8,11,8,12,7,13,7,5,11,12,6,12,12,8,11,12,8,9,10,7,11,6,7,11,7,9,6,12,12,12,14,15,13,12,13,10,10,12,9,12,10,7,7,9,8,8,9,7,2,3,1,1,2,3,3,1,1,1,1
"1699",85091719,"Jonathan Mexique","3/10/1995 (28 years old)","DM, M (C)","Châteauroux","French National","MTQ","Yes","6/24/2021","6/30/2024","$28K - $275K","Left","Very Strong","Weak","5'9""","165 lbs","169","10",105,110,8,11,11,7,12,7,8,10,5,11,12,7,11,12,14,12,11,10,11,10,13,10,13,10,11,13,12,13,13,12,14,8,14,13,14,13,11,12,12,13,10,12,8,11,10,6,12,13,8,2,3,1,3,3,3,3,3,1,1,3
"1700",8439604,"Geoffrey Malfleury","1/20/1988 (35 years old)","M/AM (R), ST (C)","US Cap d'Ail","French Regional Divisions","MTQ","Yes","7/1/2021","-","$0","Right Only","Weak","Very Strong","5'6""","134 lbs","248","64",84,110,10,10,12,10,12,11,6,9,5,5,10,13,4,12,10,12,11,11,9,10,14,12,6,12,7,10,10,12,11,12,10,6,13,11,11,10,8,15,15,12,11,10,5,12,11,7,11,13,13,3,3,2,1,1,4,4,2,3,1,2
"1701",28081633,"Kevin Wright","12/28/1995 (27 years old)","D/WB/M (L)","Oakland","USSL Championship Western Conference","SLE","No","1/18/2023","11/30/2023","$170K - $500K","Left Only","Very Strong","Weak","5'7""","152 lbs","128","8",95,110,7,10,11,6,10,7,5,4,7,10,10,6,10,10,9,10,12,10,10,12,12,9,8,13,10,12,9,13,16,15,10,5,12,14,10,9,10,12,12,14,11,10,12,11,7,4,11,13,14,2,1,1,2,1,4,1,1,4,3,2
"1702",48043020,"Boris Moltenis","5/8/1999 (24 years old)","D (C)","Wisła Kraków","Polish First Division","MTQ","Yes","3/15/2023","6/30/2024","$0 - $65K","Right Only","Weak","Very Strong","6'0""","176 lbs","85","6",102,109,5,5,6,7,9,6,13,6,8,12,11,10,11,10,13,12,14,10,11,12,13,7,11,7,12,12,8,12,11,11,12,13,13,13,13,12,7,11,13,12,11,12,7,12,8,8,11,12,15,2,1,1,1,1,2,1,1,2,1,3
"1703",73201939,"Karl Fabien","8/1/2000 (22 years old)","AM (L)","Vierzon FC","French National 3 - Group C","MTQ","Yes","7/1/2022","6/30/2024","$6K - $65K","Left","Very Strong","Reasonable","6'2""","167 lbs","34","5",85,108,7,12,9,9,13,6,5,4,6,6,7,4,7,9,12,7,8,9,7,10,11,9,8,5,6,7,9,12,13,13,7,7,11,13,12,4,12,13,11,10,11,12,5,4,5,3,14,12,15,3,1,2,2,3,2,2,1,2,3,3
"1704",152596,"William Sery","3/20/1988 (35 years old)","D (C)","FC Fleury 91","French National 2 - D","MTQ","Yes","6/10/2019","6/30/2024","$0 - $26K","Right Only","Weak","Very Strong","6'0""","180 lbs","335","13",91,106,5,6,6,5,8,6,12,7,7,12,9,6,12,8,14,12,14,10,12,11,14,5,12,7,11,12,10,14,11,9,14,11,13,11,12,12,8,8,8,10,8,12,7,13,14,6,12,12,13,1,2,1,2,3,2,2,4,2,2,3
"1705",85098694,"Thomas Ephestion","6/9/1995 (28 years old)","M (C)","Mezőkövesd","Hungarian Division I","MTQ","Yes","1/26/2023","6/30/2025","$80K - $800K","Left","Very Strong","Reasonable","6'2""","191 lbs","123","7",101,106,6,10,10,7,11,6,10,9,5,10,12,6,12,12,8,11,5,11,8,10,10,9,6,8,11,12,10,12,13,12,15,15,13,13,13,14,12,14,14,10,10,12,9,12,15,6,11,11,14,1,1,3,3,1,2,3,1,3,2,2
"1706",49038416,"Andy Cizo","3/2/2000 (23 years old)","D (C)","Develier","Swiss Lower Division","MTQ","Yes","2/1/2022","-","$0","Right Only","Weak","Very Strong","6'2""","182 lbs","21","-",70,105,1,2,2,3,8,1,11,5,4,14,6,2,13,8,15,13,12,8,9,9,6,5,1,7,8,7,1,8,13,11,8,11,10,10,11,11,12,11,11,7,11,11,7,11,13,12,13,9,16,1,3,1,2,2,1,4,2,2,2,2
"1707",2000096534,"Jonathan Audinay","5/19/2003 (20 years old)","GK","AS Samaritaine","Martinican Trophee Gerard Janvion R1","MTQ","Yes","7/1/2018","6/30/2026","$0 - $70K","Right","Fairly Strong","Very Strong","6'5""","182 lbs","-","-",77,103,4,3,2,1,2,7,1,1,3,3,9,3,2,5,5,8,12,5,9,13,8,3,13,1,9,7,5,5,12,13,2,13,15,8,1,7,12,19,12,12,9,10,7,11,11,5,19,10,10,7,5,13,10,9,6,13,5,6,12,9
"1708",2000015770,"Killian Polomat","2/23/2001 (22 years old)","ST (C)","Club Franciscain","Martinican Trophee Gerard Janvion R1","MTQ","Yes","7/1/2020","6/30/2025","$0 - $110K","Right","Reasonable","Very Strong","5'9""","165 lbs","20","16",84,103,8,7,14,15,8,8,15,9,7,8,9,5,5,8,15,8,5,11,9,12,7,8,14,11,9,8,9,9,10,9,9,7,15,10,9,10,11,16,10,12,12,12,5,12,11,5,12,11,12,2,3,2,1,2,3,3,1,3,1,1
"1709",48047549,"Ronny Labonne","9/14/1997 (25 years old)","D/WB (R), M (RC), AM (R)","Nîmes","French National","MTQ","Yes","7/1/2022","6/30/2025","$200K - $600K","Right","Weak","Very Strong","5'11""","167 lbs","60","2",97,102,8,9,10,13,11,8,10,5,1,9,12,3,10,10,8,8,9,10,10,11,2,9,5,11,10,13,12,10,12,12,12,10,11,11,14,11,13,20,10,12,13,10,12,10,8,3,12,11,7,1,1,3,2,3,2,2,1,2,1,3
"1710",50077171,"Jianinn Berenice","11/30/1998 (24 years old)","D/WB (L)","US Saint-Malo","French National 2 - C","MTQ","Yes","7/1/2022","6/30/2024","$5K - $50K","Left Only","Very Strong","Weak","5'6""","127 lbs","96","1",85,100,6,8,6,7,10,2,4,1,6,10,8,4,12,10,7,10,7,8,10,15,1,7,13,8,12,9,7,8,13,14,7,4,10,13,13,5,14,10,11,11,10,12,8,11,5,8,12,12,13,3,2,2,3,2,4,3,1,1,3,3
"1711",34009072,"Yoann Arquin","4/15/1988 (35 years old)","AM (RL), ST (C)","Enna","Italian Eccellenza Sicilia Grp.B","MTQ","Yes","6/12/2023","6/30/2024","$0","Right Only","Weak","Very Strong","6'2""","169 lbs","284","59",59,100,4,7,9,9,8,6,9,6,4,5,7,11,5,10,9,8,10,8,6,9,11,14,4,8,6,10,7,9,10,8,11,12,13,10,9,12,13,5,7,9,10,5,6,5,10,14,8,8,13,1,2,1,1,1,1,2,2,4,1,3
"1712",2000088105,"Mohamed Kamara","4/29/1999 (24 years old)","GK","Horoya AC","Guinean Premier Division","SLE","No","5/22/2022","6/30/2024","$9K - $28K","Right Only","Weak","Very Strong","6'2""","171 lbs","-","-",93,110,3,1,1,2,7,8,1,3,1,2,12,1,3,4,8,9,13,9,12,14,4,3,9,2,12,9,4,8,11,11,9,8,12,12,3,6,12,14,12,12,10,12,11,15,8,3,20,15,18,6,13,14,11,8,11,8,5,11,10,12
"1713",2000096545,"Mathis Priam","2/9/2002 (21 years old)","ST (C)","AS Samaritaine","Martinican Trophee Gerard Janvion R1","MTQ","Yes","7/1/2019","6/30/2025","$35K - $110K","Right","Reasonable","Very Strong","5'9""","143 lbs","-","-",81,100,5,5,13,13,13,6,9,7,1,5,8,10,2,8,10,7,8,12,7,13,15,14,12,11,6,7,6,5,13,14,8,7,14,13,11,5,13,17,11,13,12,12,11,6,6,4,10,13,15,4,2,1,1,3,3,2,2,1,1,3
"1714",49036408,"Florian Lapis","8/8/1993 (29 years old)","D/WB (L)","FC Versailles 78","French National","MTQ","Yes","7/1/2022","6/30/2024","$24K - $240K","Left","Very Strong","Reasonable","6'0""","171 lbs","123","2",94,100,7,9,10,7,8,5,10,5,12,10,11,7,11,11,11,10,13,10,8,9,11,10,5,11,7,12,13,13,13,11,13,10,12,13,13,12,10,10,12,10,11,10,12,8,8,1,11,11,14,1,2,4,2,2,1,1,3,2,1,1
"1715",2000096546,"Florian Goma","1/21/2001 (22 years old)","D (C)","AS Samaritaine","Martinican Trophee Gerard Janvion R1","MTQ","Yes","7/1/2019","6/30/2025","$0 - $90K","Right","Reasonable","Very Strong","6'1""","149 lbs","-","-",83,98,3,1,5,2,7,1,12,2,4,14,8,3,14,4,12,13,9,7,11,12,9,5,1,7,14,7,1,8,13,10,8,8,13,11,6,7,17,13,8,13,13,12,13,9,12,3,12,12,7,2,1,3,3,2,3,3,1,4,2,2
"1716",82084361,"Thierry Catherine","8/2/1997 (25 years old)","D/WB/M/AM (L)","Golden Lion","Martinican Trophee Gerard Janvion R1","MTQ","Yes","7/1/2021","6/30/2025","$20K - $60K","Left Only","Very Strong","Weak","5'11""","145 lbs","-","-",75,98,6,9,6,9,7,6,6,6,6,7,8,3,8,7,9,10,8,8,8,10,1,7,2,10,8,7,6,8,13,13,10,9,14,13,6,10,14,10,12,12,8,12,9,14,12,8,9,11,10,2,1,4,2,3,2,1,1,2,1,2
"1717",2000205811,"Jérémy Sebas","4/14/2003 (20 years old)","ST (C)","Strasbourg","French National 3 - Group I","MTQ","Yes","6/1/2022","6/30/2027","$18K - $190K","Right","Reasonable","Very Strong","5'9""","158 lbs","-","-",80,97,7,4,12,10,11,8,15,9,2,6,9,6,4,10,10,10,6,10,7,11,14,15,8,9,9,8,9,9,12,12,9,8,12,12,8,11,11,11,11,13,13,10,8,8,10,5,15,12,16,1,3,1,3,3,2,2,1,1,1,1
"1718",82078269,"Christophe Jougon","7/10/1995 (27 years old)","DM, M/AM (RC)","Club Franciscain","Martinican Trophee Gerard Janvion R1","MTQ","Yes","6/15/2020","6/30/2025","$35K - $110K","Right","Reasonable","Very Strong","6'2""","185 lbs","-","-",88,96,5,7,9,7,12,8,10,9,5,9,11,6,9,10,14,11,15,10,10,9,5,9,14,9,10,11,9,14,11,11,12,13,11,11,13,12,15,7,11,12,13,13,6,12,12,6,10,11,12,3,1,3,2,2,1,1,3,1,1,1
"1719",2000232076,"Matis Adon","10/5/2000 (22 years old)","M (C)","Amiens SC","Ligue 2 BKT","MTQ","Yes","7/1/2022","6/30/2024","$0 - $35K","Right","Reasonable","Very Strong","6'0""","160 lbs","2","-",72,95,4,6,7,9,12,6,12,9,3,8,10,1,8,12,15,10,2,4,9,14,10,5,10,9,10,6,9,11,13,12,8,12,14,12,9,5,10,11,9,13,10,12,14,7,13,5,10,11,14,3,2,1,1,2,1,1,1,1,2,1
"1720",85102117,"Audrick Linord","4/17/1987 (36 years old)","D/WB (R)","Club Colonial","Martinican Trophee Gerard Janvion R1","MTQ","Yes","6/14/2021","-","$0","Right Only","Weak","Very Strong","6'0""","158 lbs","113","2",70,95,8,9,7,3,6,4,9,2,8,10,9,3,9,10,7,12,9,8,13,15,14,5,6,8,9,9,9,9,8,11,13,11,14,12,10,11,11,15,11,10,11,13,9,2,13,5,11,8,7,1,1,3,3,1,1,1,1,2,2,4
"1721",82078339,"Grégory Pastel","9/18/1990 (32 years old)","M (R), AM (RC)","RC Rivière-Pilote","Martinican Régionale 2 Groupe A","MTQ","Yes","6/14/2021","6/30/2024","$1.5K - $16K","Right","Reasonable","Very Strong","5'11""","165 lbs","38","9",87,95,5,8,11,7,10,7,10,11,5,4,8,10,2,12,7,8,9,8,8,8,10,11,5,11,3,8,7,6,15,11,13,10,14,14,12,13,14,15,15,11,14,10,7,13,7,6,12,12,14,1,2,2,1,4,2,3,1,2,4,3
"1722",49037545,"Jérémy Bellune","6/16/1999 (23 years old)","DM","CA Neuville","French Regional 1 - Nouvelle Aquitaine - Group A","MTQ","Yes","7/1/2022","-","$0","Right","Fairly Strong","Very Strong","6'3""","191 lbs","13","-",70,95,6,7,8,7,9,8,13,6,7,10,11,7,13,9,13,9,16,9,7,7,6,5,12,8,10,11,8,13,9,7,11,13,11,8,11,12,8,10,11,12,9,9,11,9,11,5,8,9,10,3,4,3,1,2,1,2,3,3,3,3
"1723",17025592,"Andrey Solovey","12/13/1994 (28 years old)","ST (C)","Aqsý","Kazakhstan Premier League","BLR","No","1/13/2022","12/31/2024","$14K - $130K","Right","Reasonable","Very Strong","5'9""","147 lbs","161","68",95,110,4,4,8,12,12,8,8,6,6,4,8,12,6,12,9,12,9,12,6,10,16,10,9,14,8,8,8,12,14,13,8,8,14,14,12,6,10,8,14,13,11,8,9,8,9,8,10,6,14,1,1,1,3,1,3,1,3,2,1,3
"1724",93081650,"Jonathan Morsay","10/5/1997 (25 years old)","M/AM (RL)","Panetolikos","Greek Super League 1","SLE","Yes","8/6/2021","6/30/2024","$24K - $240K","Right","Weak","Very Strong","5'10""","169 lbs","146","12",95,110,8,10,12,9,12,6,5,10,5,5,9,8,5,13,7,8,8,9,8,8,11,9,6,11,5,7,8,8,15,13,9,7,13,14,12,9,14,9,10,11,10,10,6,7,6,7,9,12,15,3,1,3,2,2,2,2,1,3,1,2
"1725",85007501,"Ludovic Pancrate","2/23/1987 (36 years old)","AM (R), ST (C)","US Fontenay","French Regional Divisions","MTQ","Yes","7/1/2021","-","$0","Right","Weak","Very Strong","6'1""","171 lbs","237","51",94,94,5,10,11,11,12,8,10,12,5,5,9,10,6,11,7,11,8,11,12,11,9,12,5,11,9,10,12,11,11,11,12,12,10,12,12,12,8,14,14,14,10,11,6,12,7,6,12,11,19,3,3,3,2,1,1,2,1,3,1,3
"1726",82078244,"Stéphane Abaul","11/23/1991 (31 years old)","DM, M/AM (C), ST (C)","Club Franciscain","Martinican Trophee Gerard Janvion R1","MTQ","Yes","6/14/2021","6/30/2025","Not for Sale","Right Only","Weak","Very Strong","5'10""","191 lbs","-","-",82,94,5,8,10,8,10,9,8,11,1,4,11,6,7,11,16,10,13,12,9,11,15,15,11,10,4,9,11,12,10,11,11,9,12,9,10,11,16,20,13,12,13,13,5,16,8,5,20,12,7,3,1,1,2,2,3,3,2,1,3,1
"1727",8449437,"Yoan Pivaty","1/29/1990 (33 years old)","M (C)","SO Romorantin","French National 2 - B","MTQ","Yes","7/1/2022","6/30/2023","$0","Left Only","Very Strong","Weak","5'11""","174 lbs","236","17",84,93,7,11,12,7,11,7,8,7,7,5,8,10,5,13,9,10,11,9,9,10,12,12,10,10,5,10,10,11,14,12,12,9,12,12,13,11,16,14,14,11,9,13,10,13,9,8,11,12,13,3,3,2,3,1,2,3,1,3,3,3
"1728",50063898,"Geoffrey Marie-Louise","1/16/1992 (31 years old)","D (C)","Blois Foot 41","French National 2 - B","MTQ","Yes","7/1/2022","6/30/2024","$16K - $160K","Right Only","Weak","Very Strong","6'6""","238 lbs","106","7",86,92,6,7,8,5,9,6,16,6,6,12,10,7,10,9,10,10,10,11,10,10,10,10,9,10,10,9,8,9,8,9,12,16,11,8,11,13,11,18,11,12,11,13,4,10,11,8,10,13,13,1,1,2,3,1,3,3,3,2,3,1
"1729",50053154,"Lory Balustre","8/25/1995 (27 years old)","M (L)","US Roye Noyon","French Regional 1 - Hauts de France - Group A","MTQ","Yes","7/1/2019","-","$0","Left Only","Very Strong","Weak","6'2""","171 lbs","37","-",77,92,7,12,8,5,10,7,6,6,5,7,10,2,4,14,8,10,8,9,8,8,18,9,9,9,7,8,9,13,14,10,8,13,5,13,14,5,14,20,10,10,12,14,12,7,14,5,9,11,18,1,3,2,2,1,3,2,2,3,1,2
"1730",82078202,"Yordan Thimon","9/19/1996 (26 years old)","D/WB/M/AM (L)","Club Franciscain","Martinican Trophee Gerard Janvion R1","MTQ","Yes","6/15/2020","6/30/2025","$0 - $80K","Left","Very Strong","Fairly Strong","5'9""","145 lbs","-","-",83,92,6,11,8,9,9,6,6,4,4,7,9,3,8,8,10,6,8,7,8,9,14,8,11,9,8,7,5,8,12,13,7,6,15,13,13,5,11,20,10,9,10,11,11,2,9,1,16,11,11,1,3,1,2,2,3,3,2,2,3,4
"1731",85057004,"Jérôme Roussillon","1/6/1993 (30 years old)","D/WB (L)","Union Berlin","Bundesliga","GLP","Yes","1/12/2023","6/30/2025","$900K - $9.6M","Left","Very Strong","Reasonable","5'8""","180 lbs","264","12",131,140,6,13,13,8,12,6,8,9,12,11,12,7,12,13,13,12,14,11,11,11,13,13,10,14,11,12,11,12,16,12,14,7,13,16,14,13,9,15,15,13,12,12,10,14,10,10,12,13,11,2,3,2,3,3,1,2,4,1,2,2
"1732",85045661,"Dimitri Foulquier","3/23/1993 (30 years old)","D (RL), WB (R)","Valencia","Spanish First Division","GLP","Yes","8/30/2021","6/30/2025","$4.8M - $9.2M","Right","Reasonable","Very Strong","6'0""","169 lbs","273","5",130,138,9,13,11,9,11,6,9,9,11,13,9,7,12,11,11,12,14,13,13,13,14,10,7,13,13,12,10,13,15,13,14,11,15,15,14,14,16,15,15,14,10,13,7,13,10,5,13,13,12,2,1,1,2,3,3,3,1,1,1,3
"1733",34011705,"Claudio Beauvue","4/16/1988 (35 years old)","AM (RL), ST (C)","US Ivry Football","French National 3 - Group H","GLP","Yes","2/1/2023","6/30/2024","$12K - $40K","Right","Weak","Very Strong","5'9""","145 lbs","402","77",94,136,6,11,13,10,12,11,12,10,6,5,11,12,5,13,8,13,10,12,11,9,12,12,7,13,8,10,8,12,10,11,10,12,10,10,10,10,8,13,13,12,10,12,9,14,8,12,10,12,12,1,1,1,2,3,2,1,2,2,3,4
"1734",43207127,"Andreaw Gravillon","2/8/1998 (25 years old)","D (C)","Torino","Italian Serie A","GLP","Yes","1/1/2022","6/30/2025","$275K - $2.7M","Right Only","Weak","Very Strong","6'2""","165 lbs","141","4",124,135,6,6,10,6,11,5,14,9,5,14,12,10,13,12,13,12,15,12,12,13,14,6,13,9,14,13,9,12,13,13,14,13,16,13,15,14,10,8,12,12,11,10,2,13,7,10,13,12,11,1,2,2,3,1,3,3,2,3,1,1
"1735",28127310,"Kallum Cesay","9/4/2002 (20 years old)","D (R), DM, M (C)","Tottenham","English Premier Division","SLE","No","6/13/2022","6/30/2028","$35K - $350K","Right","Reasonable","Very Strong","6'0""","156 lbs","-","-",85,110,9,11,10,9,11,9,10,11,8,11,11,4,9,16,7,7,9,7,6,6,4,5,9,10,11,10,10,12,16,6,8,13,13,14,14,7,11,17,11,11,12,10,7,5,10,5,10,9,20,2,2,1,3,2,2,3,1,2,4,3
"1736",49037709,"Matthias Phaëton","1/8/2000 (23 years old)","AM (LC), ST (C)","Grenoble","Ligue 2 BKT","GLP","Yes","7/1/2022","6/30/2026","$2.1M - $4.4M","Right","Reasonable","Very Strong","6'0""","171 lbs","95","13",112,127,7,9,13,11,12,8,9,10,4,5,11,12,3,13,7,10,8,11,8,9,13,14,6,10,7,7,10,9,15,15,13,9,15,14,11,14,11,10,9,8,10,13,7,13,6,12,12,15,12,2,2,1,3,1,1,1,2,2,2,1
"1737",48042315,"Davy Rouyard","8/17/1999 (23 years old)","GK","Bordeaux","Ligue 2 BKT","GLP","Yes","6/1/2021","6/30/2025","$28K - $275K","Right","Reasonable","Very Strong","6'4""","198 lbs","-","-",95,125,4,2,3,1,1,5,1,1,3,3,8,1,3,6,9,11,11,7,12,8,13,1,11,3,14,9,8,6,6,13,6,16,11,7,5,16,10,18,12,10,12,12,5,13,8,1,10,11,16,10,13,14,14,11,10,14,5,12,8,14
"1738",8442419,"Loïc Nestor","5/20/1989 (34 years old)","D (C)","Grenoble","Ligue 2 BKT","GLP","Yes","1/18/2023","6/30/2024","$12K - $110K","Right","Weak","Very Strong","5'10""","154 lbs","414","19",107,125,4,7,9,8,11,6,13,8,8,12,11,6,13,11,11,13,13,13,11,11,15,7,12,10,12,14,10,13,10,12,14,11,13,11,11,14,13,15,15,14,13,14,9,14,11,6,12,13,10,3,1,4,3,3,3,3,2,1,1,1
"1739",913561,"Mickaël Tacalfred","4/23/1981 (42 years old)","D (C)","Reims Sainte Anne","French National 3 - Group I","GLP","Yes","7/1/2021","6/30/2024","$8K - $26K","Right Only","Weak","Very Strong","5'9""","152 lbs","594","12",90,124,6,10,8,6,10,8,13,7,9,12,11,6,12,10,15,12,15,12,12,11,14,7,13,9,12,12,8,13,8,12,13,10,13,10,12,12,8,14,12,14,12,15,7,13,11,6,12,12,15,3,3,1,3,3,3,1,1,2,1,3
"1740",2000091727,"Taïryk Arconte","11/12/2003 (19 years old)","AM (R), ST (C)","Brest","French Regional 1 - Bretagne - Group A","GLP","Yes","9/1/2022","6/30/2026","$22K - $220K","Right Only","Weak","Very Strong","5'11""","167 lbs","26","2",92,124,8,10,11,10,13,4,10,8,5,8,13,5,2,13,9,12,7,11,6,11,7,12,10,13,6,8,8,10,12,13,10,10,12,12,11,12,11,15,11,10,10,10,8,2,6,2,10,11,15,2,3,3,4,1,1,3,3,1,3,2
"1741",49041397,"Tommy Plumain","1/12/2001 (22 years old)","GK","Châteauroux","French National","GLP","Yes","7/1/2019","6/30/2024","$40K - $120K","Right","Fairly Strong","Very Strong","6'5""","185 lbs","13","-",85,121,5,1,3,1,6,7,1,3,3,2,8,3,1,5,9,8,11,7,8,13,12,1,5,3,7,7,6,5,9,11,3,13,12,10,1,6,11,14,12,14,11,12,6,18,7,6,13,8,14,9,10,11,9,9,13,13,5,8,12,13
"1742",85128191,"Dimitri Cavaré","2/5/1995 (28 years old)","D (RC)","Sion","Swiss Challenge League","GLP","Yes","1/6/2022","6/30/2025","$0","Right","Weak","Very Strong","6'1""","205 lbs","156","10",113,120,7,11,10,6,11,7,12,6,15,11,10,7,13,11,14,12,14,13,10,11,14,11,8,12,11,12,11,14,13,12,14,12,12,15,12,15,12,8,10,11,11,11,13,12,11,12,11,12,15,2,4,2,1,3,1,3,2,1,3,3
"1743",8432559,"Yohann Thuram","10/31/1988 (34 years old)","GK","QRM","Ligue 2 BKT","GLP","Yes","8/2/2022","6/30/2024","$10K - $100K","Right Only","Weak","Very Strong","6'2""","187 lbs","217","-",104,120,5,1,1,3,8,7,3,2,2,1,8,3,3,8,8,12,14,11,12,10,14,6,13,3,11,12,8,6,12,12,14,14,15,11,12,15,1,16,16,15,10,15,8,14,8,6,11,14,8,10,13,13,17,11,11,11,8,11,10,11
"1744",34011525,"Cédric Avinel","9/11/1986 (36 years old)","D (C)","AC Ajaccio","Ligue 2 BKT","GLP","Yes","6/30/2022","6/30/2024","$110K - $325K","Right Only","Weak","Very Strong","6'2""","187 lbs","434","15",115,119,4,6,8,6,10,6,13,7,5,14,11,7,12,10,13,12,15,11,13,12,14,5,12,8,12,13,7,14,12,11,15,13,15,13,14,15,10,14,14,12,12,14,6,14,7,5,11,14,10,2,1,1,3,1,3,3,3,3,1,1
"1745",2000108577,"Kenny Mixtur","10/9/2003 (19 years old)","AM (RL)","Havre AC","French National 3 - Group F","GLP","Yes","7/1/2019","6/30/2027","$45K - $130K","Right Only","Weak","Very Strong","6'1""","167 lbs","-","-",69,119,8,11,13,13,12,5,6,7,6,4,12,4,7,10,14,6,7,4,6,13,2,13,5,6,6,7,8,8,14,13,3,9,11,12,5,6,10,13,10,11,11,9,9,6,6,7,9,11,15,2,2,1,1,3,2,3,2,3,1,2
"1746",53031996,"Alfred Sankoh","10/22/1988 (34 years old)","DM, M (C)","Steinberg","Norwegian Lower Division","SLE","No","2/1/2023","-","$0","Right","Strong","Very Strong","5'9""","156 lbs","264","19",75,110,6,8,11,7,11,3,7,5,3,11,9,6,13,10,15,11,12,9,6,6,8,6,6,9,10,12,7,12,10,12,14,9,14,9,10,11,10,11,3,5,12,2,13,13,15,15,10,8,8,2,1,1,3,4,1,1,3,1,3,2
"1747",85052147,"Mickaël Alphonse","7/12/1989 (33 years old)","D/WB (R)","AC Ajaccio","Ligue 2 BKT","GLP","Yes","7/1/2022","6/30/2024","$24K - $240K","Right","Weak","Very Strong","6'0""","165 lbs","375","20",115,117,4,12,11,6,12,7,11,8,12,11,10,7,12,10,10,12,12,11,11,11,13,9,12,13,12,11,11,12,15,12,13,11,13,13,14,12,10,15,15,13,14,13,9,11,10,6,11,14,9,2,2,1,3,2,1,2,1,3,1,2
"1748",49047410,"Luther Archimède","9/17/1999 (23 years old)","M/AM (R), ST (C)","Sacramento","USSL Championship Western Conference","GLP","Yes","12/15/2021","11/30/2023","$95K - $950K","Right","Reasonable","Very Strong","6'2""","176 lbs","70","13",90,117,8,10,11,11,11,7,8,8,7,6,11,7,5,12,8,10,8,8,8,8,9,10,6,12,8,9,10,9,12,11,10,14,13,14,8,13,10,17,13,13,13,11,8,10,10,4,8,13,19,1,3,3,2,1,2,1,2,3,2,3
"1749",8428657,"Thomas Gamiette","6/21/1986 (36 years old)","DM, M (C)","FC Fleury 91","French National 2 - D","GLP","Yes","7/1/2022","6/30/2024","$8K - $24K","Right","Weak","Very Strong","5'9""","145 lbs","395","13",91,115,8,10,11,6,12,9,7,10,7,9,12,11,10,12,9,11,11,11,11,10,13,11,11,9,11,11,11,12,10,12,12,9,12,11,12,11,14,14,14,11,10,10,10,13,12,8,12,10,10,2,3,3,2,1,1,2,1,3,2,2
"1750",8440985,"David Fleurival","2/19/1984 (39 years old)","DM, M (C)","Forward-Morges","Swiss Lower Division","GLP","Yes","8/30/2022","6/30/2024","$4.5K - $14K","Right Only","Weak","Very Strong","6'0""","185 lbs","447","18",82,115,6,8,9,6,13,10,12,9,6,11,13,8,10,13,14,13,14,12,12,11,13,8,13,8,12,12,11,12,7,8,14,11,13,8,8,14,10,13,12,15,12,14,8,14,14,7,13,14,12,3,1,3,2,3,1,1,1,2,2,1
"1751",85134033,"Jordan Tell","6/10/1997 (26 years old)","AM (R), ST (C)","Grenoble","Ligue 2 BKT","GLP","Yes","1/31/2022","6/30/2025","$700K - $1.5M","Right","Weak","Very Strong","6'1""","163 lbs","137","19",109,115,6,10,12,12,12,7,13,11,6,6,12,12,6,12,9,11,13,11,12,11,10,8,7,12,8,12,11,13,13,12,14,12,14,13,12,13,10,10,14,12,10,9,10,10,6,10,12,12,10,2,3,3,3,1,2,2,2,2,1,3
"1752",85116737,"Thierry Ambrose","3/28/1997 (26 years old)","AM (R), ST (C)","Oostende","Belgian Challenger Pro League","GLP","Yes","7/24/2021","6/30/2024","$0","Right","Weak","Very Strong","5'10""","165 lbs","164","27",115,115,4,6,12,13,12,7,13,11,5,4,10,14,4,13,7,13,13,12,10,10,15,14,9,14,12,12,12,14,14,11,12,13,14,12,12,14,10,10,10,12,12,12,10,11,7,5,12,14,13,3,4,2,2,3,3,1,1,2,3,1
"1753",49046217,"Nathanael Saintini","5/30/2000 (23 years old)","D (C)","Sion","Swiss Challenge League","GLP","Yes","7/4/2022","6/30/2025","$140K - $425K","Right","Fairly Strong","Very Strong","6'2""","187 lbs","95","1",96,115,5,5,8,5,9,5,11,6,7,11,10,6,10,9,12,11,13,10,9,11,5,8,9,7,11,10,10,11,12,10,11,13,14,12,12,13,7,14,9,13,12,13,4,11,8,7,12,10,16,2,2,3,1,3,2,1,1,1,2,4
"1754",85058781,"Jérémy Cordoval","1/12/1990 (33 years old)","D/WB (RL)","Hyères 83 FC","French National 2 - A","GLP","Yes","7/1/2022","6/30/2024","$45K - $130K","Right Only","Weak","Very Strong","5'7""","134 lbs","340","2",98,111,7,11,11,5,12,6,6,7,10,12,12,6,12,13,11,11,10,12,12,11,13,7,5,8,11,13,9,13,13,12,10,6,15,13,14,8,10,16,16,14,14,13,7,13,8,6,12,13,10,3,1,2,3,1,3,1,1,2,3,3
"1755",29114914,"Nicolas Saint-Ruf","10/24/1992 (30 years old)","D (C)","US Orléans","French National","GLP","Yes","5/30/2022","6/30/2024","$85K - $850K","Right","Reasonable","Very Strong","6'1""","180 lbs","195","10",106,110,4,9,8,7,11,6,13,7,8,13,11,6,11,11,13,12,14,11,12,10,12,7,12,8,11,13,10,14,10,12,15,11,12,12,13,14,10,15,15,12,10,14,13,1,13,6,12,12,15,3,2,1,1,1,1,2,3,4,3,1
"1756",49047421,"Teddy Bartouche","6/5/1997 (26 years old)","GK","FC Lorient","Ligue 1 Uber Eats","GLP","Yes","6/15/2020","6/30/2025","$40K - $120K","Right Only","Weak","Very Strong","5'10""","154 lbs","-","-",90,110,3,1,1,3,1,4,1,2,3,2,7,2,1,2,12,11,10,6,13,13,12,2,3,3,13,8,7,7,11,13,11,8,12,10,7,10,11,10,15,15,13,13,6,10,7,6,12,11,19,6,5,11,12,8,8,11,11,11,12,9
"1757",29110870,"Amadou Bakayoko","1/1/1996 (27 years old)","ST (C)","Forest Green","Sky Bet League Two","SLE","Yes","1/12/2023","6/30/2024","$24K - $240K","Left","Very Strong","Reasonable","6'4""","187 lbs","250","36",101,110,5,8,9,10,10,7,12,8,1,4,9,14,5,9,13,13,13,10,11,9,11,9,10,12,8,15,10,14,11,11,9,13,14,11,13,16,9,12,14,12,11,10,8,10,6,5,10,9,15,2,2,2,3,3,3,2,2,3,3,2
"1758",34006509,"Livio Nabab","6/14/1988 (34 years old)","AM (R), ST (C)","US Granville","French National 2 - C","GLP","Yes","8/21/2020","6/30/2024","$14K - $40K","Right","Weak","Very Strong","6'1""","158 lbs","309","41",95,107,5,8,10,11,10,8,12,12,7,4,9,11,3,10,10,10,13,12,8,8,14,12,10,13,5,11,8,14,12,13,14,12,14,13,12,12,8,10,10,10,12,14,10,13,11,8,10,12,14,3,1,3,2,1,4,3,2,2,2,1
"1759",85116757,"Kelly Irep","9/1/1995 (27 years old)","D/WB (L)","US Raon-l'Etape","French National 3 - Group I","GLP","Yes","7/1/2022","6/30/2023","$5K - $16K","Left Only","Very Strong","Weak","6'0""","176 lbs","138","3",94,106,8,11,10,5,9,7,11,8,10,11,10,8,12,10,13,10,11,12,10,9,11,11,6,9,10,11,9,14,13,10,13,11,14,14,12,14,8,10,11,10,12,10,7,11,5,8,11,12,12,1,1,2,4,2,1,2,2,1,2,3
"1760",85057783,"Florian David","11/16/1992 (30 years old)","ST (C)","Kauno Žalgiris","Lithuanian A League","GLP","Yes","1/31/2023","12/31/2023","$14K - $150K","Right Only","Weak","Very Strong","5'11""","147 lbs","178","40",100,106,9,8,12,12,12,13,9,13,6,5,12,10,5,13,8,11,10,12,11,12,4,13,6,13,7,13,13,12,14,10,13,10,14,12,13,12,10,14,14,14,9,15,6,1,8,7,17,12,18,3,2,3,1,1,3,4,4,1,3,2
"1761",85128085,"Geoffray Durbant","5/19/1992 (31 years old)","ST (C)","Laval MFC","Ligue 2 BKT","GLP","Yes","7/1/2021","6/30/2025","$250K - $750K","Right","Weak","Very Strong","6'0""","167 lbs","268","96",102,105,5,7,11,13,12,7,13,8,6,7,10,11,7,12,12,11,11,11,11,11,14,12,10,11,6,13,11,12,12,12,13,12,15,12,13,12,8,13,9,15,10,8,7,12,11,6,12,10,12,2,3,3,3,3,1,3,1,1,2,1
"1762",85121416,"Jorris Romil","12/27/1994 (28 years old)","AM (L), ST (C)","Trélissac FC","French National 2 - B","GLP","Yes","9/22/2022","6/30/2024","$45K - $475K","Right","Weak","Very Strong","6'1""","165 lbs","151","26",95,104,6,8,11,8,12,7,13,8,6,6,10,13,6,12,7,10,8,10,11,10,11,9,12,13,7,12,10,12,12,10,14,11,13,12,11,12,10,14,12,12,10,11,5,13,8,7,11,12,10,3,1,1,3,3,3,3,1,2,2,1
"1763",49034880,"Anthony Baron","12/29/1992 (30 years old)","D (LC)","Servette","Swiss Super League","GLP","Yes","3/9/2023","6/30/2025","$22K - $220K","Left Only","Very Strong","Weak","5'11""","165 lbs","243","8",101,104,11,14,9,9,11,7,11,12,11,12,13,12,11,12,9,12,9,11,10,11,13,10,13,10,10,13,13,14,12,11,10,10,11,13,11,13,11,7,10,12,11,13,11,12,8,7,12,12,13,1,2,2,3,2,1,2,1,2,2,1
"1764",85093003,"Jordan Leborgne","9/29/1995 (27 years old)","D/WB (R), DM, M (C)","FC Versailles 78","French National","GLP","Yes","7/1/2022","6/30/2024","$10K - $110K","Right","Weak","Very Strong","5'8""","141 lbs","99","7",96,104,12,10,12,8,11,11,9,11,8,12,12,10,11,11,10,10,11,11,11,9,9,11,9,12,11,12,11,12,12,12,13,7,14,12,12,7,12,16,10,10,11,12,10,10,11,6,11,11,17,2,3,2,3,3,2,1,2,3,3,3
"1765",49033531,"Steve Solvet","3/20/1996 (27 years old)","D (C), DM","US Orléans","French National","GLP","Yes","7/1/2022","6/30/2024","$9K - $95K","Right Only","Weak","Very Strong","6'4""","154 lbs","68","-",95,102,3,6,4,7,10,5,11,8,1,11,12,2,13,9,13,9,9,9,13,13,12,5,6,6,13,8,8,9,11,10,9,13,14,11,6,10,11,7,11,11,10,12,9,7,15,1,11,10,15,3,1,1,2,1,1,2,3,2,3,2
"1766",18054719,"Grégory Gendrey","7/10/1986 (36 years old)","AM (RL), ST (C)","Solidarité Scolaire","Guadeloupe Ligue Régionale 1","GLP","Yes","6/30/2021","-","$0","Left Only","Very Strong","Weak","5'11""","171 lbs","227","53",74,101,6,9,11,11,11,9,11,11,5,2,11,8,5,12,10,11,9,11,11,11,13,13,7,12,5,11,10,10,8,10,11,10,14,8,10,11,13,17,11,10,12,10,9,12,12,6,11,11,14,3,1,2,2,1,2,3,3,3,1,3
"1767",49030789,"Christian Senneville","1/31/1991 (32 years old)","D/WB (R), DM, M (C)","Dunkerque","Ligue 2 BKT","GLP","Yes","8/31/2022","6/30/2024","$80K - $240K","Right Only","Weak","Very Strong","5'7""","152 lbs","304","9",95,100,10,11,9,5,11,7,8,9,8,11,11,9,12,11,11,12,13,12,12,11,12,8,11,12,12,13,10,13,11,12,13,5,14,12,13,7,14,12,9,12,13,16,8,9,12,10,11,11,10,1,3,3,1,2,3,3,2,2,3,3
"1768",93124090,"Michael Kargbo","8/20/1999 (23 years old)","AM (RL), ST (C)","Dalkurd FF","Swedish First Division North","SLE","No","2/6/2023","11/30/2025","$16K - $160K","Right","Reasonable","Very Strong","5'7""","149 lbs","113","39",87,110,6,6,10,10,10,7,9,9,6,6,9,8,6,10,10,11,11,11,9,11,11,11,6,11,8,8,7,9,14,12,10,6,13,13,11,10,8,10,10,10,11,7,7,7,8,7,10,11,14,1,3,2,3,2,3,2,1,1,4,1
"1769",28059430,"Kevin Sainte-Luce","4/28/1993 (30 years old)","AM (RL), ST (C)","US Luneray","French Regional 1 - Normandie - Group B","GLP","Yes","1/1/2023","-","$0","Right","Weak","Very Strong","5'8""","154 lbs","128","14",84,100,6,9,12,9,11,5,5,7,2,4,9,5,6,11,7,7,9,8,8,10,8,11,3,10,6,11,9,12,13,12,12,5,10,13,11,9,10,11,11,6,7,8,14,8,3,14,12,8,13,1,1,1,1,2,3,3,1,2,2,3
"1770",49047075,"Mathieu Luce","1/11/2001 (22 years old)","D (C)","Olympique Saumur FC","French National 2 - B","GLP","Yes","7/1/2022","6/30/2024","$2K - $18K","Right","Reasonable","Very Strong","5'10""","141 lbs","3","-",72,98,4,4,1,4,7,1,13,5,5,13,7,2,13,6,5,9,9,7,8,13,20,5,14,6,11,6,2,7,13,13,7,8,13,13,4,6,14,19,10,10,8,12,6,13,15,2,11,11,7,1,2,2,2,1,4,1,3,2,1,3
"1771",50084216,"Erwan Regulus","5/15/2000 (23 years old)","GK","US Créteil-Lusitanos","French National 2 - D","GLP","Yes","7/1/2022","6/30/2024","$0 - $110K","Right","Fairly Strong","Very Strong","6'2""","198 lbs","54","-",82,98,4,1,1,1,1,7,1,2,3,3,8,1,2,8,8,10,15,5,7,13,15,1,11,1,9,7,8,6,8,9,7,13,13,8,10,4,11,13,11,10,12,10,7,12,10,7,19,11,14,9,11,9,13,9,13,13,5,7,10,10
"1772",85122390,"Johan Rotsen","8/11/1996 (26 years old)","M (C)","SC Sète","French Regional Divisions","GLP","Yes","8/1/2022","-","$0","Right Only","Weak","Very Strong","5'10""","141 lbs","52","-",80,98,9,10,11,8,12,11,8,10,4,10,12,11,11,10,9,8,10,8,8,9,13,9,9,5,8,10,9,11,11,12,13,9,9,11,12,12,12,11,14,13,11,15,8,8,6,5,10,12,16,2,2,1,3,2,3,2,4,2,3,3
"1773",49046142,"Jairzhino Fumont","2/6/2000 (23 years old)","DM, M (C)","Ain Sud","French National 3 - Group K","GLP","Yes","11/1/2022","6/30/2023","$0 - $6K","Right Only","Weak","Very Strong","5'9""","167 lbs","6","-",82,96,7,5,7,4,10,7,6,11,3,10,10,6,10,11,13,10,12,7,7,15,8,5,9,9,10,11,10,12,9,10,11,7,11,9,10,11,13,17,12,10,12,11,8,15,13,6,11,12,16,2,1,3,2,2,2,1,2,3,3,2
"1774",82078643,"Mavrick Annerose","11/26/1995 (27 years old)","AM (LC), ST (C)","USR","Guadeloupe Ligue Régionale 2 Poule A","GLP","Yes","6/15/2020","6/30/2024","$500 - $3K","Left","Very Strong","Fairly Strong","6'3""","165 lbs","-","-",84,95,7,6,12,10,12,6,9,6,2,7,9,6,6,11,5,10,3,14,7,6,14,10,9,11,8,8,6,9,13,11,8,11,15,12,13,6,11,11,11,10,10,11,11,15,9,3,12,12,10,2,2,1,4,1,3,1,1,3,1,3
"1775",82078704,"Rudy Voteau","8/5/1994 (28 years old)","ST (C)","US Baie-Mahault","Guadeloupe Ligue Régionale 1","GLP","Yes","6/15/2020","6/30/2024","$0 - $7K","Right","Reasonable","Very Strong","5'11""","163 lbs","-","-",78,94,6,4,9,13,12,5,13,4,1,5,6,6,1,7,5,10,5,11,7,13,15,7,10,11,7,6,7,7,13,13,5,8,10,13,12,9,10,15,9,13,13,6,7,13,12,3,11,10,17,4,3,1,3,1,1,4,2,3,1,3
"1776",50068004,"Brice Cognard","4/26/1990 (33 years old)","GK","US Avranches","French National","GLP","Yes","7/1/2020","6/30/2024","$14K - $140K","Right Only","Weak","Very Strong","6'2""","187 lbs","181","-",93,94,6,1,3,2,8,7,1,1,3,2,8,3,2,8,8,12,12,7,10,14,12,1,5,1,12,9,6,8,11,10,12,14,14,12,7,13,10,13,10,13,11,12,7,10,10,4,12,11,8,8,6,13,14,11,8,11,8,13,14,12
"1777",82078541,"Ludovic Césaire-Gédéon","6/13/1995 (27 years old)","M/AM (R), ST (C)","Racing Club B-T","Guadeloupe Ligue Régionale 2 Poule A","GLP","Yes","6/15/2020","6/30/2024","$0","Right","Reasonable","Very Strong","5'9""","152 lbs","2","1",70,94,6,11,7,12,9,5,7,5,5,5,7,1,1,7,13,7,8,7,5,7,13,8,11,8,5,6,5,7,12,12,6,3,12,12,12,7,9,10,12,12,9,11,13,9,9,3,20,13,13,3,3,2,3,3,2,3,2,3,2,2
"1778",2000109975,"Quentin Annette","1/13/1998 (25 years old)","DM, M (C)","Club Franciscain","Martinican Trophee Gerard Janvion R1","GLP","Yes","6/15/2020","6/30/2025","$3.5K - $35K","Right","Fairly Strong","Very Strong","5'9""","154 lbs","-","-",83,92,2,5,6,5,13,6,6,7,1,10,9,3,13,10,10,10,8,8,8,9,14,5,4,7,11,7,5,12,13,13,7,3,14,13,12,8,14,11,14,11,9,10,10,14,8,7,10,9,15,1,1,2,2,3,1,2,3,2,3,1
"1779",93060122,"Ishmael Koroma","6/6/1996 (27 years old)","D (C)","Elverum","Norwegian Third Division Group 2","SLE","No","7/28/2022","12/31/2023","$0 - $10K","Right Only","Weak","Very Strong","5'11""","165 lbs","200","6",84,108,6,11,6,5,9,6,11,6,7,10,11,6,12,9,8,10,10,11,10,10,11,6,11,7,12,7,9,9,13,9,11,11,12,12,11,11,6,12,11,11,11,11,8,8,7,6,10,11,15,3,3,2,2,1,3,3,2,3,2,3
"1780",28127061,"Ludwig Francillette","5/1/1999 (24 years old)","D (C)","Crawley","Sky Bet League Two","GLP","Yes","8/5/2021","6/30/2024","$20K - $60K","Right","Reasonable","Very Strong","6'4""","178 lbs","53","2",82,91,3,4,6,6,8,3,15,3,12,12,9,5,12,11,7,7,11,8,8,8,10,4,6,7,11,12,6,10,10,8,8,14,14,10,14,14,8,10,10,9,11,12,9,7,6,6,9,11,11,1,1,2,3,1,1,1,1,3,3,2
"1781",50078802,"Nicolas Pistol","8/16/1996 (26 years old)","GK","Avoine Chinon","French National 2 - B","GLP","Yes","7/1/2021","6/30/2024","$0 - $95K","Right","Reasonable","Very Strong","6'0""","160 lbs","62","-",82,91,2,1,2,3,3,4,1,1,2,1,10,2,3,4,5,8,15,8,8,9,14,1,10,3,10,8,7,6,12,14,8,11,14,13,1,6,10,15,11,10,11,12,13,5,8,5,15,10,11,9,5,14,8,10,9,14,5,7,10,8
"1782",82078440,"Jean-Luc Lambourde","4/10/1980 (43 years old)","D (C), DM","Amical Club","Guadeloupe Ligue Régionale 1","GLP","Yes","6/14/2021","6/30/2024","$0","Right","Reasonable","Very Strong","6'4""","180 lbs","65","8",73,90,4,5,4,5,10,7,9,10,4,13,10,3,12,9,5,13,8,5,12,15,4,6,12,5,15,9,11,8,5,5,5,11,15,5,4,5,14,17,11,13,11,9,11,9,10,5,18,11,17,1,2,2,2,1,2,3,1,1,1,3
"1783",2000108282,"Kévin Moeson","9/30/1997 (25 years old)","D/WB/M/AM (R)","Solidarité Scolaire","Guadeloupe Ligue Régionale 1","GLP","Yes","6/15/2020","6/30/2025","$0 - $7K","Right","Reasonable","Very Strong","5'10""","152 lbs","-","-",80,90,7,10,8,10,6,5,5,4,6,7,7,3,8,8,8,6,8,8,8,12,7,8,5,12,8,7,4,8,13,13,7,8,10,13,13,5,14,20,11,10,11,11,10,10,5,1,18,12,20,2,2,2,2,3,1,1,3,3,2,1
"1784",85001044,"Dominique Mocka","8/13/1978 (44 years old)","AM (C), ST (C)","JS Vieux-Habitants","Guadeloupe Ligue Régionale 2 Poule A","GLP","Yes","6/14/2021","-","$0","Right","Reasonable","Very Strong","5'3""","130 lbs","-","-",70,90,9,9,6,11,13,9,10,8,5,3,13,10,3,12,6,10,9,13,10,14,11,13,7,13,7,10,13,11,6,6,5,1,17,6,6,6,10,20,11,9,11,10,10,4,13,4,11,13,10,4,1,3,3,1,4,2,1,3,3,3
"1785",2000108064,"Morgan Saint-Maximin","8/2/1997 (25 years old)","DM, M/AM (C)","Solidarité Scolaire","Guadeloupe Ligue Régionale 1","GLP","Yes","6/15/2020","6/30/2025","$0 - $8K","Right","Reasonable","Very Strong","5'6""","134 lbs","-","-",80,90,6,5,7,11,14,4,7,5,4,8,8,5,8,11,15,11,4,9,8,14,13,12,9,9,11,8,11,13,13,10,8,2,12,12,9,3,13,16,10,11,12,12,13,15,9,5,13,11,7,3,1,4,2,3,1,1,1,1,1,2
"1786",2000045487,"Yakine Said M'Madi","3/11/2004 (19 years old)","D (C)","OM","French National 3 - Group A","COM","Yes","4/18/2023","6/30/2026","$130K - $1.3M","Right","Weak","Very Strong","5'10""","156 lbs","-","-",82,139,7,7,8,7,10,7,11,8,6,12,9,8,11,7,9,10,11,10,10,10,11,10,9,8,11,10,5,9,10,10,9,10,13,12,11,12,10,17,10,11,9,11,5,12,10,8,12,11,18,3,3,1,1,3,3,2,2,2,1,3
"1787",85071364,"Ali Ahamada","8/19/1991 (31 years old)","GK","Azam FC","Tanzanian Mainland Premier Division","COM","Yes","7/13/2022","6/30/2024","$75K - $750K","Right","Fairly Strong","Very Strong","6'2""","182 lbs","223","1",109,135,7,2,9,8,11,10,15,7,2,5,13,10,11,10,14,11,16,12,8,5,16,8,7,9,6,11,14,5,13,14,10,15,12,10,10,15,10,14,15,13,15,14,8,17,8,15,8,17,12,16,20,17,12,14,17,13,19,8,11,13
"1788",49040181,"Yannick Pandor","5/1/2001 (22 years old)","GK","RC Lens","Ligue 1 Uber Eats","COM","Yes","1/17/2023","6/30/2026","$80K - $240K","Right Only","Weak","Very Strong","6'4""","174 lbs","-","-",100,135,6,2,2,1,12,7,1,3,1,2,11,2,3,10,8,11,12,10,11,12,14,1,10,1,11,11,11,9,12,12,11,14,14,11,4,7,14,12,12,12,12,13,10,2,7,3,20,10,14,9,10,13,8,12,11,10,8,11,10,12
"1789",49030848,"Faïz Selemani","11/14/1993 (29 years old)","AM (RL)","KV Kortrijk","Jupiler Pro League","COM","Yes","8/17/2019","6/30/2025","$325K - $3.3M","Right","Weak","Very Strong","6'0""","143 lbs","227","63",125,130,14,12,14,12,15,11,7,10,7,6,13,10,6,15,8,13,12,13,11,13,12,15,6,14,6,10,9,13,15,15,13,11,10,13,13,9,12,10,10,10,10,10,11,11,7,9,10,14,12,2,2,1,1,3,1,4,1,1,2,2
"1790",2000224323,"Osman Koroma","7/18/2002 (20 years old)","ST (C)","Aris Limassol","Cypriot First Division","SLE","No","7/1/2022","5/31/2026","$7K - $70K","Right Only","Weak","Very Strong","6'3""","182 lbs","64","6",85,107,9,5,10,11,12,6,16,10,8,9,10,6,6,11,15,14,13,11,8,10,13,9,13,11,5,9,7,10,11,10,16,13,11,11,6,10,12,18,9,10,10,14,13,7,10,6,13,10,17,3,3,1,1,2,3,1,3,3,3,1
"1791",85057307,"Fouad Bachirou","4/15/1990 (33 years old)","DM, M (C)","Omonoia","Cypriot First Division","COM","Yes","6/3/2023","5/31/2024","$22K - $230K","Right","Weak","Very Strong","5'6""","143 lbs","304","4",115,130,10,11,11,6,11,8,7,6,6,14,14,6,13,12,12,12,12,13,13,13,14,11,10,14,14,14,14,14,11,14,14,6,14,12,13,11,10,15,17,16,15,12,14,14,10,7,13,12,14,2,3,3,3,3,2,3,2,2,1,1
"1792",34002594,"Ben","6/10/1989 (34 years old)","AM (RLC), ST (C)","APOEL","Cypriot First Division","COM","Yes","1/16/2023","5/31/2025","Not for Sale","Left","Very Strong","Reasonable","5'9""","163 lbs","348","124",115,127,13,13,12,13,13,13,11,11,3,4,13,15,6,14,9,15,11,13,12,11,13,13,6,17,6,16,13,13,10,10,12,10,12,10,10,11,12,13,12,14,12,13,8,13,10,4,13,16,15,3,2,3,3,1,1,3,3,1,1,1
"1793",85059267,"Youssouf M'Changama","8/29/1990 (32 years old)","DM, M/AM (C)","AJ Auxerre","Ligue 2 BKT","COM","Yes","7/1/2022","6/30/2024","$0","Right","Weak","Very Strong","5'9""","152 lbs","331","37",122,125,13,12,12,9,13,14,6,14,1,7,13,11,8,13,9,13,11,12,10,12,13,14,12,12,9,13,13,13,13,15,12,7,16,14,16,10,11,14,13,15,11,12,4,13,6,5,12,14,10,2,3,1,3,2,3,1,3,2,2,1
"1794",49061718,"Adel Mahamoud","2/4/2003 (20 years old)","AM (L), ST (C)","FC Nantes","French National 3 - Group D","COM","Yes","6/9/2023","6/30/2026","$50K - $475K","Left","Very Strong","Reasonable","5'10""","152 lbs","-","-",91,123,8,9,13,14,14,8,12,10,5,6,13,6,4,12,8,8,4,11,9,12,15,15,2,6,7,9,10,10,14,14,9,9,12,14,7,6,13,19,9,9,11,12,9,11,9,8,11,11,9,3,2,1,2,1,3,4,1,3,3,3
"1795",2000028588,"Iyad Mohamed","3/5/2001 (22 years old)","DM, M (C)","Le Mans FC","French National","COM","Yes","7/1/2022","6/30/2025","$0","Left","Very Strong","Weak","6'3""","176 lbs","23","1",92,122,8,7,5,7,11,8,12,8,4,11,14,4,10,13,12,13,9,10,10,13,17,5,7,8,14,9,12,12,9,14,4,15,14,14,12,12,8,20,12,11,10,10,10,9,15,7,15,11,19,3,1,2,2,1,3,2,3,2,3,3
"1796",18087020,"Said Bakari","9/22/1994 (28 years old)","D/WB/M/AM (R)","RKC Waalwijk","Eredivisie","COM","Yes","6/15/2020","6/30/2025","$140K - $6.4M","Right Only","Weak","Very Strong","5'10""","158 lbs","199","22",119,121,12,12,14,7,11,7,5,6,13,9,10,5,8,12,15,12,11,10,11,11,12,12,5,13,9,13,13,10,14,13,11,7,16,14,12,10,14,12,12,12,10,10,5,11,6,6,13,13,17,1,2,2,1,3,1,2,1,3,4,4
"1797",85056101,"Kassim Abdallah","4/9/1987 (36 years old)","D/WB (R)","Marignane GCB FC","French National","COM","Yes","6/13/2022","6/30/2024","$6K - $18K","Right Only","Weak","Very Strong","6'1""","176 lbs","311","5",90,120,5,11,9,5,10,7,14,7,12,12,10,6,12,11,12,11,12,10,10,11,16,7,7,11,11,11,10,12,11,11,12,13,13,11,12,12,8,11,13,12,13,12,8,13,12,5,12,13,10,1,1,2,3,2,2,1,3,3,3,3
"1798",34011563,"Mohamed Youssouf","3/26/1988 (35 years old)","D/WB/M (R)","AC Ajaccio","Ligue 2 BKT","COM","Yes","6/30/2022","6/30/2024","$3.5K - $35K","Right","Weak","Very Strong","5'7""","143 lbs","324","32",110,120,10,11,12,8,13,8,7,10,8,11,11,10,12,12,8,11,11,12,12,11,12,13,7,13,12,11,12,13,13,15,13,6,13,13,13,7,12,14,14,13,12,14,6,14,6,7,11,12,13,3,1,1,1,2,2,1,3,2,2,2
"1799",49040397,"Rafiki Saïd","3/15/2000 (23 years old)","AM (RL), ST (C)","Nîmes","French National","COM","Yes","8/31/2022","6/30/2025","$850K - $1.8M","Right","Reasonable","Very Strong","5'10""","160 lbs","59","11",105,119,10,12,12,11,11,10,10,9,6,7,11,4,7,12,12,9,9,14,11,8,13,9,12,16,5,9,8,12,13,13,12,10,14,13,10,10,10,16,11,12,10,15,9,15,12,4,12,11,8,2,4,4,3,1,1,3,3,3,3,2
"1800",2000210718,"Kamal Ahamada","9/23/2005 (17 years old)","M/AM (C)","OM","Ligue 1 Uber Eats","COM","Yes","7/1/2022","6/30/2025","$16K - $160K","Right","Fairly Strong","Very Strong","6'0""","163 lbs","-","-",75,119,6,4,9,14,14,7,5,9,2,7,14,5,8,14,13,4,7,7,8,10,11,13,10,9,6,8,11,9,12,8,8,6,6,10,7,6,14,20,11,12,9,8,8,5,12,2,8,11,14,4,1,3,1,1,1,1,1,3,1,3
"1801",2000147224,"Alpha Conteh","5/1/2000 (23 years old)","AM (RL), ST (C)","Lokomotiv Plovdiv","Bulgarian First League","SLE","No","3/1/2023","6/30/2024","$40K - $400K","Left Only","Very Strong","Weak","6'1""","167 lbs","38","3",98,107,8,13,12,15,12,9,9,9,8,4,14,4,4,12,14,10,10,9,8,6,13,10,8,11,5,10,12,6,14,15,12,12,13,15,10,8,11,16,10,11,9,12,13,5,6,8,12,10,13,3,3,1,3,2,2,1,4,3,2,3
"1802",85033645,"Chaker Alhadhur","12/4/1991 (31 years old)","D/WB (RL)","AC Ajaccio","Ligue 2 BKT","COM","Yes","10/12/2021","6/30/2023","$8K - $26K","Right","Weak","Very Strong","5'8""","143 lbs","130","4",105,118,8,11,10,7,11,7,8,6,12,10,10,10,12,12,10,10,12,11,10,9,10,11,4,12,10,13,10,13,13,13,12,9,14,13,14,10,10,13,14,12,12,14,8,13,12,5,10,10,8,4,1,2,4,1,1,3,1,4,3,2
"1803",48037701,"Hakim Abdallah","8/18/1997 (25 years old)","D/WB/M (L)","Rodez AF","Ligue 2 BKT","COM","Yes","7/11/2022","6/30/2025","$400K - $1.2M","Left","Very Strong","Weak","5'6""","143 lbs","126","1",105,115,9,12,11,8,11,6,6,7,11,11,12,11,12,11,10,11,11,11,11,11,10,10,9,11,12,13,11,13,13,14,12,5,14,12,12,8,11,9,11,12,10,9,10,11,8,9,11,12,9,3,2,4,1,1,3,3,2,3,2,3
"1804",49041155,"Faiz Mattoir","7/12/2000 (22 years old)","AM (RL)","Almere City","Eredivisie","COM","Yes","6/30/2022","6/30/2024","$70K - $700K","Right","Weak","Very Strong","5'5""","136 lbs","48","4",100,115,9,12,11,9,12,8,9,9,4,6,10,8,5,11,8,10,12,11,10,10,15,10,7,11,8,10,11,10,15,13,11,9,12,13,12,11,9,20,11,11,9,12,8,8,8,7,10,12,19,1,1,4,3,4,3,3,2,1,2,2
"1805",85085141,"Bendjaloud Youssouf","2/11/1994 (29 years old)","D/WB/M (R)","Châteauroux","French National","COM","Yes","7/1/2021","6/30/2024","$190K - $550K","Right","Weak","Very Strong","5'9""","163 lbs","172","19",102,115,10,11,8,11,11,8,7,12,11,8,11,7,11,11,8,10,10,11,10,11,12,12,8,12,8,11,10,13,13,13,11,8,14,13,14,12,13,15,15,12,10,14,7,10,6,6,12,12,7,3,2,2,3,1,3,2,3,3,2,1
"1806",49037517,"Yacine Bourhane","9/30/1998 (24 years old)","DM, M (C)","Esbjerg fB","2. Division","COM","Yes","1/1/2022","12/31/2024","$55K - $170K","Left","Very Strong","Reasonable","6'3""","163 lbs","104","2",90,115,7,6,11,8,11,6,11,8,3,11,12,8,12,8,8,12,11,12,10,12,12,5,8,7,11,12,11,12,9,9,8,14,11,11,12,13,11,18,11,10,12,10,13,9,7,5,11,15,20,2,2,2,2,1,1,1,2,2,3,1
"1807",48047587,"Abdourahim Moina","12/17/2000 (22 years old)","M/AM (C)","GOAL FC","French National","COM","Yes","7/1/2022","6/30/2025","$9K - $90K","Right Only","Weak","Very Strong","5'10""","160 lbs","41","2",90,115,8,9,11,12,15,9,9,11,5,10,13,11,8,12,11,10,9,7,9,12,13,9,7,10,10,12,10,12,11,13,10,7,13,12,12,9,10,18,13,13,12,12,7,8,7,8,12,12,19,1,2,3,2,3,3,3,2,2,2,3
"1808",2000047331,"Ibtoihi Hadari","10/3/2003 (19 years old)","AM (RL)","OM","French National 3 - Group A","COM","Yes","7/1/2020","6/30/2027","$6K - $55K","Left","Very Strong","Reasonable","5'9""","136 lbs","-","-",78,114,6,11,9,8,13,6,6,7,6,4,11,4,3,13,12,6,5,8,6,6,16,14,1,9,4,7,3,12,13,13,8,8,13,13,9,3,12,19,11,12,13,12,5,9,11,3,8,13,18,1,2,1,1,2,1,3,3,3,3,2
"1809",49040440,"Mohamed Abdallah","4/11/1999 (24 years old)","D (R)","Stade Lausanne-Ouchy","Swiss Super League","COM","Yes","7/3/2021","6/30/2025","$45K - $425K","Right","Weak","Very Strong","5'6""","138 lbs","44","1",105,112,5,10,10,6,11,5,11,6,11,11,12,6,12,11,13,12,13,12,12,10,11,8,8,12,11,13,10,13,13,13,14,11,14,14,13,9,8,14,12,12,12,11,7,10,10,7,10,10,10,2,1,1,2,1,3,3,2,3,1,2
"1810",85051005,"Nasser Chamed","10/4/1993 (29 years old)","M (L), AM (LC)","Chindia Târgovişte","Romanian Second League","COM","Yes","3/18/2022","6/30/2024","$275K - $800K","Right","Reasonable","Very Strong","5'9""","158 lbs","246","21",99,112,13,11,12,11,13,15,9,13,5,7,11,10,7,13,7,7,9,10,10,10,9,10,12,11,9,9,11,12,12,12,11,8,14,12,10,11,12,14,10,10,8,12,7,10,5,4,8,11,12,2,3,3,2,1,3,2,1,3,1,1
"1811",2000129710,"Zaîd Amir","5/11/2002 (21 years old)","M/AM (RL)","Le Mans FC","French Regional 1 - Pays de la Loire - Group A","COM","Yes","6/2/2022","6/30/2024","$40K - $400K","Right","Fairly Strong","Very Strong","5'9""","147 lbs","15","1",85,108,3,7,12,11,14,3,5,7,3,7,11,4,8,13,10,5,8,9,8,8,11,12,6,13,7,8,10,11,14,14,7,9,13,14,6,5,10,15,13,12,13,12,10,1,10,2,10,13,18,3,4,2,1,3,1,3,1,2,1,2
"1812",29154411,"David Sesay","9/18/1998 (24 years old)","D (RL), WB/M (R)","Wealdstone","Vanarama National League","SLE","No","11/26/2021","6/30/2026","$0","Right Only","Weak","Very Strong","6'0""","165 lbs","99","-",53,105,3,7,8,4,6,3,7,5,10,8,7,6,8,8,10,7,11,8,7,6,10,7,4,8,7,8,7,10,11,10,6,9,14,12,10,6,12,9,12,11,7,11,8,10,9,8,8,12,13,2,2,1,4,2,3,1,4,2,1,1
"1813",95058536,"Kassim Hadji","3/23/2000 (23 years old)","M/AM (R), ST (C)","Ararat","Armenian High League","COM","Yes","2/15/2023","6/30/2025","$0 - $95K","Right Only","Weak","Very Strong","5'10""","156 lbs","39","5",85,108,7,11,12,8,10,5,9,10,4,12,10,9,10,11,8,10,8,10,10,9,13,11,8,10,6,11,10,10,13,10,10,8,10,12,10,10,10,11,8,11,9,10,12,12,12,10,9,13,12,2,2,1,3,3,1,3,1,4,2,3
"1814",49060931,"Karim Attoumani","3/24/2001 (22 years old)","D (C)","Dijon FCO","French National","COM","Yes","10/19/2021","6/30/2025","$1K - $9K","Right Only","Weak","Very Strong","6'2""","167 lbs","-","-",70,106,4,1,3,1,8,1,8,1,1,11,8,5,14,7,11,10,9,7,7,14,17,5,10,7,11,7,7,8,11,10,8,13,16,12,7,6,13,13,8,9,11,12,5,6,13,6,19,9,19,3,3,1,1,3,3,2,1,3,3,4
"1815",48044459,"Younn Zahary","10/8/1998 (24 years old)","D (C)","Mezőkövesd","Hungarian Division I","COM","Yes","1/26/2023","6/30/2024","$16K - $160K","Right","Weak","Very Strong","6'4""","180 lbs","67","1",98,106,5,6,6,9,9,2,12,10,6,11,10,8,11,11,10,10,11,12,11,11,2,5,10,7,16,10,6,11,9,8,13,15,12,10,10,13,14,19,11,10,11,8,11,15,7,8,12,9,8,3,2,4,1,2,1,1,2,2,1,3
"1816",2000304794,"Nasser Mbaé","9/2/2002 (20 years old)","D (LC)","FC Martigues","French Regional Divisions","COM","No","7/1/2022","6/30/2024","$0 - $55K","Left Only","Very Strong","Weak","6'5""","187 lbs","-","-",70,106,4,7,6,6,7,1,10,2,3,12,6,1,13,6,15,9,9,2,8,10,7,5,11,6,12,6,6,8,8,10,7,16,12,10,10,8,15,13,13,12,14,10,9,6,7,1,18,11,13,2,3,1,3,3,2,1,1,1,3,2
"1817",49047039,"Azihard M'Changama","4/21/2001 (22 years old)","DM","RC Grasse","French National 2 - A","COM","Yes","7/1/2022","6/30/2025","$2.5K - $24K","Right","Fairly Strong","Very Strong","5'11""","143 lbs","14","-",72,104,7,5,3,8,11,7,7,9,3,9,13,8,14,9,7,9,8,12,9,13,8,5,10,7,9,13,7,12,7,8,8,4,13,8,7,4,13,20,13,10,10,11,12,7,10,6,20,11,10,1,2,3,3,2,2,1,1,3,1,2
"1818",48045984,"Ahmed Soilihi","7/1/1996 (26 years old)","D (RC)","FC Martigues","French National","COM","Yes","1/5/2022","6/30/2025","$45K - $450K","Right","Weak","Very Strong","6'1""","165 lbs","111","-",99,104,8,8,8,7,9,9,12,7,5,12,10,8,11,4,13,11,12,11,11,11,4,5,3,7,15,9,8,10,15,11,12,12,11,12,11,12,9,16,11,11,11,12,11,12,5,1,12,12,16,3,2,2,2,2,2,2,3,3,2,1
"1819",20046472,"Alexis Souahy","1/13/1995 (28 years old)","D (C)","Omaha","United States Soccer Leagues Division One","COM","Yes","2/14/2023","11/30/2023","$28K - $300K","Right","Reasonable","Very Strong","6'1""","180 lbs","148","9",90,102,5,5,2,7,9,3,10,10,7,12,11,7,10,10,10,12,11,9,12,8,15,6,14,9,10,10,5,11,11,12,12,13,10,12,12,13,11,16,12,8,13,9,14,8,7,1,12,10,19,2,1,2,1,1,3,2,4,3,2,2
"1820",2000062059,"Adel Anzimati Aboudou","11/5/2001 (21 years old)","GK","QRM","French National 3 - Group F","COM","Yes","7/1/2019","6/30/2024","$3.5K - $35K","Right Only","Weak","Very Strong","6'4""","182 lbs","-","-",65,101,2,3,2,3,1,4,1,1,3,2,9,1,3,2,9,10,11,4,9,13,15,3,4,3,8,6,5,5,7,13,6,14,16,6,4,6,13,20,10,12,11,9,14,13,7,7,10,12,19,8,13,13,6,7,3,13,5,8,7,11
"1821",2000064609,"Ahmed Abdalla Jashak","4/26/1994 (29 years old)","M (R), AM (RL)","Shabab Al-Ahli","UAE Professional League","COM","No","7/1/2018","6/30/2024","$0","Right","Fairly Strong","Very Strong","5'7""","147 lbs","76","5",90,100,7,12,13,13,11,5,6,7,7,7,12,6,4,7,11,9,5,7,7,10,6,15,10,10,7,8,7,9,13,13,8,1,17,13,12,1,15,18,11,10,9,10,9,12,11,3,14,10,16,1,2,3,3,3,1,1,1,2,1,1
"1822",85138874,"Akim Djaha","9/14/1998 (24 years old)","D/WB (R)","FC Martigues","French National","COM","Yes","7/1/2021","6/30/2025","$40K - $400K","Right","Weak","Very Strong","5'7""","154 lbs","121","-",96,100,8,11,10,7,11,4,6,8,10,11,11,5,12,12,6,12,11,11,10,13,16,5,4,10,12,11,10,11,12,12,12,5,7,12,11,6,10,19,14,11,15,13,13,3,15,5,12,11,8,2,3,1,3,3,3,2,2,1,1,2
"1823",36078604,"John Kamara","5/12/1988 (35 years old)","DM, M (C)","Aigaleo","Greek Super League 2 South","SLE","No","1/31/2023","6/30/2023","$0","Right Only","Weak","Very Strong","6'1""","182 lbs","233","3",90,105,9,9,10,8,9,8,12,8,8,13,12,5,12,11,17,12,12,13,10,12,13,8,9,8,14,13,9,14,9,8,13,12,13,10,12,13,13,16,11,8,10,12,4,13,8,8,11,12,16,1,1,3,3,3,1,3,2,2,2,1
"1824",85077781,"Mohamed M'Changama","6/9/1987 (36 years old)","AM (RL), ST (C)","US Changé","French Regional 1 - Pays de la Loire - Group B","COM","Yes","8/1/2022","-","$0","Right Only","Weak","Very Strong","6'2""","174 lbs","151","31",82,100,4,8,12,8,12,7,11,12,5,5,10,10,2,11,8,11,12,10,10,10,13,11,6,13,5,8,9,11,11,10,14,12,14,13,13,13,10,15,15,10,14,8,6,14,8,6,10,10,11,2,1,3,3,3,3,2,3,1,1,3
"1825",49040843,"Ibrahim Madi","5/19/1998 (25 years old)","ST (C)","Stade Poitevin FC","French National 3 - Group C","COM","Yes","8/20/2022","6/30/2023","$0 - $2K","Right","Weak","Very Strong","6'0""","158 lbs","83","13",82,98,8,9,10,10,14,4,10,5,6,4,10,8,7,10,12,13,4,13,9,13,13,10,7,10,5,10,10,10,11,10,10,12,13,11,10,12,11,10,10,12,9,12,8,8,15,5,10,9,18,1,3,1,2,3,1,3,2,2,1,1
"1826",34011780,"Salim M'Ramboini","8/26/1984 (38 years old)","D (C), DM","Marignane GCB FC","French National","COM","Yes","6/30/2022","6/30/2024","$0 - $16K","Right Only","Weak","Very Strong","6'2""","154 lbs","285","6",89,98,5,7,7,6,10,6,13,8,7,12,10,6,12,8,15,12,13,11,11,11,12,5,8,7,12,13,11,12,10,11,14,13,13,10,11,10,8,14,11,11,11,18,8,6,14,8,12,10,10,1,3,3,3,3,3,1,3,2,3,1
"1827",85070066,"Ali M'Madi","4/21/1990 (33 years old)","AM (RLC)","SAS Epinal","French National","COM","Yes","7/31/2021","6/30/2024","$0 - $70K","Right","Weak","Very Strong","5'10""","158 lbs","221","37",86,98,10,12,12,7,12,12,6,10,5,5,9,10,5,12,7,10,11,9,12,7,13,13,5,12,4,7,8,10,12,13,10,9,13,12,11,8,13,16,14,11,14,12,8,14,7,6,11,13,8,1,2,3,2,3,2,3,1,4,1,1
"1828",49050530,"Moussa Djoumoi","7/16/1999 (23 years old)","ST (C)","Stade Nyonnais","Swiss Challenge League","COM","Yes","8/8/2022","6/30/2025","$0","Left","Very Strong","Strong","5'10""","143 lbs","69","12",78,97,3,3,10,13,12,5,10,6,3,5,6,2,1,13,6,11,7,9,7,10,12,13,5,11,7,6,5,7,13,13,7,10,13,13,6,5,11,13,10,9,9,11,9,1,6,1,10,12,19,2,2,3,3,4,1,1,2,3,2,2
"1829",49033427,"Salim Ben Boina","7/19/1991 (31 years old)","GK","SAS Epinal","French National","COM","Yes","10/10/2022","6/30/2024","$5K - $55K","Right Only","Weak","Very Strong","6'2""","174 lbs","78","-",87,95,3,1,3,3,5,7,1,2,3,2,8,2,3,4,12,8,12,8,10,14,8,1,11,3,9,8,4,6,10,11,4,14,11,11,2,6,10,12,12,12,11,13,12,13,7,4,11,10,19,8,9,11,9,11,8,14,5,8,13,12
"1830",50034617,"Halifa Soulé","11/12/1990 (32 years old)","DM, M (C)","A.S Béziers","French Regional 1 - Occitanie - Group A","COM","Yes","7/22/2022","-","$0","Right Only","Weak","Very Strong","5'9""","158 lbs","240","13",85,95,7,8,11,10,11,9,8,10,9,9,10,3,13,10,5,11,10,10,10,10,11,5,6,10,12,10,11,13,11,11,12,10,12,12,12,10,13,13,12,10,10,11,8,2,5,4,12,10,11,3,1,2,2,2,2,3,2,2,2,3
"1831",48037910,"Housseine Zakouani","4/30/1998 (25 years old)","AM (RL)","Jura-Sud Football","French National 2 - A","COM","Yes","7/14/2021","6/30/2024","$16K - $160K","Right","Weak","Very Strong","5'11""","163 lbs","49","5",84,95,9,10,13,9,11,6,6,9,5,4,9,7,8,12,7,8,10,10,8,7,9,13,6,12,5,9,10,10,12,14,10,6,13,12,9,8,10,20,9,10,12,6,7,6,8,12,10,12,13,3,2,3,1,1,1,2,3,1,2,1
"1832",2000301085,"Haslane Ahmed","12/28/2001 (21 years old)","AM (LC)","AS Arta","Djiboutian Premier Division","COM","No","6/12/2023","6/30/2024","$0","Left","Very Strong","Reasonable","5'7""","136 lbs","-","-",70,95,6,7,11,5,13,6,3,8,6,4,9,5,8,13,15,6,7,11,5,11,10,13,11,8,1,7,7,12,12,13,7,3,9,13,8,1,9,13,10,12,13,11,7,13,7,7,10,10,20,4,2,3,1,2,3,2,2,3,2,3
"1833",50051406,"Clément Daoudou","7/29/1994 (28 years old)","GK","SCS Locminé","French National 3 - Group E","COM","Yes","7/15/2022","6/30/2024","$0 - $90K","Right Only","Weak","Very Strong","6'0""","156 lbs","133","-",80,95,3,1,1,2,1,7,6,1,3,1,6,3,3,4,6,6,10,7,10,13,11,3,12,3,8,7,6,6,11,11,7,10,15,10,3,8,12,12,11,12,12,13,6,5,6,2,11,11,10,7,8,13,11,9,7,13,5,7,10,10
"1834",2000259456,"Yuriy Kravchenko","6/29/2006 (16 years old)","AM (RL)","Dinamo Minsk","Belarusian Highest League","BLR","No","6/29/2021","12/31/2025","$14K - $140K","Right","Reasonable","Very Strong","5'11""","132 lbs","2","-",70,110,7,10,9,8,12,5,5,8,5,3,10,2,6,9,7,4,5,9,6,6,8,9,8,13,3,7,6,8,13,12,4,9,15,13,12,4,12,11,11,8,12,10,6,8,7,5,8,13,16,2,3,2,3,3,2,2,3,3,1,1
"1835",28127527,"Kamil Conteh","12/26/2002 (20 years old)","DM, M (C)","Middlesbrough","Sky Bet Championship","SLE","No","7/1/2022","6/30/2025","$1K - $10K","Right","Reasonable","Very Strong","5'10""","160 lbs","43","3",86,105,5,7,9,7,9,8,9,7,6,11,11,4,12,11,12,9,10,9,10,10,12,6,6,12,11,13,9,13,13,8,9,10,16,12,14,12,11,11,16,16,10,10,3,8,10,1,10,14,11,3,3,2,3,3,1,3,3,3,2,2
"1836",48037297,"Ahmed Mogni","10/10/1991 (31 years old)","M/AM (LC)","Jeunesse Esch","Luxembourg National Division","COM","Yes","6/30/2022","6/30/2023","$0","Right Only","Weak","Very Strong","5'9""","154 lbs","123","17",91,94,9,13,12,13,12,9,7,8,8,9,14,9,10,14,7,10,8,8,11,10,7,12,7,11,10,10,9,11,10,12,11,8,14,12,12,9,10,20,11,12,10,11,14,14,5,1,11,12,9,2,1,1,2,2,3,2,1,1,1,4
"1837",85078874,"Fouad Rachid","11/15/1991 (31 years old)","DM, M (C)","FC Hégenheim","French Regional 1 - Grand Est - Group C","COM","Yes","7/1/2020","-","$0","Right Only","Weak","Very Strong","5'4""","125 lbs","66","1",77,94,10,10,11,6,11,7,8,9,11,7,11,8,11,11,13,12,12,12,11,11,14,11,8,8,11,13,9,13,11,12,8,5,14,11,12,5,11,14,14,14,11,13,8,13,13,5,13,11,19,1,1,3,3,2,1,2,3,2,2,2
"1838",85097013,"Nakibou Aboubakari","3/10/1993 (30 years old)","DM, M (C)","FC Fleury 91","French National 2 - D","COM","Yes","1/12/2022","6/30/2024","$45K - $140K","Right Only","Weak","Very Strong","5'11""","165 lbs","188","16",86,94,9,9,12,8,12,9,7,11,4,7,11,5,6,13,8,12,7,11,11,14,14,11,9,12,6,11,11,12,10,13,12,10,14,11,13,12,14,15,9,13,10,12,6,16,12,9,12,13,14,1,3,3,1,1,2,1,3,3,3,2
"1839",50067890,"Abdallah Imamo","4/19/1993 (30 years old)","D/WB (L)","Jura Dolois Football","French National 3 - Group J","COM","Yes","8/5/2022","6/30/2024","$0 - $55K","Left Only","Very Strong","Weak","5'11""","143 lbs","145","15",74,92,4,10,8,3,9,2,10,5,3,9,9,2,9,9,12,9,9,7,9,7,12,6,8,6,8,8,7,8,14,14,8,10,9,14,13,7,14,18,11,13,9,10,14,15,5,8,12,11,20,2,3,3,1,1,2,3,1,2,1,1
"1840",49051603,"Bryan Adinany","3/13/2000 (23 years old)","ST (C)","US Raon-l'Etape","French National 3 - Group I","COM","Yes","7/1/2022","6/30/2025","$1.5K - $16K","Right","Reasonable","Very Strong","6'2""","165 lbs","46","18",65,90,3,7,9,9,8,6,8,9,4,5,7,11,8,9,7,8,5,8,8,7,9,9,5,10,4,4,6,7,13,11,10,11,13,12,10,10,9,9,5,6,7,9,9,2,5,9,13,14,12,3,1,1,2,2,2,2,1,3,1,3
"1841",95061135,"Faouz Attoumane","1/4/1994 (29 years old)","DM, M (C)","FC Nouadhibou","Mauritanian D1","COM","No","6/30/2022","6/30/2024","$0","Either","Very Strong","Very Strong","5'9""","154 lbs","-","-",75,90,5,2,3,7,5,6,6,6,1,8,11,3,13,10,10,6,8,7,8,13,11,5,3,8,9,7,7,11,13,13,7,5,15,13,11,4,15,13,11,11,10,10,5,8,5,6,11,13,18,1,1,1,2,4,3,4,1,3,1,3
"1842",2000230887,"Déo Gracias Bassinga","8/11/2005 (17 years old)","AM (R), ST (C)","Diables Noirs","Congolese Championnat National","CGO","No","7/1/2022","12/31/2025","$0","Right","Weak","Very Strong","5'11""","156 lbs","-","-",89,139,7,10,9,12,10,7,9,9,6,7,10,11,7,11,8,12,12,10,11,10,3,11,9,14,11,9,11,12,12,11,10,9,14,11,11,10,9,19,11,12,11,12,11,16,8,7,14,10,10,1,3,4,3,3,1,1,2,2,2,2
"1843",85144802,"Antoine Makoumbou","7/18/1998 (24 years old)","DM, M (C)","Cagliari","Italian Serie A","CGO","Yes","7/15/2022","6/30/2026","$130K - $6.4M","Right","Reasonable","Very Strong","5'10""","136 lbs","100","2",128,136,9,9,15,8,13,9,8,9,7,12,14,9,13,14,12,12,12,13,13,13,14,14,10,12,13,12,14,12,13,13,12,7,12,13,16,12,12,13,13,14,13,8,8,14,10,4,12,13,13,1,1,1,2,3,1,2,3,1,3,1
"1844",13191099,"Guy Mbenza","4/1/2000 (23 years old)","ST (C)","Al-Tai","Saudi Professional League","CGO","No","7/16/2022","6/30/2024","$0","Right","Reasonable","Very Strong","6'2""","187 lbs","100","46",115,135,8,11,12,13,11,9,12,9,3,6,10,12,5,12,5,12,14,12,10,12,12,12,8,13,6,10,9,11,14,12,13,12,11,14,11,14,15,13,13,12,12,11,8,11,7,5,9,14,20,1,3,1,2,1,2,2,3,3,3,1
"1845",52082234,"Gaïus Makouta","7/25/1997 (25 years old)","DM, M (C)","BVT","Portuguese Premier League","CGO","Yes","7/27/2021","6/30/2024","$650K - $6.6M","Right","Reasonable","Very Strong","5'11""","163 lbs","175","17",130,134,11,12,13,11,12,13,12,14,8,12,11,11,11,12,16,13,13,12,14,10,16,8,7,14,13,13,11,14,13,13,16,13,17,14,16,17,13,9,10,11,12,10,6,11,9,14,13,14,17,3,2,1,1,1,3,1,2,2,2,3
"1846",13229541,"Musa Kamara","8/6/2000 (22 years old)","ST (C)","Al-Ittihad Tripoli","Libyan First Division","SLE","No","8/22/2022","6/30/2024","$40K - $120K","Right","Reasonable","Very Strong","6'2""","180 lbs","-","-",90,105,7,4,9,14,14,8,14,7,1,8,9,9,6,11,6,13,8,10,7,13,8,12,13,14,9,6,7,9,13,10,9,14,15,13,6,6,10,14,10,11,12,12,10,8,15,4,13,14,19,1,4,2,3,2,1,1,3,2,2,4
"1847",8442730,"Chris Malonga","7/11/1987 (35 years old)","M (L), AM (LC)","Racing Besançon","French National 2 - D","CGO","Yes","8/24/2021","6/30/2024","$0 - $40K","Left","Very Strong","Weak","6'0""","165 lbs","289","40",94,132,10,12,12,10,12,10,11,12,8,5,12,10,4,12,8,11,10,10,8,10,10,12,6,12,7,11,11,11,11,12,12,10,12,11,12,12,8,15,15,10,8,12,13,14,8,6,9,14,14,3,3,2,3,3,2,3,1,2,1,3
"1848",85057646,"Thievy Bifouma","5/13/1992 (31 years old)","AM (RL), ST (C)","OFI","Greek Super League 1","CGO","Yes","9/16/2022","6/30/2024","$110K - $1.1M","Right","Fairly Strong","Very Strong","5'11""","163 lbs","259","43",105,130,7,10,12,10,9,7,6,11,5,4,8,11,6,12,10,10,11,10,7,7,10,14,7,13,6,8,9,11,14,14,13,10,13,14,10,12,9,13,12,8,10,7,12,13,13,14,10,12,13,1,1,3,3,2,3,2,1,3,3,2
"1849",48037962,"Fernand Mayembo","1/9/1996 (27 years old)","D (C)","AC Ajaccio","Ligue 2 BKT","CGO","Yes","7/26/2022","6/30/2024","$0","Right","Weak","Very Strong","6'0""","194 lbs","123","1",118,126,5,7,7,5,8,5,15,6,9,13,11,5,13,8,13,12,14,12,8,11,12,6,10,11,12,13,10,14,11,11,15,15,14,11,15,18,5,13,13,10,12,12,9,12,8,12,12,12,15,2,1,2,3,3,4,1,1,2,2,3
"1850",85140255,"Bryan Passi","8/5/1997 (25 years old)","D (C)","Niort","French National","CGO","Yes","2/2/2022","6/30/2024","$0","Right","Reasonable","Very Strong","6'2""","171 lbs","90","3",105,125,5,4,8,8,9,6,11,5,7,13,12,5,11,10,14,12,13,10,13,11,8,4,7,7,12,12,11,14,12,11,13,14,14,10,12,14,6,10,11,10,11,11,10,10,9,3,11,10,18,1,2,3,4,2,2,1,3,2,2,2
"1851",48037719,"Warren Tchimbembe","4/21/1998 (25 years old)","M/AM (C)","FC Metz","Ligue 1 Uber Eats","CGO","Yes","7/23/2020","6/30/2024","$45K - $450K","Left","Very Strong","Weak","5'11""","163 lbs","71","4",111,125,11,13,13,12,12,10,10,12,3,8,14,12,7,14,11,12,12,12,13,11,11,12,12,13,12,13,12,12,12,12,12,8,14,12,13,12,12,7,10,11,11,11,8,12,8,6,9,11,8,1,1,2,2,3,1,2,2,4,3,1
"1852",13198372,"Prestige Mboungou","7/10/2000 (22 years old)","AM (RC)","Ajman","UAE Professional League","CGO","No","8/29/2022","6/30/2026","$650K - $6.4M","Right","Weak","Very Strong","5'7""","147 lbs","98","15",100,125,10,10,12,11,11,10,7,9,9,10,10,3,11,11,13,11,10,11,12,11,11,12,6,11,11,11,12,12,13,12,11,8,15,13,12,10,13,11,12,12,11,10,9,12,9,4,12,12,13,2,1,3,1,2,1,3,2,1,3,3
"1853",85093337,"Dylan Bahamboula","5/22/1995 (28 years old)","AM (RC)","Livingston","cinch Premiership","CGO","Yes","6/30/2022","6/30/2024","$55K - $160K","Right","Weak","Very Strong","6'2""","163 lbs","179","21",95,125,11,9,13,10,12,11,11,11,10,6,11,10,9,14,8,9,9,10,9,10,11,14,8,7,6,5,12,10,13,12,13,10,13,12,10,13,12,13,10,10,12,10,7,7,6,6,11,12,14,2,3,1,1,1,3,3,1,3,1,1
"1854",85128684,"Yhoan Andzouana","12/13/1996 (26 years old)","WB (L), AM (RL)","Dun. Streda","Slovak First Division","CGO","Yes","5/24/2023","6/30/2025","$75K - $750K","Right","Weak","Very Strong","5'10""","154 lbs","161","19",105,125,8,10,14,10,12,11,7,8,3,6,11,12,4,13,9,9,10,11,9,12,13,14,7,13,6,7,11,14,13,13,11,9,13,14,10,9,11,12,13,11,9,11,11,8,6,8,11,14,14,3,1,2,3,2,3,3,3,3,2,2
"1855",48031634,"Messie Biatoumoussoka","6/5/1998 (25 years old)","D (C)","Botev Vratsa","Bulgarian First League","CGO","Yes","6/24/2022","6/30/2025","$0 - $120K","Left Only","Very Strong","Weak","6'2""","176 lbs","60","2",84,124,3,4,4,7,8,1,13,7,4,10,10,2,14,7,8,12,9,8,9,9,17,6,12,6,14,7,1,8,14,11,8,14,14,12,5,14,15,11,13,12,13,10,12,5,9,5,20,12,14,3,1,1,1,2,4,1,3,3,1,1
"1856",13115567,"Mavis Tchibota","5/7/1996 (27 years old)","AM (RL), ST (C)","Maccabi Haifa","Israeli Premier League","CGO","No","2/2/2022","5/31/2025","$35K - $350K","Right","Reasonable","Very Strong","5'10""","156 lbs","216","41",110,124,11,10,13,11,10,12,6,12,5,4,9,10,5,13,14,8,9,9,7,6,15,15,7,12,4,6,8,11,16,17,10,9,11,16,10,8,10,9,3,10,4,15,9,11,12,15,7,13,18,2,1,2,1,1,2,3,3,2,1,1
"1857",27132108,"Sheka Fofanah","1/2/1998 (25 years old)","AM (RL), ST (C)","Diyala","Iraqi First Division Group B","SLE","No","8/15/2022","7/31/2023","$0 - $12K","Left","Very Strong","Fairly Strong","6'0""","165 lbs","5","2",93,104,5,12,4,13,7,3,11,8,3,7,9,3,3,7,7,10,6,9,8,13,4,11,12,10,7,7,9,9,13,12,8,12,11,13,13,14,10,17,10,14,11,9,10,11,5,7,20,12,15,1,4,2,2,2,2,1,1,2,3,1
"1858",2000051324,"Prince Mouandza","10/23/2001 (21 years old)","D/WB (R)","Vita Club","DR Congo Premier Division B","CGO","No","8/18/2022","6/30/2024","$110K - $1.1M","Right Only","Weak","Very Strong","5'11""","149 lbs","-","-",85,124,6,12,7,3,10,2,10,7,1,11,10,3,15,10,8,10,10,9,10,11,13,5,8,8,11,9,9,9,12,14,9,9,9,14,8,6,12,17,11,11,7,9,7,13,5,1,11,9,18,3,3,3,1,2,3,2,2,1,1,1
"1859",85135695,"Ryan Bidounga","4/29/1997 (26 years old)","D (C)","CSKA 1948","Bulgarian First League","CGO","Yes","1/10/2023","6/30/2025","$24K - $250K","Right Only","Weak","Very Strong","6'1""","189 lbs","35","2",100,123,8,11,10,8,10,10,12,10,12,10,11,10,13,13,13,12,12,9,10,10,11,8,12,8,12,13,11,11,11,11,12,13,12,12,12,14,10,14,14,14,10,11,8,12,10,5,11,12,9,2,1,1,3,2,2,2,2,2,3,3
"1860",13148012,"Silvère Ganvoula","6/29/1996 (26 years old)","ST (C)","VfL Bochum","Bundesliga","CGO","No","7/5/2019","6/30/2025","$325K - $3.3M","Right","Fairly Strong","Very Strong","6'3""","198 lbs","178","37",117,123,4,8,12,11,9,8,13,9,8,6,9,13,7,11,13,12,15,12,10,10,12,13,8,12,6,11,10,12,13,11,12,16,14,16,11,16,6,10,10,10,8,7,6,12,9,10,10,11,16,2,1,2,2,1,4,1,3,1,4,2
"1861",49047842,"Gabriel Charpentier","5/17/1999 (24 years old)","ST (C)","Parma","Italian Serie B","CGO","Yes","8/30/2022","6/30/2025","$240K","Right Only","Weak","Very Strong","6'2""","176 lbs","65","21",106,121,9,10,12,12,11,10,14,10,7,7,10,10,8,12,9,11,13,12,11,11,10,11,8,12,8,12,10,12,13,11,13,13,9,12,14,13,12,12,11,12,10,10,15,10,10,6,10,11,10,4,2,3,2,4,3,1,2,3,3,3
"1862",85083145,"Marvin Baudry","1/26/1990 (33 years old)","D (RC)","Laval MFC","Ligue 2 BKT","CGO","Yes","7/1/2022","6/30/2024","$130K - $400K","Right","Weak","Very Strong","6'2""","178 lbs","255","12",106,120,7,8,7,8,10,8,13,7,9,12,11,6,13,9,12,12,13,11,13,12,11,6,9,9,12,13,8,12,10,11,14,13,13,10,13,13,8,14,14,13,11,13,10,15,12,6,12,11,11,2,2,3,2,1,3,2,2,1,2,1
"1863",48036268,"Bradley Mazikou","6/2/1996 (27 years old)","D/WB/M (L)","Aris","Greek Super League 1","CGO","Yes","7/5/2022","6/30/2024","$110K - $1.1M","Left Only","Very Strong","Weak","5'10""","152 lbs","182","4",115,120,8,10,10,8,10,7,6,7,12,11,9,10,12,10,12,10,14,11,11,10,14,9,8,11,10,15,10,14,16,15,10,10,14,16,15,7,12,15,12,14,12,12,6,12,6,7,12,15,17,3,3,3,3,2,3,3,1,1,1,4
"1864",48042510,"Mons Bassouamina","5/28/1998 (25 years old)","AM (RL), ST (C)","Pau FC","Ligue 2 BKT","CGO","Yes","7/1/2022","6/30/2024","$110K - $1.1M","Right","Weak","Very Strong","5'8""","156 lbs","92","15",105,120,10,11,12,12,10,10,6,11,11,11,9,9,10,10,8,12,11,12,10,11,8,10,11,11,10,11,12,13,12,13,11,6,12,13,12,7,10,14,8,12,11,13,7,3,12,1,11,12,10,3,1,1,3,2,2,2,2,2,1,1
"1865",2000059092,"Beni Makouana","9/28/2002 (20 years old)","AM (RL), ST (C)","Montpellier","French National 3 - Group A","CGO","No","10/19/2020","6/30/2027","$85K - $850K","Right Only","Weak","Very Strong","5'11""","160 lbs","31","-",110,120,4,10,12,11,12,6,7,8,4,6,9,7,5,12,8,11,10,10,8,11,14,12,8,12,5,13,8,13,15,11,11,10,12,17,11,12,14,12,14,14,13,13,11,14,10,8,12,12,13,1,3,1,3,3,2,2,3,3,2,3
"1866",2000254529,"Reich Triomphe Kokolo","2/23/2002 (21 years old)","M/AM (C)","Cotonsport","Cameroonian MTN Elite One Group B","CGO","No","7/1/2022","6/30/2024","$35K - $100K","Right","Reasonable","Very Strong","5'9""","163 lbs","-","-",80,118,4,7,9,13,14,7,3,11,3,9,10,4,11,9,12,5,6,8,9,13,11,8,4,4,7,8,14,13,13,11,8,7,6,11,10,10,13,18,10,10,12,11,7,7,5,8,10,10,14,1,1,2,1,2,1,2,1,3,4,3
"1867",2000230873,"Domi Jaures Massoumou","6/4/2003 (20 years old)","ST (C)","Diables Noirs","Congolese Championnat National","CGO","No","7/1/2022","12/31/2025","$65K - $190K","Right","Reasonable","Very Strong","5'10""","158 lbs","-","-",73,118,6,6,11,13,13,6,13,7,3,5,6,7,1,11,12,11,3,11,7,9,8,12,1,13,7,6,7,7,8,11,7,6,11,11,12,7,10,17,11,12,13,10,9,17,7,2,11,11,20,2,2,1,3,4,1,2,2,3,3,1
"1868",2000301048,"Alpha Turay","5/26/2005 (18 years old)","D (C), DM","Kallon","Sierra Leonean Premier Division","SLE","No","7/1/2022","6/30/2024","$0 - $4K","Right","Fairly Strong","Very Strong","6'2""","167 lbs","-","-",72,104,6,6,5,7,4,5,8,6,5,7,8,4,14,8,10,6,8,7,6,13,17,5,1,4,13,7,7,11,13,10,7,14,12,12,6,5,13,11,10,12,11,14,13,18,8,5,11,12,8,1,2,1,1,2,1,1,1,3,3,3
"1869",85137582,"Morgan Poaty","7/15/1997 (25 years old)","D/WB (L)","Seraing FC","Belgian Challenger Pro League","CGO","Yes","7/16/2021","6/30/2024","$0","Left","Very Strong","Weak","5'10""","165 lbs","94","3",105,117,7,11,11,6,11,3,9,10,6,9,12,9,11,10,10,11,12,12,9,10,11,12,5,13,9,15,13,12,14,13,10,9,13,14,13,10,10,16,11,13,11,14,7,12,7,1,10,13,8,4,1,2,1,2,1,4,1,1,2,2
"1870",2000180107,"Slone Matondo","11/26/2003 (19 years old)","D/WB (R)","VVV-Venlo","Keuken Kampioen Divisie","CGO","Yes","7/1/2022","6/30/2024","$50K - $500K","Right","Reasonable","Very Strong","6'1""","160 lbs","-","-",88,117,5,12,11,5,14,2,8,6,1,7,13,7,12,14,12,5,9,8,4,12,18,8,6,6,9,11,5,10,14,14,14,8,13,14,12,4,13,12,11,12,8,13,6,13,12,8,18,9,13,2,1,1,2,1,2,3,3,2,1,3
"1871",29132024,"Offrande Zanzala","11/8/1996 (26 years old)","ST (C)","Newport Co","Sky Bet League Two","CGO","No","6/21/2022","6/30/2024","$0 - $60K","Right","Reasonable","Very Strong","6'1""","158 lbs","139","24",83,116,3,7,10,10,9,6,10,6,7,5,8,11,7,10,7,9,12,8,9,9,10,12,7,11,8,10,9,11,14,10,13,12,10,12,9,12,9,11,12,13,11,12,14,8,5,12,9,11,14,2,2,1,1,4,3,2,3,3,2,3
"1872",18083551,"Senna Miangue","2/5/1997 (26 years old)","D (LC), WB (L)","Cercle Brugge","Jupiler Pro League","CGO","Yes","6/30/2022","6/30/2025","$80K - $800K","Left","Very Strong","Reasonable","6'6""","178 lbs","79","3",115,116,5,11,9,6,9,5,13,6,12,12,12,5,12,8,12,11,14,12,11,11,4,8,7,11,12,13,8,14,13,13,12,14,15,14,13,14,9,18,11,11,10,12,5,9,11,8,10,10,18,1,3,2,2,3,2,3,3,1,2,3
"1873",13165014,"Merveil Ndockyt","7/20/1998 (24 years old)","M (C), AM (RLC), ST (C)","HNK Gorica","Croatian First League","CGO","No","7/27/2022","6/30/2024","$180K - $1.8M","Right Only","Weak","Very Strong","5'7""","143 lbs","136","11",113,116,8,10,13,9,12,8,6,11,6,5,11,8,6,13,14,8,11,8,8,7,13,12,4,12,5,9,11,10,16,16,10,6,15,14,13,8,15,10,14,13,12,10,5,12,9,5,11,12,15,3,3,1,3,1,2,4,3,1,1,2
"1874",2000259759,"Ceti Junior Tchibinda","4/5/2005 (18 years old)","DM, M (C)","Diables Noirs","Congolese Championnat National","CGO","No","8/1/2022","12/31/2024","$0","Right Only","Weak","Very Strong","6'0""","163 lbs","-","-",75,116,7,7,6,7,12,7,7,11,1,7,12,6,13,11,7,8,8,7,7,14,5,5,10,8,10,8,14,12,11,11,8,11,16,10,8,8,9,20,12,10,12,14,5,10,5,7,12,10,7,3,2,2,1,2,3,3,2,3,1,3
"1875",85095005,"Nolan Mbemba","2/19/1995 (28 years old)","D (RL), DM, M (C)","Havre AC","Ligue 1 Uber Eats","CGO","Yes","6/2/2023","6/30/2025","$650K - $1.5M","Right","Weak","Very Strong","6'0""","165 lbs","117","2",108,115,10,11,12,11,13,11,11,13,5,9,12,12,9,13,10,11,11,11,11,9,12,12,7,11,8,11,13,12,13,12,12,10,13,13,14,12,13,10,12,14,10,13,10,10,5,5,12,12,7,1,1,1,1,3,1,3,1,1,1,2
"1876",13117094,"Béranger Itoua","5/9/1992 (31 years old)","D (R)","AS Otôho","Congolese Championnat National","CGO","Yes","6/30/2022","12/31/2023","$0 - $120K","Right","Reasonable","Very Strong","6'0""","169 lbs","-","-",95,115,7,13,9,4,12,4,7,8,9,10,10,2,15,7,7,10,11,10,11,11,8,6,15,9,14,10,8,10,8,13,8,11,11,11,15,7,13,19,12,11,11,11,6,12,6,4,12,11,20,1,3,1,3,3,2,1,3,1,1,2
"1877",67293839,"Kaya Makosso","8/25/1998 (24 years old)","DM, M (C)","Moss","Norwegian First Division","CGO","No","7/11/2021","6/30/2024","$4K - $40K","Right","Fairly Strong","Very Strong","5'9""","149 lbs","68","2",90,115,9,9,7,7,9,8,6,9,2,7,8,6,9,8,13,14,10,9,11,15,12,5,7,6,12,10,7,9,12,10,9,6,14,10,11,9,10,11,11,12,10,11,13,12,12,3,13,12,14,3,1,4,2,3,1,1,1,3,2,1
"1878",52091957,"Will Hondermarck","11/21/2000 (22 years old)","DM, M/AM (C)","Northampton","Sky Bet League One","CGO","Yes","1/26/2023","6/30/2025","$275K - $800K","Right","Reasonable","Very Strong","6'1""","174 lbs","41","1",86,115,6,8,10,7,10,7,9,9,5,8,12,9,10,12,10,11,9,10,8,9,13,12,4,10,8,10,10,12,12,12,12,13,13,12,14,10,14,11,11,11,8,9,7,12,6,6,11,11,13,3,4,3,2,3,1,1,3,1,3,1
"1879",28058601,"Alie Sesay","8/2/1994 (28 years old)","D (C)","Lee Man","Hong Kong Premier League","SLE","No","1/20/2023","6/30/2024","$0","Right Only","Weak","Very Strong","6'2""","194 lbs","152","3",101,103,6,7,8,6,8,7,12,7,9,12,9,7,14,10,16,10,13,10,9,10,12,4,11,7,11,13,7,12,13,13,12,14,12,14,14,14,14,5,13,13,13,13,8,10,13,12,12,13,12,2,3,3,1,3,2,4,1,3,1,2
"1880",48044473,"Herman Moussaki","2/10/1999 (24 years old)","AM (R), ST (C)","Dudelange","Luxembourg National Division","CGO","Yes","6/30/2022","6/30/2023","$1.5K - $5K","Right Only","Weak","Very Strong","6'1""","165 lbs","78","9",94,115,10,10,11,11,13,6,13,9,5,7,11,2,6,11,9,5,10,12,10,12,11,3,2,10,8,10,11,11,14,12,11,13,13,13,12,11,8,17,11,13,11,9,7,11,5,3,11,11,12,1,2,2,2,2,4,2,3,2,1,3
"1881",48031383,"Bevic Moussiti-Oko","1/28/1995 (28 years old)","AM (C), ST (C)","Ankaragücü","Turkish Super League","CGO","No","2/2/2023","6/30/2025","$0","Right","Weak","Very Strong","6'0""","194 lbs","190","41",109,114,7,8,10,10,11,10,14,11,5,6,10,8,7,10,10,12,13,13,11,9,12,7,10,13,9,12,10,14,12,9,15,15,14,12,14,16,11,17,10,10,14,10,7,13,11,8,11,12,14,1,1,1,2,2,2,2,1,3,1,2
"1882",49048557,"Kévin Monzialo","7/28/2000 (22 years old)","AM (RL)","SKN St. Pölten","Austrian First Division","CGO","Yes","7/7/2022","6/30/2025","$2M - $4.2M","Right","Reasonable","Very Strong","6'0""","149 lbs","54","4",95,114,8,10,13,10,14,8,8,8,8,8,13,3,6,14,10,10,6,8,9,10,6,13,8,12,6,9,7,11,11,14,6,12,14,14,8,9,12,18,10,8,13,12,8,11,8,3,13,9,19,2,2,3,2,2,1,2,2,2,1,1
"1883",2000024585,"Borel Tomandzoto","8/14/2002 (20 years old)","AM (RLC)","AS Otôho","Congolese Championnat National","CGO","No","7/1/2022","12/31/2024","$0","Right","Reasonable","Very Strong","5'8""","158 lbs","-","-",87,114,9,12,12,9,13,7,7,8,1,7,10,4,7,13,8,8,2,4,4,6,6,12,11,11,7,8,9,12,14,14,14,2,10,14,7,4,14,15,11,12,9,10,7,16,8,1,15,13,9,2,2,2,3,2,2,2,2,3,1,4
"1884",2000268723,"Christ Makosso","5/9/2004 (19 years old)","D (C)","FCSM","French National 3 - Group J","CGO","No","5/16/2023","6/30/2026","$45K - $450K","Right Only","Weak","Very Strong","6'4""","187 lbs","5","-",95,112,5,7,7,6,11,5,13,6,8,11,11,6,11,11,13,12,14,11,11,10,12,7,7,6,11,13,10,13,11,11,13,16,14,11,11,13,7,10,12,12,12,12,7,13,7,8,12,12,12,2,3,2,2,2,3,3,1,3,1,3
"1885",48036071,"Dylan Saint-Louis","4/26/1995 (28 years old)","AM (RL)","Hatayspor","Turkish Super League","CGO","Yes","7/30/2021","6/30/2025","$0","Right","Weak","Very Strong","6'0""","169 lbs","187","27",106,112,12,12,12,11,13,13,10,12,5,5,12,12,8,14,7,12,8,12,10,8,9,12,7,14,6,9,12,8,13,12,9,7,14,13,13,12,15,13,9,10,8,10,8,3,6,10,10,13,19,3,3,3,3,1,1,3,3,1,3,4
"1886",13174497,"Junior Makiesse","6/12/1993 (30 years old)","AM (RL)","AS Otôho","Congolese Championnat National","CGO","No","1/21/2022","12/31/2023","$30K - $90K","Right","Reasonable","Very Strong","6'0""","167 lbs","21","1",88,112,7,12,10,13,13,6,6,6,6,6,9,5,7,9,6,9,10,7,7,13,12,12,13,9,5,7,10,9,10,10,11,9,14,10,13,7,13,20,10,10,11,11,12,6,15,6,18,11,19,2,1,1,1,2,1,2,3,3,2,1
"1887",85081510,"Ravy Tsouka","12/23/1994 (28 years old)","D (RC), WB (R)","Zulte Waregem","Belgian Challenger Pro League","CGO","Yes","7/29/2022","6/30/2025","$0","Right Only","Weak","Very Strong","5'11""","178 lbs","125","1",104,112,6,10,8,5,9,6,11,6,8,10,7,5,13,9,15,11,14,8,10,10,12,6,7,11,11,12,9,12,13,12,14,11,17,14,15,15,12,7,9,12,11,9,7,10,15,9,13,11,11,3,2,1,1,2,3,2,2,2,2,1
"1888",2000071115,"Francis Beny Nzaba","12/3/2002 (20 years old)","D (C)","Dinamo Tb.","Georgian National League","CGO","No","6/25/2022","6/30/2025","$14K - $140K","Right","Weak","Very Strong","5'10""","160 lbs","12","-",90,112,3,4,5,3,6,3,12,6,7,12,6,5,12,4,11,12,12,7,8,12,7,3,8,4,15,9,6,10,10,12,10,10,11,10,13,12,8,12,10,9,11,10,5,8,8,7,7,9,8,3,2,1,3,2,3,3,2,3,1,1
"1889",2000230888,"Christ Toulouenga","8/24/2005 (17 years old)","AM (RL)","Diables Noirs","Congolese Championnat National","CGO","No","7/1/2022","12/31/2024","$0","Left","Very Strong","Fairly Strong","5'7""","138 lbs","-","-",70,111,8,11,13,11,13,6,6,7,6,5,11,6,6,13,5,6,6,4,7,13,5,13,8,7,4,6,9,11,13,9,7,1,8,8,7,4,10,11,11,11,12,11,8,7,11,6,18,11,15,4,2,1,3,3,1,2,3,1,1,3
"1890",2000255951,"Mahdi Kallon","11/29/2006 (16 years old)","AM (L)","Club Brugge","Jupiler Pro League","SLE","No","7/1/2022","6/30/2025","$45K - $425K","Left","Very Strong","Weak","5'9""","136 lbs","-","-",74,103,7,10,11,13,14,7,4,6,7,4,9,1,7,14,5,8,7,5,5,7,11,13,10,9,7,8,7,9,13,9,8,6,15,12,7,5,11,14,10,13,10,8,15,8,10,2,5,14,8,2,2,2,1,2,2,4,2,2,3,1
"1891",29005501,"Juvhel Tsoumou","12/27/1990 (32 years old)","ST (C)","CA Ha Noi","V.League One","CGO","Yes","1/9/2023","12/31/2024","Not for Sale","Right Only","Weak","Very Strong","6'2""","198 lbs","322","80",95,110,6,12,10,11,10,10,11,11,6,6,12,11,6,13,16,10,14,11,12,12,16,13,8,14,6,12,12,11,12,10,13,15,9,11,11,13,5,6,12,6,11,7,10,10,10,15,15,11,13,1,1,3,3,3,3,1,1,3,2,3
"1892",13158389,"Faria Ondongo","6/19/1996 (26 years old)","D (LC)","AS Otôho","Congolese Championnat National","CGO","No","6/15/2020","12/31/2023","$50K - $150K","Left","Very Strong","Reasonable","5'9""","167 lbs","-","-",98,110,6,11,7,9,9,1,11,6,1,13,10,4,13,8,5,14,11,10,9,15,4,5,11,9,8,9,8,10,15,13,10,5,15,13,7,13,15,20,9,10,11,10,12,9,12,6,11,12,14,3,3,3,3,3,2,2,2,2,1,3
"1893",2000051320,"Chandrel Massanga","8/17/1999 (23 years old)","DM, M (C)","FK Partizani","Albanian Superleague","CGO","No","7/1/2022","6/30/2024","$110K - $1.1M","Right Only","Weak","Very Strong","5'8""","171 lbs","36","2",95,110,9,8,7,10,10,9,9,9,4,12,12,9,12,8,15,12,9,15,11,15,7,5,12,10,15,14,7,14,13,12,14,7,15,8,9,12,13,12,10,11,12,9,10,12,6,3,10,9,7,3,3,2,2,2,2,2,1,3,2,1
"1894",2000071095,"Giscard Mavoungou","11/30/1999 (23 years old)","GK","Diables Noirs","Congolese Championnat National","CGO","No","8/29/2021","12/31/2025","$1K - $12K","Right","Reasonable","Very Strong","6'4""","185 lbs","-","-",80,110,5,1,2,3,1,8,1,2,2,2,12,3,1,1,14,7,14,4,12,12,18,3,13,1,12,6,5,5,9,12,3,14,7,6,3,5,12,12,11,12,11,10,12,9,10,5,10,11,11,5,14,12,11,7,9,8,6,8,11,12
"1895",2000259763,"Guélord Musese","7/12/2001 (21 years old)","ST (C)","Diables Noirs","Congolese Championnat National","CGO","No","7/1/2022","12/31/2025","$0","Right","Reasonable","Very Strong","5'11""","156 lbs","-","-",64,110,5,3,8,13,13,5,13,7,2,5,7,6,4,12,5,9,4,9,5,12,4,12,12,11,6,5,10,7,11,8,6,8,13,9,4,4,10,18,12,11,13,12,8,5,14,1,12,10,10,1,1,3,3,3,2,2,2,3,3,2
"1896",2000268728,"Chance Mondzenga","5/10/2001 (22 years old)","AM (RLC)","ES Métlaoui","Ligue Professionnelle 1","CGO","No","1/2/2023","6/30/2024","$45K - $425K","Right","Reasonable","Very Strong","5'8""","165 lbs","17","6",89,110,8,11,12,10,13,7,5,9,4,4,11,9,6,13,9,10,6,12,8,9,14,12,5,11,4,9,10,10,12,12,13,5,11,13,10,6,15,17,8,10,9,12,14,8,9,1,12,14,14,3,1,3,2,3,2,2,4,1,2,1
"1897",87034587,"Alberth Elis","2/12/1996 (27 years old)","AM (RL), ST (C)","Brest","Ligue 1 Uber Eats","HON","No","7/1/2022","6/30/2025","$700K - $5.2M","Right Only","Weak","Very Strong","6'0""","169 lbs","224","76",125,139,7,9,10,13,10,8,12,8,7,7,10,13,7,12,14,10,15,13,11,12,16,11,11,16,7,13,11,11,16,10,10,12,18,16,15,14,13,6,8,14,8,7,4,15,13,12,11,13,11,1,3,2,3,1,2,2,1,3,1,3
"1898",87006900,"Anthony Lozano","4/25/1993 (30 years old)","ST (C)","Cádiz","Spanish First Division","HON","Yes","7/22/2020","6/30/2025","$250K - $2.5M","Right","Fairly Strong","Very Strong","6'0""","163 lbs","382","89",125,137,7,8,12,13,13,7,13,12,8,6,12,12,7,14,12,15,14,10,12,11,14,13,9,13,9,12,12,15,13,13,13,12,14,14,13,12,11,10,13,14,11,14,12,14,9,6,11,13,14,1,1,3,1,1,1,1,2,3,1,3
"1899",87034555,"Bryan Acosta","11/24/1993 (29 years old)","M/AM (C)","Colorado","Major League Soccer","HON","No","1/19/2022","12/31/2024","$250K - $2.6M","Right","Reasonable","Very Strong","5'8""","163 lbs","264","23",119,135,13,11,11,10,11,13,9,15,9,12,13,11,12,12,15,13,15,12,11,11,13,12,13,13,9,11,12,15,13,13,13,9,13,13,13,14,12,13,15,14,11,11,7,8,11,5,13,13,12,3,2,1,2,3,3,2,2,2,2,2
"1900",84111804,"Jonathan Toro","10/21/1996 (26 years old)","M (C), AM (RLC)","Ac. Viseu","Portuguese Second League","HON","Yes","7/6/2022","6/30/2025","$120K - $1.2M","Right","Reasonable","Very Strong","5'9""","156 lbs","196","19",107,133,13,13,15,12,13,9,6,12,5,4,12,13,4,14,11,8,7,12,10,12,14,16,6,12,6,10,12,10,13,14,14,7,12,12,10,8,12,11,10,14,15,12,5,13,8,5,11,16,12,2,1,3,3,1,2,1,1,3,1,3
"1901",2000298394,"David Momoh","6/24/2005 (17 years old)","ST (C)","Sant Andreu","Spanish Federation Second Group 3","SLE","Yes","6/13/2022","6/30/2026","$16K - $160K","Right","Weak","Very Strong","5'11""","149 lbs","-","-",85,102,6,7,9,11,10,8,12,9,7,6,9,10,7,9,13,11,12,11,8,9,14,12,7,12,5,8,7,9,12,13,12,11,14,13,10,10,12,12,10,12,14,8,6,16,8,8,14,14,12,3,1,2,3,1,1,3,3,2,1,1
"1902",87040509,"Luis Palma","1/17/2000 (23 years old)","AM (LC), ST (C)","Aris","Greek Super League 1","HON","No","1/19/2022","6/30/2026","$4.3M - $8.2M","Right","Reasonable","Very Strong","5'10""","163 lbs","123","36",115,130,16,15,13,13,14,17,12,16,7,6,13,14,7,14,10,13,9,12,8,8,13,12,7,13,7,8,13,10,12,11,11,10,11,12,12,11,7,15,12,7,12,8,11,10,11,15,13,19,15,3,3,3,2,3,2,1,2,2,3,3
"1903",72006696,"Roger Espinoza","10/25/1986 (36 years old)","DM, M (C)","Sporting KC","Major League Soccer","HON","No","12/2/2022","12/31/2023","$16K - $150K","Left","Very Strong","Reasonable","5'10""","185 lbs","380","14",106,130,9,11,12,9,13,9,9,7,9,10,13,8,14,11,15,13,14,11,13,9,11,9,15,11,14,14,12,15,9,12,13,9,13,10,8,12,13,6,8,12,11,9,7,12,15,10,13,11,10,3,2,1,1,1,2,3,1,3,1,3
"1904",87034557,"Jhow Benavidez","12/26/1995 (27 years old)","AM (RLC)","Real España","Liga Nacional de Honduras","HON","No","6/15/2020","6/30/2025","$70K - $210K","Right","Reasonable","Very Strong","5'10""","169 lbs","306","39",91,130,7,9,10,13,13,4,1,6,5,6,9,10,7,11,13,9,9,12,8,13,4,11,6,11,7,8,10,10,13,13,7,4,9,13,13,5,17,14,9,10,12,13,8,9,5,7,9,11,14,1,2,3,3,1,2,1,1,3,1,3
"1905",87001967,"Levon Smith","8/3/1985 (37 years old)","GK","Arsenal (HON)","Liga de Ascenso de Honduras","HON","No","6/14/2021","6/30/2024","$500 - $4K","Right","Fairly Strong","Very Strong","6'2""","189 lbs","-","-",92,129,4,1,1,2,2,8,1,1,3,1,11,2,2,1,9,11,15,9,14,14,14,1,9,1,14,9,8,8,8,8,8,14,15,8,7,8,11,10,4,9,12,10,5,7,9,2,11,7,14,10,12,8,13,12,11,14,7,9,12,13
"1906",87002075,"Jerry Bengtson","4/8/1987 (36 years old)","ST (C)","Olimpia (HON)","Liga Nacional de Honduras","HON","No","6/14/2021","6/30/2024","$1K - $9K","Right","Fairly Strong","Very Strong","6'2""","160 lbs","435","193",113,128,5,8,9,15,11,6,14,7,5,10,11,13,9,12,13,12,13,12,12,11,10,8,11,12,9,11,8,11,12,11,12,13,14,14,13,14,5,12,4,6,6,8,9,13,6,14,15,11,5,2,2,2,4,2,1,1,1,1,3,3
"1907",87015304,"Romell Quioto","8/9/1991 (31 years old)","AM (RL), ST (C)","CF Montréal","Major League Soccer","HON","No","11/30/2020","12/31/2023","$240K - $2.4M","Right","Reasonable","Very Strong","5'11""","171 lbs","320","101",120,128,10,10,13,13,12,12,13,7,10,7,9,6,6,13,13,10,13,11,12,9,11,8,11,12,7,9,11,13,13,12,12,12,17,16,12,13,11,6,8,7,10,12,8,12,13,12,9,12,9,1,1,2,1,3,3,1,3,1,1,2
"1908",87039294,"Denil Maldonado","5/26/1998 (25 years old)","D (RC)","LAFC","Major League Soccer","HON","No","6/15/2020","6/30/2025","$100K - $1M","Right","Fairly Strong","Very Strong","6'0""","171 lbs","144","5",111,128,5,9,11,1,9,1,13,8,6,13,10,5,13,8,6,10,12,12,12,12,12,5,12,8,11,12,5,13,12,11,11,12,14,11,12,12,10,5,3,10,12,9,6,7,7,6,11,12,7,4,2,3,2,1,1,2,1,2,1,3
"1909",87030583,"Harold Fonseca","10/8/1993 (29 years old)","GK","Olancho FC","Liga Nacional de Honduras","HON","No","12/15/2022","6/30/2024","$5K - $50K","Right","Reasonable","Very Strong","6'1""","176 lbs","133","-",94,125,8,3,3,1,2,11,1,1,2,1,13,13,1,1,7,7,10,7,10,13,13,1,12,1,12,8,7,7,12,11,11,11,13,12,7,11,12,14,1,13,13,11,5,6,10,3,19,11,7,11,5,9,9,10,12,13,5,8,10,11
"1910",87034793,"Devron García","2/17/1996 (27 years old)","D (C), DM, M (C)","Real España","Liga Nacional de Honduras","HON","No","7/1/2019","6/30/2025","$70K - $210K","Right","Reasonable","Very Strong","6'2""","187 lbs","227","10",92,125,4,6,9,8,10,4,12,8,5,11,9,8,12,11,13,9,13,9,10,10,9,5,8,9,9,13,6,13,12,11,11,13,13,14,13,12,12,13,12,12,11,9,5,11,11,12,11,12,6,3,3,1,3,1,1,2,2,3,3,1
"1911",87000377,"Brayan Beckeles","11/28/1985 (37 years old)","D/WB (R)","Olimpia (HON)","Liga Nacional de Honduras","HON","No","12/31/2020","6/30/2024","$14K - $40K","Right","Reasonable","Very Strong","6'1""","180 lbs","387","10",106,123,5,10,10,7,9,5,12,5,12,12,9,5,12,10,15,12,14,11,10,13,14,7,11,10,11,10,8,14,11,10,14,13,14,12,12,14,13,15,12,12,11,10,4,13,12,5,15,11,8,3,2,3,3,2,2,3,3,2,2,2
"1912",2000215881,"Esheik Kamara","2/7/2002 (21 years old)","D (C)","Bo Rangers","Sierra Leonean Premier Division","SLE","No","7/1/2019","6/30/2024","$1.5K - $4.5K","Right","Reasonable","Very Strong","6'4""","182 lbs","-","-",79,102,3,2,4,4,7,1,13,5,5,14,6,1,14,6,13,7,9,4,7,13,4,5,1,5,14,7,7,8,10,10,8,15,12,11,9,8,14,10,10,11,10,10,14,12,9,2,20,9,8,3,2,2,1,1,2,2,1,2,2,2
"1913",87000102,"Mario Martínez","7/30/1989 (33 years old)","M/AM (RLC), ST (C)","Olancho FC","Liga Nacional de Honduras","HON","No","6/30/2022","6/30/2024","$30K - $325K","Left","Very Strong","Fairly Strong","5'8""","154 lbs","372","69",114,122,12,12,12,8,13,9,9,9,10,7,12,6,6,13,11,11,9,10,12,10,11,9,11,11,8,9,11,13,13,13,9,6,13,13,13,8,14,12,12,12,11,10,4,12,8,8,13,12,10,3,2,1,1,2,4,1,4,3,3,1
"1914",20042309,"Elder Torres","4/14/1995 (28 years old)","AM (LC)","UPNFM FC","Liga Nacional de Honduras","HON","No","12/31/2020","6/30/2024","$75K - $230K","Left Only","Very Strong","Weak","5'7""","145 lbs","198","7",94,121,6,12,6,12,10,3,8,9,7,8,11,9,4,15,10,8,9,10,8,14,3,12,5,13,8,8,13,11,13,13,10,7,8,14,9,8,8,14,1,13,12,11,5,7,13,2,9,10,17,3,2,2,1,2,1,3,3,3,4,2
"1915",87038195,"Douglas Martìnez","6/5/1997 (26 years old)","AM (RL), ST (C)","Indy Eleven","USSL Championship Eastern Conference","HON","No","3/17/2023","11/30/2023","$30K - $300K","Right","Weak","Very Strong","5'11""","152 lbs","148","39",101,120,10,8,11,13,11,7,9,8,8,5,11,13,7,12,16,12,10,11,10,10,13,13,13,12,8,10,12,13,13,12,8,11,11,14,11,9,10,19,3,10,11,12,13,15,7,4,11,11,13,1,1,2,2,4,2,3,1,2,1,2
"1916",87015259,"David Velásquez","12/8/1989 (33 years old)","D (C), DM","Victoria (HON)","Liga Nacional de Honduras","HON","No","5/31/2021","6/30/2024","$10K - $100K","Right","Fairly Strong","Very Strong","6'0""","171 lbs","266","9",105,120,7,7,11,9,12,5,12,4,8,12,11,6,13,11,13,9,13,11,11,11,4,6,9,9,10,13,9,12,12,12,11,11,13,13,13,11,13,7,9,12,12,11,4,11,10,8,13,11,11,2,1,3,2,3,2,1,2,2,1,3
"1917",87015301,"Rubilio Castillo","11/26/1991 (31 years old)","ST (C)","Nantong","Chinese Super League","HON","No","2/28/2023","12/31/2024","Not for Sale","Right","Reasonable","Very Strong","6'0""","174 lbs","348","154",105,120,8,10,11,12,11,8,12,6,3,7,9,12,8,11,12,12,12,11,10,9,14,9,12,12,9,8,10,13,13,12,11,12,13,14,11,12,12,9,1,12,11,11,3,8,10,8,12,10,12,1,2,1,4,3,1,3,2,1,3,3
"1918",87001299,"Bayron Oliva","12/21/1987 (35 years old)","D/WB (R)","Olanchano","Lower Leagues","HON","No","7/1/2022","6/30/2024","$500 - $4K","Right","Fairly Strong","Very Strong","6'0""","167 lbs","2","-",78,120,5,10,6,4,10,2,8,4,8,9,10,2,14,9,12,9,9,9,8,12,17,7,6,8,10,7,7,9,11,10,9,10,12,8,11,8,11,7,4,9,9,11,13,4,8,2,18,10,18,3,2,1,1,4,3,2,1,2,1,1
"1919",87040726,"Kervin Arriaga","1/5/1998 (25 years old)","DM, M (C)","Minnesota","Major League Soccer","HON","No","2/16/2022","12/31/2023","$170K - $1.7M","Right","Weak","Very Strong","6'3""","189 lbs","164","22",112,120,11,7,9,10,13,10,14,11,9,9,13,8,12,13,14,9,16,12,9,12,14,5,3,11,12,11,13,13,11,10,12,16,14,13,14,14,12,7,10,10,13,14,9,13,11,3,12,11,12,3,3,1,3,4,2,3,1,3,1,3
"1920",87037944,"Maylor Núñez","7/5/1996 (26 years old)","D/WB/M (R)","Olimpia (HON)","Liga Nacional de Honduras","HON","No","12/31/2018","6/30/2025","$16K - $160K","Right","Reasonable","Very Strong","5'11""","149 lbs","166","3",94,120,9,13,9,6,9,6,8,5,8,10,9,2,11,10,14,10,9,4,8,11,16,11,13,9,7,9,7,10,14,14,8,6,15,14,8,10,11,12,1,12,12,11,10,8,5,7,12,12,7,3,3,3,1,3,2,1,1,3,1,2
"1921",87033272,"Allans Vargas","9/25/1993 (29 years old)","D (LC), WB (L)","Marathón","Liga Nacional de Honduras","HON","No","5/31/2021","6/30/2025","$20K - $210K","Left","Very Strong","Reasonable","6'0""","152 lbs","228","10",89,120,4,11,7,3,9,1,9,6,7,14,9,2,14,7,15,11,9,7,9,14,10,5,11,7,12,8,6,8,14,12,8,7,8,14,10,7,12,5,7,11,13,10,12,18,7,3,19,11,11,2,1,2,2,4,3,3,1,2,1,1
"1922",80035258,"Joseph Rosales","11/6/2000 (22 years old)","M (C)","Minnesota","Major League Soccer","HON","No","12/7/2022","12/31/2023","$325K - $3.4M","Left","Very Strong","Reasonable","5'11""","152 lbs","83","2",106,120,11,11,13,8,13,7,8,10,9,9,12,10,11,13,12,11,12,10,11,11,14,12,9,12,10,13,11,14,12,13,12,10,14,12,12,12,14,3,1,16,11,13,5,3,14,1,9,12,11,2,4,2,3,1,4,2,2,2,2,4
"1923",2000158498,"Saidu Kamara","3/3/2002 (21 years old)","DM, M (C)","Bo Rangers","Sierra Leonean Premier Division","SLE","No","6/13/2022","6/30/2024","$0 - $5K","Right","Fairly Strong","Very Strong","6'1""","167 lbs","-","-",76,101,5,5,5,8,14,7,7,9,3,9,12,4,14,9,15,9,8,10,6,14,11,7,13,8,7,13,7,12,9,9,8,13,15,9,7,5,16,12,13,11,10,13,8,12,11,2,14,13,10,3,2,2,2,1,2,2,1,1,1,3
"1924",87031274,"Bryan Róchez","1/1/1995 (28 years old)","ST (C)","PTM","Portuguese Premier League","HON","No","7/13/2022","6/30/2025","$65K - $650K","Right","Reasonable","Very Strong","6'0""","165 lbs","242","84",106,120,5,5,12,13,12,9,15,8,3,4,8,13,5,10,18,15,16,11,12,8,11,8,8,13,4,9,7,11,12,12,11,14,15,13,12,13,9,11,11,7,7,8,8,11,6,8,11,12,12,3,1,1,3,1,1,3,1,1,3,3
"1925",2000262765,"Giancarlos Sacaza","1/18/2004 (19 years old)","D (C)","Motagua","Liga Nacional de Honduras","HON","No","7/1/2022","6/30/2025","$90K - $275K","Right","Reasonable","Very Strong","6'3""","174 lbs","1","-",70,120,1,2,2,4,6,1,12,2,1,12,6,2,11,1,6,10,8,5,5,12,5,5,5,4,12,5,1,6,12,9,6,13,12,12,7,5,11,9,3,8,10,14,8,12,9,8,10,9,10,3,1,2,1,2,2,1,3,1,1,2
"1926",87001057,"Luis Guzmán","12/19/1979 (43 years old)","WB/M (L), AM (LC)","Real de Minas","-","HON","No","6/14/2021","6/30/2024","$18K - $55K","Left","Very Strong","Fairly Strong","5'7""","147 lbs","199","10",104,120,12,11,13,10,12,7,12,6,7,8,11,7,8,12,9,9,9,11,10,7,4,13,14,11,8,9,11,12,13,13,10,6,11,13,13,10,15,11,2,13,11,11,12,7,12,8,13,12,9,1,2,2,1,2,2,2,1,1,1,1
"1927",87033270,"Jonathan Paz","6/18/1995 (27 years old)","D (C), DM","Olimpia (HON)","Liga Nacional de Honduras","HON","No","6/15/2020","6/30/2025","$16K - $160K","Right","Reasonable","Very Strong","6'1""","180 lbs","241","3",92,119,5,7,4,5,8,7,12,7,5,8,6,5,13,8,7,8,10,8,6,11,8,6,10,7,12,7,5,9,13,13,8,13,13,13,13,9,13,11,5,11,12,11,12,16,5,5,11,9,12,3,2,2,3,2,2,3,3,1,1,3
"1928",87038129,"Shalton González","12/17/1995 (27 years old)","M (RL), AM (R)","Olancho FC","Liga Nacional de Honduras","HON","No","7/1/2022","6/30/2024","$0","Right","Reasonable","Very Strong","5'11""","154 lbs","26","-",87,118,8,12,9,9,12,3,5,6,4,6,10,3,7,11,12,7,8,9,4,9,7,11,5,9,6,7,7,12,13,13,7,5,13,13,13,5,12,2,1,11,12,13,8,12,11,4,11,12,18,3,2,2,3,4,3,2,1,1,4,3
"1929",87032343,"Marcelo Canales","1/6/1991 (32 years old)","M (RC), AM (C)","Vida","Liga Nacional de Honduras","HON","No","6/30/2022","6/30/2024","$4.5K - $45K","Right","Reasonable","Very Strong","5'9""","152 lbs","242","23",108,118,12,11,14,11,13,9,10,9,5,7,12,13,6,14,12,12,10,11,12,12,9,12,11,12,8,12,12,12,13,14,10,7,13,13,13,9,13,5,12,12,12,10,5,13,6,6,14,12,18,2,3,3,1,2,3,3,2,2,2,1
"1930",87036354,"Kevin Álvarez","8/3/1996 (26 years old)","D/WB (R)","Motagua","Liga Nacional de Honduras","HON","No","12/31/2022","12/31/2023","$0 - $110K","Right Only","Weak","Very Strong","5'11""","165 lbs","173","10",101,118,9,10,10,6,11,8,8,8,8,12,13,6,14,10,13,10,10,10,9,10,10,5,5,12,10,12,11,12,14,13,11,12,14,15,14,11,15,11,11,11,10,8,11,4,12,7,9,11,7,1,2,4,2,3,3,3,2,1,2,2
"1931",87033271,"Luis Aurelio López","9/13/1993 (29 years old)","GK","Real España","Liga Nacional de Honduras","HON","No","6/15/2020","6/30/2024","$8K - $80K","Right Only","Weak","Very Strong","5'11""","191 lbs","237","1",102,118,4,3,2,2,1,6,1,1,3,1,10,2,1,1,12,14,11,7,9,14,4,2,9,2,13,9,8,8,11,11,13,10,13,12,8,14,11,4,3,10,11,11,13,8,12,8,11,13,11,13,14,14,9,11,11,14,16,12,13,10
"1932",7720067,"Jerry Palacios","5/13/1982 (41 years old)","ST (C)","Bandits (BLZ)","Belizean Premier Football League","HON","No","6/14/2021","6/30/2024","$500 - $3.5K","Right","Fairly Strong","Very Strong","5'11""","176 lbs","237","68",90,117,8,8,10,8,12,9,11,8,1,8,10,12,8,11,10,11,13,9,11,10,8,15,13,12,9,9,8,12,11,11,12,13,9,11,12,12,11,8,7,11,14,12,10,10,6,6,8,11,7,3,1,1,2,4,3,2,1,3,3,3
"1933",87037670,"Germán Mejía","10/1/1994 (28 years old)","D/WB (R), DM","Olimpia (HON)","Liga Nacional de Honduras","HON","No","6/15/2020","6/30/2025","$18K - $170K","Right","Reasonable","Very Strong","5'7""","154 lbs","256","4",88,117,5,8,7,7,11,7,7,8,1,9,7,4,12,8,6,13,8,6,8,14,15,5,5,7,9,8,9,12,14,14,8,5,11,14,7,7,11,2,5,10,9,8,10,15,8,5,13,13,16,2,1,3,1,3,1,2,3,2,3,1
"1934",18110497,"Amadu Jalloh","10/2/2000 (22 years old)","AM (L)","R Knokke FC","Belgian First National Amateur Division","SLE","Yes","7/1/2022","6/30/2024","$8K - $24K","Right Only","Weak","Very Strong","5'11""","160 lbs","51","9",84,100,8,13,11,10,14,6,9,8,5,5,9,8,7,11,6,8,2,12,8,8,11,12,13,13,7,9,9,9,13,12,8,7,16,14,8,8,12,18,12,12,9,13,6,3,8,5,8,10,16,3,2,1,2,1,1,1,3,2,1,2
"1935",87032256,"Henry Figueroa","12/28/1992 (30 years old)","D (RC)","Vida","Liga Nacional de Honduras","HON","No","5/31/2020","6/30/2024","$22K - $210K","Right","Fairly Strong","Very Strong","5'10""","163 lbs","195","6",101,116,9,13,9,7,11,6,13,5,6,11,9,6,11,11,13,9,13,10,12,10,14,6,9,9,9,12,9,13,12,12,11,12,14,14,13,11,9,6,11,10,12,11,4,13,11,5,12,11,17,2,2,1,1,2,1,3,2,4,1,2
"1936",87001071,"Alfredo Mejía","4/3/1990 (33 years old)","DM, M (C)","Levadeiakos","Greek Super League 2 North","HON","No","5/26/2022","6/30/2024","$18K - $180K","Right","Weak","Very Strong","5'7""","160 lbs","316","15",105,115,8,9,10,8,12,9,10,13,9,13,13,9,12,12,16,13,14,10,12,11,16,8,12,10,12,15,12,14,10,12,10,6,13,12,12,9,10,12,7,12,13,14,5,13,14,6,15,13,14,2,2,2,3,1,3,2,3,3,1,1
"1937",87001968,"Georgie Welcome","3/9/1985 (38 years old)","ST (C)","Juticalpa","Liga de Ascenso de Honduras","HON","No","2/10/2021","6/30/2024","$0 - $12K","Right","Weak","Very Strong","6'4""","187 lbs","207","56",80,115,2,3,7,11,7,5,13,7,3,6,7,10,3,7,12,12,13,9,10,8,13,8,12,10,7,10,4,14,11,10,15,14,13,10,12,14,12,11,14,14,12,13,6,15,12,5,13,13,11,3,3,4,2,2,1,1,1,1,1,3
"1938",87037764,"Kevin López","2/3/1996 (27 years old)","WB (R), M (RL), AM (R)","Olimpia (HON)","Liga Nacional de Honduras","HON","No","12/31/2022","6/30/2025","$16K - $160K","Right","Reasonable","Very Strong","5'7""","152 lbs","247","54",92,115,8,13,12,10,10,8,2,6,7,8,12,5,9,9,5,11,7,10,10,13,16,8,10,13,8,9,9,10,14,14,7,9,11,14,7,7,11,5,4,10,12,10,13,14,5,2,13,11,15,1,2,2,1,1,3,4,2,2,3,3
"1939",87000488,"Wilmer Crisanto","6/24/1989 (33 years old)","D (RC), WB/M (R)","Real Sociedad (HON)","Liga Nacional de Honduras","HON","No","12/15/2022","6/30/2024","$30K - $325K","Right","Reasonable","Very Strong","5'11""","176 lbs","396","26",112,115,9,9,12,8,12,6,10,6,11,9,11,5,12,12,14,10,14,11,13,9,14,8,13,12,9,13,10,14,13,12,14,11,14,14,14,14,15,4,4,11,12,13,4,13,11,5,14,9,19,3,2,2,1,1,3,3,2,2,3,3
"1940",87042725,"Edwin Rodríguez","9/25/1999 (23 years old)","AM (RLC)","Olimpia (HON)","Liga Nacional de Honduras","HON","No","1/26/2023","6/30/2026","$80K - $250K","Right","Reasonable","Very Strong","5'5""","132 lbs","133","12",85,115,7,9,12,9,10,7,6,6,7,7,9,5,6,12,5,9,8,11,9,14,16,11,13,14,5,9,11,13,11,12,9,5,12,11,11,4,10,7,12,8,11,11,11,8,7,2,12,10,9,2,3,3,2,4,2,4,3,2,3,1
"1941",5397619,"Luis Rodas","1/3/1985 (38 years old)","M/AM (R), ST (C)","Carchá","Segunda División de Guatemala","HON","No","6/14/2021","6/30/2024","$2K - $20K","Right","Fairly Strong","Very Strong","5'7""","160 lbs","176","43",98,115,10,10,13,10,12,6,13,7,6,7,12,11,7,12,8,9,8,10,12,8,9,10,9,12,7,8,9,11,14,13,9,6,13,13,11,9,9,12,4,9,12,10,6,11,6,11,13,10,18,3,2,2,1,1,3,1,2,3,1,1
"1942",87037651,"Edrick Menjívar","3/1/1993 (30 years old)","GK","Olimpia (HON)","Liga Nacional de Honduras","HON","No","6/14/2021","6/30/2024","$4K - $40K","Right","Reasonable","Very Strong","6'2""","189 lbs","201","-",98,115,3,1,1,2,4,6,1,3,2,3,6,2,2,4,10,13,13,7,9,14,9,1,5,1,11,9,8,8,11,8,9,9,14,10,7,6,13,15,8,10,11,11,5,12,11,5,12,12,20,12,7,14,5,9,10,11,5,10,10,13
"1943",87017190,"Alex López","6/5/1992 (31 years old)","M/AM (RC)","Alajuelense","Primera División de Costa Rica","HON","No","6/14/2021","6/30/2024","$85K - $850K","Right","Reasonable","Very Strong","5'9""","156 lbs","376","52",106,115,8,10,12,10,13,10,9,11,4,7,12,7,6,13,13,10,11,10,8,10,8,9,11,11,8,10,12,7,13,13,11,5,13,13,13,9,8,12,12,13,6,11,5,13,6,5,14,12,9,4,3,3,2,4,1,2,1,1,3,2
"1944",87037819,"Kevin Johnson","9/11/1995 (27 years old)","M (C)","Real de Minas","-","HON","No","1/1/2020","6/30/2024","$6K - $65K","Right","Reasonable","Very Strong","5'9""","149 lbs","30","-",88,115,6,6,3,5,11,6,6,9,5,8,13,6,8,13,6,8,6,8,8,13,17,5,10,8,10,7,13,12,13,13,7,7,9,13,9,4,14,6,6,12,9,12,12,5,6,2,19,9,7,1,3,1,1,3,3,1,2,1,2,2
"1945",2000008937,"Maxim Gaevoy","5/27/2002 (21 years old)","M (C), AM (R)","Smorgon","Belarusian Highest League","BLR","No","1/1/2022","12/31/2023","$35K - $100K","Right","Reasonable","Very Strong","5'10""","136 lbs","16","-",78,110,10,7,6,7,8,6,7,8,1,3,11,1,8,10,15,5,6,9,6,13,14,10,13,8,8,7,10,8,13,13,7,7,12,13,13,5,10,13,12,11,11,14,5,4,6,2,8,10,19,3,3,3,3,3,1,1,2,2,2,3
"1946",13161745,"Christian Moses","8/10/1993 (29 years old)","ST (C)","Vasalunds IF","Swedish First Division North","SLE","No","2/2/2023","12/31/2023","$30K - $90K","Right","Weak","Very Strong","6'0""","167 lbs","141","41",89,100,5,6,11,10,10,6,11,6,5,5,10,8,6,11,12,11,9,11,10,9,11,9,5,11,7,10,10,10,13,11,12,12,12,13,12,12,5,9,9,10,10,9,5,8,10,9,11,10,12,1,2,2,2,3,3,1,3,4,2,2
"1947",87030592,"Ricardo Barrios","2/22/1994 (29 years old)","D (C), DM, M (C)","Juticalpa","Liga de Ascenso de Honduras","HON","No","6/15/2020","6/30/2025","$24K - $250K","Right","Reasonable","Very Strong","6'5""","198 lbs","79","3",92,115,6,6,4,8,12,8,10,10,4,11,9,5,14,10,15,9,9,10,9,14,4,7,14,10,9,9,12,11,10,9,13,16,11,13,7,14,15,7,1,10,10,12,5,5,7,6,14,10,16,1,3,2,1,2,3,3,2,2,1,3
"1948",2000085255,"Murana Conteh","12/31/2000 (22 years old)","ST (C)","Ljungskile SK","Swedish First Division South","SLE","No","2/20/2021","11/30/2025","$500 - $3.5K","Right","Weak","Very Strong","5'11""","160 lbs","54","16",69,100,6,7,11,10,10,8,7,7,5,6,7,8,6,10,12,8,9,8,9,8,12,7,6,11,7,8,7,8,13,12,8,9,12,12,12,8,5,10,10,10,10,8,10,1,10,8,9,12,13,2,3,4,3,3,3,1,3,3,2,1
"1949",33001384,"Medo","11/16/1987 (35 years old)","DM, M (C)","Gnistan","Finnish First Division","SLE","Yes","8/15/2022","11/15/2023","$0","Right","Weak","Very Strong","5'9""","152 lbs","332","22",80,100,7,7,7,8,12,10,9,11,6,10,11,9,11,10,15,12,13,11,10,13,14,8,12,13,9,11,10,12,7,8,10,8,12,7,10,10,9,8,10,9,7,10,12,13,10,9,12,9,12,2,2,4,3,1,4,4,1,1,2,1
"1950",2000109760,"Suffian Kalokoh","12/22/2001 (21 years old)","AM (RL), ST (C)","Bo Rangers","Sierra Leonean Premier Division","SLE","No","7/1/2022","6/30/2024","$0","Left","Very Strong","Fairly Strong","5'11""","154 lbs","-","-",72,98,6,8,12,13,13,4,7,7,2,5,9,6,3,11,5,8,2,12,6,8,13,13,5,7,6,7,6,7,13,13,13,6,13,13,6,5,11,15,12,10,12,9,12,6,6,2,12,11,12,3,1,2,2,2,3,2,2,3,2,2
"1951",2000249233,"Mengeh Turay","6/11/2002 (21 years old)","M/AM (C)","AA Gent","Jupiler Pro League","SLE","No","9/27/2021","6/30/2024","$16K - $50K","Right Only","Weak","Very Strong","5'8""","143 lbs","6","-",65,97,1,5,5,10,14,4,6,5,1,4,13,1,7,10,8,8,7,6,6,12,2,9,8,13,8,6,11,10,13,9,7,7,15,12,7,4,12,16,12,12,13,11,8,3,6,1,12,12,9,3,3,1,1,1,3,3,3,2,2,2
"1952",2000168627,"Alie Conteh","10/29/2002 (20 years old)","ST (C)","East End Lions","Sierra Leonean Premier Division","SLE","No","6/13/2022","6/30/2024","$0","Right","Reasonable","Very Strong","6'1""","165 lbs","-","-",72,97,7,4,9,13,10,6,13,8,2,5,8,4,3,12,11,11,8,9,8,12,3,15,9,14,8,7,2,8,11,8,5,10,15,10,4,4,10,20,10,12,10,9,14,12,9,2,9,12,16,2,1,4,1,1,2,3,1,1,2,1
"1953",23414964,"Suphanat Mueanta","8/2/2002 (20 years old)","AM (RL), ST (C)","Buriram Utd","Thai League","THA","No","5/31/2023","6/30/2026","$160K - $1.6M","Right","Fairly Strong","Very Strong","5'8""","138 lbs","110","28",107,140,3,8,13,14,13,5,8,7,4,5,10,12,7,13,9,13,11,13,13,13,15,14,3,14,5,12,12,11,12,13,7,8,13,12,12,10,10,13,16,15,13,14,9,13,6,4,13,15,14,3,1,3,1,1,2,4,3,3,3,2
"1954",53138009,"Nicholas Mickelson","7/24/1999 (23 years old)","D (RL), WB (R)","OB","3F Superliga","THA","Yes","8/31/2021","6/30/2025","$850K - $1.8M","Right","Weak","Very Strong","6'1""","160 lbs","124","-",109,136,11,12,13,6,13,10,6,6,7,8,9,7,9,14,9,11,10,9,9,9,14,11,6,11,8,14,11,9,15,15,9,12,12,13,16,7,14,7,12,14,12,8,6,8,8,8,9,15,15,3,1,1,2,1,1,1,2,3,2,2
"1955",23328209,"Jaroensak Wonggorn","5/18/1997 (26 years old)","M (R), AM (RC)","Muangthong Utd","Thai League","THA","No","12/19/2022","6/30/2025","$750K - $1.6M","Right","Reasonable","Very Strong","5'6""","132 lbs","151","14",112,133,8,11,13,11,12,8,8,12,6,7,12,11,8,12,9,10,12,11,11,12,13,13,9,11,3,11,12,12,15,14,10,7,13,13,13,7,8,15,14,13,13,10,8,13,6,4,12,13,14,2,3,3,2,1,1,3,4,3,1,3
"1956",23328907,"Supachok Sarachat","5/22/1998 (25 years old)","M (L), AM (RLC)","Sapporo","J1 League","THA","No","11/12/2022","1/31/2027","$55K - $550K","Right","Fairly Strong","Very Strong","5'7""","145 lbs","192","43",107,131,7,10,12,11,12,8,7,1,9,2,12,11,6,12,6,10,14,11,11,11,15,15,6,10,5,9,11,12,13,13,8,6,14,12,12,10,9,13,16,15,13,10,9,13,4,5,14,15,14,3,1,2,4,3,3,2,1,1,3,2
"1957",5112976,"Curtis Davies","3/15/1985 (38 years old)","D (C)","Derby","Sky Bet League One","SLE","Yes","6/14/2021","6/30/2024","$0 - $20K","Right Only","Weak","Very Strong","6'2""","167 lbs","558","27",98,140,2,5,10,5,9,5,16,3,7,15,7,4,14,9,12,13,15,13,13,11,17,5,16,9,14,15,4,10,5,6,11,15,14,7,9,12,6,14,17,20,13,16,14,16,5,3,14,16,13,1,1,2,1,3,3,1,2,1,1,3
"1958",23280235,"Kritsada Kaman","3/18/1999 (24 years old)","D (C), DM, M (C)","Chonburi","Thai League","THA","No","6/15/2020","5/31/2025","$55K - $550K","Right","Reasonable","Very Strong","5'9""","154 lbs","146","9",103,129,4,7,7,11,11,12,10,12,9,11,12,9,11,8,14,14,11,10,12,12,17,13,12,3,13,13,12,13,11,10,7,9,13,11,13,12,14,10,11,18,11,10,8,10,10,5,13,17,13,3,1,3,3,1,1,3,3,2,2,3
"1959",23246378,"Chanathip Songkrasin","10/5/1993 (29 years old)","AM (RLC)","Kawasaki-F","J1 League","THA","No","1/11/2022","12/31/2025","$475K - $4.8M","Right","Strong","Very Strong","5'3""","130 lbs","296","33",122,129,4,7,15,12,14,5,5,11,4,2,14,8,8,13,5,12,12,12,13,11,15,15,5,11,8,13,14,13,15,13,5,4,13,13,13,9,13,13,14,15,13,12,7,12,4,8,10,14,14,1,4,3,3,4,2,1,1,3,2,2
"1960",93102146,"William Weidersjö","6/10/2001 (22 years old)","M/AM (C)","Port","Thai League","THA","Yes","12/31/2021","6/30/2025","$140K - $1.4M","Right","Reasonable","Very Strong","5'10""","156 lbs","72","2",94,128,9,11,12,10,12,12,7,12,7,8,12,8,10,12,11,11,8,10,10,12,17,9,7,10,10,11,12,10,11,12,8,7,12,12,12,10,7,14,12,15,12,8,5,10,6,4,13,15,11,1,2,3,1,3,1,1,2,2,2,2
"1961",93058681,"Kevin Deeromram","9/11/1997 (25 years old)","D/WB (L)","Port","Thai League","THA","Yes","6/15/2020","6/30/2024","$180K - $550K","Left Only","Very Strong","Weak","5'11""","143 lbs","153","8",95,127,9,13,12,4,12,7,9,6,7,10,11,6,10,12,11,11,7,9,11,11,11,13,7,12,10,11,10,12,13,13,10,9,13,13,13,8,12,11,10,11,9,9,6,12,7,7,11,12,13,3,3,1,3,1,2,1,3,1,1,1
"1962",23459506,"Channarong Promsrikaew","4/17/2001 (22 years old)","M (C), AM (RLC)","Chonburi","Thai League","THA","No","7/1/2018","6/30/2024","$130K - $1.3M","Left","Very Strong","Reasonable","5'7""","136 lbs","74","5",101,126,9,12,12,9,11,10,7,10,5,4,13,8,7,13,6,13,9,11,11,12,15,15,4,11,6,12,14,13,12,12,8,8,13,11,12,10,8,14,11,15,11,9,9,5,7,8,12,15,14,1,3,3,3,1,4,2,3,2,2,2
"1963",23281251,"Thitawee Aksornsri","11/8/1997 (25 years old)","D (RC)","Port","Thai League","THA","No","6/14/2020","6/30/2025","$0","Right","Reasonable","Very Strong","6'0""","143 lbs","60","1",90,125,4,9,8,5,8,4,12,5,8,11,7,6,12,6,11,13,12,11,12,11,18,13,4,3,12,8,6,11,12,10,8,11,13,10,13,12,10,13,15,17,13,13,8,11,7,5,12,17,12,2,3,2,4,1,3,2,3,3,3,2
"1964",48042518,"Thanawat Suengchitthawon","1/8/2000 (23 years old)","M/AM (C)","Leicester","Sky Bet Championship","THA","Yes","9/19/2020","6/30/2026","$0 - $55K","Right","Weak","Very Strong","5'7""","149 lbs","-","-",88,125,11,10,12,8,12,12,8,10,12,8,12,12,5,13,15,10,13,12,12,10,15,14,13,12,8,12,13,12,10,11,11,10,11,11,12,8,12,20,11,12,11,12,7,13,5,6,12,11,16,3,3,1,2,3,3,2,1,3,3,2
"1965",29191714,"Ben Davis","11/24/2000 (22 years old)","M (C), AM (LC)","Chonburi","Thai League","THA","No","6/1/2023","6/30/2024","$170K - $1.7M","Right","Reasonable","Very Strong","5'8""","130 lbs","13","-",95,125,9,8,13,8,11,7,8,10,4,4,12,11,8,13,10,11,12,10,10,9,15,14,5,10,6,8,12,12,13,13,8,8,13,12,12,10,13,14,12,15,10,9,9,3,8,2,11,14,14,2,2,2,2,3,3,2,3,2,3,2
"1966",23368225,"Weerathep Pomphan","9/19/1996 (26 years old)","DM, M/AM (C)","Muangthong Utd","Thai League","THA","No","12/3/2018","6/30/2025","$550K - $1.7M","Left","Very Strong","Reasonable","6'0""","152 lbs","114","4",106,124,10,13,10,7,12,8,9,9,6,10,14,11,10,12,12,13,11,12,12,11,17,13,6,12,10,13,14,12,11,11,9,10,13,11,12,10,9,13,15,18,13,10,8,10,5,5,12,17,13,3,1,1,1,3,1,1,1,2,2,2
"1967",23281238,"Thitathorn Aksornsri","11/8/1997 (25 years old)","D (L)","Port","Thai League","THA","No","6/14/2020","6/30/2025","$28K - $275K","Left","Very Strong","Reasonable","6'0""","143 lbs","79","5",85,124,4,10,11,6,10,4,12,7,10,11,8,7,11,10,11,12,12,11,12,11,14,12,5,4,11,13,7,11,11,11,8,11,13,10,12,10,9,14,16,15,13,13,9,11,6,5,13,14,12,3,1,1,1,2,1,2,2,2,3,2
"1968",28028360,"Steven Caulker","12/29/1991 (31 years old)","D (C)","Wigan","Sky Bet League One","SLE","No","1/10/2023","6/30/2025","$24K - $240K","Right","Reasonable","Very Strong","6'3""","167 lbs","336","21",110,135,5,6,9,7,12,6,15,6,8,12,10,5,12,11,11,11,13,12,11,12,5,7,12,9,12,12,9,12,10,8,13,15,14,10,11,16,7,10,12,7,5,5,5,10,8,19,12,14,11,3,1,3,2,2,2,3,3,1,1,3
"1969",23366542,"Supachai Jaided","12/1/1998 (24 years old)","M/AM (C), ST (C)","Buriram Utd","Thai League","THA","No","5/31/2023","6/30/2026","$140K - $1.4M","Right","Fairly Strong","Very Strong","6'0""","154 lbs","181","43",106,124,4,6,11,13,12,6,12,8,8,7,9,12,10,11,12,12,11,13,10,13,15,11,2,12,7,13,9,12,12,12,10,12,13,11,12,12,11,13,12,14,12,10,9,11,6,4,12,14,12,1,2,1,1,3,2,3,1,3,2,3
"1970",23063113,"Kawin Thamsatchanan","1/26/1990 (33 years old)","GK","Muangthong Utd","Thai League","THA","No","8/9/2022","5/31/2024","$130K - $375K","Right Only","Weak","Very Strong","6'0""","171 lbs","176","-",98,124,1,2,2,1,10,1,3,2,1,2,8,1,1,6,5,11,13,12,10,11,13,12,11,7,13,12,5,7,12,12,9,12,12,11,11,10,1,19,15,14,12,13,9,11,2,8,11,10,14,11,9,12,8,13,10,11,5,12,11,10
"1971",2000227894,"Yotsakorn Burapa","6/8/2005 (18 years old)","ST (C)","Chonburi","Thai League","THA","No","7/1/2022","6/30/2024","$170K - $1.7M","Right","Fairly Strong","Very Strong","6'2""","176 lbs","31","7",81,123,7,6,10,12,9,4,10,8,5,5,8,9,7,10,10,11,12,12,9,10,14,12,5,12,5,8,7,11,11,11,7,10,12,10,11,10,11,11,11,14,10,11,8,1,5,5,12,14,20,2,2,1,2,2,4,2,1,1,1,3
"1972",23280236,"Sittichok Paso","1/28/1999 (24 years old)","AM (RL), ST (C)","Chonburi","Thai League","THA","No","6/15/2020","6/30/2025","$0 - $75K","Right","Weak","Very Strong","5'9""","147 lbs","88","8",67,122,2,9,11,11,9,4,7,10,2,2,9,10,4,10,7,11,9,11,10,10,12,13,8,11,9,11,10,10,11,10,6,7,12,11,11,7,8,12,15,12,11,12,11,11,7,6,11,11,13,2,2,3,1,1,1,3,3,3,3,4
"1973",23328980,"Ekanit Panya","10/21/1999 (23 years old)","M (RL), AM (RLC)","Muangthong Utd","Thai League","THA","No","7/5/2022","5/31/2026","$180K - $1.8M","Right","Reasonable","Very Strong","5'6""","123 lbs","160","23",113,122,4,11,13,12,13,6,7,10,2,7,12,10,8,12,10,12,10,11,11,11,13,15,7,12,8,14,13,13,13,13,8,9,13,12,12,10,7,12,16,13,12,11,8,13,4,3,14,13,14,2,3,2,2,1,3,3,3,2,2,3
"1974",23305296,"Phitiwat Sookjitthammakul","2/1/1995 (28 years old)","DM, M (C)","BG Pathum Utd","Thai League","THA","No","7/4/2022","6/30/2024","$110K - $1.1M","Left","Very Strong","Weak","5'8""","147 lbs","197","11",104,122,12,10,12,10,11,11,7,13,3,12,12,9,10,11,14,13,12,11,12,12,13,14,8,12,12,13,12,13,12,13,8,7,14,11,13,10,12,14,13,12,15,10,9,13,7,5,14,12,12,1,2,3,1,3,1,1,2,3,4,4
"1975",23040270,"Teerasil Dangda","6/6/1988 (35 years old)","AM (RC), ST (C)","BG Pathum Utd","Thai League","THA","No","5/30/2023","6/30/2025","Not for Sale","Right","Fairly Strong","Very Strong","6'0""","160 lbs","412","162",109,122,5,7,11,14,12,8,11,8,7,5,12,13,9,14,7,13,7,13,12,12,14,13,11,13,7,12,14,9,11,10,11,12,13,11,10,10,10,15,15,15,8,10,9,13,5,4,14,13,13,2,3,3,2,3,2,3,3,3,2,2
"1976",23289519,"Sasalak Haiprakhon","1/8/1996 (27 years old)","D/WB (RL), M (L), AM (RL)","Buriram Utd","Thai League","THA","No","6/15/2020","6/30/2025","$75K - $750K","Left","Very Strong","Fairly Strong","5'8""","143 lbs","140","5",113,121,4,9,13,7,11,6,6,10,7,8,11,7,9,12,13,10,11,10,11,9,17,15,5,10,7,11,11,13,14,13,6,8,14,13,12,9,16,17,14,17,10,10,9,12,10,6,13,17,14,3,1,2,1,2,1,1,2,3,2,3
"1977",23280685,"Chaowat Weerachart","6/23/1996 (26 years old)","M (C)","BG Pathum Utd","Thai League","THA","No","6/15/2020","6/30/2024","$240K - $700K","Left","Very Strong","Reasonable","5'8""","143 lbs","168","12",100,120,12,11,10,11,12,10,7,12,6,10,13,9,7,11,11,13,10,11,11,11,16,8,10,13,10,13,12,12,11,12,8,9,13,11,11,11,13,20,15,16,11,11,8,12,6,4,13,16,14,2,3,3,1,3,2,2,3,3,3,2
"1978",23098404,"Theerathon Bunmathan","2/6/1990 (33 years old)","D/WB (L), M (C)","Buriram Utd","Thai League","THA","No","12/16/2021","6/30/2024","$60K - $600K","Left","Very Strong","Reasonable","5'7""","134 lbs","384","30",120,120,14,14,13,12,14,15,6,13,13,11,14,13,11,13,13,13,14,10,12,12,15,14,14,8,12,13,14,12,12,13,7,7,13,13,12,11,12,13,13,16,13,11,6,13,9,1,13,14,12,3,1,1,3,2,1,3,2,2,3,3
"1979",37064890,"Alex Bangura","7/13/1999 (23 years old)","D/WB/M/AM (L)","SC Cambuur","Keuken Kampioen Divisie","SLE","Yes","11/16/2022","6/30/2024","$275K - $2.7M","Left","Very Strong","Weak","6'0""","163 lbs","103","5",123,133,11,12,12,7,11,11,11,11,10,10,11,7,10,11,14,10,13,12,11,11,17,10,6,11,11,14,7,14,15,12,9,11,13,15,14,7,13,16,10,14,12,9,4,7,8,2,10,12,16,2,3,3,3,1,3,3,3,2,3,1
"1980",27153139,"Jonathan Khemdee","5/9/2002 (21 years old)","D (C)","Ratchaburi","Thai League","THA","Yes","1/17/2023","6/30/2026","$12K - $120K","Right Only","Weak","Very Strong","6'3""","167 lbs","23","1",82,120,4,6,7,4,10,5,13,3,4,11,9,3,10,6,15,11,12,8,10,10,15,13,7,4,10,9,7,7,11,11,8,15,12,10,11,12,6,10,13,14,12,10,6,12,14,3,10,14,11,1,3,3,2,1,1,3,2,1,2,1
"1981",23282365,"Sivakorn Tiatrakul","7/7/1994 (28 years old)","M (C), AM (LC)","Chiangrai Utd","Thai League","THA","No","5/10/2022","5/31/2027","$500K - $1.5M","Left","Very Strong","Reasonable","5'9""","143 lbs","217","24",106,119,13,8,12,11,13,13,7,13,7,9,12,10,8,12,11,13,13,11,11,12,11,13,12,11,7,13,12,13,12,12,8,7,13,11,12,10,10,13,15,12,14,11,8,12,5,5,13,11,12,3,3,2,3,2,2,1,2,3,3,3
"1982",23123687,"Thitiphan Puangjan","9/1/1993 (29 years old)","DM, M (C)","Bangkok Utd","Thai League","THA","No","6/1/2022","6/30/2025","$28K - $275K","Right","Reasonable","Very Strong","5'10""","143 lbs","249","25",100,117,6,10,12,9,9,7,10,11,4,11,10,9,13,12,13,13,13,10,12,11,12,14,11,12,12,12,11,13,11,10,9,10,14,10,13,12,5,13,15,11,14,11,8,13,4,5,13,11,13,2,2,3,2,1,2,4,1,2,2,3
"1983",23282364,"Suphan Thongsong","8/26/1994 (28 years old)","D (C)","Bangkok Utd","Thai League","THA","No","12/9/2021","6/30/2025","$100K - $1M","Right","Reasonable","Very Strong","6'0""","143 lbs","138","1",100,116,2,4,6,6,11,3,13,3,7,13,7,4,13,5,10,13,12,11,13,12,10,5,11,3,13,12,4,10,12,11,6,12,13,11,13,12,12,12,11,11,10,12,9,12,6,1,13,12,20,1,1,1,3,2,1,1,3,3,1,2
"1984",93122429,"Anthonio Sanjairag","4/16/2002 (21 years old)","D (C)","Chonburi","Thai League","THA","Yes","5/4/2021","6/30/2025","$0","Right","Weak","Very Strong","6'2""","176 lbs","5","-",76,116,5,6,7,4,9,4,11,6,8,11,9,5,11,8,8,10,10,9,9,9,13,8,11,7,10,10,9,11,11,9,7,14,12,11,9,11,11,10,12,13,10,13,14,3,8,5,10,12,15,3,1,1,2,1,2,1,2,3,3,2
"1985",97208737,"Leon James","8/29/2001 (21 years old)","DM, M (C)","Nong Bua Pitchaya","Thai League Two","THA","No","6/1/2022","6/30/2025","$0","Right","Reasonable","Very Strong","5'11""","149 lbs","54","2",85,116,5,6,10,7,10,4,10,9,3,11,11,5,10,8,9,12,11,9,10,10,15,13,5,9,11,12,12,11,11,12,10,11,12,11,12,12,13,19,13,14,12,12,6,8,6,1,11,14,12,2,2,1,1,3,3,3,3,1,1,3
"1986",23106032,"Sarach Yooyen","5/30/1992 (31 years old)","M (C)","BG Pathum Utd","Thai League","THA","No","5/26/2020","5/31/2026","Not for Sale","Right","Fairly Strong","Very Strong","5'6""","132 lbs","239","14",101,114,11,13,12,10,12,12,7,10,2,10,13,10,7,12,8,12,11,10,10,12,13,13,13,10,7,13,12,12,12,12,8,7,14,11,13,9,9,12,15,14,12,10,7,12,6,6,13,13,13,2,1,1,1,1,2,2,2,3,2,3
"1987",23280222,"Worachit Kanitsribumphen","8/24/1997 (25 years old)","M/AM (C)","Port","Thai League","THA","No","6/1/2023","6/30/2024","$200K - $2M","Right","Reasonable","Very Strong","5'7""","132 lbs","193","43",92,114,5,10,12,12,11,5,7,10,9,6,13,10,7,12,8,12,10,11,8,11,11,12,6,11,7,12,13,10,12,12,6,7,13,11,11,7,13,17,10,12,10,11,9,8,6,8,13,10,8,2,1,3,1,1,2,3,1,4,4,1
"1988",93140496,"Patrik Gustavsson","4/19/2001 (22 years old)","AM (R), ST (C)","BG Pathum Utd","Thai League","THA","Yes","1/5/2022","6/30/2025","$120K - $1.2M","Right Only","Weak","Very Strong","6'0""","171 lbs","98","20",89,114,6,6,11,10,11,7,8,8,6,5,7,8,6,10,8,10,9,10,9,10,15,9,7,11,7,10,7,10,16,9,11,11,11,15,12,11,5,12,12,15,12,7,5,12,7,5,12,15,17,1,1,4,4,1,2,1,3,3,2,1
"1989",23328908,"Noppol Lakornpol","7/19/1999 (23 years old)","GK","Buriram Utd","Thai League","THA","No","6/15/2020","6/30/2026","$75K - $750K","Right","Reasonable","Very Strong","5'11""","165 lbs","113","-",97,113,4,3,2,1,11,9,8,1,2,3,11,4,1,7,12,12,11,11,12,11,15,1,7,1,12,7,4,5,11,12,8,10,13,9,7,10,13,10,12,14,9,9,13,13,10,2,13,14,12,9,9,13,8,11,13,12,5,10,11,11
"1990",43459202,"Yayah Kallon","6/30/2001 (21 years old)","AM (RLC), ST (C)","Genoa","Italian Serie A","SLE","No","7/1/2019","6/30/2027","$500K - $5M","Left","Very Strong","Reasonable","5'9""","154 lbs","55","1",116,132,5,9,13,10,12,8,10,10,3,4,11,9,7,11,9,11,11,9,9,11,11,10,6,12,7,10,10,11,15,14,11,8,14,15,11,10,13,13,13,12,15,13,6,11,7,2,11,13,14,1,2,2,2,1,2,2,3,1,4,2
"1991",2000037264,"Chatmongkol Rueangthanarot","5/9/2002 (21 years old)","D (L)","Chonburi","Thai League","THA","No","7/1/2020","6/30/2025","$80K - $800K","Left","Very Strong","Reasonable","5'9""","147 lbs","73","1",79,113,5,8,7,7,9,1,8,4,4,11,7,1,13,9,10,11,9,8,5,12,12,5,4,7,8,8,6,9,14,14,8,9,14,14,7,7,10,11,15,12,12,11,11,10,10,3,10,12,12,1,2,1,1,3,2,1,3,2,1,1
"1992",2000135387,"Kiattiphon Udom","6/26/2000 (22 years old)","GK","Chainat Hornbill","Thai League Two","THA","No","12/27/2021","6/30/2025","$28K - $300K","Right","Reasonable","Very Strong","6'3""","185 lbs","38","-",77,113,3,2,3,1,6,6,3,3,2,2,9,1,3,8,13,11,10,9,9,10,12,3,8,2,11,6,4,3,11,11,9,5,11,10,6,10,12,20,11,12,11,13,14,12,6,7,10,11,11,10,11,10,10,11,12,10,3,9,9,13
"1993",23289566,"Anon Amornlertsak","11/6/1997 (25 years old)","M (L), AM (RLC)","Bangkok Utd","Thai League","THA","No","10/24/2018","6/30/2024","$28K - $300K","Left","Very Strong","Reasonable","5'7""","143 lbs","154","28",91,112,10,10,13,9,12,8,3,8,2,4,10,12,7,12,12,11,12,8,10,10,12,12,4,12,6,10,10,11,13,13,5,6,12,12,12,8,11,17,15,12,10,13,9,8,4,5,12,12,12,3,1,2,3,4,2,3,3,3,1,1
"1994",23280525,"Bordin Phala","12/18/1994 (28 years old)","M/AM (RL)","Port","Thai League","THA","No","6/15/2020","6/30/2024","$200K - $600K","Right","Reasonable","Very Strong","6'0""","138 lbs","231","35",94,112,8,10,12,12,13,12,7,12,5,4,10,6,8,12,12,11,14,9,10,10,15,13,2,10,6,9,11,11,13,12,7,8,13,12,11,9,14,12,15,16,12,11,10,12,4,4,13,15,12,1,1,3,2,2,2,2,2,2,3,1
"1995",85045195,"Tristan Do","1/31/1993 (30 years old)","D/WB/M (R)","Muangthong Utd","Thai League","THA","Yes","6/1/2023","6/30/2024","$28K - $275K","Right","Reasonable","Very Strong","5'7""","141 lbs","252","22",100,111,8,11,13,9,11,7,8,9,12,10,10,12,12,12,13,13,10,10,12,11,11,13,5,8,11,12,10,13,12,12,7,8,13,12,12,11,14,15,15,11,12,10,5,13,6,4,14,11,13,3,1,2,1,3,2,1,1,3,2,1
"1996",91123788,"Manuel Bihr","9/17/1993 (29 years old)","D (C)","Bangkok Utd","Thai League","THA","Yes","6/15/2020","12/31/2023","$35K - $350K","Right Only","Weak","Very Strong","6'0""","167 lbs","230","8",98,110,5,6,8,6,10,5,12,5,4,12,11,4,13,10,12,12,12,10,11,12,10,10,8,9,13,11,11,13,10,10,11,12,13,11,13,13,13,14,14,11,14,13,6,13,5,6,10,10,7,2,1,3,3,3,3,2,1,2,3,2
"1997",23281377,"Peeradol Chamrasamee","9/15/1992 (30 years old)","DM, M (C)","Buriram Utd","Thai League","THA","No","7/21/2021","5/31/2024","$75K - $220K","Right","Reasonable","Very Strong","5'9""","154 lbs","169","29",90,110,6,8,11,10,12,10,7,12,4,8,12,11,11,12,12,11,12,10,9,11,12,13,11,9,9,12,11,12,11,11,8,7,13,11,12,8,12,12,11,11,12,15,9,11,5,6,13,13,10,4,1,2,3,4,1,3,3,2,3,2
"1998",23410607,"Nattawut Suksum","11/6/1997 (25 years old)","AM (RL), ST (C)","Bangkok Utd","Thai League","THA","No","7/1/2020","6/30/2025","$10K - $110K","Right","Reasonable","Very Strong","5'9""","149 lbs","122","42",91,110,5,8,12,12,12,5,10,6,7,4,8,13,7,11,9,12,11,12,10,11,13,13,4,11,6,11,8,10,12,12,8,10,13,11,11,8,10,14,16,13,14,10,8,9,6,4,14,13,15,2,2,2,1,3,3,1,4,2,3,3
"1999",23281751,"Santiphap Chan-ngom","9/23/1996 (26 years old)","D/WB (R)","BG Pathum Utd","Thai League","THA","No","5/31/2023","6/30/2026","$9K - $95K","Right","Reasonable","Very Strong","5'8""","145 lbs","184","4",91,110,7,12,12,9,10,9,8,11,8,9,11,8,9,10,12,10,12,10,11,10,12,11,7,8,9,11,8,12,13,12,10,8,14,11,13,8,7,11,14,12,11,11,7,13,7,4,12,12,12,1,2,2,3,2,1,3,4,2,3,2
"2000",2000135150,"Anan Yodsangwan","7/9/2001 (21 years old)","AM (RL), ST (C)","Lamphun","Thai League","THA","No","10/19/2021","6/30/2026","$85K - $850K","Right","Reasonable","Very Strong","5'9""","158 lbs","53","13",82,109,5,9,12,11,11,9,7,11,3,4,9,10,8,11,9,11,8,10,10,9,14,13,5,11,4,12,6,8,12,12,8,8,12,11,10,10,11,16,10,14,10,13,9,12,4,2,11,13,12,1,3,1,1,3,2,1,2,3,3,2
"2001",72044601,"Deybi Flores","6/16/1996 (26 years old)","DM, M (C)","Fehérvár","Hungarian Division I","HON","No","1/17/2023","12/31/2024","$550K - $1.6M","Right","Reasonable","Very Strong","5'11""","180 lbs","191","4",110,115,12,11,10,8,12,12,11,11,7,13,13,10,11,12,13,10,12,10,10,12,13,7,6,11,12,11,10,14,13,12,11,10,12,13,13,12,6,9,12,11,9,9,9,8,8,8,9,14,10,1,1,2,3,2,1,1,3,4,3,2
"2002",85093468,"Guessouma Fofana","12/17/1992 (30 years old)","DM","Nîmes","French National","MTN","Yes","1/26/2023","6/30/2024","$100K - $1M","Right","Weak","Very Strong","6'0""","171 lbs","188","9",105,120,5,4,10,7,11,6,14,10,5,12,12,8,11,10,16,12,15,11,11,13,13,10,10,12,12,13,13,14,11,11,14,13,12,12,11,15,11,13,15,12,12,11,11,12,12,8,12,13,10,2,2,2,1,1,1,2,3,4,2,3
"2003",2000101016,"Jassim Taqi","3/25/2002 (21 years old)","D/WB (L)","Al-Arabi","Kuwaiti Premier League","KUW","No","7/1/2018","6/30/2025","$24K - $230K","Left","Very Strong","Strong","6'1""","165 lbs","-","-",67,108,5,8,3,1,8,1,7,1,5,8,8,1,10,8,8,8,8,7,9,12,10,6,10,6,6,13,7,12,14,10,13,13,14,10,7,4,12,16,10,13,13,13,6,10,7,4,9,9,9,3,2,1,1,3,2,2,1,3,2,2
"2004",2000099934,"Mohammed Al-Hussainan","6/25/2000 (22 years old)","GK","Naser","Kuwaiti Premier League","KUW","No","6/15/2020","6/30/2024","$100K - $1M","Right","Reasonable","Very Strong","5'10""","152 lbs","-","-",81,108,2,2,2,2,1,7,1,3,3,1,8,2,1,4,10,12,10,8,9,14,14,1,13,1,8,8,7,7,9,10,8,6,14,9,7,4,12,16,12,13,10,10,5,15,10,1,13,8,13,7,5,14,12,7,12,14,5,8,10,9
"2005",2000068052,"Sultan Al-Faraj","6/16/2001 (21 years old)","D/WB (L)","Kuwait SC","Kuwaiti Premier League","KUW","No","7/1/2019","6/30/2024","$180K - $1.8M","Left Only","Very Strong","Weak","5'10""","154 lbs","3","-",79,108,5,8,5,8,8,2,7,8,8,10,8,5,14,10,14,10,9,9,7,11,4,5,14,8,7,9,9,9,15,15,9,10,12,15,8,6,13,17,10,11,10,12,15,6,6,1,8,11,16,2,1,2,1,1,2,2,1,3,1,1
"2006",2000067605,"Yousef Al-Haqqan","3/5/2002 (21 years old)","D (C), DM","Qadsia","Kuwaiti Premier League","KUW","No","7/1/2019","6/30/2024","$550K - $1.6M","Right Only","Very Weak","Very Strong","6'1""","174 lbs","13","-",79,108,8,7,5,2,7,8,11,7,1,11,9,1,14,9,11,12,10,9,11,15,7,5,1,7,11,8,6,10,10,9,9,14,9,9,11,8,16,19,11,12,11,9,14,5,14,3,13,11,12,3,2,2,1,2,3,1,4,1,1,1
"2007",23413661,"Redah Hani","10/27/1996 (26 years old)","DM, M (C)","Kuwait SC","Kuwaiti Premier League","KUW","No","6/30/2022","6/30/2025","$300K - $900K","Right Only","Weak","Very Strong","5'7""","143 lbs","59","5",95,106,11,7,11,6,10,7,9,12,2,13,14,9,13,11,12,13,12,11,13,11,14,14,3,14,12,14,12,13,11,12,10,6,9,12,11,8,11,13,12,13,12,8,5,11,14,7,9,13,20,1,2,2,2,2,2,3,3,3,2,1
"2008",2000099983,"Abdulredha Shehab","6/20/2004 (18 years old)","GK","Al-Arabi","Kuwaiti Premier League","KUW","No","6/13/2022","6/30/2025","$35K - $325K","Right","Reasonable","Very Strong","6'0""","163 lbs","-","-",69,106,2,1,2,3,4,3,1,1,1,2,8,1,3,1,8,4,5,4,9,14,9,2,11,2,12,7,6,6,8,13,7,6,12,5,1,4,9,14,12,13,9,10,12,6,6,8,11,13,15,9,5,11,12,7,8,12,5,6,9,9
"2009",2000042589,"Ivar Jenner","1/10/2004 (19 years old)","DM, M (C)","FC Utrecht","Keuken Kampioen Divisie","IDN","Yes","6/13/2022","6/30/2027","$4.2M - $8M","Right","Weak","Very Strong","6'2""","160 lbs","18","-",100,137,9,11,12,8,13,9,9,9,2,11,13,8,10,12,6,12,13,13,11,10,12,9,12,11,11,14,12,11,12,12,10,13,5,12,14,10,11,11,11,12,11,10,12,3,12,5,20,13,16,1,3,3,2,1,2,3,1,1,3,2
"2010",67064765,"Jordi Amat","3/21/1992 (31 years old)","D (C)","Johor DT","Malaysian Super League","IDN","Yes","1/1/2023","11/30/2023","$75K - $220K","Right","Fairly Strong","Very Strong","6'0""","182 lbs","275","3",112,135,6,7,9,5,11,5,12,10,10,12,11,5,13,10,18,13,17,12,11,10,15,9,12,8,14,13,10,11,10,10,12,11,15,10,11,13,6,7,11,18,15,16,13,14,15,3,12,13,18,3,3,1,1,2,1,1,1,3,2,2
"2011",18054105,"Sandy Walsh","3/14/1995 (28 years old)","D (RLC)","KV Mechelen","Jupiler Pro League","IDN","Yes","3/2/2021","6/30/2025","$800K - $1.8M","Right Only","Weak","Very Strong","5'11""","171 lbs","210","12",111,125,10,10,11,8,12,8,10,8,8,13,13,6,12,11,12,10,11,11,13,12,14,14,12,11,11,14,8,14,14,10,11,11,9,15,12,10,13,11,12,14,14,12,8,12,8,6,12,15,7,3,1,4,2,3,3,1,1,3,1,4
"2012",29233179,"Elkan Baggott","10/23/2002 (20 years old)","D (C)","Ipswich","Sky Bet Championship","IDN","No","6/16/2022","6/30/2025","$70K - $700K","Left Only","Very Strong","Weak","6'5""","189 lbs","29","2",96,123,3,4,6,6,10,3,13,6,9,10,11,5,11,10,7,11,11,12,9,8,14,7,9,8,11,14,9,12,11,10,11,16,15,11,15,13,7,12,12,15,11,10,5,9,7,4,8,11,10,3,4,4,1,3,1,3,2,3,2,1
"2013",85072592,"Harouna Abou Demba","12/31/1991 (31 years old)","D/WB (R)","FC Martigues","French National","MTN","Yes","7/1/2022","6/30/2025","Not for Sale","Right Only","Weak","Very Strong","5'10""","158 lbs","118","3",100,120,7,12,9,6,11,6,8,10,9,12,11,6,12,10,12,11,13,10,9,12,13,8,6,13,11,12,8,13,13,13,11,9,14,13,14,11,10,14,14,10,9,8,12,7,13,7,12,12,10,1,1,2,2,1,1,1,1,1,1,3
"2014",2000133305,"Marselino Ferdinan","9/9/2004 (18 years old)","AM (C)","KMSK Deinze","Belgian Challenger Pro League","IDN","No","1/31/2023","6/30/2024","$425K - $1.3M","Right","Reasonable","Very Strong","5'9""","145 lbs","38","8",77,122,6,9,12,8,13,9,11,12,4,9,9,4,7,11,15,9,7,9,10,9,9,8,8,8,8,11,13,11,9,10,8,8,12,11,10,9,19,14,10,10,12,13,8,14,5,3,15,9,12,1,4,2,2,2,1,1,2,2,2,2
"2015",41056668,"Egy Maulana Vikri","7/7/2000 (22 years old)","AM (RLC)","Dewa United","Indonesian League One","IDN","No","1/30/2023","5/31/2024","$20K - $190K","Left","Very Strong","Reasonable","5'6""","143 lbs","69","20",100,120,10,12,12,9,11,10,4,9,3,3,12,11,6,15,6,9,15,11,11,10,14,17,3,13,5,12,14,13,13,12,9,5,11,11,9,7,12,14,14,14,12,11,7,15,5,6,11,14,8,2,3,2,3,1,1,2,3,3,1,1
"2016",37058443,"Shayne Pattynama","8/11/1998 (24 years old)","D/WB (L), DM","Viking","Norwegian Premier Division","IDN","Yes","3/31/2021","12/31/2023","$4.5K - $45K","Left","Very Strong","Reasonable","5'11""","171 lbs","131","8",113,118,7,13,12,7,11,7,8,7,12,9,11,7,11,12,10,12,11,12,12,11,6,13,7,10,8,13,11,12,14,11,11,9,13,13,14,11,10,15,10,11,12,8,13,7,5,4,11,9,7,1,3,3,2,3,2,2,2,3,3,1
"2017",37028466,"Marc Klok","4/20/1993 (30 years old)","DM, M (C)","Persib","Indonesian League One","IDN","Yes","6/30/2021","5/31/2024","$20K - $200K","Right","Reasonable","Very Strong","5'10""","165 lbs","190","21",113,115,10,8,8,9,12,10,7,10,4,12,12,8,11,11,15,10,16,10,12,12,14,11,10,8,12,13,11,15,10,11,13,9,15,12,13,14,8,12,9,14,11,13,5,12,14,5,10,13,14,2,1,2,2,1,3,3,1,3,2,1
"2018",318693,"Beto","12/31/1980 (42 years old)","ST (C)","Madura United","Indonesian League One","IDN","No","1/21/2019","5/31/2025","$3K - $10K","Right","Reasonable","Very Strong","5'10""","165 lbs","363","215",76,110,6,3,4,13,12,7,10,9,4,11,8,8,5,11,8,8,8,10,9,10,10,12,8,14,9,7,8,9,12,11,4,5,12,13,14,13,11,19,9,11,10,11,11,12,6,2,16,13,16,2,1,2,3,2,4,3,1,3,1,3
"2019",7744865,"Boaz","3/16/1986 (37 years old)","AM (L), ST (C)","PSS","Indonesian League One","IDN","No","5/30/2022","5/31/2024","$4.5K - $14K","Left","Very Strong","Reasonable","5'7""","156 lbs","337","186",71,110,10,7,10,11,12,7,7,8,3,3,11,8,2,12,8,8,12,9,11,13,14,12,15,11,3,8,11,8,10,11,9,6,12,12,10,9,5,15,12,9,6,15,5,9,2,5,10,4,12,3,1,3,1,2,2,3,1,2,4,3
"2020",41056665,"Witan Sulaeman","10/8/2001 (21 years old)","M (C), AM (RLC)","Persija","Indonesian League One","IDN","No","1/30/2023","5/31/2026","$130K - $400K","Right","Weak","Very Strong","5'7""","143 lbs","40","5",85,110,8,10,11,13,11,8,8,10,2,7,11,7,6,12,12,10,8,9,9,14,16,12,11,11,9,9,11,10,12,11,8,5,13,12,7,6,14,12,9,8,10,10,9,16,12,1,16,13,17,3,3,2,3,2,3,1,3,2,3,1
"2021",41024777,"Evan Dimas","3/13/1995 (28 years old)","M (C)","Arema","Indonesian League One","IDN","No","4/1/2022","5/31/2024","$65K - $190K","Right","Reasonable","Very Strong","5'6""","138 lbs","133","14",103,108,9,8,10,9,12,10,9,9,6,7,14,4,8,11,15,12,7,11,13,13,13,8,15,13,9,11,15,15,9,10,12,8,14,10,12,10,15,14,12,13,13,13,6,11,10,8,12,11,19,1,1,1,2,3,3,1,4,3,2,3
"2022",41021140,"Febri Hariyadi","2/19/1996 (27 years old)","M (R), AM (RL)","Persib","Indonesian League One","IDN","No","4/15/2022","5/31/2025","$35K - $350K","Right","Reasonable","Very Strong","5'6""","152 lbs","132","20",104,107,9,10,13,9,11,9,9,8,7,6,11,9,6,11,11,8,12,11,11,12,14,12,10,12,6,11,10,11,13,10,12,8,13,14,13,10,12,14,13,14,13,15,6,11,8,4,14,9,12,1,2,3,2,1,4,2,2,2,3,3
"2023",41022781,"Yanto Basna","10/12/1995 (27 years old)","D (C)","Bhayangkara","Indonesian League One","IDN","No","5/1/2022","5/31/2024","$0","Right","Reasonable","Very Strong","5'10""","169 lbs","95","5",76,107,3,5,1,2,7,1,13,3,3,11,7,5,10,5,9,11,9,6,12,11,9,7,12,5,10,6,5,7,10,11,7,6,16,10,7,13,10,11,11,9,8,10,9,17,12,5,10,10,12,2,1,3,1,2,2,3,3,1,2,3
"2024",13173475,"Bessam","12/5/1987 (35 years old)","M (C), AM (LC)","FC Nouadhibou","Mauritanian D1","MTN","No","7/1/2020","6/30/2024","$0","Right","Reasonable","Very Strong","5'11""","156 lbs","55","6",91,119,5,9,10,10,14,8,8,10,6,6,14,5,10,14,8,10,7,8,9,12,9,13,9,14,8,9,10,13,10,10,9,11,5,10,10,6,12,19,10,10,12,12,12,12,11,5,14,10,6,1,3,3,1,2,1,1,1,3,3,2
"2025",2000040098,"Rafael Struick","3/27/2003 (20 years old)","M (RL), AM (RLC)","ADO Den Haag","Keuken Kampioen Divisie","IDN","Yes","6/10/2022","6/30/2024","$120K - $1.2M","Right Only","Weak","Very Strong","6'1""","176 lbs","3","-",95,106,6,9,12,11,12,5,8,11,10,5,10,10,6,12,10,8,12,11,11,8,10,11,5,11,5,12,8,12,13,13,11,16,12,13,8,11,13,17,11,10,13,14,12,7,5,4,11,10,14,2,3,3,3,1,3,3,3,1,2,3
"2026",2000284190,"Well","4/25/2007 (16 years old)","D (R)","SPO","Brazilian National First Division","IDN","No","3/18/2022","12/31/2026","$0 - $40K","Right","Reasonable","Very Strong","5'5""","119 lbs","5","-",58,106,4,9,13,2,7,1,7,5,5,4,8,4,10,8,14,3,8,5,6,11,9,16,8,5,5,7,7,7,14,14,3,4,12,13,10,4,12,13,11,11,14,11,12,6,13,6,5,10,16,2,1,3,1,1,4,3,1,1,2,1
"2027",5760101,"Ilija Spasojević","11/9/1987 (35 years old)","ST (C)","Bali United","Indonesian League One","IDN","No","2/4/2021","12/31/2023","$4.5K - $14K","Right","Fairly Strong","Very Strong","6'0""","187 lbs","324","160",90,103,7,6,10,11,14,9,16,9,9,4,9,5,8,12,9,12,9,10,12,10,11,15,6,12,11,10,9,9,11,12,9,10,10,11,9,9,10,11,10,10,11,8,8,7,8,2,9,10,7,2,2,2,2,3,3,1,2,3,2,2
"2028",37045584,"Ezra Walian","10/22/1997 (25 years old)","AM (R), ST (C)","Persib","Indonesian League One","IDN","Yes","3/14/2021","1/31/2024","$14K - $150K","Right","Reasonable","Very Strong","5'10""","165 lbs","112","13",101,103,4,6,11,12,13,5,9,8,7,4,10,11,4,12,11,13,11,13,9,9,15,9,5,13,5,8,8,12,11,13,13,7,13,12,12,7,4,11,14,13,13,8,4,10,4,4,8,13,7,4,4,3,1,2,3,1,2,1,1,2
"2029",2000043694,"Mohammed Rahman","2/3/2000 (23 years old)","DM, M (C)","Al-Gharafa","Qatar Lower Division","IDN","No","7/1/2018","6/30/2025","$65K - $650K","Right","Fairly Strong","Very Strong","5'10""","154 lbs","-","-",70,100,5,5,3,6,12,2,4,8,4,8,6,1,11,12,7,6,7,7,8,13,16,5,1,7,13,7,9,9,10,13,7,8,11,12,9,5,12,20,12,11,10,11,12,7,9,6,9,9,14,1,3,1,1,3,1,3,3,2,1,3
"2030",37027599,"Stefano Lilipaly","1/10/1990 (33 years old)","M (RC), AM (RLC)","Borneo","Indonesian League One","IDN","Yes","5/9/2022","5/31/2024","$2.5K - $22K","Right","Fairly Strong","Very Strong","6'2""","180 lbs","235","59",89,99,8,8,12,5,12,6,3,6,2,4,11,6,4,13,12,11,3,11,9,10,1,15,5,11,5,10,12,8,11,12,7,5,13,10,11,9,16,18,11,13,12,11,13,12,4,6,13,12,13,1,3,2,3,1,1,1,1,3,3,3
"2031",41063039,"Todd Ferre","3/15/1999 (24 years old)","AM (C)","PSS","Indonesian League One","IDN","No","5/11/2022","5/31/2025","$40K","Right","Reasonable","Very Strong","5'2""","132 lbs","86","13",78,98,7,8,12,10,12,12,7,14,7,5,10,5,7,11,11,12,9,8,4,13,13,12,6,8,7,9,9,11,11,14,9,6,14,12,11,1,11,4,9,10,14,13,5,14,6,5,11,10,9,2,2,1,2,2,3,1,1,2,2,3
"2032",2000176033,"Yuda Editya Pratama","5/31/2004 (19 years old)","ST (C)","Borneo","Indonesian League One","IDN","No","1/1/2022","5/31/2025","$40K - $120K","Right","Reasonable","Very Strong","5'11""","149 lbs","-","-",62,98,5,6,13,13,8,4,8,2,1,1,3,9,1,7,9,9,2,13,6,12,8,13,9,8,6,5,6,6,13,13,6,10,12,13,8,4,11,19,10,11,13,10,8,3,12,2,9,12,15,1,3,1,3,4,3,2,2,3,1,1
"2033",41062688,"Muhammad Ridwan","6/13/2000 (22 years old)","ST (C)","Persik","Indonesian League One","IDN","No","5/28/2021","5/31/2024","$0","Right","Reasonable","Very Strong","6'0""","176 lbs","31","2",77,97,7,3,9,10,11,7,10,8,5,7,8,7,1,9,5,12,2,11,3,14,3,8,5,10,8,7,8,9,10,9,8,8,10,11,14,10,11,18,9,11,10,11,15,17,5,4,14,10,12,2,2,2,3,1,2,3,2,1,2,3
"2034",41042025,"Ilham Udin Armayn","5/10/1996 (27 years old)","AM (L)","Arema","Indonesian League One","IDN","No","4/11/2022","5/31/2025","$95K - $275K","Left","Very Strong","Reasonable","5'6""","145 lbs","144","20",88,97,7,7,12,13,13,8,7,8,7,6,11,9,7,10,12,9,9,11,9,12,11,12,13,8,8,8,9,9,13,9,9,5,12,14,12,4,14,19,10,11,11,10,14,12,11,7,18,10,20,4,3,3,2,2,3,2,3,1,3,3
"2035",13209426,"Abdallahi Mahmoud","5/4/2000 (23 years old)","DM, M (C)","Alavés B","Spanish Federation Second Group 2","MTN","No","7/1/2018","6/30/2025","$0 - $95K","Right","Weak","Very Strong","6'2""","178 lbs","85","6",95,119,9,7,10,6,7,9,9,11,6,8,11,7,10,10,12,10,13,11,9,13,12,10,5,9,8,7,9,10,14,12,10,13,15,14,10,11,14,7,6,9,12,12,13,8,9,10,10,12,17,3,3,2,2,3,3,2,3,1,4,2
"2036",41039830,"Hansamu Yama","1/16/1995 (28 years old)","D (C), DM","Persija","Indonesian League One","IDN","No","4/6/2022","5/31/2025","$35K - $350K","Right","Reasonable","Very Strong","5'11""","165 lbs","119","8",94,96,6,4,5,8,9,6,11,6,7,12,12,6,13,8,13,11,11,10,12,16,13,5,6,8,12,10,9,12,10,10,11,8,17,11,13,11,7,12,9,10,12,12,9,12,10,6,12,12,8,1,3,2,2,2,1,3,2,3,3,1
"2037",41024425,"Terens Puhiri","10/13/1996 (26 years old)","AM (RL)","Borneo","Indonesian League One","IDN","No","12/31/2020","12/31/2023","$45K - $130K","Right","Weak","Very Strong","5'2""","130 lbs","161","26",84,95,5,9,9,10,7,5,6,6,1,4,9,4,6,10,11,4,6,6,5,11,10,9,13,11,5,6,9,7,17,12,6,1,11,16,11,1,15,18,10,10,14,12,11,16,12,6,11,13,20,2,3,1,3,3,1,4,3,3,3,3
"2038",41064593,"Muhammad Supriadi","5/22/2002 (21 years old)","AM (RL)","Persik","Indonesian League One","IDN","No","5/18/2023","5/31/2024","$85K - $250K","Right","Reasonable","Very Strong","5'7""","143 lbs","35","1",72,94,5,11,12,9,11,3,6,9,7,7,11,3,7,13,11,12,2,12,8,13,12,12,1,10,7,8,8,12,11,11,3,7,13,13,7,2,10,11,10,10,12,11,6,1,12,8,14,12,20,2,3,4,1,1,3,3,2,3,2,3
"2039",2000249329,"Victor Dethan","7/11/2004 (18 years old)","AM (R)","PSM","Indonesian League One","IDN","No","6/12/2023","5/31/2025","$90K - $275K","Right","Reasonable","Very Strong","5'9""","127 lbs","16","-",62,93,5,9,14,8,10,6,7,6,6,4,10,4,5,8,14,6,2,8,4,9,5,7,9,13,5,7,7,8,12,9,6,8,13,12,8,4,7,17,10,11,13,13,10,16,15,6,12,10,11,2,2,3,2,2,2,1,3,1,2,3
"2040",7747807,"Victor Igbonefo","10/10/1985 (37 years old)","D (C)","Persib","Indonesian League One","IDN","No","1/1/2020","5/31/2024","$500 - $4.5K","Right","Reasonable","Very Strong","6'1""","182 lbs","388","15",76,93,3,3,3,6,7,1,9,6,5,11,9,4,11,8,10,9,8,8,10,10,18,7,15,4,12,8,8,9,9,7,10,12,16,9,12,10,17,12,14,11,12,14,6,8,13,8,9,11,12,1,3,3,1,2,1,3,1,1,2,1
"2041",29233205,"Jack Brown","11/2/2001 (21 years old)","M/AM (C)","Persita","Indonesian League One","IDN","No","1/28/2021","5/31/2025","$65K - $190K","Right Only","Weak","Very Strong","5'9""","165 lbs","6","-",62,93,7,6,11,10,9,11,7,9,4,11,10,6,8,8,6,11,7,9,11,11,10,7,8,11,7,8,11,10,8,9,7,7,11,10,9,9,6,6,8,11,9,10,4,12,6,6,9,11,8,1,3,2,2,2,3,1,2,3,1,3
"2042",41066733,"Rizky Ridho","11/21/2001 (21 years old)","D (C)","Persija","Indonesian League One","IDN","No","4/1/2023","6/30/2026","$100K - $300K","Right","Reasonable","Very Strong","6'0""","158 lbs","38","3",68,92,3,4,4,3,5,1,14,5,3,12,5,3,11,1,10,6,8,7,9,13,4,5,4,6,14,6,2,7,13,10,7,6,12,10,11,9,14,15,12,10,9,12,5,10,5,2,11,13,19,1,1,2,1,2,2,2,2,3,2,3
"2043",37007957,"Irfan Bachdim","8/11/1988 (34 years old)","AM (RLC), ST (C)","Persis","Indonesian League One","IDN","Yes","1/5/2022","7/5/2023","$0","Right","Reasonable","Very Strong","5'8""","143 lbs","181","49",80,92,4,8,10,12,9,6,8,3,1,6,11,4,3,11,15,7,8,7,7,11,12,9,9,9,7,7,10,12,13,10,7,7,15,11,13,10,11,20,8,10,14,12,8,5,5,3,11,11,14,2,2,2,3,3,3,1,2,3,3,1
"2044",41039835,"David Maulana","9/2/1996 (26 years old)","M (L), AM (RL)","PSIS","Indonesian League One","IDN","No","2/1/2020","5/31/2024","$5K - $55K","Left","Very Strong","Reasonable","5'8""","152 lbs","141","28",90,92,7,9,12,10,12,10,6,7,9,5,9,9,7,9,9,13,6,12,11,11,9,9,7,10,8,11,9,12,11,9,11,9,12,12,13,9,13,15,10,13,9,10,11,4,6,4,11,9,11,2,2,2,1,1,1,1,1,4,3,1
"2045",41066698,"David Maulana","2/25/2002 (21 years old)","M (C)","Bhayangkara","Indonesian League One","IDN","No","6/27/2022","5/31/2025","$28K - $275K","Left","Very Strong","Reasonable","5'7""","143 lbs","27","-",73,92,6,8,7,6,10,6,5,9,6,10,12,7,11,10,5,8,8,14,8,14,6,9,14,10,6,9,12,8,9,14,4,8,12,13,9,2,10,17,12,12,8,14,15,12,12,7,18,9,12,3,4,4,3,3,1,1,1,3,2,1
"2046",85058546,"El Hadji Ba","3/5/1993 (30 years old)","DM, M (C)","Apol. Limassol","Cypriot First Division","MTN","Yes","7/1/2022","6/30/2025","$75K - $750K","Right","Weak","Very Strong","6'0""","165 lbs","157","3",107,117,6,10,12,7,12,6,11,10,9,12,13,6,13,13,13,12,13,13,12,12,13,12,7,10,11,12,12,13,12,11,14,11,8,11,11,12,5,12,14,10,11,8,15,12,11,8,12,14,10,1,1,3,1,3,3,1,2,2,3,4
"2047",41038743,"Paulo Sitanggang","10/17/1995 (27 years old)","M (C)","Borneo","Indonesian League One","IDN","No","4/21/2021","5/31/2024","$0","Right Only","Very Weak","Very Strong","5'8""","149 lbs","135","9",78,91,6,8,8,7,11,7,8,9,4,9,12,4,9,10,8,10,12,10,11,11,11,6,14,10,10,11,11,12,11,10,9,9,13,11,12,10,7,19,12,10,9,10,5,1,8,7,12,11,18,3,3,3,2,1,4,1,3,2,3,3
"2048",14004063,"Silvio Escobar","7/18/1986 (36 years old)","AM (R), ST (C)","Semen Padang","Indonesian League Two","IDN","No","5/27/2022","5/31/2024","$0 - $1.5K","Right","Weak","Very Strong","5'10""","169 lbs","145","28",67,91,8,8,9,7,9,8,7,9,4,5,11,2,7,10,12,8,14,8,8,9,10,7,12,10,8,9,8,13,11,8,12,14,8,12,12,11,10,16,10,10,13,12,11,1,12,7,20,11,13,2,3,3,3,2,1,3,2,1,2,3
"2049",41052910,"Asnawi Mangkualam","10/4/1999 (23 years old)","D (R), DM","Jeonnam","Hana 1Q K LEAGUE 2","IDN","No","1/27/2023","12/31/2024","$0 - $110K","Right","Reasonable","Very Strong","5'7""","143 lbs","92","6",83,91,6,10,12,2,8,7,8,8,4,11,8,3,12,9,12,12,12,8,10,9,8,5,3,6,10,10,6,9,14,12,9,5,15,12,10,10,14,19,14,10,9,12,6,7,7,8,9,12,20,3,1,1,3,2,2,3,1,1,1,1
"2050",41066891,"Rizky Eka","12/24/1999 (23 years old)","AM (R), ST (C)","PSM","Indonesian League One","IDN","No","3/1/2020","5/31/2024","$9K - $90K","Right","Reasonable","Very Strong","5'7""","147 lbs","78","1",83,91,9,9,9,9,11,9,6,7,9,4,8,9,6,11,8,11,4,14,10,10,11,12,13,12,4,8,10,12,13,10,8,7,12,12,12,7,9,16,10,13,10,8,9,3,9,5,12,10,16,3,2,1,3,4,1,1,3,2,3,2
"2051",41056669,"Aulia Hidayat","5/2/1999 (24 years old)","ST (C)","Semen Padang","Indonesian League Two","IDN","No","3/1/2020","5/31/2024","$0","Right","Reasonable","Very Strong","5'7""","143 lbs","1","-",72,90,4,2,8,12,13,6,9,7,1,5,6,5,4,12,11,12,7,6,7,8,12,12,14,11,7,6,7,7,13,13,7,1,6,13,11,4,9,12,11,12,11,14,12,9,11,6,11,10,14,3,2,2,1,3,2,2,2,1,1,2
"2052",2000140420,"Dony Tri Pamungkas","1/11/2005 (18 years old)","M/AM (C)","Persija","Indonesian League One","IDN","No","9/1/2021","5/31/2024","$22K - $220K","Left","Very Strong","Reasonable","5'10""","147 lbs","24","-",65,90,6,3,10,5,10,3,4,8,5,5,12,3,8,5,5,9,5,6,6,7,15,5,10,8,7,7,9,12,14,14,7,5,13,14,7,4,11,15,11,11,11,13,12,20,7,1,8,14,15,2,3,2,2,1,1,3,3,3,2,1
"2053",41024822,"Gavin Kwan Adsit","4/5/1996 (27 years old)","D/M (R), ST (C)","Persis","Indonesian League One","IDN","No","5/15/2022","5/31/2025","$20K - $200K","Right Only","Very Weak","Very Strong","5'11""","165 lbs","119","10",88,90,6,9,10,9,12,8,10,8,7,10,10,7,10,12,8,8,12,10,12,11,14,9,13,9,11,10,10,10,10,10,9,9,14,11,12,10,16,11,9,11,11,12,10,12,5,4,14,8,13,1,3,1,4,2,2,1,1,2,1,3
"2054",2000128792,"Seiya Da Costa Lay","9/30/2001 (21 years old)","DM, M (C)","Arema","Indonesian League One","IDN","No","3/3/2021","12/31/2023","$20K - $200K","Right","Reasonable","Very Strong","5'10""","154 lbs","2","-",61,90,6,3,3,7,10,7,7,5,4,9,8,6,14,12,5,10,5,6,7,9,11,5,7,8,13,9,12,12,7,11,5,7,15,9,7,5,11,11,13,12,10,11,13,4,11,5,11,14,11,2,3,3,3,2,3,1,3,3,3,1
"2055",2000132961,"Ronaldo Kwateh","10/19/2004 (18 years old)","AM (R)","Bodrum FK","Turkish 1. League","IDN","No","2/8/2023","6/30/2025","$8K - $24K","Right","Weak","Very Strong","5'11""","141 lbs","19","1",65,90,6,10,13,7,12,5,2,6,3,3,6,4,5,8,8,4,5,5,4,10,2,10,10,11,4,6,7,7,13,12,2,8,13,13,12,6,9,19,10,14,9,11,7,10,4,5,6,12,7,2,1,3,1,2,1,1,1,2,3,1
"2056",41065853,"Kevin Gomes","6/24/1998 (24 years old)","D (LC), DM","PSS","Indonesian League One","IDN","No","1/20/2023","5/31/2024","$30K - $90K","Left","Very Strong","Reasonable","6'1""","176 lbs","54","-",76,90,4,7,4,3,8,6,9,6,1,8,8,1,10,7,13,12,9,7,10,13,5,7,11,4,8,7,7,8,13,13,7,7,12,13,13,6,11,17,9,12,11,11,5,10,11,4,10,11,12,1,1,2,2,2,1,3,2,1,1,1
"2057",13209417,"Abdou Boïdiya","11/25/1999 (23 years old)","D (LC)","Tevragh Zeïna","Mauritanian D1","MTN","No","7/1/2018","6/30/2024","$0","Left","Very Strong","Fairly Strong","6'0""","165 lbs","-","-",85,116,5,10,5,4,9,2,14,7,1,14,8,4,12,4,6,10,9,7,10,9,12,5,2,7,14,7,6,8,14,10,8,8,12,12,6,7,15,13,10,10,13,9,9,5,6,2,8,14,18,1,1,3,3,3,2,1,1,1,1,2
"2058",8158241,"Bruno Casimir","12/17/1981 (41 years old)","DM, M (C)","PS Siak","Indonesian League Four","IDN","No","11/1/2021","5/31/2024","$4K - $12K","Right","Weak","Very Strong","6'1""","171 lbs","34","2",71,89,7,7,9,7,9,8,14,7,14,12,8,5,13,9,16,9,13,7,7,8,15,8,15,6,6,11,8,13,8,10,14,14,16,8,12,16,8,5,5,8,9,11,8,8,17,7,8,15,11,1,2,2,1,2,1,3,2,2,1,4
"2059",23136348,"Mamadou Barry","5/16/1986 (37 years old)","ST (C)","Persewar","Indonesian League Two","IDN","No","11/1/2021","5/31/2024","$0 - $4K","Right","Reasonable","Very Strong","6'3""","194 lbs","65","30",68,88,6,4,6,11,11,4,12,8,4,2,9,7,2,7,9,11,8,12,8,9,14,11,10,10,6,10,8,10,5,6,13,12,14,7,11,13,12,17,13,13,12,10,5,12,8,1,12,12,19,3,3,3,2,2,1,3,2,1,2,3
"2060",41056862,"Teuku Ichsan","11/25/1997 (25 years old)","M (C)","Bhayangkara","Indonesian League One","IDN","No","2/1/2020","5/31/2024","$24K","Right","Reasonable","Very Strong","5'9""","156 lbs","74","2",74,88,5,6,2,7,11,6,6,8,1,9,12,1,8,10,11,7,8,5,10,11,11,5,9,7,7,7,13,11,13,13,7,3,11,13,13,6,10,17,10,10,7,12,10,13,11,5,18,13,12,3,3,1,1,2,3,3,2,3,2,2
"2061",41066696,"Bagus Kahfi","1/16/2002 (21 years old)","ST (C)","Asteras Tripolis","Greek Super League 1","IDN","No","8/22/2022","6/30/2025","$0 - $18K","Right","Fairly Strong","Very Strong","5'6""","127 lbs","2","-",60,88,2,5,13,14,7,4,8,7,2,4,4,12,1,8,6,8,6,14,7,12,14,8,12,6,7,3,6,7,14,11,7,1,5,12,4,1,9,19,11,10,10,12,8,8,8,7,8,13,16,2,1,2,2,2,2,1,1,3,2,2
"2062",67158093,"Arthur Irawan","3/3/1993 (30 years old)","D/WB (R)","Persik","Indonesian League One","IDN","No","11/23/2021","5/31/2025","$30K","Right Only","Weak","Very Strong","5'9""","158 lbs","52","1",79,88,5,9,7,7,12,3,7,7,1,9,9,5,9,9,13,7,7,9,9,8,3,5,5,7,7,6,7,9,14,14,8,9,14,14,14,7,10,12,12,9,11,10,14,10,8,5,12,9,5,3,2,2,3,2,1,3,1,3,1,2
"2063",2000200301,"Ilham Pratama","4/14/2001 (22 years old)","GK","Sada Sumut","Indonesian League Two","IDN","No","5/24/2022","5/31/2024","$6K - $18K","Right","Weak","Very Strong","5'8""","134 lbs","-","-",57,88,3,2,1,2,3,5,1,1,1,3,9,3,1,3,12,5,15,6,6,13,7,1,12,3,9,6,5,5,9,8,6,6,15,11,4,4,12,12,12,11,12,13,9,6,6,2,19,11,13,8,11,8,9,6,12,9,5,6,10,12
"2064",59010778,"Artur Ioniţă","8/17/1990 (32 years old)","DM, M/AM (C)","Modena","Italian Serie B","MDA","Yes","8/11/2022","6/30/2024","$120K - $1.2M","Left","Very Strong","Strong","6'0""","160 lbs","443","42",116,136,7,8,10,10,12,10,13,12,3,10,12,10,12,12,14,13,14,14,11,11,14,10,10,14,12,15,12,14,11,10,14,12,11,11,12,11,12,12,11,14,11,10,10,14,12,7,13,14,14,3,3,4,3,1,1,2,3,2,3,2
"2065",43617527,"Andrei Moţoc","4/13/2002 (21 years old)","D (C)","Siena","Italian Eccellenza Toscana Grp.B","MDA","Yes","7/5/2022","6/30/2025","$9K - $90K","Right Only","Very Weak","Very Strong","6'5""","176 lbs","7","-",90,136,4,5,6,5,11,5,13,4,5,12,11,6,12,9,12,10,12,10,9,10,13,7,11,8,11,12,8,10,10,12,12,15,13,12,12,12,12,13,13,13,13,14,4,12,10,5,12,13,14,3,3,3,1,3,1,2,2,2,1,1
"2066",59004209,"Igor Armaş","7/14/1987 (35 years old)","D (C)","FC Voluntari","Romanian First League","MDA","Yes","6/14/2021","6/30/2024","$55K - $160K","Left","Very Strong","Weak","6'4""","189 lbs","412","14",107,135,7,7,6,8,9,7,14,9,11,14,10,8,13,11,14,12,11,12,11,12,15,10,15,10,11,11,9,12,8,8,12,16,15,9,10,15,11,13,14,15,13,14,3,11,10,7,13,12,12,3,3,2,2,3,3,1,3,2,3,1
"2067",96501736,"Luvannor","5/19/1990 (33 years old)","D/WB/M (L), AM (RL), ST (C)","CEA","Brazilian National Second Division","MDA","No","1/9/2023","12/31/2024","$60K - $600K","Left","Very Strong","Reasonable","6'0""","171 lbs","246","97",113,130,6,9,11,13,10,9,11,12,8,6,10,10,8,10,9,12,10,9,9,10,7,12,8,11,8,10,10,12,12,9,11,11,12,13,11,8,10,16,8,12,9,13,10,12,10,3,12,11,18,1,3,2,2,3,2,2,3,3,2,3
"2068",13158364,"Pape Ibnou Bâ","1/5/1993 (30 years old)","ST (C)","Havre AC","Ligue 1 Uber Eats","MTN","No","8/31/2021","6/30/2024","$140K - $1.4M","Right","Weak","Very Strong","5'10""","149 lbs","215","97",106,116,7,8,11,12,13,8,10,13,4,7,10,13,6,9,8,13,12,11,12,13,14,11,10,12,7,10,11,11,14,13,11,9,13,14,13,11,7,16,11,12,10,11,14,12,7,8,11,13,10,3,4,2,2,1,1,3,1,2,3,4
"2069",83111579,"Oleg Reabciuk","1/16/1998 (25 years old)","D/WB (L)","Olympiacos","Greek Super League 1","MDA","Yes","1/1/2021","6/30/2024","$5.2M - $6.4M","Left Only","Very Strong","Weak","5'11""","158 lbs","165","8",120,130,7,10,9,8,10,6,9,8,13,12,10,6,12,10,16,11,16,10,9,10,16,7,6,11,11,16,10,17,16,13,12,10,17,15,16,12,7,13,10,16,11,14,3,12,12,5,12,15,14,3,2,4,2,1,3,3,4,1,1,2
"2070",49037859,"Virgiliu Postolachi","3/17/2000 (23 years old)","AM (L), ST (C)","UTA Arad","Romanian First League","MDA","Yes","6/24/2022","6/30/2026","$30K - $325K","Right","Weak","Very Strong","6'2""","187 lbs","64","10",115,130,9,9,11,14,13,10,13,11,6,8,10,14,9,13,5,11,10,12,11,11,13,13,6,15,6,13,10,12,13,12,11,14,12,13,11,13,6,14,13,14,13,10,8,10,6,2,12,13,12,3,2,1,1,2,1,3,3,2,3,1
"2071",43461719,"Daniel Dumbravanu","7/22/2001 (21 years old)","D (C)","SPAL","Italian Serie C/B","MDA","Yes","7/4/2022","6/30/2025","$24K - $240K","Left","Very Strong","Weak","6'4""","191 lbs","16","-",82,126,4,6,6,5,7,5,11,4,9,11,10,6,8,9,12,10,11,13,12,11,11,5,10,9,11,12,8,10,10,9,13,14,12,11,10,13,5,12,5,10,11,10,8,9,6,5,12,13,16,2,2,4,2,2,3,4,3,1,1,3
"2072",59118441,"Ion Nicolăescu","9/7/1998 (24 years old)","ST (C)","Beitar Jerusalem","Israeli Premier League","MDA","Yes","9/23/2022","5/31/2025","$1.3M - $2.7M","Right","Strong","Very Strong","6'0""","160 lbs","134","41",117,122,7,10,11,14,11,6,14,9,6,6,12,14,8,13,8,13,10,12,12,10,13,12,11,13,8,11,13,11,12,11,13,13,12,12,12,9,14,12,15,12,14,10,10,12,6,5,10,14,16,1,2,1,3,2,3,3,2,1,2,2
"2073",71090206,"Vladyslav Babohlo","11/14/1998 (24 years old)","D (C)","Oleksandriia","Ukrainian Premier League","MDA","No","6/15/2020","5/31/2025","$120K - $1.2M","Right Only","Weak","Very Strong","6'2""","178 lbs","97","6",108,120,3,4,5,3,8,6,13,6,7,14,8,7,15,6,12,11,13,11,10,11,14,4,11,9,12,13,9,13,12,11,15,14,14,12,12,14,3,12,4,9,12,16,5,2,14,7,9,13,7,1,1,3,3,3,1,2,3,1,2,2
"2074",67224131,"Viorel Boian","6/18/1996 (26 years old)","GK","Gernika","Spanish Federation Second Group 2","MDA","Yes","6/30/2022","6/30/2023","$0","Right","Fairly Strong","Very Strong","6'1""","189 lbs","131","-",83,120,5,2,2,2,4,7,1,3,1,2,10,4,2,3,14,10,15,7,13,13,8,2,5,2,9,7,6,6,11,6,7,10,12,10,6,6,13,14,8,13,11,13,10,13,7,7,12,11,10,8,14,13,6,8,6,13,5,9,12,11
"2075",8055578,"Vitalie Bordian","8/11/1984 (38 years old)","D (RL)","FV Austria XIII","Austrian Vienna League","MDA","No","6/1/2020","6/30/2024","$0 - $7K","Right","Reasonable","Very Strong","5'10""","158 lbs","334","8",76,120,9,9,9,8,9,7,6,7,9,10,11,9,10,10,10,11,12,10,10,10,17,12,11,9,10,12,11,13,10,12,9,7,13,10,11,6,13,9,12,12,12,16,7,10,8,5,12,12,14,1,1,1,2,1,1,3,3,1,2,3
"2076",96501824,"Vadim Raţă","5/5/1993 (30 years old)","M (C), AM (RC)","FC Voluntari","Romanian First League","MDA","Yes","9/3/2022","6/30/2025","$130K - $1.3M","Right","Reasonable","Very Strong","5'9""","158 lbs","333","27",106,120,6,5,12,9,13,12,10,13,6,10,14,12,9,12,8,12,11,12,9,12,12,7,8,12,10,12,12,13,12,12,10,7,12,12,12,10,15,10,10,13,11,11,5,10,5,7,12,13,14,3,3,1,3,4,3,2,2,1,3,2
"2077",59132318,"Ioan-Călin Revenco","6/26/2000 (22 years old)","D (C)","Petrocub Hînceşti","Moldovan Divizia Naţională","MDA","No","7/1/2021","6/30/2024","$160K - $1.6M","Right","Reasonable","Very Strong","6'0""","169 lbs","58","3",88,118,1,4,2,5,8,1,13,3,1,14,8,2,14,3,7,12,9,5,7,14,10,5,11,7,14,7,5,8,14,10,8,9,10,11,11,7,17,10,3,13,11,10,11,15,12,3,11,12,13,3,1,3,1,3,3,1,2,3,1,2
"2078",71053501,"Cătălin Carp","10/20/1993 (29 years old)","D (C), DM, M (C)","Ufa","Russian Second Division A Gold","MDA","Yes","7/13/2022","6/30/2024","$220K - $650K","Right","Weak","Very Strong","6'0""","176 lbs","187","4",95,116,6,5,9,6,9,9,14,10,10,12,11,7,12,9,12,12,13,12,12,10,12,6,10,9,12,12,9,13,11,11,13,11,11,11,11,11,9,13,13,14,11,9,5,12,9,7,12,12,13,3,1,4,1,4,4,1,2,2,3,2
"2079",98030082,"Birama N'Doye","4/17/1994 (29 years old)","D (C), DM","Al-Arabi","Saudi First Division League","MTN","No","7/7/2022","6/30/2023","$16K - $170K","Right Only","Weak","Very Strong","6'2""","180 lbs","264","12",110,115,7,7,9,6,10,7,12,9,11,12,12,8,13,10,14,8,15,12,12,10,12,8,8,10,13,13,9,15,12,8,14,15,14,12,13,17,12,11,7,12,14,10,13,10,15,3,12,10,15,3,1,2,3,1,3,2,3,1,1,2
"2080",59126109,"Vitalie Damaşcan","1/24/1999 (24 years old)","AM (RL), ST (C)","Sepsi OSK","Romanian First League","MDA","Yes","9/2/2022","6/30/2025","$650K - $1.4M","Right","Reasonable","Very Strong","5'11""","163 lbs","152","44",107,115,8,8,11,13,13,6,12,11,4,6,11,12,6,13,10,13,12,12,12,11,8,12,6,12,6,8,9,13,12,11,11,13,13,13,11,12,14,10,8,11,8,8,6,10,6,6,11,12,11,1,2,3,1,3,2,1,1,1,2,3
"2081",57105134,"Alexei Koșelev","11/19/1993 (29 years old)","GK","Lamia","Greek Super League 1","MDA","Yes","6/6/2023","6/30/2024","$120K - $1.2M","Right Only","Weak","Very Strong","6'7""","198 lbs","170","-",105,115,6,1,1,1,6,7,4,3,2,1,7,3,3,4,9,11,12,11,11,10,12,8,9,9,12,12,9,13,9,13,11,15,10,8,10,13,9,15,7,6,10,14,6,10,5,8,9,5,7,12,9,13,12,12,12,14,4,12,13,16
"2082",2000151003,"Nichita Moțpan","7/17/2001 (21 years old)","M (C), AM (RC)","FC Bălți","Moldovan Divizia Naţională","MDA","Yes","7/1/2020","12/31/2024","$16K - $160K","Right","Reasonable","Very Strong","5'10""","160 lbs","41","9",95,115,8,10,14,14,14,8,8,10,3,9,14,7,8,10,10,10,6,9,5,14,6,10,6,11,10,9,10,13,11,14,6,9,15,14,9,6,13,12,6,11,10,12,8,3,7,3,11,13,10,2,1,2,1,3,2,1,3,1,2,3
"2083",59126649,"Mihail Caimacov","7/22/1998 (24 years old)","DM, M (RC), AM (C)","Slaven Belupo","Croatian First League","MDA","No","3/1/2022","6/15/2025","$100K - $300K","Left","Very Strong","Weak","6'0""","152 lbs","102","7",101,111,9,9,12,9,11,8,7,8,4,7,13,10,9,13,14,13,13,10,11,11,11,15,5,11,10,11,12,12,12,13,7,10,13,12,14,8,14,18,12,11,11,9,12,11,5,4,11,13,11,2,3,1,3,2,2,2,1,3,2,2
"2084",2000187093,"Daniele Grosu","11/20/2005 (17 years old)","D (C)","Padova","Italian Serie C/A","MDA","Yes","7/1/2022","6/30/2025","$100K - $325K","Left","Very Strong","Reasonable","6'1""","167 lbs","-","-",79,110,1,4,2,2,7,1,13,2,4,13,7,1,11,6,8,11,9,3,9,12,7,5,4,4,11,6,2,7,13,13,7,8,10,11,4,8,11,18,11,11,7,11,7,9,7,8,10,12,18,1,3,2,3,1,3,3,3,2,2,3
"2085",96501443,"Radu Gînsari","12/10/1991 (31 years old)","AM (RLC), ST (C)","Milsami Orhei","Moldovan Divizia Naţională","MDA","Yes","7/1/2022","6/30/2023","$1.5K - $18K","Right","Reasonable","Very Strong","5'10""","154 lbs","322","70",105,110,11,10,11,10,14,12,10,10,6,7,12,11,7,13,10,12,11,13,10,10,10,11,12,11,8,12,11,10,11,11,12,11,12,12,11,11,14,13,10,12,6,5,10,11,8,8,12,13,10,3,1,3,3,1,4,2,4,3,3,2
"2086",57135813,"Vladimir Ambros","12/30/1993 (29 years old)","AM (LC), ST (C)","Petrocub Hînceşti","Moldovan Divizia Naţională","MDA","No","6/15/2020","12/31/2024","$600K - $1.8M","Right Only","Weak","Very Strong","6'0""","174 lbs","147","65",105,110,8,8,12,6,14,8,10,9,5,7,14,2,9,12,5,13,9,13,9,12,5,13,9,10,9,9,14,10,14,14,9,10,12,14,14,10,12,16,9,9,10,10,9,13,5,7,16,12,9,2,2,2,2,1,1,2,1,1,2,3
"2087",43474386,"Iurie Iovu","7/6/2002 (20 years old)","D (C)","Istra 1961","Croatian First League","MDA","Yes","7/1/2022","6/30/2025","$0 - $55K","Right Only","Very Weak","Very Strong","6'4""","165 lbs","3","-",65,109,2,4,4,5,6,4,14,4,12,10,6,4,9,7,9,5,12,10,11,8,16,6,7,5,11,7,4,8,8,9,11,17,11,9,11,12,12,12,6,9,12,12,6,5,6,4,10,11,17,3,3,2,3,2,3,3,3,1,3,1
"2088",47005899,"Alexandru Dedov","7/26/1989 (33 years old)","M (RL), AM (RLC)","Zimbru Chişinău","Moldovan Divizia Naţională","MDA","No","7/22/2022","6/30/2023","$0 - $2K","Left Only","Very Strong","Weak","5'9""","165 lbs","299","47",89,108,5,10,11,11,11,10,7,10,4,6,10,12,5,11,8,10,11,12,11,11,6,12,8,12,7,11,10,11,12,12,12,8,13,12,12,12,12,20,8,11,10,12,10,13,8,1,13,11,7,1,2,2,1,3,3,1,2,1,3,3
"2089",2000184281,"Matteo Obleac","6/23/2006 (16 years old)","D (RC)","AS Roma","Italian Serie A","MDA","Yes","7/1/2022","6/30/2026","$100K - $300K","Right","Reasonable","Very Strong","6'4""","167 lbs","-","-",60,107,2,8,1,1,4,1,6,3,1,10,6,2,12,4,11,7,8,4,3,13,3,6,6,5,12,5,4,6,13,10,6,15,11,12,8,6,8,17,9,11,12,11,6,2,8,6,10,10,9,2,1,2,3,3,1,3,3,2,1,1
"2090",13232462,"Yassine El Welly","10/10/1998 (24 years old)","WB/M/AM (R)","FC Nouadhibou","Mauritanian D1","MTN","No","8/17/2022","6/30/2024","$0","Right","Reasonable","Very Strong","5'9""","154 lbs","12","2",90,115,8,12,10,11,9,4,4,9,4,6,12,7,6,10,15,9,6,8,9,13,11,12,7,13,8,6,7,9,13,12,9,4,14,12,13,7,14,19,11,10,12,12,12,2,5,2,10,12,16,2,2,2,2,1,1,2,3,2,3,2
"2091",57007460,"Artur Pătraş","10/1/1988 (34 years old)","M (LC)","SCM Zalău","Romanian Third League Group 10","MDA","No","1/26/2023","6/30/2024","$0 - $26K","Left","Very Strong","Weak","5'9""","156 lbs","381","45",85,107,12,11,10,7,11,13,6,9,3,4,10,11,6,10,8,10,12,9,11,10,11,12,3,9,9,10,10,12,11,10,9,7,12,11,11,10,13,15,13,14,11,11,3,11,6,1,11,8,8,3,2,1,2,2,2,1,3,3,2,3
"2092",2000284106,"Vlad Coliş","1/24/2004 (19 years old)","D (RC)","Sheriff Tiraspol","Moldovan Divizia A Group A","MDA","No","3/1/2023","12/31/2024","$0","Right","Weak","Very Strong","5'10""","160 lbs","-","-",75,106,8,9,7,5,7,8,12,5,3,15,8,5,16,7,15,9,16,10,7,7,15,5,3,9,6,9,4,11,7,14,11,8,15,12,11,10,11,18,7,10,9,13,12,11,10,7,8,11,16,3,2,2,2,2,1,3,3,1,3,2
"2093",59010240,"Stanislav Namaşco","11/10/1986 (36 years old)","GK","FC Bălți","Moldovan Divizia Naţională","MDA","No","7/27/2022","12/31/2023","$0 - $50K","Right","Weak","Very Strong","6'2""","174 lbs","330","-",106,106,3,2,1,1,6,7,2,3,2,2,12,1,1,6,6,14,12,12,8,11,3,2,12,2,16,11,10,10,11,15,11,14,15,11,6,10,10,15,12,13,12,14,5,12,12,5,12,8,17,10,9,12,16,12,10,12,15,11,12,11
"2094",2000150836,"Alexandru Gău","1/27/2004 (19 years old)","D (L), DM, M (C)","Viitorul Darabani","Romanian Third League Group 1","MDA","Yes","8/25/2022","-","$0","Left Only","Very Strong","Weak","5'11""","138 lbs","44","1",55,106,3,6,4,1,7,5,5,7,1,9,4,1,11,5,12,6,7,7,4,13,9,5,5,5,10,7,7,12,13,13,6,6,14,13,7,4,20,15,13,11,10,12,5,1,14,6,10,13,11,2,4,2,4,2,1,2,2,1,1,3
"2095",96501709,"Maxim Potîrniche","6/13/1989 (33 years old)","D (C)","Petrocub Hînceşti","Moldovan Divizia Naţională","MDA","Yes","6/14/2021","8/15/2024","Not for Sale","Right","Weak","Very Strong","6'1""","176 lbs","247","6",85,105,9,6,7,6,9,6,13,7,8,10,11,2,10,10,10,14,10,9,8,11,14,5,14,9,9,9,11,9,9,11,13,11,13,10,13,13,13,10,12,8,13,11,7,12,13,7,9,10,18,2,3,1,3,2,2,1,1,1,1,3
"2096",59118443,"Victor Stînă","3/20/1998 (25 years old)","M (C), AM (RLC)","Panserraikos","Greek Super League 1","MDA","No","1/2/2022","6/30/2024","$12K - $130K","Right","Reasonable","Very Strong","5'6""","141 lbs","146","28",95,105,12,13,13,8,13,12,6,12,3,5,13,8,6,14,8,8,8,9,10,9,11,14,6,11,7,10,13,10,12,13,7,5,12,11,10,6,10,12,15,15,8,13,6,13,3,4,15,12,15,1,1,2,2,3,2,3,2,2,2,1
"2097",59118530,"Dmitri Mandrîcenco","5/13/1997 (26 years old)","M/AM (C), ST (C)","Inhulets","Ukrainian First League","MDA","No","1/4/2022","6/30/2024","$40K - $425K","Right","Strong","Very Strong","6'0""","169 lbs","107","23",95,105,5,6,9,11,11,6,10,8,4,6,11,6,7,9,12,11,10,11,9,8,12,8,6,13,8,11,10,12,12,10,13,13,11,11,10,12,14,19,2,11,9,8,5,11,7,4,20,8,10,4,3,3,1,1,4,1,2,1,1,2
"2098",59013398,"Ion Jardan","1/10/1990 (33 years old)","D/WB (R)","Petrocub Hînceşti","Moldovan Divizia Naţională","MDA","No","1/28/2019","6/30/2024","$18K - $180K","Right","Reasonable","Very Strong","6'0""","169 lbs","313","20",90,105,6,13,7,9,9,4,9,4,9,11,10,3,13,11,10,11,11,5,14,10,3,7,5,9,11,10,8,10,13,11,10,11,10,10,12,7,10,15,6,11,12,11,8,5,6,3,9,11,9,3,2,1,1,1,1,1,2,2,1,2
"2099",139153,"Gheorghe Boghiu","10/26/1981 (41 years old)","AM (L), ST (C)","FC Sîngerei","Moldovan Lower Division","MDA","No","7/1/2022","6/30/2023","$0","Left Only","Very Strong","Weak","5'11""","171 lbs","306","130",79,105,9,10,9,14,10,9,10,11,3,7,11,8,9,11,12,8,10,11,8,9,7,7,10,14,7,8,9,10,12,10,9,10,11,12,10,10,11,17,6,10,10,8,2,10,6,7,10,6,11,1,4,2,3,2,1,3,2,2,2,1
"2100",57103321,"Veaceslav Posmac","11/7/1990 (32 years old)","D (C)","Boluspor","Turkish 1. League","MDA","No","6/1/2023","6/30/2025","Not for Sale","Right","Reasonable","Very Strong","6'4""","196 lbs","323","21",95,105,3,5,6,5,11,4,13,4,5,12,10,6,12,9,10,13,12,11,13,11,10,7,8,9,13,14,10,11,6,8,11,15,10,10,11,14,1,14,1,11,11,11,9,3,10,4,14,10,8,2,1,3,1,2,3,1,2,3,1,1
"2101",13173473,"Taghiyoullah Denna","6/15/1986 (36 years old)","D (C), DM, M (C)","FC Nouadhibou","Mauritanian D1","MTN","No","7/1/2020","6/30/2024","$0","Right","Fairly Strong","Very Strong","6'0""","167 lbs","-","-",75,115,5,6,3,8,10,8,8,7,3,11,10,2,14,10,11,9,9,9,10,11,11,6,5,8,11,9,10,14,10,6,9,9,16,9,10,7,15,10,12,10,10,11,10,11,8,8,19,12,8,1,1,1,2,3,1,2,1,1,2,3
"2102",59130531,"Mihail Ghecev","11/5/1997 (25 years old)","M/AM (L), ST (C)","Minaj","Ukrainian Premier League","MDA","Yes","2/3/2023","12/31/2024","$1K - $9K","Right","Strong","Very Strong","5'9""","160 lbs","100","11",89,105,9,9,12,9,9,8,8,7,5,5,8,9,6,11,13,8,7,8,6,5,7,8,5,8,7,11,8,12,11,10,11,8,15,14,11,9,12,10,8,10,10,11,8,10,7,5,18,11,13,3,3,1,1,1,3,3,2,3,1,3
"2103",2000110098,"Victor Bogaciuc","10/17/1999 (23 years old)","DM, M (C)","Petrocub Hînceşti","Moldovan Divizia Naţională","MDA","Yes","7/1/2019","12/31/2024","$0","Right","Strong","Very Strong","6'1""","158 lbs","88","8",81,105,3,6,3,6,12,6,6,10,1,8,11,5,7,11,15,10,8,8,8,13,12,5,13,8,12,7,13,11,12,12,7,13,11,10,6,5,13,20,1,10,10,11,6,13,5,7,12,10,12,1,2,4,2,1,2,1,1,3,1,2
"2104",96501425,"Denis Rusu","8/2/1990 (32 years old)","GK","Gloria Buzău","Romanian Second League","MDA","Yes","1/18/2023","6/30/2024","$100K - $300K","Right Only","Weak","Very Strong","5'11""","167 lbs","206","-",93,105,3,3,3,1,6,6,1,2,1,1,7,1,2,6,7,10,11,8,11,13,14,8,8,9,9,12,9,13,8,9,10,11,9,8,11,11,10,11,14,14,12,14,3,8,6,5,11,14,14,12,9,13,10,12,11,13,6,13,12,11
"2105",59010473,"Alexandru Antoniuc","5/23/1989 (34 years old)","AM (C), ST (C)","Milsami Orhei","Moldovan Divizia Naţională","MDA","No","6/14/2021","6/30/2023","$2.5K - $8K","Right Only","Weak","Very Strong","5'11""","167 lbs","324","65",94,105,10,11,12,8,11,10,8,12,5,5,12,9,4,13,10,11,13,13,13,10,14,10,14,12,9,11,12,12,12,11,12,12,15,12,13,13,11,10,6,13,13,11,13,7,12,6,12,11,20,3,1,3,3,1,3,1,1,3,3,4
"2106",2000127251,"Vicu Bulmaga","7/5/2003 (19 years old)","D (C)","Isloch","Belarusian Highest League","MDA","No","2/15/2023","11/30/2024","$5K - $50K","Right","Reasonable","Very Strong","5'11""","167 lbs","62","6",80,105,5,3,3,5,8,2,8,4,5,12,8,2,8,6,12,10,9,8,7,14,14,6,13,5,8,7,3,8,9,14,8,8,7,13,11,9,8,19,5,14,10,12,15,13,5,1,10,12,8,2,1,2,3,3,4,2,1,1,1,1
"2107",59118351,"Iaser Ţurcan","1/7/1998 (25 years old)","DM, M (C)","Petrocub Hînceşti","Moldovan Divizia Naţională","MDA","Yes","1/15/2019","12/31/2024","$4K - $40K","Right","Reasonable","Very Strong","6'2""","174 lbs","118","13",77,105,7,7,5,8,13,4,6,8,2,7,13,2,13,9,15,9,8,8,9,14,9,5,6,9,9,13,9,12,9,9,9,14,9,9,7,8,10,19,7,14,12,10,12,14,9,3,8,11,17,2,4,1,3,4,4,3,1,1,2,3
"2108",59007797,"Gheorghe Ovseanicov","10/12/1985 (37 years old)","AM (C), ST (C)","FC Făleşti","Moldovan Divizia A Group B","MDA","No","1/1/2022","6/30/2024","$8K - $24K","Right","Reasonable","Very Strong","6'0""","169 lbs","291","66",83,105,7,3,14,11,5,6,14,7,3,7,8,1,2,13,5,12,6,9,8,14,13,10,9,13,8,7,11,9,8,11,8,8,13,14,14,11,12,16,7,12,14,10,10,4,6,2,15,9,14,3,1,2,1,1,2,1,3,1,3,3
"2109",83273304,"Nicky Cleșcenco","7/23/2001 (21 years old)","AM (L), ST (C)","Petrocub Hînceşti","Moldovan Divizia Naţională","MDA","Yes","2/2/2021","6/30/2025","$0 - $35K","Right Only","Weak","Very Strong","5'10""","149 lbs","45","9",72,104,7,9,8,14,11,7,7,9,5,7,11,6,5,11,13,8,8,13,8,9,17,10,14,10,7,8,8,11,14,14,13,4,13,13,7,4,12,20,3,10,10,12,5,14,10,7,11,12,10,3,1,1,2,2,4,3,2,1,1,2
"2110",57134237,"Alexandru Boiciuc","8/21/1997 (25 years old)","ST (C)","Gloria Buzău","Romanian Second League","MDA","Yes","9/5/2022","6/30/2024","$140K - $425K","Left Only","Very Strong","Weak","6'3""","180 lbs","170","36",89,104,5,7,10,11,11,8,13,11,6,7,10,12,6,10,11,12,11,12,11,9,11,8,6,10,9,11,11,12,11,12,9,13,10,12,9,12,9,8,10,11,12,10,8,10,6,4,12,12,10,1,1,4,3,1,3,2,1,1,1,3
"2111",57132555,"Vadim Paireli","11/8/1995 (27 years old)","AM (R), ST (C)","Milsami Orhei","Moldovan Divizia Naţională","MDA","No","6/12/2023","6/30/2024","$10K - $100K","Right Only","Weak","Very Strong","5'11""","154 lbs","186","28",88,104,7,10,8,14,14,6,12,5,4,7,12,8,2,13,13,13,7,9,8,10,17,12,5,11,7,7,7,9,14,14,8,9,15,14,14,6,12,20,9,12,13,12,6,9,10,5,12,11,18,1,3,1,4,3,1,1,1,2,4,1
"2112",87002129,"Éder Delgado","11/20/1986 (36 years old)","WB (RL), DM, M (RLC)","Real Sociedad (HON)","Liga Nacional de Honduras","HON","No","5/31/2021","6/30/2024","$80K - $240K","Right","Fairly Strong","Very Strong","5'9""","154 lbs","467","48",108,115,10,9,11,8,12,7,12,7,2,11,11,5,12,12,12,9,12,11,11,10,3,9,11,10,10,12,9,13,13,13,11,8,14,13,13,10,16,4,4,11,10,9,5,12,8,3,14,10,15,2,3,1,3,2,1,2,3,2,3,3
"2113",8440918,"Oumar N'Diaye","12/9/1988 (34 years old)","DM, M (C)","Saint-Alban Aucamville FC","French Regional 1 - Occitanie - Group C","MTN","Yes","7/1/2021","-","$0","Right Only","Weak","Very Strong","6'0""","147 lbs","85","4",72,115,7,9,10,6,11,8,9,11,7,6,10,8,8,10,13,11,12,10,10,9,17,11,11,9,9,12,8,12,12,11,11,11,12,11,12,9,10,14,14,16,8,15,10,13,13,6,12,13,13,1,2,1,2,2,2,3,1,2,2,4
"2114",59142857,"Daniel Danu","8/26/2002 (20 years old)","M/AM (C)","FC Bălți","Moldovan Divizia Naţională","MDA","No","7/6/2020","6/30/2024","$22K - $65K","Right","Fairly Strong","Very Strong","6'1""","169 lbs","4","-",64,103,4,4,7,7,10,3,6,8,4,6,6,6,8,12,7,5,7,14,6,9,11,14,11,10,8,7,7,12,14,8,7,12,15,10,13,6,12,10,5,12,12,9,8,8,6,7,9,13,15,1,3,1,1,2,1,1,1,4,2,1
"2115",43599132,"Gheorghe Fomov","2/3/2001 (22 years old)","D/WB (R), M (RC), AM (R)","Derthona","Italian Serie D Grp. A","MDA","Yes","1/1/2023","6/30/2024","$0 - $30K","Right Only","Very Weak","Very Strong","5'9""","152 lbs","89","7",64,102,6,8,6,5,8,4,7,5,10,7,7,4,10,8,11,9,11,9,7,8,10,5,7,8,8,9,4,11,11,10,10,10,15,11,11,8,19,12,13,14,12,5,8,12,14,7,13,12,15,3,3,2,3,2,2,3,2,3,2,1
"2116",2000297519,"Alexandros Targon","6/13/2006 (16 years old)","GK","Dinamo Bucureşti","Romanian First League","MDA","No","1/1/2023","6/30/2026","$16K - $160K","Right Only","Weak","Very Strong","5'11""","158 lbs","-","-",51,102,1,3,3,2,6,3,6,3,2,3,7,3,2,7,9,9,9,10,9,8,12,8,5,7,8,9,8,9,8,12,7,9,13,8,6,6,7,17,8,9,12,13,5,10,5,4,10,11,16,9,10,12,8,10,8,9,8,7,7,7
"2117",57103248,"Maxim Focşa","4/21/1992 (31 years old)","D (C), WB (L)","SCM Zalău","Romanian Third League Group 10","MDA","No","1/31/2023","6/30/2024","$20K - $200K","Right","Reasonable","Very Strong","6'1""","182 lbs","203","9",85,100,4,4,4,4,12,6,12,12,12,12,8,8,12,6,8,8,8,8,8,12,3,6,8,6,12,8,4,12,10,11,12,12,12,10,12,14,6,13,10,10,11,12,12,6,12,6,16,11,13,1,1,2,3,3,2,1,1,1,2,3
"2118",1653192,"Vadim Bolohan","8/15/1986 (36 years old)","D (LC)","Milsami Orhei","Moldovan Divizia Naţională","MDA","No","6/14/2021","6/30/2023","$0","Left","Very Strong","Reasonable","6'2""","185 lbs","345","11",85,100,5,9,10,5,5,1,11,7,5,12,9,2,12,6,12,9,9,9,8,13,17,5,14,8,11,13,5,11,12,9,11,10,10,9,9,10,12,11,4,11,14,11,11,5,13,1,8,11,16,4,3,1,2,2,1,3,3,1,2,4
"2119",57116259,"Dinu Graur","1/27/1994 (29 years old)","D/WB/M (R)","Milsami Orhei","Moldovan Divizia Naţională","MDA","Yes","10/1/2022","6/30/2023","$500 - $5K","Right Only","Weak","Very Strong","5'9""","145 lbs","124","3",90,100,6,5,8,6,11,6,8,6,12,12,6,6,12,8,6,12,12,11,12,12,12,11,6,12,13,12,9,12,13,12,10,8,10,12,12,10,11,20,6,11,11,12,5,11,11,8,11,10,9,3,3,1,1,1,3,2,3,3,3,3
"2120",53152431,"Simen Alexander Santos Lyngbø","2/18/1998 (25 years old)","D (RL)","Persik","Indonesian League One","PHI","Yes","5/23/2023","5/31/2024","$5K - $50K","Right","Strong","Very Strong","5'9""","163 lbs","47","2",122,136,9,14,11,5,11,2,11,2,6,11,12,1,13,12,11,11,11,13,11,11,18,7,11,10,13,12,6,13,13,13,13,11,13,12,14,13,10,11,12,17,12,12,3,9,9,9,12,20,14,3,1,1,3,1,3,3,4,2,1,4
"2121",5006680,"Neil Etheridge","2/7/1990 (33 years old)","GK","Birmingham","Sky Bet Championship","PHI","No","9/11/2020","6/30/2024","$28K - $275K","Right Only","Weak","Very Strong","6'2""","198 lbs","264","-",109,134,5,2,2,1,10,10,7,3,3,3,8,4,3,11,12,12,13,11,12,10,12,5,9,10,11,5,7,5,11,15,14,13,12,11,12,12,13,15,12,13,11,10,3,11,6,5,11,10,12,10,12,14,14,13,6,14,13,12,12,12
"2122",8718375,"Stephan Schröck","8/21/1986 (36 years old)","D (R), M/AM (RL)","ADT","Philippines Football League","PHI","Yes","8/6/2022","12/31/2023","$0 - $1.5K","Right","Reasonable","Very Strong","5'6""","132 lbs","266","27",77,130,7,11,10,7,10,5,4,9,16,8,10,8,12,10,17,9,17,10,10,7,17,15,8,12,6,9,10,10,10,10,10,5,13,10,9,7,17,7,10,11,10,14,13,14,15,10,14,12,11,3,3,1,1,1,1,1,1,1,3,2
"2123",67248166,"Óscar Arribas","10/22/1998 (24 years old)","AM (RLC)","Johor DT","Malaysian Super League","PHI","Yes","1/8/2023","11/30/2024","$95K - $950K","Right","Fairly Strong","Very Strong","5'10""","152 lbs","184","17",114,129,10,12,13,12,11,7,8,10,9,7,13,7,8,12,9,12,13,10,11,13,4,13,12,13,8,12,12,13,12,12,10,8,12,13,12,10,11,12,10,12,11,9,6,14,5,6,12,12,12,1,3,2,1,1,3,3,3,1,2,3
"2124",13173476,"Ismaël Diakité","12/13/1991 (31 years old)","AM (R), ST (C)","CS Sfax","Ligue Professionnelle 1","MTN","No","10/15/2021","6/30/2025","Not for Sale","Right","Weak","Very Strong","5'7""","145 lbs","164","28",103,115,8,10,12,13,11,7,8,9,7,5,11,12,5,12,8,13,11,10,11,12,5,13,9,13,6,10,10,11,14,12,10,10,13,13,12,7,12,15,12,12,10,11,5,7,14,1,11,12,15,2,1,1,2,1,3,4,3,2,2,3
"2125",91147351,"Gerrit Holtmann","3/25/1995 (28 years old)","M/AM (L)","VfL Bochum","Bundesliga","PHI","Yes","7/21/2022","6/30/2025","$200K - $2M","Left","Very Strong","Reasonable","6'0""","169 lbs","204","28",121,129,10,11,13,10,11,9,7,11,12,8,10,8,9,12,14,10,10,9,9,8,11,13,5,12,8,10,10,11,17,14,9,9,12,17,12,8,16,12,11,12,10,8,12,11,6,6,10,14,9,1,1,3,3,2,2,1,2,2,2,1
"2126",91175719,"Raphael Obermair","4/1/1996 (27 years old)","D/WB (RL)","Paderborn","Bundesliga 2","PHI","Yes","7/1/2022","6/30/2025","$120K - $1.2M","Right","Reasonable","Very Strong","6'0""","169 lbs","260","23",118,125,12,12,13,8,12,12,6,9,6,9,12,6,11,13,12,11,10,11,9,9,13,16,4,13,9,12,12,13,15,14,10,9,13,15,13,9,19,12,13,12,12,13,7,12,7,6,13,13,9,1,1,2,1,2,1,2,4,2,1,2
"2127",93024929,"Jesper Nyholm","9/10/1993 (29 years old)","D (RC)","Muangthong Utd","Thai League","PHI","Yes","1/1/2022","6/30/2026","$550K - $1.6M","Right Only","Weak","Very Strong","6'0""","163 lbs","167","6",106,125,5,9,9,4,10,6,11,5,7,12,12,6,13,11,13,13,14,13,12,12,14,7,10,6,12,12,8,14,12,11,11,13,12,13,13,13,5,17,15,14,12,5,15,10,10,5,12,10,13,2,1,1,1,1,2,3,3,2,3,3
"2128",2000211769,"Sandro Reyes","3/29/2003 (20 years old)","M/AM (C)","Fürth","Bundesliga 2","PHI","Yes","1/31/2023","6/30/2024","$350K - $1M","Left","Very Strong","Reasonable","5'9""","154 lbs","13","1",84,119,3,4,9,11,14,7,3,7,4,8,14,7,9,9,13,7,8,9,9,13,9,12,4,9,9,8,9,13,14,10,8,9,9,12,8,6,14,10,11,11,11,10,7,14,14,2,11,9,14,1,2,1,1,2,1,2,2,3,1,3
"2129",92072098,"John-Patrick Strauß","1/28/1996 (27 years old)","D (RL), WB (R)","Hansa Rostock","Bundesliga 2","PHI","Yes","7/1/2022","6/30/2024","$65K - $650K","Right","Reasonable","Very Strong","5'10""","154 lbs","164","13",107,115,6,12,11,7,11,4,7,8,15,11,11,7,13,11,14,11,14,10,10,11,13,11,8,11,11,14,11,15,14,14,9,7,15,15,13,8,16,14,16,16,9,10,5,8,7,7,11,12,7,1,4,3,1,3,3,2,4,2,1,1
"2130",91124145,"Mike Ott","3/2/1995 (28 years old)","M (C), AM (RC), ST (C)","Barito Putera","Indonesian League One","PHI","Yes","8/1/2022","5/31/2024","$65K - $200K","Right","Fairly Strong","Very Strong","5'6""","130 lbs","133","36",101,115,8,8,13,9,12,9,6,9,8,10,10,7,8,12,7,10,8,9,9,10,14,12,9,14,9,9,10,10,13,13,8,5,10,12,11,6,12,14,14,14,14,11,10,12,9,6,12,13,10,3,1,2,3,1,1,1,2,1,3,3
"2131",89054845,"Kike","4/5/1994 (29 years old)","AM (C), ST (C)","Lincoln (GIB)","Gibraltar Football League","PHI","Yes","3/31/2023","6/30/2024","$14K - $45K","Right","Fairly Strong","Very Strong","5'7""","143 lbs","162","132",95,115,8,9,14,13,14,8,8,8,3,7,9,6,7,12,9,13,4,8,9,11,12,13,8,9,9,8,12,10,11,14,6,7,6,13,14,5,9,13,9,11,13,8,11,10,13,2,14,11,8,2,2,3,2,2,3,3,2,3,2,1
"2132",45055172,"Daisuke Sato","9/20/1994 (28 years old)","D/WB (L)","Persib","Indonesian League One","PHI","No","6/10/2022","5/31/2024","$18K - $190K","Left Only","Very Strong","Weak","5'9""","143 lbs","179","8",97,115,7,11,12,9,10,7,10,11,6,9,11,7,12,11,14,10,12,10,11,11,11,9,8,12,8,10,11,15,14,13,12,8,12,13,12,9,11,12,13,13,12,11,6,10,6,6,10,12,13,3,2,1,1,2,1,2,4,4,1,1
"2133",854452,"Paul Mulders","1/16/1981 (42 years old)","M/AM (C), ST (C)","Global","Filipino Lower Division","PHI","Yes","6/14/2021","12/31/2023","$0 - $6K","Right","Reasonable","Very Strong","6'0""","182 lbs","312","45",76,115,8,9,11,5,10,8,10,9,5,5,11,4,8,11,6,12,10,13,14,12,15,9,13,9,7,13,10,11,8,11,11,10,16,8,10,12,13,11,11,10,9,10,5,12,5,7,11,12,13,3,2,2,1,4,2,3,1,1,2,3
"2134",16004342,"Stephan Palla","5/15/1989 (34 years old)","D/WB (L)","ASK Voitsberg","Austrian Regional League Central","PHI","Yes","6/30/2022","6/30/2024","$0 - $45K","Left","Very Strong","Reasonable","5'8""","154 lbs","291","2",89,115,5,7,10,7,11,5,7,9,11,10,11,8,11,10,11,11,12,10,11,9,11,10,6,13,12,12,10,12,13,10,8,7,13,11,11,11,8,14,12,12,10,11,13,9,6,6,13,11,8,3,1,1,3,1,1,2,1,2,1,2
"2135",18091310,"Babacar Niasse","12/20/1996 (26 years old)","GK","TND","Portuguese Second League","MTN","No","8/22/2019","6/30/2024","$60K - $600K","Right","Weak","Very Strong","6'4""","171 lbs","90","-",108,115,1,3,5,1,10,1,11,1,2,1,10,3,7,8,14,12,16,12,8,8,13,2,8,2,10,12,12,12,10,16,12,17,14,14,13,10,1,16,7,8,10,13,9,10,10,5,10,12,11,8,15,13,14,9,14,11,15,10,8,17
"2136",61085652,"Yrick Gallantes","1/14/2001 (22 years old)","M/AM (LC)","ADT","Philippines Football League","PHI","No","7/1/2021","12/31/2024","$0 - $130K","Left","Very Strong","Reasonable","5'6""","134 lbs","-","-",75,114,7,10,10,9,14,8,9,10,4,7,15,2,10,9,15,9,8,10,10,15,9,8,3,15,8,12,7,7,10,11,10,1,13,10,6,2,12,17,12,13,12,11,8,12,5,3,14,11,19,1,3,2,2,3,1,2,2,3,2,3
"2137",2000010846,"John Lucero","12/1/2003 (19 years old)","D (RC)","Newhaven","English Southern Combination Premier Division","PHI","No","6/13/2022","-","$0","Right","Weak","Very Strong","5'8""","136 lbs","-","-",60,113,4,8,6,1,8,4,14,5,3,11,7,1,9,4,15,9,8,6,9,10,10,5,10,5,10,7,5,7,13,11,7,4,14,12,6,6,9,17,10,13,12,13,8,4,11,5,10,12,17,3,2,3,3,1,2,1,2,3,3,2
"2138",775090,"Satoshi Otomo","10/1/1981 (41 years old)","AM (C)","Aguilas","Filipino Lower Division","PHI","No","6/14/2021","12/31/2024","Not for Sale","Right","Reasonable","Very Strong","5'8""","160 lbs","271","21",61,110,8,7,6,12,14,8,5,8,2,8,14,5,8,16,8,10,7,16,6,11,8,13,7,11,8,9,10,12,6,6,6,8,6,6,7,6,14,11,10,10,13,12,12,14,12,7,9,11,11,3,3,2,3,1,4,2,1,3,1,1
"2139",15046698,"Jesse Curran","7/16/1996 (26 years old)","D/M (R)","BG Pathum Utd","Thai League","PHI","No","7/3/2022","6/30/2025","$50K - $500K","Right","Reasonable","Very Strong","6'0""","149 lbs","137","8",95,110,9,11,12,8,12,9,8,7,5,8,11,7,9,12,8,10,6,9,9,9,8,11,8,9,8,11,11,11,13,12,11,7,11,13,11,9,10,9,10,9,6,8,5,6,9,7,8,12,10,3,1,3,1,3,2,2,1,1,1,1
"2140",27162532,"Sebastian Beraque","6/17/2002 (20 years old)","ST (C)","Hobro IK","Denmark's Series Group 4","PHI","Yes","1/25/2023","6/30/2024","$55K - $550K","Left","Very Strong","Weak","6'4""","165 lbs","55","14",75,109,6,7,12,13,12,6,13,7,1,5,7,4,5,7,7,7,6,6,5,12,17,7,2,11,6,6,7,8,13,10,7,10,15,11,6,6,9,14,11,7,12,14,10,10,8,5,17,9,12,3,1,2,1,3,2,2,1,2,3,2
"2141",98017177,"Michael Kempter","1/12/1995 (28 years old)","D/WB/M (L)","St. Gallen","Swiss Super League","PHI","Yes","7/1/2021","6/30/2025","$110K - $350K","Left","Very Strong","Reasonable","5'11""","165 lbs","142","3",106,108,8,12,12,3,12,6,11,11,13,11,10,2,12,12,11,10,12,12,11,11,13,11,7,11,11,13,8,13,13,12,11,9,9,13,13,10,14,12,11,12,8,11,17,11,10,6,11,10,16,1,1,1,3,3,2,1,4,3,1,1
"2142",27069858,"Kevin Mendoza","9/29/1994 (28 years old)","GK","Kuala Lumpur","Malaysian Super League","PHI","Yes","1/1/2023","11/30/2024","$30K - $325K","Right","Strong","Very Strong","6'2""","189 lbs","208","-",99,108,2,1,1,3,8,4,6,2,2,2,8,2,1,7,7,10,11,12,11,8,5,15,4,11,8,10,8,10,11,14,11,14,12,11,8,11,10,11,13,12,8,8,6,5,5,7,12,11,11,9,17,15,4,12,14,11,5,10,10,12
"2143",84151439,"Anthony Pinthus","4/4/1998 (25 years old)","GK","PSS","Indonesian League One","PHI","Yes","5/28/2023","5/31/2024","$2.5K - $24K","Right","Reasonable","Very Strong","6'0""","196 lbs","52","-",87,108,6,1,1,3,5,8,2,2,2,1,11,3,1,5,8,13,12,8,1,15,11,3,10,2,11,9,2,8,11,12,9,10,9,12,8,10,11,15,11,8,11,13,5,5,11,7,20,10,19,10,8,12,12,11,12,12,5,12,11,12
"2144",53151205,"Adrian Ugelvik","9/21/2001 (21 years old)","D (RC)","Levanger","Norwegian Second Division Group 2","PHI","Yes","1/1/2023","12/31/2024","$12K - $35K","Right Only","Weak","Very Strong","6'2""","180 lbs","76","4",87,107,6,7,6,6,9,5,12,6,7,11,8,6,12,9,8,12,10,12,11,12,13,8,9,5,12,11,8,11,9,9,11,12,12,10,12,11,11,8,15,13,11,14,7,1,12,7,13,13,10,1,1,2,1,1,1,2,2,2,1,1
"2145",72044895,"Kainoa Bailey","8/2/1995 (27 years old)","M (L), AM (RL), ST (C)","Stallion","Philippines Football League","PHI","No","3/8/2022","12/31/2024","$3.5K - $35K","Right Only","Weak","Very Strong","5'8""","156 lbs","48","4",83,106,8,9,9,8,9,9,4,8,3,4,10,9,4,11,6,9,9,8,9,8,9,11,8,9,3,10,9,13,13,11,11,6,12,13,11,8,13,13,9,8,8,11,12,10,6,8,9,11,8,1,3,2,3,2,2,2,3,2,3,3
"2146",85094793,"Adama Ba","8/27/1993 (29 years old)","M/AM (RL)","RS Berkane","Botola Pro 1","MTN","No","8/1/2019","6/30/2023","$7K - $20K","Right","Weak","Very Strong","5'10""","160 lbs","163","15",103,115,5,8,12,9,12,7,12,11,6,5,11,12,4,10,10,12,12,9,10,10,10,11,6,13,6,8,9,12,15,13,14,10,14,14,10,13,11,15,14,10,11,11,8,10,7,9,9,13,9,1,1,1,2,2,3,2,3,1,4,2
"2147",23353676,"Kenshiro Daniels","1/13/1995 (28 years old)","M (R), AM (RL), ST (C)","RANS Nusantara","Indonesian League One","PHI","No","6/10/2023","5/31/2024","$20K - $200K","Right","Fairly Strong","Very Strong","5'10""","141 lbs","60","20",95,105,10,11,10,10,10,10,8,6,3,8,9,9,8,10,8,11,8,9,9,9,16,10,6,15,9,9,8,8,11,10,9,10,14,11,11,10,13,13,11,9,10,13,5,12,9,3,20,10,9,2,2,1,3,1,2,3,3,3,3,1
"2148",53122156,"Elias Mordal","1/20/1998 (25 years old)","D/WB (R)","Mendiola","Philippines Football League","PHI","Yes","1/1/2020","12/31/2023","$0 - $40K","Right Only","Very Weak","Very Strong","5'6""","125 lbs","88","3",80,105,10,12,10,6,9,7,4,5,10,8,7,4,8,9,7,8,13,5,8,8,16,13,12,10,8,12,7,13,15,10,4,7,14,15,12,5,13,9,16,15,11,13,12,7,12,7,14,15,14,3,1,3,2,2,3,2,1,3,3,1
"2149",2000091503,"Paul Bismarck Tabinas","7/5/2002 (20 years old)","D (LC), WB/M (R)","Vukovar 1991","Croatian Second League","PHI","No","2/22/2023","6/15/2025","$1.5K - $16K","Right","Reasonable","Very Strong","6'1""","165 lbs","41","2",71,104,5,7,9,6,10,4,10,7,6,10,8,1,11,10,13,9,10,10,9,12,4,5,6,8,9,9,8,10,8,10,9,13,10,11,6,6,13,17,12,5,12,13,7,6,19,14,5,11,16,1,3,3,2,1,3,1,2,1,1,3
"2150",45109177,"Tabinas Jefferson","8/7/1998 (24 years old)","D (LC)","Mito","J2 League","PHI","No","1/1/2022","1/31/2024","$200K - $600K","Left","Very Strong","Reasonable","6'0""","176 lbs","114","2",92,102,3,8,9,4,8,4,8,8,9,12,8,6,9,8,12,11,13,12,8,8,3,8,6,6,10,12,11,12,13,13,13,12,14,12,12,13,10,10,11,13,11,12,4,10,6,1,8,14,15,1,1,1,2,1,1,1,1,2,1,2
"2151",53162708,"Lloyd Fagerlie","7/15/2002 (20 years old)","AM (RL), ST (C)","Lysekloster","-","PHI","Yes","3/30/2022","12/31/2024","$0","Right Only","Weak","Very Strong","5'7""","132 lbs","29","2",77,101,6,8,12,8,11,6,3,6,2,4,8,6,5,12,12,7,13,6,7,6,14,16,5,10,4,11,10,12,14,14,8,4,8,12,9,5,10,9,14,14,12,14,5,13,14,6,14,14,11,3,2,2,1,1,4,2,2,3,3,3
"2152",91147891,"Harry Föll","3/2/1998 (25 years old)","M (RC), AM (C)","Villingen","German Div. Baden-Württemberg","PHI","Yes","7/1/2021","6/30/2025","$0","Right Only","Weak","Very Strong","5'11""","156 lbs","26","3",76,100,6,7,7,8,9,6,1,6,1,5,8,1,8,13,7,6,5,5,8,13,12,13,4,8,8,7,11,12,13,13,7,9,12,13,12,7,11,13,13,13,13,12,8,16,9,6,12,12,6,2,1,1,1,3,1,1,3,1,2,1
"2153",67118136,"Diego Bardanca","3/20/1993 (30 years old)","D (C)","Buriram Utd","Thai League","PHI","Yes","3/11/2022","6/30/2025","$30K - $300K","Left Only","Very Strong","Weak","6'3""","176 lbs","218","3",91,100,3,6,8,7,9,8,12,8,10,12,9,7,12,9,14,12,13,11,10,10,12,8,8,9,12,12,8,12,9,8,12,14,12,10,12,14,8,11,11,14,12,12,9,12,12,6,11,10,11,1,2,1,4,2,1,1,3,2,3,1
"2154",67044401,"Bienve","5/15/1986 (37 years old)","M (R), AM (RC), ST (C)","Villarrubia","Spanish Federation Third Group 18","PHI","Yes","7/1/2022","6/30/2024","$7K - $22K","Right","Weak","Very Strong","5'8""","149 lbs","264","97",85,100,8,9,9,11,14,8,9,11,7,6,12,15,9,12,13,13,4,12,9,14,6,10,9,10,7,9,11,10,9,10,9,6,16,9,9,6,10,16,12,13,13,9,10,11,6,7,20,8,7,1,1,4,2,3,3,2,1,2,1,1
"2155",91108082,"Manuel Ott","5/6/1992 (31 years old)","DM, M/AM (RC)","Kedah","Malaysian Super League","PHI","Yes","12/13/2022","11/30/2024","$0 - $100K","Right","Strong","Very Strong","5'9""","152 lbs","181","27",82,100,7,9,5,8,9,7,3,7,1,5,5,5,9,10,12,7,8,13,9,14,7,14,8,13,8,8,10,13,9,8,8,7,15,8,14,7,10,13,14,10,9,12,5,6,15,4,11,9,18,2,1,2,3,3,1,2,2,3,3,2
"2156",74000269,"Iain Ramsay","2/27/1988 (35 years old)","M/AM (L)","Chiangmai Utd","Thai League Two","PHI","No","1/17/2023","6/30/2024","$20K - $60K","Left","Very Strong","Reasonable","5'10""","167 lbs","308","26",93,100,10,9,12,8,7,10,3,7,2,2,11,9,6,9,10,11,12,7,12,7,16,10,15,9,3,5,7,15,15,13,11,5,13,13,15,11,5,14,9,11,11,10,8,9,5,2,8,13,15,2,3,1,1,2,1,1,2,3,1,2
"2157",85080840,"Khassa Camara","10/22/1992 (30 years old)","DM, M (C)","Chania","Greek Super League 2 South","MTN","Yes","9/24/2022","6/30/2023","$0 - $5K","Right Only","Weak","Very Strong","5'9""","145 lbs","167","2",95,110,8,8,9,6,11,8,7,8,10,14,9,8,13,11,16,11,16,10,10,11,15,7,6,10,12,14,10,15,14,13,12,7,15,13,14,8,12,11,8,10,14,14,6,9,15,6,12,16,13,3,3,1,1,1,4,3,1,1,3,4
"2158",27013505,"Michael Falkesgaard","4/9/1991 (32 years old)","GK","Bangkok Utd","Thai League","PHI","Yes","6/14/2021","6/30/2024","$170K - $500K","Right","Weak","Very Strong","6'3""","178 lbs","156","-",98,99,2,2,3,2,9,4,8,2,3,3,10,2,2,6,10,14,10,8,8,8,8,8,10,5,10,12,13,14,8,11,11,16,10,10,11,14,13,12,14,7,6,11,12,5,2,7,10,12,8,12,12,14,9,14,9,12,10,13,11,15
"2159",35011018,"Roland Müller","3/2/1988 (35 years old)","GK","Amical Saint-Prex","Swiss Second League Interregio Gr 1","PHI","Yes","2/9/2021","6/30/2024","$0 - $14K","Right Only","Weak","Very Strong","5'11""","165 lbs","210","-",76,98,3,3,3,2,1,7,1,3,1,1,9,1,3,5,6,10,12,7,13,10,11,1,11,3,9,7,5,6,9,12,8,8,12,9,1,9,9,17,12,13,12,10,10,6,11,3,7,10,8,8,8,15,6,13,4,12,9,10,7,6
"2160",23352780,"Amani Aguinaldo","4/24/1995 (28 years old)","D (C)","Nakhon Ratchasima","Thai League Two","PHI","No","6/20/2022","6/30/2024","$0","Right","Reasonable","Very Strong","6'0""","171 lbs","109","4",85,98,2,3,3,4,9,2,11,3,3,13,7,5,11,6,10,13,13,10,11,11,9,5,7,3,13,5,3,8,11,10,9,11,12,10,11,11,13,11,11,11,13,10,11,12,9,6,11,9,20,3,1,1,1,3,3,3,3,3,2,2
"2161",91108796,"Kevin Ingreso","2/10/1993 (30 years old)","M/AM (C)","Pahang","Malaysian Super League","PHI","Yes","1/1/2023","11/30/2024","$0 - $110K","Right","Reasonable","Very Strong","5'10""","152 lbs","192","8",75,98,1,5,8,6,13,4,4,8,1,6,9,4,3,10,10,10,7,9,5,12,5,10,5,11,8,7,7,12,13,13,7,8,17,13,13,10,12,18,12,11,10,11,9,14,3,2,8,10,13,2,2,1,1,1,1,2,3,2,1,3
"2162",91177337,"Oliver Bias","6/15/2001 (21 years old)","M/AM (RL)","ADT","Philippines Football League","PHI","Yes","1/1/2023","12/31/2023","$18K - $55K","Right","Reasonable","Very Strong","5'5""","132 lbs","5","-",77,93,9,10,12,8,11,9,5,9,5,4,11,8,4,12,10,9,8,10,8,8,12,12,7,8,7,10,12,11,13,13,7,4,12,8,8,4,13,13,13,13,11,12,7,12,7,7,11,13,9,2,2,3,2,2,3,1,1,2,2,1
"2163",23089830,"Misagh Bahadoran","1/10/1987 (36 years old)","AM (R), ST (C)","Global","Filipino Lower Division","PHI","No","2/13/2020","12/31/2023","$0 - $4.5K","Right","Fairly Strong","Very Strong","5'7""","152 lbs","41","28",73,90,5,9,9,12,10,6,10,6,7,6,13,6,6,12,12,7,4,8,7,12,13,13,11,12,7,8,9,9,9,9,8,7,16,9,9,5,11,18,12,10,12,10,8,1,14,1,10,11,15,1,3,1,2,2,2,2,4,2,1,1
"2164",29165768,"Kevin Kempter","4/2/1996 (27 years old)","M (C)","Mutschellen","Swiss Lower Division","PHI","Yes","6/15/2020","-","$0","Right","Reasonable","Very Strong","5'4""","119 lbs","47","7",58,85,5,5,2,4,13,5,1,6,1,9,13,3,5,10,14,7,5,5,6,13,8,5,13,6,8,6,8,10,13,13,6,1,18,13,10,1,14,10,12,8,12,10,8,5,6,1,12,12,17,4,3,3,2,3,2,3,3,1,2,3
"2165",23352786,"Patrick Deyto","2/15/1990 (33 years old)","GK","Stallion","Philippines Football League","PHI","No","2/1/2023","12/31/2024","Not for Sale","Right","Weak","Very Strong","6'1""","178 lbs","124","-",77,84,3,3,3,1,8,5,8,2,2,1,10,2,2,6,8,10,10,9,11,9,12,1,8,2,11,4,3,3,10,11,9,11,12,8,7,10,11,11,10,11,12,14,6,12,4,2,11,11,9,11,9,11,10,10,12,11,5,9,10,12
"2166",5120076,"Phil Younghusband","8/4/1987 (35 years old)","AM (L), ST (C)","Aguilas","Filipino Lower Division","PHI","No","6/14/2021","12/31/2023","$0 - $6K","Right Only","Weak","Very Strong","5'11""","147 lbs","57","111",73,84,12,7,9,12,6,10,8,5,1,6,6,10,8,11,6,9,9,8,9,9,8,8,10,11,8,10,7,10,13,10,10,11,13,13,10,8,12,12,13,10,12,8,10,7,5,4,7,11,10,2,2,2,3,2,3,1,2,3,1,1
"2167",67033926,"Carli de Murga","11/30/1988 (34 years old)","D/WB/M (R)","Barito Putera","Indonesian League One","PHI","Yes","6/12/2023","5/31/2024","$0 - $3.5K","Right","Reasonable","Very Strong","5'9""","156 lbs","127","13",70,84,8,7,9,4,7,8,9,8,7,10,6,8,11,9,7,8,7,10,13,15,7,5,5,8,9,9,7,10,11,11,9,7,10,8,8,6,11,14,10,10,11,8,12,8,5,1,10,9,9,3,2,3,2,2,3,2,3,3,3,1
"2168",13173478,"Boubacar Beguily","12/7/1994 (28 years old)","M/AM (C), ST (C)","ACS Ksar","Mauritanian D1","MTN","No","6/15/2020","6/30/2024","$0","Right","Reasonable","Very Strong","6'0""","167 lbs","-","-",80,110,6,6,11,13,12,4,8,8,3,6,13,6,7,11,12,6,5,10,7,13,16,11,13,11,8,7,9,4,13,13,7,8,12,13,9,7,12,12,12,10,11,11,11,8,9,1,20,12,10,2,2,3,2,2,3,3,2,3,3,1
"2169",29178497,"Julian Schwarzer","10/26/1999 (23 years old)","GK","Kuching","Malaysian Super League","PHI","No","1/11/2023","11/30/2024","$0","Right","Weak","Very Strong","5'11""","143 lbs","22","-",56,84,3,1,3,3,1,4,1,3,3,1,6,3,1,5,14,9,10,6,11,10,11,1,1,3,10,6,5,5,5,16,6,9,12,3,3,4,9,20,12,11,13,13,14,7,7,2,7,12,8,6,15,13,11,7,7,13,5,12,9,7
"2170",92028755,"Bernd Schipmann","7/5/1994 (28 years old)","GK","Madison","United States Soccer Leagues Division One","PHI","Yes","2/8/2023","11/30/2023","$2K - $18K","Right Only","Very Weak","Very Strong","6'4""","207 lbs","114","1",75,84,3,3,2,3,8,7,5,1,3,1,8,3,2,8,9,9,11,9,8,8,12,5,9,3,10,9,8,8,9,8,10,16,10,7,12,14,8,13,13,13,12,11,5,10,5,6,12,12,6,8,8,8,10,10,8,11,7,8,13,14
"2171",43009698,"O. J. Porteria","5/9/1994 (29 years old)","M (L), AM (RL)","Kelantan Utd","Malaysian Super League","PHI","No","2/5/2023","11/30/2024","$0 - $95K","Left","Very Strong","Reasonable","5'7""","138 lbs","60","27",66,83,6,11,10,7,11,5,1,6,1,5,7,2,5,9,15,5,3,10,6,8,14,13,11,9,5,6,8,11,13,13,6,4,5,13,12,1,13,12,11,13,13,11,13,4,12,4,9,9,15,3,2,3,4,1,1,1,4,1,2,2
"2172",91100147,"Patrick Reichelt","6/15/1988 (34 years old)","M/AM (RL), ST (C)","Kuala Lumpur","Malaysian Super League","PHI","Yes","1/9/2023","11/30/2024","$500 - $3.5K","Right","Fairly Strong","Very Strong","5'11""","158 lbs","169","49",73,80,8,11,8,10,10,7,9,6,3,5,8,1,6,10,11,12,6,8,7,14,14,13,8,12,4,8,9,9,10,8,8,9,12,9,10,5,8,13,11,13,10,12,13,12,13,5,19,7,17,2,2,3,2,1,3,3,1,2,2,2
"2173",2000032416,"William Bereuter","4/2/2004 (19 years old)","M (C)","FC Alberschwende","Austrian Eliteleague Vorarlberg","PHI","Yes","7/1/2020","6/30/2024","$0","Right Only","Weak","Very Strong","5'8""","143 lbs","18","-",61,80,6,2,2,7,11,6,4,6,2,10,12,3,7,12,9,6,5,5,7,14,11,5,10,9,5,8,7,11,14,11,7,7,16,13,6,5,9,17,11,13,13,11,6,11,5,7,9,9,13,1,3,2,1,2,1,2,3,4,1,2
"2174",2000141789,"Pocholo Bugas","12/3/2001 (21 years old)","D (R)","ADT","Philippines Football League","PHI","No","1/1/2023","12/31/2024","$3.5K - $10K","Right","Fairly Strong","Very Strong","5'9""","152 lbs","7","2",68,79,6,9,7,6,7,3,5,5,2,5,8,4,6,8,7,6,4,5,7,4,12,5,11,7,6,10,10,10,17,11,6,9,15,16,11,8,14,11,11,9,13,12,5,14,14,8,12,11,16,4,3,4,2,2,1,3,1,4,1,1
"2175",28026279,"Romaine Sawyers","11/2/1991 (31 years old)","DM, M/AM (C)","Cardiff","Sky Bet Championship","SKN","No","7/6/2022","6/30/2024","$26K - $275K","Right","Reasonable","Very Strong","6'1""","147 lbs","384","28",111,136,10,11,13,10,13,10,8,13,7,8,14,12,8,14,9,12,8,15,9,12,13,12,11,12,11,12,14,12,11,13,13,11,13,11,10,10,12,15,13,16,13,11,5,12,7,7,10,15,12,3,3,1,3,3,2,2,3,3,2,2
"2176",90039469,"Michael Nottingham","4/14/1989 (34 years old)","D (RC)","Accrington","Sky Bet League Two","SKN","No","10/16/2020","6/30/2023","$0","Right","Reasonable","Very Strong","6'4""","194 lbs","396","41",96,115,4,7,10,8,10,6,13,9,8,8,10,10,12,8,12,10,12,10,11,10,14,5,12,8,12,12,8,11,10,10,12,15,10,10,11,15,11,10,10,10,11,12,8,8,11,7,11,12,10,4,3,3,2,1,3,3,1,1,2,3
"2177",29190781,"Tyrese Shade","6/9/2000 (23 years old)","WB/AM (RL)","Swindon","Sky Bet League Two","SKN","No","7/1/2022","6/30/2024","$160K - $500K","Right","Reasonable","Very Strong","6'0""","167 lbs","100","12",89,112,8,7,10,11,10,10,7,8,5,8,9,9,8,8,7,8,6,8,9,7,10,12,6,6,5,6,7,10,14,11,10,10,12,14,11,9,10,14,14,12,11,12,8,9,5,5,9,10,12,2,4,1,3,3,2,3,1,2,2,2
"2178",2000045035,"Rico Browne","12/28/2003 (19 years old)","D (C)","Birmingham","Sky Bet Championship","SKN","No","6/27/2022","6/30/2024","$30K - $325K","Right","Weak","Very Strong","6'1""","176 lbs","-","-",84,110,7,7,8,6,10,7,12,7,6,10,11,8,11,11,12,11,10,10,11,11,5,6,11,10,10,10,10,11,11,10,10,11,10,10,10,11,9,9,9,12,11,15,9,11,11,7,10,11,7,3,2,1,2,3,3,1,2,1,1,3
"2179",67225568,"Aly Abeid","12/11/1997 (25 years old)","D (L)","UTA Arad","Romanian First League","MTN","No","8/18/2022","6/30/2024","$110K - $1.1M","Left Only","Very Strong","Weak","5'9""","154 lbs","118","2",103,110,6,11,10,7,10,6,11,7,12,12,11,8,13,9,14,12,14,10,11,10,10,8,7,11,12,12,8,13,13,12,12,12,12,14,11,13,10,16,11,10,11,14,8,11,11,3,11,13,7,3,3,3,3,2,2,4,1,1,2,3
"2180",20048840,"Raheem Somersall","7/5/1997 (25 years old)","M (C)","North Carolina","United States Soccer Leagues Division One","SKN","No","2/3/2021","11/30/2023","$20K - $190K","Right","Reasonable","Very Strong","5'11""","174 lbs","87","-",86,105,4,8,4,8,15,8,8,6,5,12,12,4,9,10,14,10,7,10,9,10,17,5,11,10,7,9,11,14,12,11,11,10,8,12,10,12,14,11,12,11,12,13,8,5,5,4,13,11,9,1,3,2,4,2,1,1,3,1,1,1
"2181",30001438,"Devaughn Elliott","10/28/1991 (31 years old)","D/WB/M/AM (RL)","Superstars","SKNFA Super League","SKN","No","9/1/2018","-","$0","Left","Very Strong","Strong","5'8""","147 lbs","85","15",93,103,11,9,12,8,10,11,7,7,7,8,9,12,5,11,16,12,9,9,9,11,5,17,13,11,9,8,6,8,13,11,3,4,11,10,6,5,17,18,12,11,9,12,11,3,12,3,11,12,13,3,1,2,3,4,2,3,3,2,1,1
"2182",30001424,"Julani Archibald","5/18/1991 (32 years old)","GK","Lorca D.","Spanish Federation Third Group 13","SKN","No","7/11/2022","6/30/2024","$0","Right","Reasonable","Very Strong","6'2""","191 lbs","103","-",79,100,4,3,3,2,5,5,1,2,1,1,10,3,2,5,6,11,10,6,11,14,9,1,7,3,13,8,7,6,9,7,6,8,9,10,1,6,10,12,10,12,11,10,12,3,8,8,8,11,15,8,5,13,15,9,8,8,9,10,12,14
"2183",90049932,"Omari Sterling-James","9/15/1993 (29 years old)","M (RL), AM (LC), ST (C)","Ebbsfleet","Vanarama National League","SKN","No","5/30/2023","6/30/2024","$16K - $160K","Right","Weak","Very Strong","5'10""","165 lbs","231","30",73,100,9,10,11,10,11,14,4,9,3,6,10,6,4,10,5,5,6,6,7,8,10,11,3,8,5,8,7,10,12,11,10,7,11,11,11,5,6,11,9,9,6,10,5,7,2,5,14,12,8,4,2,3,2,3,3,3,1,3,3,3
"2184",2000071682,"Javern Matthew","3/25/2001 (22 years old)","M/AM (R)","Conaree Utd","SKNFA Super League","SKN","No","6/1/2021","6/30/2024","$0 - $3.5K","Right","Reasonable","Very Strong","5'9""","143 lbs","31","11",69,97,6,10,8,5,8,5,2,6,3,5,8,2,6,13,11,3,5,7,6,11,10,13,12,9,4,7,7,12,13,13,6,3,13,13,7,3,11,19,12,12,10,9,11,11,5,5,17,12,12,4,2,1,2,1,3,2,2,1,1,1
"2185",82090065,"Geovannie Lake","8/24/1998 (24 years old)","ST (C)","Garden Hotspurs","SKNFA Super League","SKN","No","1/1/2021","6/30/2025","$3.5K - $10K","Right Only","Weak","Very Strong","6'0""","178 lbs","17","6",79,95,6,3,12,10,14,7,9,8,1,5,9,4,4,12,5,8,7,13,6,9,18,11,7,9,8,7,3,12,14,11,14,9,11,14,9,13,13,14,11,12,9,10,11,13,10,8,17,12,20,2,1,2,2,4,1,2,1,2,1,2
"2186",29066606,"Jacob Hazel","4/15/1994 (29 years old)","ST (C)","Darlington","Vanarama National League North","SKN","No","5/6/2022","6/30/2024","$0 - $40K","Left","Very Strong","Reasonable","5'11""","158 lbs","343","184",66,95,3,6,6,10,8,8,9,9,6,2,10,12,4,10,14,8,8,11,7,10,8,7,14,8,4,15,8,15,12,12,8,9,12,12,10,13,11,10,9,8,11,7,6,8,12,8,14,5,5,4,1,2,2,3,4,3,4,3,3,2
"2187",82070899,"Kimaree Rogers","1/14/1994 (29 years old)","M/AM (RL), ST (C)","Superstars","SKNFA Super League","SKN","No","6/15/2020","6/30/2025","$500 - $4K","Left","Very Strong","Reasonable","6'1""","167 lbs","60","101",82,95,7,10,12,10,12,5,4,10,3,6,9,6,6,11,8,10,7,12,8,12,6,16,13,8,7,6,4,8,13,12,10,9,13,10,9,5,11,20,12,11,11,10,9,10,5,7,10,12,20,1,3,1,3,3,3,3,1,3,1,3
"2188",45021205,"Gerard Williams","6/4/1988 (35 years old)","D (C), DM, M (C)","Tiddim Road FC","Indian National Football League","SKN","No","8/16/2022","5/31/2024","$0","Right","Fairly Strong","Very Strong","5'11""","160 lbs","86","4",92,95,7,6,2,5,12,7,9,5,3,9,10,1,10,9,6,9,14,8,8,13,15,5,16,8,13,13,8,15,9,9,12,6,14,9,12,12,10,11,8,15,14,18,7,12,11,4,17,10,11,2,2,3,1,1,2,1,3,2,4,1
"2189",82070919,"Keithroy Freeman","10/16/1993 (29 years old)","WB/M/AM (L), ST (C)","St. Paul's Utd","SKNFA Super League","SKN","No","6/15/2020","6/30/2025","$500 - $5K","Left","Very Strong","Reasonable","6'3""","191 lbs","44","54",85,95,4,8,14,10,8,7,12,8,2,7,7,2,5,12,12,10,11,11,9,9,14,11,14,11,8,8,9,9,9,8,13,15,10,9,14,12,12,8,11,13,15,9,13,16,6,5,14,13,17,3,2,2,3,2,3,1,1,1,2,1
"2190",48032196,"Issa Samba","1/29/1998 (25 years old)","D/WB (R)","FC Drouais","French Regional 1 - Centre Val de Loire","MTN","Yes","7/1/2022","-","$0","Right Only","Very Weak","Very Strong","6'0""","167 lbs","16","-",67,110,6,9,8,5,8,6,9,7,10,9,10,7,11,10,15,7,10,7,7,8,12,8,9,8,9,8,8,11,12,12,9,11,11,13,10,11,11,14,12,11,9,12,8,12,11,1,10,10,15,2,1,2,2,2,2,3,4,1,2,4
"2191",82090219,"Malique Roberts","8/1/2001 (21 years old)","D/WB (R)","Cayon FC","SKNFA Super League","SKN","No","7/1/2019","6/30/2025","$0 - $2.5K","Right","Reasonable","Very Strong","5'10""","160 lbs","15","-",76,94,5,8,8,3,11,2,9,8,4,9,8,5,14,10,8,12,10,9,10,12,4,5,8,6,7,6,7,9,10,13,9,8,13,12,11,8,12,15,10,12,13,11,5,1,5,7,10,9,12,2,3,2,2,1,3,3,1,2,1,3
"2192",82063906,"Tahir Hanley","5/5/1997 (26 years old)","AM (R), ST (C)","Real de Minas","-","SKN","No","1/15/2021","6/30/2024","$20K - $200K","Right","Reasonable","Very Strong","6'1""","176 lbs","45","17",83,92,7,8,11,13,9,5,11,8,4,6,7,11,4,11,9,10,1,14,5,7,12,15,11,13,5,7,8,8,12,13,9,8,17,10,14,9,8,11,7,12,13,13,15,8,10,4,17,15,12,2,2,3,1,3,2,3,4,3,1,1
"2193",82084514,"Salas Cannonier","11/29/1997 (25 years old)","D (RC), WB (R), DM","St. Peter's (SKN)","SKNFA Super League","SKN","No","1/1/2021","6/30/2024","$0 - $6K","Right Only","Weak","Very Strong","6'1""","180 lbs","2","-",80,92,5,9,8,5,10,6,10,7,5,10,8,5,8,8,15,10,10,9,9,10,12,5,13,8,10,9,3,10,10,10,9,10,14,10,10,13,15,15,11,11,11,12,5,12,8,2,10,12,7,1,3,3,4,4,2,1,2,2,3,1
"2194",82084577,"G'Vaune Amory","6/22/1997 (25 years old)","M (RL), AM (RLC)","Superstars","SKNFA Super League","SKN","No","6/15/2020","6/30/2025","$2.5K - $8K","Left","Very Strong","Reasonable","5'11""","149 lbs","19","6",75,90,6,8,10,8,11,6,4,7,3,2,10,1,6,11,11,8,1,10,6,13,5,16,3,11,5,7,9,11,12,13,7,9,11,13,13,4,11,11,12,11,10,12,7,9,11,4,13,15,10,2,3,2,2,2,1,3,3,1,3,2
"2195",82070904,"Ordell Flemming","9/16/1993 (29 years old)","D (RC)","Superstars","SKNFA Super League","SKN","No","6/15/2020","6/30/2025","$0 - $8K","Right","Reasonable","Very Strong","5'11""","165 lbs","-","-",80,90,3,8,7,3,5,1,12,7,5,12,8,5,12,4,13,9,8,8,11,14,6,5,5,7,12,7,1,8,10,10,9,8,15,10,13,11,13,7,11,10,12,11,13,6,7,7,11,11,16,2,3,2,2,3,2,2,3,3,3,2
"2196",2000202745,"Tyquan Terrell","4/16/1998 (25 years old)","AM (C), ST (C)","St. Peter's (SKN)","SKNFA Super League","SKN","No","6/15/2020","6/30/2024","$3K - $8K","Right","Reasonable","Very Strong","6'4""","189 lbs","-","-",79,90,2,5,11,14,10,4,8,9,1,6,10,8,2,11,12,12,5,10,8,9,12,13,10,10,6,8,10,10,11,12,8,14,12,10,10,12,10,20,15,11,9,10,11,13,13,5,9,15,13,2,3,3,2,2,1,2,1,3,2,2
"2197",29125710,"Lois Maynard","1/22/1989 (34 years old)","DM, M (C)","Radcliffe","English Northern Premier League Premier Division","SKN","No","6/1/2023","6/30/2024","$0 - $10K","Right Only","Weak","Very Strong","6'0""","189 lbs","371","38",60,89,5,6,8,8,9,6,11,9,9,9,9,5,9,9,11,10,12,13,11,11,11,8,8,7,10,13,9,10,6,7,9,13,9,6,10,13,11,12,11,12,13,9,16,11,6,5,11,10,13,2,1,4,3,2,4,2,3,2,3,3
"2198",2000202753,"Kalonjie Clarke","2/15/2001 (22 years old)","M/AM (C)","St. Paul's Utd","SKNFA Super League","SKN","No","7/1/2018","6/30/2025","$1.5K - $4K","Left","Very Strong","Weak","5'10""","154 lbs","-","-",67,88,7,7,9,13,9,7,7,10,1,9,13,7,8,13,9,11,4,10,8,9,5,12,10,7,5,8,15,7,10,8,8,5,9,10,9,5,14,17,10,10,10,11,7,14,5,4,9,11,7,2,1,1,2,2,1,1,3,1,1,1
"2199",82084597,"Petrez Williams","6/18/2000 (22 years old)","D/WB/M/AM (L)","St. Paul's Utd","SKNFA Super League","SKN","No","7/1/2019","6/30/2025","$2K - $6K","Left","Very Strong","Reasonable","6'2""","169 lbs","-","-",74,88,9,12,9,6,12,8,6,5,3,9,11,3,10,12,12,6,8,10,5,7,10,10,7,6,10,9,8,10,15,11,9,13,12,11,10,5,14,10,8,12,9,12,8,4,6,7,13,11,10,3,1,1,2,1,4,3,3,3,4,3
"2200",29079168,"Harry Panayiotou","10/28/1994 (28 years old)","M (R), AM (RLC), ST (C)","Aldershot","Vanarama National League","SKN","Yes","1/5/2022","6/30/2024","$0 - $35K","Right","Reasonable","Very Strong","5'10""","154 lbs","155","18",70,85,5,8,13,11,10,6,5,6,5,5,9,11,5,11,4,6,6,7,6,7,14,10,9,9,6,12,9,9,12,9,10,8,12,11,9,9,11,11,12,10,9,10,7,6,4,2,5,6,9,2,4,2,3,2,2,3,2,1,3,3
"2201",13173472,"Abdoulaye Gaye","9/13/1991 (31 years old)","M/AM (C)","Khaleej Sirt","Libyan Second Division","MTN","No","2/4/2022","6/30/2024","$0 - $40K","Right","Reasonable","Very Strong","5'8""","156 lbs","8","-",85,110,8,8,7,12,15,8,7,15,2,8,13,4,10,14,9,10,8,7,7,13,13,13,5,11,9,9,15,13,10,10,4,5,13,8,8,6,13,16,13,12,12,13,11,8,11,6,10,11,9,3,1,1,3,3,1,1,2,1,2,1
"2202",2000202738,"Yohannes Mitchum","4/6/1998 (25 years old)","M/AM (C)","Newtown Utd","SKNFA Super League","SKN","No","7/1/2019","6/30/2024","$0 - $9K","Right","Reasonable","Very Strong","5'7""","134 lbs","21","5",77,85,6,4,8,11,10,6,1,8,2,5,12,4,5,7,10,9,6,6,7,11,5,8,13,8,6,7,10,12,13,13,7,2,12,13,13,1,10,10,12,12,10,10,8,5,7,1,9,12,7,2,2,1,2,2,2,3,1,2,2,2
"2203",2000202756,"Nicquan Phipps","10/13/1999 (23 years old)","ST (C)","Conaree Utd","SKNFA Super League","SKN","No","7/1/2022","6/30/2024","$0 - $4.5K","Right","Reasonable","Very Strong","5'11""","156 lbs","-","-",69,85,4,2,13,8,7,5,13,6,1,5,6,4,1,8,5,12,4,6,5,13,2,11,4,11,5,5,5,7,13,13,6,8,13,13,11,6,9,16,10,12,12,10,5,14,8,6,10,11,10,4,1,1,3,1,2,2,3,1,3,3
"2204",2000071677,"Kirkland Harris","11/9/1982 (40 years old)","ST (C)","St. Peter's (SKN)","SKNFA Super League","SKN","No","6/14/2021","6/30/2024","$0","Right","Reasonable","Very Strong","6'0""","167 lbs","61","37",60,85,7,5,6,15,15,7,9,5,1,7,8,6,1,11,5,9,8,10,8,9,12,9,6,14,7,7,3,8,6,6,6,10,15,6,5,6,12,12,11,16,12,13,6,8,9,6,7,12,13,1,1,4,3,2,3,3,1,2,2,2
"2205",82084549,"Carlos Bertie","9/10/1995 (27 years old)","ST (C)","Superstars","SKNFA Super League","SKN","No","9/1/2019","6/30/2025","$3K - $9K","Right","Reasonable","Very Strong","6'1""","171 lbs","37","33",78,85,6,2,10,10,12,6,8,7,2,5,7,10,1,9,9,11,6,10,6,11,14,9,12,13,7,6,7,7,13,10,11,12,15,11,12,10,8,14,10,10,12,11,10,3,6,3,17,15,13,4,2,2,3,1,2,3,2,2,2,3
"2206",82070687,"Vinceroy Nelson","1/10/1996 (27 years old)","AM (RL), ST (C)","St. Paul's Utd","SKNFA Super League","SKN","No","1/1/2021","6/30/2025","$500 - $3.5K","Right","Weak","Very Strong","5'10""","156 lbs","46","36",80,85,6,5,9,13,13,6,8,7,1,6,11,10,1,8,7,9,4,13,7,8,8,8,11,9,6,6,5,8,13,13,7,5,14,13,13,9,12,19,11,8,10,11,10,2,8,6,10,11,11,1,3,1,1,3,2,1,2,3,2,1
"2207",2000083474,"Kezandre Buchanan","5/1/2002 (21 years old)","D/WB (L)","Superstars","SKNFA Super League","SKN","No","2/1/2021","6/30/2025","$0","Left","Very Strong","Reasonable","5'9""","154 lbs","10","-",65,81,6,11,8,6,8,2,8,7,1,10,10,7,13,7,14,10,8,9,10,12,12,9,7,8,9,9,9,9,10,14,9,8,8,11,8,6,15,13,13,11,12,11,12,15,5,3,11,14,18,1,3,2,1,3,3,2,1,2,2,2
"2208",82070699,"Evansroy Barns","6/3/1996 (27 years old)","M (C)","Cayon FC","SKNFA Super League","SKN","No","6/15/2020","6/30/2025","$0","Right","Reasonable","Very Strong","5'7""","143 lbs","-","-",62,80,2,4,3,7,10,2,2,7,2,11,10,5,6,6,9,7,5,10,7,14,15,6,8,7,8,7,11,12,10,14,7,7,15,12,9,6,11,12,13,12,12,10,7,12,10,3,9,12,9,1,2,2,2,3,2,3,1,3,2,4
"2209",82084638,"Dennis Flemming","12/17/1996 (26 years old)","D/WB/M/AM (L)","Superstars","SKNFA Super League","SKN","No","1/2/2019","6/30/2025","$0 - $6K","Left","Very Strong","Reasonable","6'2""","169 lbs","38","-",70,80,6,9,8,8,5,6,5,3,6,6,9,4,8,8,15,9,8,7,8,10,16,8,12,9,7,7,6,8,13,13,7,10,15,13,12,7,16,17,12,10,10,10,10,15,8,1,10,9,19,2,3,1,3,1,1,2,2,1,2,1
"2210",82070694,"Raheem Francis","5/28/1996 (27 years old)","D (C), DM, M (C)","Superstars","SKNFA Super League","SKN","No","6/15/2020","6/30/2025","$0 - $5K","Right","Fairly Strong","Very Strong","6'1""","165 lbs","18","2",70,80,4,5,1,4,10,5,6,4,2,10,7,3,12,8,13,8,7,7,6,12,14,5,5,5,10,6,6,11,12,12,7,12,11,12,12,5,13,14,11,12,11,10,8,12,5,2,12,7,13,1,1,2,2,2,2,2,4,1,3,2
"2211",2000259936,"Ezer Browne","8/13/1998 (24 years old)","DM","Michigan Stars","National Independent Soccer Association","SKN","No","3/27/2023","11/30/2023","$0 - $35K","Right","Fairly Strong","Very Strong","5'10""","160 lbs","1","-",72,80,6,4,3,5,8,6,6,8,6,8,8,1,13,8,10,13,8,5,8,11,5,5,12,6,8,7,5,12,13,13,7,4,12,13,7,10,11,12,9,12,13,12,8,10,8,8,11,12,10,3,1,2,1,1,3,3,3,1,1,3
"2212",13173482,"Yali Dellahi","11/1/1997 (25 years old)","DM, M (C)","FC Nouadhibou","Mauritanian D1","MTN","No","1/15/2022","6/30/2024","$0","Right Only","Weak","Very Strong","6'0""","160 lbs","18","1",87,110,6,6,8,8,14,2,4,9,1,8,14,4,12,13,15,11,8,9,9,11,16,5,4,8,12,8,12,12,13,14,8,9,15,14,13,8,10,12,9,9,11,13,10,9,7,5,20,10,16,2,4,2,4,4,3,1,2,1,2,1
"2213",2000182987,"Tiquanny Williams","9/10/2001 (21 years old)","AM (RL)","Old Road Jets","SKNFA Super League","SKN","No","1/1/2023","6/30/2024","$0 - $2K","Right Only","Very Weak","Very Strong","5'4""","121 lbs","3","1",73,80,8,13,13,9,13,5,8,7,8,6,11,2,9,8,14,6,9,6,9,9,7,9,10,13,8,9,8,14,10,13,4,3,12,15,9,1,10,11,11,12,10,11,5,13,5,8,9,12,9,1,3,3,3,1,1,1,2,2,2,3
"2214",29175612,"Andre Burley","9/10/1999 (23 years old)","D (RC)","Oxford City","Vanarama National League","SKN","No","6/6/2023","5/31/2024","$0 - $95K","Right Only","Weak","Very Strong","5'11""","165 lbs","65","1",72,79,6,8,7,6,12,5,11,4,13,10,10,4,10,8,14,9,13,8,8,7,12,3,6,6,10,11,7,11,14,9,8,11,16,12,13,13,13,11,12,13,9,8,5,5,5,4,10,8,11,1,1,1,2,1,3,3,1,3,3,3
"2215",30001430,"Javeim Blanchette","9/29/1991 (31 years old)","AM (RLC), ST (C)","FC Kaohsiung","Chinese Taipei Second Division","SKN","No","1/1/2020","12/31/2023","$0 - $60K","Right","Reasonable","Very Strong","5'10""","180 lbs","4","2",70,78,6,8,8,9,12,5,7,11,6,6,10,3,1,11,15,7,4,13,7,9,5,13,3,6,6,7,8,8,12,10,7,3,8,12,11,5,10,18,9,12,9,13,6,5,8,4,7,11,8,3,2,3,1,3,3,2,3,2,4,1
"2216",82070641,"Jamal Francis","3/23/1993 (30 years old)","GK","St. Paul's Utd","SKNFA Super League","SKN","No","1/1/2019","6/30/2024","$1.5K - $4.5K","Right","Reasonable","Very Strong","6'0""","165 lbs","52","-",74,77,5,2,1,3,3,6,1,1,3,2,7,3,1,1,5,9,9,7,9,13,13,3,8,3,9,7,6,6,11,15,7,7,12,11,1,6,9,15,12,16,11,18,7,6,8,1,8,12,6,4,9,13,7,8,13,8,5,7,10,11
"2217",30001446,"Mudassa Howe","10/22/1988 (34 years old)","D (C)","Conaree Utd","SKNFA Super League","SKN","No","6/14/2021","6/30/2024","$0","Right","Reasonable","Very Strong","6'2""","169 lbs","4","-",72,75,4,3,6,5,7,1,13,1,5,13,7,1,13,3,6,12,9,7,6,13,3,5,13,5,13,6,4,7,9,8,7,9,14,8,10,5,13,20,13,9,8,12,5,12,15,3,10,10,11,3,3,2,3,3,2,3,2,3,1,2
"2218",2000288739,"Mervin Lewis","8/26/2000 (22 years old)","DM","Cayon FC","SKNFA Super League","SKN","No","7/1/2019","6/30/2025","$0 - $2K","Right","Reasonable","Very Strong","5'6""","136 lbs","-","-",73,75,7,5,6,8,13,7,7,9,7,12,11,4,14,11,10,5,8,6,10,9,12,6,9,5,14,8,7,12,9,11,8,5,18,13,7,6,12,19,9,8,15,12,13,13,11,5,12,13,13,3,2,2,2,3,1,2,2,1,2,1
"2219",20015281,"Tishan Hanley","8/22/1990 (32 years old)","AM (R), ST (C)","Prime Bangkok","Thai League Three Bangkok Perimeter Region","SKN","No","8/1/2022","6/30/2024","$24K - $70K","Right Only","Weak","Very Strong","5'11""","160 lbs","51","12",73,75,5,9,10,13,12,7,10,7,6,4,9,6,4,9,5,12,3,11,7,8,11,10,13,9,7,7,9,9,13,13,8,10,11,10,7,7,9,14,11,15,11,11,6,2,9,4,11,15,20,2,3,2,3,3,2,1,1,3,1,1
"2220",82070690,"Clyde Mitcham","6/16/1994 (28 years old)","D (LC)","Cayon FC","SKNFA Super League","SKN","No","6/15/2020","6/30/2025","$0","Left","Very Strong","Reasonable","6'2""","165 lbs","-","-",63,75,2,6,1,1,7,3,7,5,3,13,4,1,13,5,5,10,8,6,7,10,10,5,11,5,11,5,1,6,13,13,6,11,11,13,5,3,10,11,11,8,9,14,12,14,9,1,12,11,20,2,2,3,4,2,2,2,2,3,3,3
"2221",29157386,"Rowan Liburd","8/28/1992 (30 years old)","ST (C)","Ramsgate","English Isthmian League South East Division","SKN","No","1/21/2023","6/30/2024","$0","Right","Weak","Very Strong","6'6""","187 lbs","201","63",60,75,3,3,6,9,9,6,11,9,2,4,8,3,6,8,7,7,7,10,7,7,12,7,6,8,3,8,7,8,10,9,11,17,8,12,10,11,8,5,10,12,8,8,7,6,5,5,7,12,13,2,3,4,4,3,2,3,1,2,3,4
"2222",2000202758,"Tijani Fahie","11/4/1998 (24 years old)","ST (C)","Sandy Point","SKNFA Super League","SKN","No","7/1/2020","6/30/2024","$0 - $5K","Right","Reasonable","Very Strong","6'2""","171 lbs","-","-",69,75,3,5,12,12,12,4,7,3,1,4,5,3,1,10,10,9,6,7,4,8,5,11,6,9,4,4,5,6,12,12,3,12,17,12,11,9,11,11,11,9,11,10,9,16,8,7,18,11,8,1,2,4,1,1,2,3,3,2,1,3
"2223",87030617,"Celio Valladares","5/2/1989 (34 years old)","GK","UPNFM FC","Liga Nacional de Honduras","HON","No","6/30/2022","6/30/2024","$30K - $95K","Right","Reasonable","Very Strong","6'0""","165 lbs","154","-",94,114,2,3,1,1,1,4,1,1,2,1,7,3,3,1,13,10,15,9,12,14,9,1,13,3,14,9,8,8,11,6,9,11,13,9,8,7,10,5,3,11,11,11,12,4,7,2,17,11,15,7,6,11,13,13,7,14,8,8,10,13
"2224",13201760,"El Hassen Houeibib","10/31/1993 (29 years old)","D (C)","Al-Zawra'a","Iraqi Premier League","MTN","No","7/9/2022","7/31/2023","$0 - $18K","Right","Reasonable","Very Strong","5'11""","167 lbs","-","-",106,110,6,8,3,7,9,3,16,10,4,13,10,7,13,10,11,13,11,8,10,12,1,7,11,10,13,10,8,11,11,16,11,8,12,14,12,11,14,16,12,12,12,12,14,11,14,7,19,12,9,2,3,1,3,4,2,3,2,2,1,3
"2225",2000202691,"Dihjorn Simmonds","11/2/1998 (24 years old)","D (C)","Cayon FC","SKNFA Super League","SKN","No","7/1/2020","6/30/2025","$0 - $1.5K","Right","Reasonable","Very Strong","5'11""","163 lbs","-","-",70,75,2,2,1,3,7,1,13,3,1,13,7,1,13,3,9,9,9,6,8,13,9,5,7,5,9,6,1,7,13,11,7,8,13,12,4,8,12,16,10,10,11,13,14,6,15,6,10,9,14,3,1,1,2,4,2,2,1,3,3,1
"2226",29021931,"Thrizen Leader","7/3/1984 (38 years old)","D (RC), WB (R), DM, M (R)","St. Paul's Utd","SKNFA Super League","SKN","No","6/14/2021","6/30/2024","$0","Right","Fairly Strong","Very Strong","6'1""","171 lbs","-","-",67,75,2,6,7,1,11,5,8,6,3,8,8,2,11,8,7,9,5,8,7,14,16,5,15,6,12,7,7,8,7,7,7,14,13,7,7,7,12,19,14,15,10,15,7,8,6,3,8,13,13,3,3,3,2,2,1,3,3,1,2,2
"2227",30001442,"Tiran Hanley","3/22/1988 (35 years old)","D/WB (R), M/AM (RC)","Garden Hotspurs","SKNFA Super League","SKN","No","6/14/2021","6/30/2024","$0","Right","Reasonable","Very Strong","5'11""","160 lbs","-","-",67,75,7,7,9,5,11,6,6,8,7,8,11,3,9,9,15,10,8,7,8,10,11,9,13,10,7,8,9,9,9,10,8,9,12,8,11,6,8,12,14,14,9,13,10,4,9,3,12,11,9,2,2,3,2,1,3,2,3,3,3,2
"2228",82084798,"Jayan Duncan","12/11/1995 (27 years old)","M (C)","Cayon FC","SKNFA Super League","SKN","No","7/1/2019","6/30/2025","$0 - $7K","Right","Reasonable","Very Strong","5'10""","152 lbs","44","10",73,73,4,7,6,6,9,7,6,10,1,13,13,2,8,13,7,11,7,8,7,8,5,5,10,8,8,8,9,11,12,13,8,5,13,11,11,5,14,20,10,13,10,12,13,5,12,8,9,11,13,3,2,3,4,2,2,4,2,1,2,3
"2229",15081417,"Jermaine Chiuta","5/30/2003 (20 years old)","D (C)","Holland Park Hawks","Football Queensland Premier League 2","SKN","No","1/16/2023","9/30/2023","$0","Right","Weak","Very Strong","5'11""","145 lbs","19","1",55,70,3,2,1,3,6,1,12,5,4,10,7,1,11,6,14,9,8,7,7,14,6,6,3,5,10,6,1,5,14,13,7,8,13,9,9,4,15,13,10,12,9,12,6,1,11,4,13,10,16,2,3,1,3,3,1,3,1,3,3,3
"2230",30001455,"Josh Leader","8/20/1990 (32 years old)","AM (RLC), ST (C)","St. Paul's Utd","SKNFA Super League","SKN","No","6/14/2021","6/30/2024","$0","Left","Very Strong","Strong","6'1""","167 lbs","-","-",68,70,4,6,7,10,10,6,7,10,6,5,8,4,3,13,11,7,1,10,7,13,2,12,3,10,6,7,7,8,9,11,7,12,11,10,4,5,9,10,11,12,11,16,12,10,10,1,10,11,12,2,2,2,3,3,1,2,1,2,4,2
"2231",485768,"Andris Vanins","4/30/1980 (43 years old)","GK","Dietikon","Swiss First League Classic Group 2","LVA","Yes","1/24/2023","6/30/2023","$0","Right","Reasonable","Very Strong","6'1""","171 lbs","447","-",70,136,4,1,1,1,8,7,3,2,2,2,9,2,1,8,7,11,12,12,10,11,14,4,12,1,13,10,9,8,4,5,7,6,5,4,4,6,12,13,11,17,14,15,7,13,6,3,14,13,13,11,14,11,9,11,10,12,4,13,9,11
"2232",47092784,"Raimonds Krollis","10/28/2001 (21 years old)","AM (C), ST (C)","Spezia","Italian Serie B","LVA","Yes","1/20/2023","6/30/2026","$275K - $2.7M","Left","Very Strong","Reasonable","6'1""","163 lbs","110","52",106,131,5,10,10,14,12,6,12,15,7,4,12,12,8,11,11,10,10,10,9,10,16,13,12,12,8,10,10,13,13,11,11,14,11,12,11,12,11,11,12,14,11,10,12,12,6,4,10,15,12,1,3,2,3,3,3,3,3,2,1,2
"2233",37075484,"Andrejs Cigaņiks","4/12/1997 (26 years old)","D/WB (RL), M/AM (L)","Widzew","PKO Bank Polski Ekstraklasa","LVA","Yes","1/2/2023","6/30/2024","$110K - $1.1M","Left","Very Strong","Reasonable","5'8""","149 lbs","140","10",110,130,10,12,11,8,11,5,10,10,12,11,12,8,13,10,11,10,8,12,10,10,14,10,8,10,11,9,13,10,12,12,13,9,11,12,14,10,11,20,15,15,12,9,5,8,8,7,12,13,18,2,2,4,4,2,1,3,3,2,1,1
"2234",47090280,"Kristers Tobers","12/13/2000 (22 years old)","D (C), DM","Lechia","Polish First Division","LVA","Yes","7/1/2020","6/30/2024","$70K - $700K","Right","Reasonable","Very Strong","6'3""","165 lbs","116","5",106,125,8,7,7,8,9,8,13,10,9,12,11,9,13,8,8,13,13,13,13,13,8,7,7,6,13,14,9,13,10,9,11,13,12,9,11,14,12,11,11,10,10,13,9,12,14,6,11,11,7,2,1,1,2,3,3,2,2,1,1,3
"2235",13209424,"Idrissa Thiam","9/2/2000 (22 years old)","AM (RLC)","Lugo","Spanish Federation First Division A","MTN","No","7/1/2021","6/30/2025","$26K - $250K","Right","Fairly Strong","Very Strong","5'10""","134 lbs","46","10",91,109,7,12,13,8,13,7,7,8,6,7,9,4,7,12,14,10,7,6,6,13,6,12,4,9,7,8,13,12,13,13,8,4,13,13,7,5,15,13,12,10,11,10,5,10,11,8,11,10,7,2,1,2,3,2,3,1,3,3,1,1
"2236",47048432,"Dāvis Ikaunieks","1/7/1994 (29 years old)","AM (RL), ST (C)","Jablonec","Czech First Division","LVA","Yes","7/1/2018","6/30/2024","$65K - $650K","Right","Strong","Very Strong","6'1""","176 lbs","214","55",100,124,10,10,11,12,12,11,10,9,12,9,9,14,9,11,13,10,7,13,9,8,11,8,8,13,8,7,7,6,13,7,12,11,7,13,8,13,13,10,13,12,13,12,7,13,13,8,9,10,12,1,1,1,1,3,2,2,1,3,1,2
"2237",47056324,"Roberts Uldriķis","4/3/1998 (25 years old)","ST (C)","SC Cambuur","Keuken Kampioen Divisie","LVA","Yes","3/28/2023","6/30/2024","$375K - $3.8M","Right","Weak","Very Strong","6'6""","202 lbs","192","38",111,121,11,7,9,13,11,11,16,13,7,6,9,10,5,9,12,12,11,12,11,12,12,12,7,11,5,10,11,12,11,12,16,20,11,11,11,12,13,17,10,11,11,11,9,13,15,1,8,12,19,2,3,3,3,2,4,3,4,1,2,2
"2238",47075764,"Mārtiņš Ķigurs","3/31/1997 (26 years old)","M/AM (C)","Liepāja","Optibet Virsliga","LVA","Yes","6/15/2020","11/30/2024","$120K - $1.2M","Right","Reasonable","Very Strong","5'8""","152 lbs","105","12",100,120,12,11,14,10,11,10,5,12,5,4,12,12,6,14,10,11,12,10,10,11,13,11,4,11,6,12,9,12,12,12,12,7,9,14,11,9,9,10,12,12,10,12,7,10,8,4,9,12,8,4,3,2,1,2,2,1,3,3,1,3
"2239",47084695,"Alvis Jaunzems","6/16/1999 (23 years old)","D/WB/M (R)","Valmiera","Optibet Virsliga","LVA","Yes","6/15/2020","12/31/2023","$0","Right","Reasonable","Very Strong","5'10""","167 lbs","245","27",107,119,13,13,13,10,13,10,8,8,13,10,11,9,11,13,10,11,12,12,10,9,15,10,9,10,12,13,11,12,13,13,9,8,11,12,10,10,14,12,12,13,12,9,7,9,7,4,9,16,13,2,1,1,1,1,2,2,3,2,2,2
"2240",2000047973,"Dario Šits","2/4/2004 (19 years old)","AM (RL), ST (C)","Parma","Italian Serie B","LVA","Yes","10/6/2022","6/30/2026","$160K - $500K","Right","Weak","Very Strong","6'2""","156 lbs","5","-",100,118,5,7,11,12,10,8,12,9,6,4,11,11,7,10,8,11,11,12,13,12,13,8,8,13,7,8,8,15,12,10,13,12,11,13,12,10,12,14,12,13,13,12,10,8,8,3,9,11,12,1,4,2,3,3,1,2,1,4,3,3
"2241",47046280,"Vladislavs Kurakins","7/9/1996 (26 years old)","GK","BFC","Optibet Virsliga","LVA","Yes","12/31/2021","12/31/2023","$0 - $80K","Right Only","Weak","Very Strong","6'1""","185 lbs","179","-",82,118,1,4,3,2,9,3,7,8,12,3,8,2,7,8,8,7,12,9,9,9,12,3,6,1,13,11,8,13,10,11,13,14,13,8,14,13,1,14,12,12,8,8,7,4,4,6,11,13,8,12,7,9,14,12,8,9,4,9,11,14
"2242",92103068,"Daniels Ontužāns","3/7/2000 (23 years old)","M (L), AM (LC)","SC Freiburg","Bundesliga","LVA","Yes","7/1/2021","6/30/2027","$16K - $160K","Right","Reasonable","Very Strong","6'0""","154 lbs","36","3",97,116,8,10,12,13,11,8,8,8,8,8,9,5,8,12,12,10,1,10,9,11,9,11,1,14,6,9,10,11,14,14,9,6,8,14,7,6,13,18,9,14,11,8,7,4,10,1,15,10,14,1,1,2,3,3,2,2,4,2,4,3
"2243",47078604,"Rihards Ozoliņš","5/31/2001 (22 years old)","DM","Alberts","Latvian Future League","LVA","Yes","3/23/2023","-","$0","Right","Fairly Strong","Very Strong","5'10""","160 lbs","135","4",84,116,7,9,11,8,10,7,8,10,5,11,9,6,10,10,12,12,14,11,12,13,16,6,14,7,6,13,12,11,9,10,8,7,10,10,12,9,8,14,18,18,13,13,5,12,8,4,12,15,14,3,1,1,3,3,3,2,3,1,1,1
"2244",47040547,"Jānis Ikaunieks","2/16/1995 (28 years old)","M (L), AM (RLC)","RFS","Optibet Virsliga","LVA","Yes","12/11/2022","11/30/2023","$16K - $160K","Left","Very Strong","Weak","6'0""","165 lbs","176","61",106,115,11,10,13,8,13,10,11,7,6,10,14,9,10,14,10,11,7,10,11,10,11,10,8,11,9,13,12,11,13,11,12,10,13,14,10,7,13,10,9,12,10,9,8,8,8,7,8,11,12,1,2,3,4,1,3,1,4,2,3,4
"2245",47017325,"Vitālijs Jagodinskis","2/28/1992 (31 years old)","D (C)","RFS","Optibet Virsliga","LVA","Yes","9/21/2021","12/31/2023","$120K - $375K","Right Only","Weak","Very Strong","6'3""","176 lbs","235","12",101,115,4,4,5,7,11,8,14,5,5,13,11,7,11,7,15,12,14,10,12,11,13,6,13,12,12,12,7,12,10,9,10,15,11,10,13,13,9,8,8,12,12,7,5,10,8,14,10,12,12,1,2,1,3,3,3,3,1,1,2,2
"2246",13167964,"Mamadou Niass","6/4/1994 (29 years old)","AM (R), ST (C)","Arab Contractors","Egyptian Premier League","MTN","No","9/2/2021","7/31/2024","$0 - $95K","Right","Weak","Very Strong","5'11""","154 lbs","120","29",90,108,6,8,12,10,14,8,10,7,7,7,9,4,7,9,5,8,3,13,9,8,14,8,14,13,8,9,8,12,14,14,14,9,9,14,7,4,12,18,8,13,10,10,12,9,10,3,13,13,15,1,3,3,3,3,3,2,1,3,2,2
"2247",47019816,"Valērijs Šabala","10/12/1994 (28 years old)","ST (C)","B36","Faroese Premier League","LVA","Yes","3/1/2023","11/30/2023","$0 - $75K","Right","Reasonable","Very Strong","5'11""","176 lbs","297","94",95,115,10,8,9,11,10,7,11,12,7,10,11,10,6,11,13,9,15,7,10,10,14,14,5,12,8,12,9,15,12,13,12,9,13,11,12,13,11,10,13,13,11,12,7,16,13,9,11,11,12,3,1,3,2,3,1,4,2,1,4,3
"2248",8404400,"Pāvels Šteinbors","9/21/1985 (37 years old)","GK","RFS","Optibet Virsliga","LVA","Yes","6/23/2022","6/30/2023","$0 - $4K","Right","Reasonable","Very Strong","6'2""","178 lbs","363","-",109,114,4,2,1,3,7,7,3,2,2,3,11,2,2,4,8,11,11,9,10,12,11,3,10,2,12,11,10,10,8,12,11,15,13,8,9,13,13,10,14,14,14,6,6,12,6,12,14,11,15,11,12,15,8,12,10,14,4,11,12,14
"2249",47023317,"Vladislavs Gutkovskis","4/2/1995 (28 years old)","ST (C)","Raków","PKO Bank Polski Ekstraklasa","LVA","Yes","8/1/2020","6/30/2025","$850K - $1.8M","Right","Reasonable","Very Strong","6'2""","180 lbs","303","109",110,112,7,8,10,12,11,7,12,10,4,6,11,14,6,10,12,13,13,11,10,12,14,8,11,12,6,13,11,13,12,10,14,15,12,12,13,15,9,10,12,12,10,8,6,15,7,6,11,11,15,2,3,2,2,1,3,2,4,1,2,2
"2250",47075793,"Renārs Varslavāns","8/23/2001 (21 years old)","AM (RL)","Valmiera","Optibet Virsliga","LVA","Yes","1/1/2023","11/30/2024","$250K - $750K","Right","Reasonable","Very Strong","5'5""","136 lbs","79","5",88,111,5,7,10,8,10,6,5,9,4,5,10,10,5,11,8,9,8,8,9,8,16,10,5,8,5,12,8,14,14,13,12,4,14,14,10,9,10,10,10,10,9,6,5,8,4,3,8,15,15,2,3,4,1,2,1,1,2,3,4,3
"2251",47046112,"Eduards Tīdenbergs","12/18/1994 (28 years old)","D (R), M (RL)","Liepāja","Optibet Virsliga","LVA","Yes","8/2/2020","11/30/2024","$28K - $275K","Right","Reasonable","Very Strong","6'0""","160 lbs","201","27",90,111,10,13,11,9,10,11,6,6,10,9,11,12,11,12,9,10,9,9,10,15,12,5,6,10,11,11,9,11,11,10,10,6,9,12,9,9,17,10,12,11,11,10,9,3,10,4,10,10,10,1,3,2,1,1,1,3,3,3,2,1
"2252",43318808,"Roberts Veips","2/22/2000 (23 years old)","D (C)","Valmiera","Optibet Virsliga","LVA","Yes","9/1/2021","12/31/2023","$16K - $170K","Right Only","Weak","Very Strong","6'3""","182 lbs","26","-",74,110,1,3,5,5,9,3,11,3,5,11,7,7,10,9,12,8,12,8,8,7,16,8,12,7,12,11,9,11,9,10,11,15,12,9,11,11,10,12,12,16,10,12,4,10,10,1,12,16,12,1,3,2,1,2,2,3,1,1,2,3
"2253",47006673,"Kaspars Dubra","12/20/1990 (32 years old)","D (C)","RFS","Optibet Virsliga","LVA","Yes","3/1/2022","11/30/2023","$70K - $220K","Right Only","Weak","Very Strong","6'3""","189 lbs","298","27",105,110,5,5,5,8,10,10,13,7,12,13,11,10,14,7,10,12,12,11,11,11,11,5,13,10,13,12,10,10,10,7,11,16,12,10,11,16,10,11,11,11,11,9,12,9,10,5,11,12,9,2,3,3,1,1,3,2,2,3,4,3
"2254",47051808,"Vjačeslavs Kudrjavcevs","3/30/1998 (25 years old)","GK","Super Nova","Optibet Virsliga","LVA","Yes","1/13/2023","12/31/2023","$0 - $100K","Right Only","Weak","Very Strong","6'2""","165 lbs","76","-",85,110,3,1,3,2,6,5,5,2,2,2,7,1,1,6,5,11,8,8,10,7,13,3,7,6,12,9,4,12,10,15,12,14,13,10,10,12,10,13,10,11,9,10,4,8,3,6,10,10,9,12,7,12,11,12,8,13,6,9,10,11
"2255",29193746,"David Titov","1/5/2000 (23 years old)","D/WB (R)","Mjølner","Norwegian Third Division Group 6","LVA","Yes","10/11/2021","-","$0","Right Only","Weak","Very Strong","5'7""","141 lbs","30","2",84,109,10,11,10,7,10,7,8,6,10,11,11,6,11,12,11,9,12,10,10,11,13,12,6,9,12,12,11,13,11,10,10,7,12,11,11,10,11,10,11,13,12,12,4,3,5,5,3,11,13,3,4,4,3,3,2,2,1,1,1,3
"2256",43339890,"Dmitrijs Zelenkovs","5/15/2000 (23 years old)","M/AM (C)","RFS","Optibet Virsliga","LVA","Yes","1/1/2022","11/30/2024","$0 - $75K","Left","Very Strong","Reasonable","5'10""","163 lbs","23","-",77,108,13,11,12,8,10,12,7,12,4,5,10,12,8,11,8,10,8,9,8,10,8,9,7,9,7,10,11,8,11,10,11,8,10,11,10,9,12,10,9,13,11,13,12,10,7,1,10,12,15,2,1,2,1,2,2,2,2,1,1,2
"2257",2000176231,"Mohamed El Mokhtar","10/10/2002 (20 years old)","GK","AS Douanes (MTN)","Mauritanian D1","MTN","No","7/1/2021","6/30/2025","$0","Right Only","Weak","Very Strong","6'1""","147 lbs","-","-",69,108,3,3,1,2,1,6,1,1,2,1,10,3,3,4,14,9,15,2,7,13,14,2,11,2,8,6,5,5,8,8,6,7,14,9,1,4,11,17,11,12,11,11,12,6,14,6,11,12,8,10,12,13,11,8,12,9,5,5,10,7
"2258",47005336,"Mārcis Ošs","7/25/1991 (31 years old)","D (C)","RFS","Optibet Virsliga","LVA","Yes","1/1/2023","11/30/2023","$28K - $275K","Left Only","Very Strong","Weak","6'4""","205 lbs","257","31",103,108,2,4,5,5,7,9,15,4,19,13,10,7,13,8,15,12,15,11,11,10,14,4,12,6,11,10,5,10,8,7,16,16,12,9,12,17,11,9,8,13,12,7,4,12,13,6,12,10,14,2,1,3,2,3,1,1,2,1,2,3
"2259",47040466,"Ingars Stuglis","2/12/1996 (27 years old)","DM, M/AM (C)","FK Tukums 2000/Telms","Optibet Virsliga","LVA","Yes","3/1/2022","11/30/2024","$30K - $300K","Right","Reasonable","Very Strong","5'10""","149 lbs","198","12",84,106,5,6,11,8,10,10,9,10,8,10,10,9,11,10,12,10,9,9,8,11,12,9,11,10,12,11,10,10,12,11,9,10,10,11,11,9,11,12,13,12,9,8,10,8,10,4,10,12,10,2,3,1,2,3,1,2,1,3,2,3
"2260",47017064,"Deniss Rakels","8/20/1992 (30 years old)","AM (L), ST (C)","Super Nova","Optibet Virsliga","LVA","Yes","1/1/2023","11/30/2024","$130K - $1.3M","Right","Fairly Strong","Very Strong","5'10""","160 lbs","322","101",98,105,8,8,10,12,12,9,8,9,7,5,12,14,6,11,13,11,10,10,11,10,10,10,8,12,8,12,10,14,12,11,12,9,10,12,12,11,6,5,11,10,12,8,9,13,7,15,10,8,16,3,2,2,3,1,1,3,3,1,3,2
"2261",28110177,"Rihards Matrevics","3/18/1999 (24 years old)","GK","Riga","Optibet Virsliga","LVA","Yes","1/1/2023","11/30/2024","$80K - $230K","Right","Weak","Very Strong","6'7""","209 lbs","72","-",89,105,3,3,1,3,7,5,3,2,3,2,8,3,3,9,10,10,7,8,12,11,14,3,11,1,12,10,9,9,10,11,10,12,11,9,9,13,8,11,12,14,10,10,7,11,5,5,8,14,14,9,10,12,8,9,9,12,7,9,10,11
"2262",47005906,"Artūrs Zjuzins","6/18/1991 (31 years old)","DM, M/AM (C)","RFS","Optibet Virsliga","LVA","Yes","1/1/2019","11/30/2023","$30K - $300K","Right","Reasonable","Very Strong","6'0""","160 lbs","264","24",102,105,6,9,10,11,14,5,8,9,6,8,14,10,11,13,10,13,8,14,13,15,5,13,12,10,7,12,15,7,8,10,8,8,8,9,9,9,8,13,12,10,9,12,14,13,4,3,12,11,12,2,2,1,3,1,2,1,3,2,2,3
"2263",47040525,"Jevgēņijs Kazačoks","8/12/1995 (27 years old)","AM (C)","Mosjøen","Norwegian Third Division Group 5","LVA","Yes","1/1/2023","-","$0","Right","Weak","Very Strong","5'9""","187 lbs","219","44",71,105,10,10,8,11,11,10,10,14,9,10,12,11,10,13,9,11,8,10,10,10,9,7,8,12,13,7,10,7,7,9,13,8,10,9,9,13,6,12,11,12,12,9,7,12,9,5,12,8,12,1,2,2,4,2,1,1,1,2,2,1
"2264",47040534,"Roberts Ozols","9/10/1995 (27 years old)","GK","Auda","Optibet Virsliga","LVA","Yes","2/4/2023","11/30/2024","$90K - $900K","Right Only","Weak","Very Strong","6'2""","180 lbs","135","-",100,105,4,3,3,2,3,7,1,3,3,3,11,2,3,2,13,10,11,7,12,14,14,3,8,2,13,9,8,8,11,13,11,12,12,10,13,13,13,9,8,12,12,10,5,11,8,13,10,12,10,10,12,12,9,11,10,11,11,11,10,12
"2265",47000198,"Vladislavs Gabovs","7/13/1987 (35 years old)","D (RL), WB (R)","Salaspils","Latvian Second League East","LVA","Yes","12/31/2020","-","$0","Right","Reasonable","Very Strong","5'9""","160 lbs","376","9",70,105,5,10,7,5,9,6,8,5,10,11,9,8,9,7,12,11,5,10,11,11,12,10,6,8,10,11,7,9,10,10,8,7,12,10,10,12,8,9,10,12,11,8,6,13,9,4,12,12,13,2,2,2,3,3,4,2,1,1,2,2
"2266",47005162,"Germans Māliņš","10/12/1987 (35 years old)","GK","Alberts","Latvian Future League","LVA","Yes","1/1/2021","-","$0","Right Only","Weak","Very Strong","6'2""","169 lbs","236","1",67,105,2,1,1,3,1,3,1,2,1,1,11,2,2,3,6,7,15,6,12,7,7,2,12,2,11,6,5,5,9,12,5,9,13,9,3,4,9,15,11,9,10,13,11,4,13,7,9,7,20,8,9,9,12,6,12,12,7,5,9,9
"2267",43390820,"Aleksejs Saveļjevs","1/30/1999 (24 years old)","DM, M (C)","Auda","Optibet Virsliga","LVA","Yes","1/2/2023","12/31/2023","$26K - $250K","Right","Fairly Strong","Very Strong","6'0""","167 lbs","77","3",86,105,6,8,10,9,10,7,7,9,5,6,11,8,11,10,10,12,10,12,11,10,12,9,8,10,11,13,8,15,11,11,9,10,8,10,12,9,9,14,12,14,12,14,5,9,7,6,11,9,8,3,3,2,1,2,2,3,3,3,3,2
"2268",13182565,"Hemeya Tanjy","5/1/1998 (25 years old)","ST (C)","FC Nouadhibou","Mauritanian D1","MTN","No","7/1/2019","6/30/2024","$0","Right","Reasonable","Very Strong","5'10""","141 lbs","-","-",98,108,8,8,13,14,12,7,14,8,1,5,8,6,2,9,5,12,4,14,9,9,3,12,4,13,9,8,9,9,14,12,9,5,7,12,14,11,10,16,11,10,9,10,7,5,13,4,11,7,11,2,2,3,1,1,3,3,1,2,2,2
"2269",47043927,"Dāvis Indrāns","6/6/1995 (28 years old)","M/AM (C)","Alberts","Latvian Future League","LVA","Yes","7/12/2022","-","$0","Right","Reasonable","Very Strong","6'0""","167 lbs","145","14",81,104,6,8,8,8,11,6,5,7,1,7,11,5,6,8,8,11,8,7,2,13,4,6,13,10,8,8,8,10,13,13,7,7,11,13,13,8,11,15,12,11,14,12,8,16,11,7,10,11,15,2,3,2,2,2,2,2,2,2,2,2
"2270",47005161,"Nauris Bulvītis","3/15/1987 (36 years old)","D (C)","Leevon","Latvian Future League","LVA","Yes","12/31/2020","-","$0","Right Only","Weak","Very Strong","6'3""","178 lbs","306","26",63,104,2,5,7,5,8,4,14,6,8,9,6,4,11,7,13,8,10,8,8,8,13,6,8,5,9,13,8,10,7,9,11,14,16,8,13,11,7,9,11,12,11,10,7,10,7,8,11,11,11,1,1,3,2,2,4,2,1,3,2,3
"2271",47019810,"Roberts Savaļnieks","2/4/1993 (30 years old)","D/WB/M (R)","RFS","Optibet Virsliga","LVA","Yes","1/1/2023","11/30/2023","$30K - $325K","Right","Reasonable","Very Strong","5'7""","143 lbs","304","26",100,103,12,14,12,8,12,12,6,11,11,9,12,11,9,12,9,10,8,10,11,14,10,6,8,9,13,11,11,10,11,9,12,5,11,12,12,11,12,11,14,14,10,6,10,10,6,1,10,10,10,2,3,3,3,1,1,3,3,1,4,2
"2272",47092783,"Normunds Uldriķis","1/29/2001 (22 years old)","D (C), DM","Metta","Optibet Virsliga","LVA","Yes","6/15/2020","11/30/2024","$8K - $75K","Right","Reasonable","Very Strong","6'6""","202 lbs","100","4",67,103,5,4,5,8,6,4,11,5,7,10,9,5,11,4,10,10,10,9,8,8,15,4,4,6,7,12,8,13,10,8,9,14,10,10,13,13,7,10,15,15,9,10,3,5,5,4,8,15,14,3,3,2,1,3,2,4,1,3,1,2
"2273",47051773,"Eduards Emsis","2/23/1996 (27 years old)","DM, M (C)","KF Egnatia","Albanian Superleague","LVA","Yes","1/16/2023","6/30/2024","$55K - $170K","Right Only","Weak","Very Strong","6'0""","167 lbs","154","4",91,103,8,8,10,8,9,7,10,8,11,13,11,8,13,9,11,12,11,11,8,11,12,8,12,10,12,9,14,14,10,10,12,11,11,10,13,11,14,6,7,14,12,9,7,6,14,12,12,13,11,2,1,1,2,1,4,2,2,1,2,1
"2274",91180011,"Bogdans Samoilovs","3/13/2000 (23 years old)","M/AM (C)","FK Tukums 2000/Telms","Optibet Virsliga","LVA","Yes","7/4/2022","-","$0","Left","Very Strong","Reasonable","5'10""","149 lbs","45","10",70,102,6,6,8,11,13,3,2,8,3,8,12,7,6,13,12,6,3,8,7,8,14,13,3,8,6,7,9,7,13,13,7,4,12,13,5,4,10,13,14,14,11,12,9,3,5,7,11,12,13,2,1,1,2,4,2,2,3,2,2,2
"2275",2000010570,"Raivis Ķiršs","1/15/2000 (23 years old)","AM (R)","FK Tukums 2000/Telms","Optibet Virsliga","LVA","Yes","3/8/2023","12/31/2023","$22K - $220K","Right","Reasonable","Very Strong","5'7""","141 lbs","60","5",86,102,7,9,10,8,10,7,5,7,8,5,10,10,7,11,6,9,9,9,10,10,12,10,6,10,6,10,11,12,13,10,10,6,12,13,12,7,12,8,12,12,9,8,4,9,4,5,8,13,13,3,3,2,3,4,2,3,2,1,3,2
"2276",47017341,"Kaspars Svārups","1/28/1994 (29 years old)","ST (C)","Modenese","Italian Seconda Categoria","LVA","Yes","1/2/2023","-","$0","Right Only","Weak","Very Strong","6'3""","180 lbs","202","31",71,102,3,5,9,11,6,4,14,11,8,5,8,7,7,8,10,10,8,10,7,11,13,4,11,10,10,8,7,7,9,9,12,15,8,9,14,12,4,8,7,7,9,8,7,4,11,10,9,12,14,1,1,2,1,3,1,1,1,3,1,3
"2277",96082925,"Antonijs Černomordijs","9/26/1996 (26 years old)","D (C)","Riga","Optibet Virsliga","LVA","Yes","6/15/2020","12/31/2023","$110K - $325K","Right","Reasonable","Very Strong","6'3""","171 lbs","160","8",98,102,4,5,7,7,9,7,13,6,6,13,11,9,12,10,12,9,13,10,9,11,11,4,13,8,11,12,10,10,10,9,8,14,12,10,13,14,5,10,10,10,10,7,4,9,7,4,10,9,10,1,2,3,2,2,3,3,3,1,1,2
"2278",47065840,"Ivans Baturins","6/25/1997 (25 years old)","GK","Harju","Estonian Premier League","LVA","Yes","2/19/2023","12/31/2023","$0 - $35K","Right","Reasonable","Very Strong","6'0""","158 lbs","105","-",65,101,3,2,2,1,1,3,1,2,3,2,7,1,2,1,14,7,13,6,8,13,17,1,7,3,10,6,5,5,13,5,6,9,17,13,5,5,9,15,9,11,13,8,8,6,5,4,15,10,7,7,7,13,9,8,12,13,9,6,9,11
"2279",2000229570,"Ibrahima Keita","11/8/2001 (21 years old)","D (RC)","TP Mazembe","DR Congo Premier Division A","MTN","No","6/12/2023","6/30/2025","$80K - $800K","Right","Reasonable","Very Strong","5'11""","163 lbs","4","-",80,106,4,8,7,3,8,1,12,6,1,13,8,3,11,7,7,10,9,8,11,14,12,5,9,7,12,7,4,8,13,10,8,7,15,10,6,7,13,20,11,9,11,8,5,8,15,5,11,13,7,4,1,3,3,1,2,2,3,2,1,2
"2280",47000173,"Vladimirs Kamešs","10/28/1988 (34 years old)","AM (RL)","Elverum","Norwegian Third Division Group 2","LVA","Yes","2/9/2023","12/31/2023","$2K - $6K","Left","Very Strong","Reasonable","5'11""","160 lbs","308","63",99,101,9,10,11,10,11,6,7,7,8,9,11,12,9,11,11,11,14,9,11,11,13,7,10,13,9,12,11,11,13,11,10,10,12,12,12,12,18,11,15,16,12,7,12,9,7,5,14,12,12,3,3,1,1,3,2,1,3,3,1,3
"2281",2000307793,"Emils Sprukts","1/23/2007 (16 years old)","ST (C)","Roda JC Kerkrade","Keuken Kampioen Divisie","LVA","Yes","7/1/2021","6/30/2027","$0","Right","Weak","Very Strong","5'8""","132 lbs","-","-",74,101,6,4,12,13,9,6,13,5,4,2,3,4,2,9,7,12,7,13,6,10,18,9,6,13,4,6,5,7,13,13,7,3,13,13,6,5,10,14,11,7,12,11,9,10,11,1,9,9,7,2,2,4,3,1,3,2,4,3,1,2
"2282",47051634,"Deivids Dobrecovs","2/26/1997 (26 years old)","AM (C), ST (C)","Grobiņas","Latvian Future League","LVA","Yes","7/20/2020","-","$0","Right","Reasonable","Very Strong","5'11""","158 lbs","76","35",85,100,4,7,12,11,8,3,6,9,2,7,7,7,7,8,6,6,8,11,6,11,9,7,8,11,8,8,9,9,14,14,8,7,8,14,9,6,10,12,11,12,11,11,6,8,5,2,19,11,10,2,4,3,3,3,2,1,2,2,2,3
"2283",29176605,"Rūdolfs Soloha","3/16/2000 (23 years old)","GK","Super Nova","Optibet Virsliga","LVA","Yes","1/1/2023","11/30/2024","$50K - $150K","Right","Reasonable","Very Strong","6'2""","167 lbs","47","-",75,100,3,3,3,3,4,6,1,2,1,1,9,2,1,1,12,11,11,8,10,14,12,2,12,2,13,8,6,7,13,10,8,8,13,12,4,13,12,9,10,11,9,10,11,13,5,6,10,9,11,10,6,11,11,11,10,10,3,7,6,8
"2284",47014913,"Artūrs Karašausks","1/29/1992 (31 years old)","M/AM (L), ST (C)","Ypsonas","Cypriot Second Division","LVA","Yes","8/19/2022","5/31/2024","$16K - $45K","Right","Reasonable","Very Strong","5'10""","163 lbs","269","95",85,100,7,12,7,9,10,7,11,14,6,7,9,3,5,10,9,9,6,7,8,14,5,9,12,11,7,8,10,13,13,9,14,9,15,10,14,9,11,7,7,12,12,5,6,11,12,3,20,11,8,1,3,3,1,3,3,1,2,1,4,2
"2285",2000268608,"Rodrigo Vitols","2/20/2007 (16 years old)","GK","Aberdeen","cinch Premiership","LVA","Yes","7/1/2022","5/31/2026","$12K - $130K","Right","Fairly Strong","Very Strong","6'3""","160 lbs","-","-",60,99,2,2,3,2,4,6,1,2,1,3,7,2,1,4,11,4,9,2,9,12,16,2,12,3,5,5,4,3,6,14,6,13,13,5,1,4,6,11,11,7,11,7,12,6,12,2,8,17,15,5,9,12,9,9,7,12,5,11,6,12
"2286",59145902,"Maksim Samorodov","6/29/2002 (20 years old)","AM (RLC), ST (C)","Aqtóbe","Kazakhstan Premier League","KAZ","No","1/17/2022","12/31/2023","$240K - $2.4M","Right","Strong","Very Strong","5'9""","138 lbs","83","15",115,136,7,8,12,12,11,5,6,10,1,6,9,11,6,12,10,11,12,11,12,11,6,12,11,12,11,12,10,13,14,14,13,6,14,13,10,7,14,12,13,10,10,14,3,14,8,5,12,9,17,1,3,3,4,2,3,2,3,3,2,2
"2287",59136080,"Nüraly Älip","12/22/1999 (23 years old)","D (LC)","Zenit","Russian Premier League","KAZ","No","12/15/2022","6/30/2025","$35K - $5.6M","Left","Very Strong","Fairly Strong","6'2""","185 lbs","127","5",118,135,6,6,9,6,10,6,15,7,9,11,12,7,15,10,14,14,12,14,16,12,15,5,8,7,10,13,8,13,11,11,13,13,14,12,13,13,7,12,12,12,10,11,13,11,15,2,13,10,20,3,2,1,3,3,4,1,2,3,2,2
"2288",59112599,"Baqtiiar Zainutdinov","4/2/1998 (25 years old)","D (LC), WB (L), M (LC)","CSKA Moscow","Russian Premier League","KAZ","No","8/25/2020","6/30/2025","$950K - $5.8M","Left","Very Strong","Reasonable","6'1""","169 lbs","190","22",125,131,9,10,12,10,12,12,14,13,9,11,12,10,13,12,14,14,14,12,14,12,14,12,10,10,12,15,8,14,12,11,12,11,15,13,14,10,17,15,17,18,15,10,9,11,8,2,14,12,14,4,1,1,3,1,1,1,1,2,3,1
"2289",59102345,"Bekkhan Shaizada","8/18/1998 (24 years old)","GK","Ordabasy","Kazakhstan Premier League","KAZ","No","6/15/2020","12/31/2024","$220K - $650K","Right","Fairly Strong","Very Strong","6'2""","171 lbs","112","-",102,127,6,1,2,3,1,8,1,3,1,3,11,3,3,3,5,10,15,9,14,14,6,3,13,1,8,9,8,7,10,6,9,11,11,13,2,6,9,18,11,8,13,12,11,10,14,4,20,12,8,9,13,14,6,14,14,14,10,12,8,13
"2290",13182557,"Alassane Diop","9/22/1997 (25 years old)","M (C)","Al-Nasr (OMA)","Omani Professional League","MTN","No","1/19/2022","6/30/2024","$6K - $20K","Right","Reasonable","Very Strong","6'0""","165 lbs","11","1",83,105,7,7,7,4,13,7,7,9,7,10,12,1,9,8,15,10,8,8,8,14,5,10,4,11,9,8,8,13,14,13,8,9,5,13,14,5,14,17,11,9,14,8,7,13,5,3,11,9,16,3,2,1,3,2,3,2,1,3,3,2
"2291",2000227641,"Raul' Allahverdiev","10/4/2006 (16 years old)","ST (C)","Jeńis","Kazakhstan First League","KAZ","No","1/1/2022","12/31/2025","$170K - $500K","Right","Weak","Very Strong","6'1""","160 lbs","19","3",85,127,7,6,8,13,14,7,9,7,4,3,8,9,3,14,7,9,8,12,6,12,3,13,6,7,4,8,7,11,11,11,14,10,10,12,14,4,9,12,12,11,11,10,7,7,10,7,10,10,11,2,1,2,1,1,3,2,1,1,3,3
"2292",59136615,"Arman Kenesov","9/4/2000 (22 years old)","M/AM (C)","Aqtóbe","Kazakhstan Premier League","KAZ","No","12/14/2021","12/31/2023","$50K - $500K","Left","Very Strong","Weak","5'7""","136 lbs","133","16",100,127,9,5,12,12,13,9,4,15,8,11,12,6,8,13,15,7,8,13,11,15,16,11,7,15,13,12,10,13,15,13,14,7,12,13,8,3,15,19,10,11,12,11,7,11,8,8,8,12,10,1,3,3,3,2,2,1,1,1,1,3
"2293",2000142552,"Adilet Sadybekov","5/26/2002 (21 years old)","D (C), DM","Qairat","Kazakhstan Premier League","KAZ","No","6/20/2022","12/31/2024","$170K - $1.7M","Right","Weak","Very Strong","6'0""","176 lbs","35","2",95,126,4,5,5,3,9,8,14,8,6,13,6,2,14,9,8,9,9,9,7,14,12,5,12,7,12,8,7,13,14,14,9,8,9,14,14,8,12,12,11,8,8,10,10,7,7,3,19,9,19,3,3,4,2,1,2,2,2,2,3,2
"2294",85011629,"Dmytro Nepogodov","2/17/1988 (35 years old)","GK","Chornomorets","Ukrainian Premier League","KAZ","No","1/2/2023","6/30/2024","$5K - $16K","Left Only","Very Strong","Very Weak","6'5""","198 lbs","244","-",102,126,4,1,2,2,5,7,2,2,2,2,6,2,2,5,12,12,14,12,12,11,8,5,11,3,11,11,5,10,6,9,16,18,12,5,10,16,1,18,11,11,10,10,5,6,10,8,13,12,12,8,8,14,12,14,8,13,7,15,13,14
"2295",59062447,"Abat Aiymbetov","8/7/1995 (27 years old)","AM (R), ST (C)","Astana","Kazakhstan Premier League","KAZ","No","2/10/2022","12/31/2024","$55K - $550K","Right","Reasonable","Very Strong","6'0""","165 lbs","200","61",118,123,10,13,14,13,10,8,11,6,9,9,13,8,6,14,5,12,6,13,10,14,10,13,5,13,8,10,8,11,13,11,10,7,17,14,14,7,14,16,11,13,10,11,8,15,8,6,10,8,11,2,1,2,1,1,1,3,3,3,2,1
"2296",2000060849,"Damir Kasabulat","8/29/2002 (20 years old)","D (C)","Qairat","Almaty A League","KAZ","No","2/22/2022","12/31/2023","$550K - $1.6M","Right","Weak","Very Strong","5'11""","143 lbs","61","1",90,123,4,3,1,5,8,1,11,7,2,14,9,6,10,6,11,11,10,6,7,14,6,6,9,8,14,8,8,9,14,14,9,10,13,14,8,7,16,13,9,11,13,11,12,6,10,5,11,11,10,2,4,4,4,3,4,3,1,1,2,4
"2297",59067414,"Iurii Pertsukh","5/13/1996 (27 years old)","DM, M (C)","Shahter Q.","Kazakhstan Premier League","KAZ","No","2/28/2023","12/31/2023","$50K - $500K","Right","Reasonable","Very Strong","6'1""","171 lbs","174","16",102,122,8,7,7,7,14,8,8,8,2,10,14,2,14,11,8,10,5,10,5,14,4,5,9,8,9,9,8,12,11,12,9,11,15,14,14,7,14,16,13,10,13,10,10,11,13,2,11,12,20,3,2,1,1,3,3,3,3,1,3,1
"2298",59062198,"Roman Mürtazaev","9/10/1993 (29 years old)","AM (RL), ST (C)","Shahter Q.","Kazakhstan Premier League","KAZ","No","12/1/2021","12/31/2023","$40K - $425K","Right","Fairly Strong","Very Strong","6'2""","189 lbs","303","92",106,122,9,12,9,9,15,9,9,10,9,9,12,13,9,14,10,13,6,13,10,13,13,12,12,10,9,10,10,11,10,9,10,13,17,12,12,14,14,11,11,12,8,11,14,8,8,6,9,13,14,2,2,3,1,1,2,2,1,3,2,3
"2299",59036244,"Ğafurzhan Süiimbaev","8/19/1990 (32 years old)","D (RL), WB (L)","Ordabasy","Kazakhstan Premier League","KAZ","No","2/24/2023","12/31/2023","$50K - $475K","Right","Reasonable","Very Strong","5'8""","147 lbs","300","14",118,120,10,13,7,8,11,7,11,8,9,12,12,8,14,11,15,11,12,11,11,15,3,5,10,10,14,12,8,12,12,10,12,7,10,10,12,12,15,12,13,10,12,7,12,12,5,1,19,11,17,2,2,4,1,1,1,3,1,3,1,1
"2300",59036443,"Abzal Beisebekov","11/30/1992 (30 years old)","D/WB/M (R)","Astana","Kazakhstan Premier League","KAZ","No","12/21/2021","12/31/2023","$35K - $350K","Right","Reasonable","Very Strong","6'2""","178 lbs","333","19",117,119,8,11,11,4,14,10,10,8,10,12,8,7,12,12,8,11,11,11,8,12,15,13,13,11,14,11,9,12,15,12,11,11,12,14,12,10,14,13,12,11,12,11,6,12,6,6,11,11,13,3,3,3,2,2,4,2,1,1,3,3
"2301",13232465,"Sidi Yacoub Ethmane","1/1/1995 (28 years old)","DM, M (C)","FC Nouadhibou","Mauritanian D1","MTN","No","10/22/2022","6/30/2023","$0","Right Only","Weak","Very Strong","6'2""","180 lbs","-","-",98,105,9,9,10,9,12,8,9,8,5,11,14,2,11,11,15,14,10,11,12,15,3,5,2,9,12,14,7,12,11,11,9,15,12,11,15,11,16,13,11,13,13,12,12,14,12,7,13,9,17,1,4,3,1,1,3,3,2,4,1,3
"2302",59110696,"Aibol Äbiken","6/1/1996 (27 years old)","D (C), DM","Qairat","Kazakhstan Premier League","KAZ","No","6/15/2020","12/31/2025","$210K - $2.1M","Right","Reasonable","Very Strong","5'10""","121 lbs","148","23",115,119,9,9,7,5,11,10,10,11,6,15,12,5,15,10,12,10,12,11,12,14,8,5,2,10,15,10,10,12,15,12,11,5,12,13,14,8,13,16,10,11,11,10,7,5,9,6,15,13,12,3,2,2,3,3,2,2,3,2,3,2
"2303",59003731,"Dmitrii Shomko","3/19/1990 (33 years old)","D (RL), WB/M (L)","Aqtóbe","Kazakhstan Premier League","KAZ","No","5/31/2021","12/31/2024","Not for Sale","Left","Very Strong","Reasonable","6'1""","176 lbs","382","17",109,119,9,14,10,6,13,8,10,9,9,11,6,3,14,11,7,10,10,10,9,14,13,8,11,9,11,10,9,11,12,11,10,15,12,10,13,7,11,20,8,14,11,11,7,11,5,6,14,13,11,1,2,1,3,1,2,2,3,2,1,3
"2304",59137756,"Abylaikhan Zhumabek","10/19/2001 (21 years old)","ST (C)","Aqtóbe","Kazakhstan First League","KAZ","No","2/7/2023","12/31/2024","$170K - $1.7M","Right","Weak","Very Strong","6'0""","160 lbs","106","28",97,119,7,6,13,13,8,7,13,7,5,7,8,4,1,13,9,12,7,12,8,12,7,14,14,11,7,7,8,8,13,13,7,6,14,13,13,12,13,17,9,12,9,10,13,10,7,2,11,14,9,1,4,3,3,1,2,1,2,3,1,3
"2305",2000061226,"Batyrkhan Tazhibai","8/7/2001 (21 years old)","ST (C)","Ordabasy","Kazakhstan Second League Conference South-West","KAZ","No","7/1/2020","12/31/2024","$95K - $950K","Right","Reasonable","Very Strong","5'9""","147 lbs","41","4",89,119,7,5,9,14,11,7,14,4,2,5,8,7,1,10,15,11,5,9,8,12,11,9,1,14,8,7,7,8,14,14,8,4,15,14,11,6,11,18,11,9,12,10,8,16,11,5,5,14,17,2,1,3,3,3,1,3,1,1,1,1
"2306",5311590,"Serhiy Kostiuk","11/30/1978 (44 years old)","M/AM (C)","Kulevcha","Ukrainian Reg Div - Odesa region - D1","KAZ","No","6/27/2020","6/30/2024","$0","Left","Very Strong","Reasonable","5'9""","154 lbs","469","64",65,119,7,7,11,13,11,7,14,12,4,9,14,6,9,13,8,10,7,10,7,10,17,10,6,11,15,12,11,13,5,5,5,13,12,6,7,7,8,10,11,11,11,11,8,2,11,8,7,8,7,2,2,1,1,1,2,2,2,2,1,1
"2307",59136362,"Ramazan Karimov","7/5/1999 (23 years old)","ST (C)","Maqtaaral","Kazakhstan Premier League","KAZ","No","1/1/2022","12/31/2024","$60K - $600K","Right","Reasonable","Very Strong","6'3""","178 lbs","125","56",94,119,7,5,12,13,13,5,8,8,4,7,8,5,6,11,10,13,9,9,6,12,13,14,11,13,8,7,8,8,13,12,8,13,13,13,6,7,9,12,10,11,9,11,5,10,9,5,11,13,16,1,3,3,1,2,1,2,1,2,2,2
"2308",2000160816,"Almat Nürğazy","2/14/2002 (21 years old)","DM, M (C)","Shahter Q.","Kazakhstan Premier League","KAZ","No","1/1/2021","12/31/2026","$160K - $1.6M","Right","Strong","Very Strong","5'9""","152 lbs","37","2",97,118,8,4,5,9,11,8,8,7,4,13,13,4,14,13,13,9,9,7,10,14,6,5,8,9,13,9,13,12,14,11,9,4,15,13,7,6,13,20,11,9,11,10,8,8,12,3,13,12,9,2,1,2,3,1,1,3,3,2,1,1
"2309",59112597,"Artur Shushenachev","4/7/1998 (25 years old)","AM (L), ST (C)","Qairat","Kazakhstan Premier League","KAZ","No","6/21/2022","12/31/2023","$160K - $475K","Right","Weak","Very Strong","6'3""","132 lbs","170","56",105,118,8,9,11,14,14,8,14,9,4,8,10,11,2,11,11,9,5,13,9,14,10,10,11,11,9,8,9,10,14,9,9,14,15,10,14,8,12,15,11,12,13,12,11,13,5,2,11,9,17,1,3,2,2,3,3,1,1,1,3,3
"2310",59070895,"Ian Vorogovskiy","8/7/1996 (26 years old)","D/WB/M/AM (L)","RWD Molenbeek","Jupiler Pro League","KAZ","No","1/18/2022","6/30/2025","$45K - $425K","Left Only","Very Strong","Weak","6'0""","165 lbs","208","13",108,118,11,11,12,8,11,9,11,9,13,12,12,5,12,11,13,12,12,12,12,11,15,12,11,12,11,12,8,12,13,11,10,11,10,14,12,10,13,15,11,15,12,11,7,4,12,15,13,13,7,3,1,4,2,3,2,2,1,2,3,1
"2311",59062747,"Temirlan Erlanov","7/9/1993 (29 years old)","D (C)","Ordabasy","Kazakhstan Premier League","KAZ","No","2/24/2023","12/31/2023","$35K - $350K","Right","Fairly Strong","Very Strong","6'1""","163 lbs","209","18",115,117,4,4,4,1,11,1,13,5,3,14,10,8,14,6,12,13,11,10,8,14,7,5,5,9,10,9,3,10,14,14,10,13,6,14,11,7,14,18,10,13,10,10,5,6,5,8,12,12,10,1,4,2,3,2,1,3,2,2,2,3
"2312",49033659,"Oumar Camara","8/19/1992 (30 years old)","M/AM (RL)","Nantong","Chinese Super League","MTN","Yes","8/12/2022","12/31/2023","$9K - $90K","Right","Weak","Very Strong","6'1""","174 lbs","165","17",92,105,9,10,13,9,11,9,10,10,6,5,10,3,6,13,12,11,13,9,7,8,9,12,6,12,6,8,8,12,13,10,13,13,9,14,8,13,9,12,8,8,9,8,8,14,8,9,11,12,13,2,2,2,2,1,2,4,2,3,2,3
"2313",59042447,"Bauyrzhan Islamkhan","2/23/1993 (30 years old)","AM (C)","Ordabasy","Kazakhstan Premier League","KAZ","No","2/25/2023","12/31/2023","$20K - $210K","Right","Reasonable","Very Strong","5'9""","138 lbs","235","57",109,117,9,10,12,10,11,9,9,11,5,7,13,7,11,12,9,12,10,15,9,15,12,11,8,11,10,10,10,14,12,11,10,6,9,12,14,7,14,17,13,12,11,14,6,12,12,6,12,9,17,3,3,3,1,3,3,1,4,1,1,4
"2314",2000161998,"Seif Popov","6/30/2004 (18 years old)","AM (R)","Qairat","Almaty A League","KAZ","No","1/1/2021","12/31/2023","$95K - $950K","Right","Reasonable","Very Strong","5'7""","132 lbs","19","7",75,117,3,6,14,7,11,7,3,10,2,3,5,11,3,12,15,8,4,8,8,7,14,15,4,7,7,7,5,8,15,13,8,4,10,14,10,7,6,10,12,11,9,12,6,4,9,3,10,12,20,1,2,2,3,3,4,1,4,1,1,1
"2315",59137142,"Sultanbek Astanov","9/23/1999 (23 years old)","AM (RL), ST (C)","Ordabasy","Kazakhstan Premier League","KAZ","No","1/1/2023","12/31/2023","$35K - $375K","Right","Fairly Strong","Very Strong","5'9""","156 lbs","122","18",93,116,7,11,9,13,10,7,8,7,7,7,6,7,6,10,5,8,9,8,8,11,18,13,8,11,7,7,8,9,13,13,8,4,13,13,7,6,10,18,12,11,12,10,12,11,10,4,12,10,17,1,3,3,3,1,3,3,3,1,2,2
"2316",59134810,"Rauan Orynbasar","3/1/1998 (25 years old)","D (C), DM","Jetisu","Kazakhstan Premier League","KAZ","No","12/31/2020","12/31/2024","$30K - $300K","Right","Weak","Very Strong","6'0""","165 lbs","137","7",91,116,3,6,2,5,9,8,14,6,4,12,7,3,14,9,10,14,10,9,9,14,5,6,12,8,8,8,7,10,14,10,9,6,13,14,7,7,12,18,10,10,13,14,10,13,9,8,9,9,20,1,2,1,1,3,3,2,3,2,2,3
"2317",2000061004,"Alisher Mambetzhanov","1/4/2002 (21 years old)","GK","Aqtóbe","Kazakhstan Premier League","KAZ","No","7/1/2020","12/31/2026","$110K - $1.1M","Right","Reasonable","Very Strong","6'0""","160 lbs","23","-",99,116,4,3,1,1,4,6,1,1,3,1,12,3,1,2,6,14,15,9,10,14,13,3,8,1,9,9,8,7,11,11,9,10,12,12,2,7,12,16,9,11,8,11,10,13,5,7,12,11,8,8,10,14,9,8,9,14,15,9,14,7
"2318",2000061216,"Kurban Baishyk","3/5/2001 (22 years old)","DM, M (C)","Tūran Türkistan","Kazakhstan First League","KAZ","No","7/1/2021","12/31/2025","$100K - $1M","Right","Fairly Strong","Very Strong","5'9""","132 lbs","41","7",97,116,7,6,4,7,9,8,8,8,4,9,14,4,14,14,12,6,9,10,4,14,10,5,8,9,9,7,12,12,14,14,9,6,14,12,8,7,17,16,11,10,10,11,11,13,5,2,17,13,8,3,2,1,1,3,2,3,1,1,2,1
"2319",2000164029,"Ersūltan Tazhimukanov","3/16/2002 (21 years old)","M (C)","Jeńis","Kazakhstan First League","KAZ","No","1/1/2022","12/31/2024","$80K - $240K","Right","Reasonable","Very Strong","6'0""","149 lbs","10","-",82,116,7,7,6,6,13,7,5,9,1,11,14,1,7,9,7,5,5,8,7,13,4,5,11,10,9,8,14,12,12,10,3,6,13,10,7,6,11,17,12,11,10,11,7,14,8,2,10,11,14,2,1,2,3,2,2,3,1,3,1,1
"2320",59110691,"Älibek Qasym","5/27/1998 (25 years old)","D (C)","Aqtóbe","Kazakhstan Premier League","KAZ","No","1/1/2022","12/31/2025","$6K - $60K","Right","Reasonable","Very Strong","6'1""","154 lbs","149","24",91,116,3,6,7,4,8,1,13,5,1,11,8,4,13,4,14,11,10,8,8,9,14,5,5,7,13,7,5,8,13,13,8,10,12,13,9,13,12,12,12,12,9,12,6,1,11,5,10,14,19,1,2,2,1,1,1,2,3,4,3,3
"2321",58069136,"Marat Bystrov","6/19/1992 (30 years old)","D (RLC), WB/M (R)","Akhmat","Russian Premier League","KAZ","No","5/20/2022","6/10/2024","$200K - $2M","Right","Strong","Very Strong","5'11""","154 lbs","219","6",113,116,10,10,12,7,10,6,10,7,9,10,9,5,12,11,15,10,15,11,10,10,14,12,4,10,10,14,7,15,13,13,14,9,14,14,13,9,15,12,11,14,15,13,5,14,7,2,12,10,13,3,3,3,4,3,1,2,3,3,1,1
"2322",91004747,"Konstantin Engel","7/27/1988 (34 years old)","D (RLC), DM","Jeddeloh","German Regional Division North","KAZ","Yes","7/4/2021","6/30/2024","$1K - $9K","Right","Reasonable","Very Strong","5'10""","169 lbs","325","9",100,116,8,11,10,7,10,6,14,7,12,14,11,7,12,9,14,10,14,8,9,10,13,5,12,8,12,14,9,12,11,11,12,8,11,10,13,11,17,14,12,15,10,12,12,11,11,6,13,14,12,1,2,3,3,3,2,2,1,1,4,1
"2323",49063232,"Souleymane Kamara","1/10/2002 (21 years old)","ST (C)","Mandel United","Belgian Second Amateur Division VV A","MTN","Yes","9/1/2022","6/30/2025","$0 - $60K","Right","Reasonable","Very Strong","6'2""","182 lbs","18","1",79,104,3,4,10,13,13,5,13,7,3,4,9,10,3,9,12,11,14,9,6,8,4,5,6,11,12,10,7,10,10,7,8,10,13,12,11,12,5,10,10,12,11,10,11,8,11,6,6,11,10,1,2,3,1,2,2,3,3,1,1,2
"2324",59021145,"Timur Dosmagambetov","5/1/1989 (34 years old)","M (RL), AM (R), ST (C)","Astana","Kazakhstan Premier League","KAZ","No","7/7/2022","12/31/2023","$65K - $200K","Right","Fairly Strong","Very Strong","5'8""","138 lbs","412","68",115,116,8,13,8,15,15,6,12,9,8,8,15,7,8,13,13,13,11,11,11,15,6,11,14,13,10,7,12,12,12,12,5,4,8,12,9,8,10,14,11,12,11,13,6,12,7,7,13,8,6,2,2,3,1,3,1,2,2,3,1,3
"2325",58029259,"Viktor Dmitrenko","4/4/1991 (32 years old)","D (C)","Shahter Q.","Kazakhstan Premier League","KAZ","No","2/22/2023","12/31/2023","$12K - $130K","Right Only","Weak","Very Strong","6'3""","196 lbs","288","10",107,116,9,9,8,8,10,8,14,8,10,11,10,11,10,9,9,14,8,9,12,11,2,11,11,8,12,10,8,12,11,9,13,15,7,11,10,14,9,17,10,10,10,14,9,10,12,7,9,12,17,1,2,2,1,3,4,3,4,2,1,4
"2326",59112595,"Bekzat Shadmanov","8/12/1997 (25 years old)","D (C)","Qyzyljar","Kazakhstan Premier League","KAZ","No","3/3/2023","12/31/2023","$12K - $120K","Right","Fairly Strong","Very Strong","6'2""","125 lbs","151","3",100,116,3,3,1,3,8,5,14,5,3,14,9,6,11,6,14,12,10,6,9,14,16,6,9,7,14,8,1,9,14,12,9,13,15,12,10,11,12,19,10,10,10,11,5,3,15,7,14,11,7,2,3,3,3,1,2,1,3,3,3,2
"2327",2000227441,"Aslan Akhmedov","5/1/2004 (19 years old)","D/WB (L)","Qairat","Almaty A League","KAZ","No","1/1/2022","12/31/2024","$100K - $300K","Right","Fairly Strong","Very Strong","5'4""","125 lbs","2","-",65,116,6,11,4,2,10,4,8,5,7,9,9,3,13,5,9,8,9,9,9,14,11,5,10,7,7,9,9,9,12,11,9,1,14,12,8,2,15,12,9,11,11,10,12,17,14,7,9,11,8,3,1,1,2,1,2,2,2,1,3,1
"2328",71012475,"Sergei Malyi","6/5/1990 (33 years old)","D (C)","Ordabasy","Kazakhstan Premier League","KAZ","No","2/24/2023","12/31/2023","$8K - $75K","Right","Reasonable","Very Strong","6'3""","174 lbs","303","25",107,115,9,5,5,6,9,9,15,8,3,13,9,5,12,8,7,11,11,10,11,10,8,4,14,4,11,13,9,14,9,9,14,14,12,11,15,18,5,18,13,13,10,14,6,11,10,1,20,11,8,2,1,2,3,2,1,2,3,1,3,1
"2329",59042978,"Stas Pokatilov","12/8/1992 (30 years old)","GK","Aqtóbe","Kazakhstan Premier League","KAZ","No","12/25/2021","12/31/2024","$200K - $2M","Right","Reasonable","Very Strong","6'3""","185 lbs","219","-",113,115,2,2,3,3,5,5,1,2,2,3,13,3,1,7,13,10,13,9,14,14,5,1,11,2,9,10,9,9,11,17,10,16,9,12,8,8,13,11,12,10,11,13,7,12,14,7,15,12,17,10,11,14,12,10,11,14,5,9,9,14
"2330",59112312,"Artem Popov","1/17/1998 (25 years old)","DM, M/AM (C)","Aqsý","Kazakhstan Premier League","KAZ","No","7/2/2020","12/31/2025","$0 - $110K","Right","Reasonable","Very Strong","5'11""","165 lbs","127","17",82,115,5,5,7,7,12,5,5,12,2,7,4,3,9,12,15,9,7,6,5,12,5,13,1,7,7,6,12,11,12,12,6,8,17,12,12,7,17,14,11,10,13,11,8,6,10,2,19,11,15,2,1,1,2,2,1,2,1,3,2,1
"2331",59042694,"Islambek Kuat","1/12/1993 (30 years old)","D (R), DM, M (RC)","Astana","Kazakhstan Premier League","KAZ","No","12/21/2021","12/31/2024","$50K - $500K","Right","Reasonable","Very Strong","5'10""","152 lbs","248","16",101,114,9,9,9,9,10,7,10,8,10,11,12,8,12,11,14,11,12,12,11,10,13,7,8,8,11,13,10,12,12,11,13,10,13,12,13,12,13,14,10,12,11,13,5,13,17,7,14,10,7,2,2,2,3,3,1,2,1,3,3,1
"2332",2000060855,"Aleksandr Shirobokov","1/2/2003 (20 years old)","D (C)","Qairat","Almaty A League","KAZ","No","1/1/2020","12/31/2024","$24K - $250K","Right","Reasonable","Very Strong","6'0""","176 lbs","35","2",78,114,1,6,1,4,7,1,12,2,1,13,5,2,13,6,11,8,9,6,9,13,15,6,8,5,13,6,4,7,13,10,7,10,13,9,7,4,13,18,12,10,10,12,5,8,13,8,17,9,17,2,2,2,3,1,2,3,2,2,1,1
"2333",2000227446,"Ramazan Karimov","11/24/2004 (18 years old)","D/WB/M (L)","Qairat","Almaty A League","KAZ","No","1/1/2022","12/31/2023","$40K - $400K","Left","Very Strong","Weak","5'7""","132 lbs","11","-",65,114,7,9,8,4,9,7,7,7,5,9,9,7,8,9,7,5,8,9,5,11,15,10,12,8,4,14,8,14,14,13,6,5,10,9,9,6,8,11,10,11,12,12,12,11,6,2,14,10,17,2,3,2,2,2,2,1,3,1,3,1
"2334",63001452,"Luis Ramos","4/11/1985 (38 years old)","DM, M (C)","Hajdúböszörmény","Hungarian Lower Division","HON","Yes","9/7/2022","-","$0","Right","Weak","Very Strong","5'10""","158 lbs","248","6",68,114,7,8,8,6,8,8,11,10,8,11,8,7,12,8,13,12,13,10,9,8,17,8,9,10,11,13,11,12,9,11,10,9,11,9,10,11,12,12,10,18,13,15,10,12,15,14,12,5,9,2,2,3,1,2,2,3,1,3,2,3
"2335",13173516,"Djibril Diop","10/14/1990 (32 years old)","M (C)","FC Nouadhibou","Mauritanian D1","MTN","No","7/1/2020","6/30/2024","$0","Right","Reasonable","Very Strong","5'11""","160 lbs","-","-",65,104,6,6,3,6,14,6,3,14,6,12,7,5,10,11,12,8,4,10,7,13,12,7,6,8,6,6,14,11,7,11,7,9,12,8,6,5,13,17,12,11,13,10,10,2,5,8,16,15,11,3,1,1,2,2,1,1,2,3,1,3
"2336",1650734,"Renat Abdulin","4/14/1982 (41 years old)","D (RLC)","Vista Gelendzhik","Russian Lower Division","KAZ","No","9/12/2022","-","$0","Right","Fairly Strong","Very Strong","6'1""","167 lbs","436","13",75,114,7,7,6,9,7,4,8,10,9,9,8,8,11,10,12,11,14,10,7,11,7,6,8,9,9,11,7,13,7,8,6,11,11,8,12,10,14,19,12,12,11,12,11,19,5,2,8,12,12,3,3,2,3,3,3,3,3,3,2,2
"2337",59047095,"Dmitrii Miroshnichenko","2/26/1992 (31 years old)","D (RC), WB/M (R)","Spartak Kostroma","Russian Second Division A Gold","KAZ","No","6/12/2023","6/30/2024","$9K - $90K","Right","Reasonable","Very Strong","6'0""","165 lbs","257","13",94,114,10,13,9,8,11,10,11,6,6,11,11,4,12,9,13,13,10,10,11,11,19,5,1,10,14,11,11,13,8,11,10,10,12,11,14,10,11,19,10,11,14,8,10,4,12,4,13,11,16,3,2,3,2,1,2,3,2,4,3,4
"2338",59137531,"El'khan Astanov","5/21/2000 (23 years old)","AM (LC)","Astana","Kazakhstan Premier League","KAZ","No","3/10/2023","12/31/2026","$26K - $275K","Right","Weak","Very Strong","6'1""","169 lbs","124","28",100,114,8,8,14,13,13,8,8,8,7,6,9,8,9,13,8,10,7,12,8,10,15,12,13,14,6,9,10,12,14,14,14,8,11,14,7,6,13,19,8,11,10,9,12,13,8,7,14,9,16,1,4,3,3,1,2,1,2,2,3,2
"2339",59138037,"Ädilbek Zhumakhanov","12/27/2002 (20 years old)","D (RC)","Atyraý","Kazakhstan Premier League","KAZ","No","3/1/2023","12/31/2026","$475K - $1.4M","Right","Weak","Very Strong","6'4""","180 lbs","82","4",95,113,4,9,5,6,11,1,13,8,8,14,11,3,12,10,8,7,10,9,10,14,17,5,9,9,13,10,4,11,13,10,7,16,10,10,8,7,11,11,14,10,14,10,10,7,10,7,8,11,10,1,2,3,1,3,2,1,2,3,2,2
"2340",59033593,"Aleksei Shchetkin","5/21/1991 (32 years old)","ST (C)","Kuban PFC","Russian First Division","KAZ","No","9/7/2022","9/6/2023","$28K - $85K","Right","Reasonable","Very Strong","6'4""","191 lbs","346","84",92,113,5,5,7,13,11,7,10,7,10,7,11,14,7,12,15,8,13,9,10,10,18,9,11,11,8,8,11,9,11,10,13,15,9,11,12,15,4,17,13,11,10,12,14,11,11,8,12,10,7,3,3,2,1,4,1,1,2,4,2,4
"2341",59062834,"Aleksandr Marochkin","7/14/1990 (32 years old)","D (RC), DM","Tobyl","Kazakhstan Premier League","KAZ","No","12/16/2019","12/31/2025","Not for Sale","Right","Reasonable","Very Strong","6'3""","132 lbs","246","15",111,113,7,10,5,8,10,9,11,6,9,14,11,4,13,10,5,13,11,10,11,14,18,5,13,5,14,10,9,11,11,8,10,15,12,9,13,7,15,10,11,11,11,11,12,5,9,8,13,13,16,2,2,3,2,2,1,2,2,1,3,3
"2342",59130423,"Musa Qurbanlı","4/13/2002 (21 years old)","ST (C)","Qarabağ","Azeri Premier League","AZE","No","6/13/2022","6/30/2026","$55K - $550K","Right Only","Weak","Very Strong","6'1""","171 lbs","86","56",105,135,6,7,11,14,12,8,11,11,8,4,11,10,6,11,7,14,12,12,12,12,15,12,7,13,6,12,8,13,13,11,11,12,13,12,12,11,12,12,12,14,13,11,6,20,5,5,11,15,14,1,1,2,3,1,3,2,1,3,1,3
"2343",59115358,"Ömər Buludov","12/15/1998 (24 years old)","D (R)","Neftçi","Azeri Premier League","AZE","No","5/25/2021","5/31/2024","$200K - $2M","Right","Fairly Strong","Very Strong","5'9""","158 lbs","111","5",109,134,6,12,8,8,11,2,10,5,8,9,10,6,13,10,9,12,10,10,10,14,17,5,10,8,12,8,10,10,14,14,9,9,15,14,11,6,10,10,10,10,13,13,9,10,5,6,20,10,18,3,3,3,1,3,4,2,2,3,2,2
"2344",59114896,"Ismayil Ibrahimli","2/13/1998 (25 years old)","M/AM (C)","Qarabağ","Azeri Premier League","AZE","No","6/15/2020","6/30/2025","$240K - $2.4M","Right","Reasonable","Very Strong","5'10""","156 lbs","120","13",116,129,9,8,11,12,14,9,7,10,2,9,14,6,10,11,7,11,10,11,10,11,7,10,3,11,10,10,14,13,14,14,4,8,13,14,12,7,11,16,11,13,13,11,9,9,6,6,14,10,10,4,3,1,2,1,2,2,1,3,3,1
"2345",24008279,"Filip Ozobić","4/8/1991 (32 years old)","M (R), AM (RLC)","Qarabağ","Azeri Premier League","AZE","Yes","6/27/2021","6/30/2023","$3K - $28K","Right","Reasonable","Very Strong","5'9""","154 lbs","231","60",121,124,14,12,14,13,14,15,8,15,9,4,13,14,4,15,13,12,8,13,8,8,9,14,4,14,7,11,14,13,15,15,9,10,13,14,12,10,10,14,11,14,6,8,7,10,10,6,8,14,11,4,4,2,2,3,2,4,1,3,2,3
"2346",13173467,"Souleymane Diallo","5/22/1990 (33 years old)","GK","ASC SNIM","Mauritanian D1","MTN","No","7/1/2020","6/30/2024","$0","Right","Fairly Strong","Very Strong","6'0""","163 lbs","-","-",90,103,3,2,2,2,2,6,1,2,3,2,10,1,2,5,10,10,13,9,8,14,14,1,12,3,13,9,8,8,12,9,7,9,15,11,3,6,11,13,12,10,13,11,5,17,12,1,12,12,18,6,11,12,12,13,12,14,8,12,11,10
"2347",91151086,"Renat Dadaşov","5/17/1999 (24 years old)","ST (C)","Grasshoppers","Swiss Super League","AZE","Yes","7/9/2022","6/30/2024","$190K - $1.9M","Right","Fairly Strong","Very Strong","6'2""","178 lbs","93","14",118,124,7,8,13,12,13,8,14,12,3,4,12,10,4,14,12,14,16,12,10,11,13,13,6,11,5,13,11,13,12,12,12,12,14,13,13,14,6,7,8,6,13,6,10,12,5,17,12,17,7,1,1,1,2,4,3,3,1,3,2,2
"2348",71101698,"Rüstəm Əhmədzadə","12/25/2000 (22 years old)","ST (C)","Qarabağ","Azeri Premier League","AZE","No","12/15/2021","6/30/2026","$190K - $1.9M","Right","Weak","Very Strong","6'0""","174 lbs","76","5",92,124,5,5,12,11,12,6,9,6,7,5,9,6,7,12,13,9,10,6,6,9,12,9,6,10,8,12,9,15,16,14,9,12,14,14,10,10,5,14,13,15,8,12,14,4,7,2,13,11,10,2,1,3,2,3,1,2,2,1,3,3
"2349",59027795,"Qara Qarayev","10/12/1992 (30 years old)","DM","Qarabağ","Azeri Premier League","AZE","No","1/8/2021","6/30/2023","$4K - $40K","Left","Very Strong","Strong","5'7""","143 lbs","307","5",119,123,10,7,7,8,7,10,10,10,1,10,11,8,8,8,12,15,20,12,11,18,13,6,14,6,9,20,9,14,15,15,11,3,13,15,15,4,9,10,10,11,12,10,5,10,7,7,20,11,13,1,3,3,3,2,1,2,3,3,2,1
"2350",58100120,"Ramil Şeydayev","3/15/1996 (27 years old)","AM (L), ST (C)","Qarabağ","Azeri Premier League","AZE","No","7/1/2021","6/30/2025","$0","Right","Reasonable","Very Strong","6'2""","178 lbs","198","78",112,121,6,5,12,13,11,7,12,8,7,6,12,13,9,12,11,13,11,11,12,11,16,4,7,14,7,11,10,15,12,11,14,13,15,14,12,12,7,12,10,16,12,10,7,5,11,2,10,16,15,2,1,1,1,2,3,1,3,1,1,1
"2351",71096232,"Anton Krivotsyuk","8/20/1998 (24 years old)","D (LC), WB (L)","Daejeon","Hana 1Q K LEAGUE 1","AZE","No","2/20/2023","12/31/2025","$180K - $1.8M","Left Only","Very Strong","Weak","6'1""","169 lbs","116","12",110,120,4,8,8,8,10,8,12,9,11,13,10,11,13,8,12,12,9,12,11,12,10,9,12,10,13,12,10,12,10,12,10,12,10,12,11,13,11,10,12,12,13,12,7,11,13,4,9,9,12,2,2,1,3,1,2,2,2,2,1,1
"2352",71111930,"Emil Mustafayev","9/24/2001 (21 years old)","M (C), AM (RC)","Oleksandriia","Ukrainian Premier League","AZE","No","7/1/2018","6/30/2026","$0 - $70K","Left","Very Strong","Reasonable","5'9""","152 lbs","24","2",100,120,12,12,11,9,12,12,5,9,5,6,13,6,8,13,14,12,7,12,7,11,14,13,6,9,8,13,13,16,12,12,10,6,15,11,13,10,12,18,12,16,11,11,6,7,4,2,13,13,19,4,2,1,2,3,1,3,1,3,3,1
"2353",91002782,"Dimitrij Nazarov","4/4/1990 (33 years old)","AM (C), ST (C)","Erzgebirge Aue","3. Liga","AZE","Yes","6/14/2021","6/30/2024","$0","Left","Very Strong","Reasonable","6'0""","160 lbs","379","77",106,120,12,12,13,11,11,12,6,12,4,7,12,19,7,12,16,10,10,12,12,11,12,14,12,12,7,11,12,10,13,13,8,10,10,12,13,8,13,8,10,13,11,7,13,12,7,10,13,12,16,3,1,1,3,1,2,2,2,1,2,3
"2354",58045556,"Emin Mahmudov","4/27/1992 (31 years old)","M/AM (C)","Neftçi","Azeri Premier League","AZE","No","6/1/2020","6/30/2023","$0 - $95K","Right","Reasonable","Very Strong","5'9""","158 lbs","243","40",113,120,12,9,12,8,12,14,9,10,8,13,14,9,13,12,10,13,10,13,11,11,8,11,5,12,11,15,13,15,13,13,11,9,9,13,13,9,11,15,13,9,12,12,13,11,6,5,13,9,13,3,2,3,2,1,1,3,3,1,1,1
"2355",67179025,"Eddy Silvestre","8/2/1992 (30 years old)","M/AM (C)","Neftçi","Azeri Premier League","AZE","Yes","7/1/2021","6/30/2024","$450K - $1.3M","Right","Weak","Very Strong","6'3""","176 lbs","252","13",108,120,9,14,13,11,12,7,13,9,6,10,14,8,11,12,10,12,14,10,10,10,12,10,11,13,13,14,11,10,11,12,9,13,17,13,15,15,9,16,5,8,6,6,9,9,10,16,12,14,19,3,1,1,1,1,2,1,1,3,2,2
"2356",59007385,"Elvin Məmmədov","7/18/1988 (34 years old)","AM (LC), ST (C)","Şamaxı","Azeri First League","AZE","No","7/1/2022","6/30/2023","$1.5K - $4K","Left","Very Strong","Reasonable","5'9""","143 lbs","375","25",88,120,9,7,6,14,9,11,12,11,9,7,11,12,6,7,5,6,11,12,13,12,9,5,14,16,9,19,8,13,7,9,8,9,9,9,7,11,7,8,8,13,10,8,10,9,5,10,10,15,10,2,1,1,2,1,1,3,3,3,1,3
"2357",2000028476,"Oumar M'Bareck","3/15/2002 (21 years old)","M (C), AM (LC)","FC Nouadhibou","Mauritanian D1","MTN","No","1/26/2023","6/30/2026","$0","Left","Very Strong","Reasonable","5'5""","127 lbs","-","-",80,103,6,8,13,10,13,5,6,6,5,6,10,4,8,13,13,8,8,8,6,10,13,13,4,6,7,7,9,8,13,13,5,2,12,13,8,1,17,14,12,8,13,9,8,7,6,5,11,11,10,3,3,1,1,1,3,2,1,1,2,2
"2358",59043571,"Emil Balayev","4/17/1994 (29 years old)","GK","Sabail","Azeri Premier League","AZE","No","7/1/2022","6/30/2023","$0","Right","Fairly Strong","Very Strong","6'2""","171 lbs","143","-",117,119,3,1,1,3,1,6,1,3,3,1,13,2,2,4,10,10,14,10,7,14,15,2,10,2,12,10,8,9,12,11,10,14,15,13,4,7,12,12,11,10,11,11,12,15,9,5,14,8,20,11,7,14,6,12,10,14,5,14,12,14
"2359",59142437,"Turan Vəlizadə","1/1/2001 (22 years old)","M (C)","Neftçi","Azeri Premier League","AZE","No","1/3/2019","6/30/2024","$500K - $1.5M","Right","Fairly Strong","Very Strong","5'10""","154 lbs","79","2",88,119,7,7,4,6,13,4,5,11,3,9,14,5,6,12,13,9,8,13,8,7,18,8,10,10,8,7,14,11,14,14,8,8,11,12,6,6,11,20,12,13,13,12,7,8,6,4,17,10,13,3,3,3,2,3,1,1,1,3,2,3
"2360",58033864,"Bədavi Hüseynov","7/11/1991 (31 years old)","D (C)","Qarabağ","Azeri Premier League","AZE","No","5/25/2021","6/30/2023","$0 - $55K","Right","Reasonable","Very Strong","6'1""","158 lbs","286","5",114,117,6,7,4,7,6,3,15,5,7,15,8,6,15,9,13,15,11,11,11,15,8,5,12,10,11,8,7,5,15,11,11,12,9,12,9,11,16,15,11,11,11,10,5,2,11,1,12,9,12,2,3,1,1,2,4,3,1,1,1,2
"2361",59127531,"Bəhlul Mustafazadə","2/27/1997 (26 years old)","D (C)","Qarabağ","Azeri Premier League","AZE","No","7/1/2021","6/30/2025","$26K - $250K","Right","Weak","Very Strong","6'3""","187 lbs","119","6",100,117,2,5,2,7,5,1,13,6,5,13,10,5,11,5,15,11,10,9,11,14,8,5,13,6,10,8,7,10,9,11,9,14,12,13,6,12,15,14,11,12,11,12,6,15,6,3,13,9,18,1,3,3,1,2,3,1,3,3,2,2
"2362",59043615,"Coşqun Diniyev","9/13/1995 (27 years old)","DM, M (C)","Zira","Azeri Premier League","AZE","No","9/1/2021","6/30/2025","$20K - $210K","Right","Reasonable","Very Strong","5'7""","132 lbs","221","10",91,117,8,8,6,7,14,8,8,9,6,10,11,5,12,13,8,11,9,10,10,7,5,5,9,9,12,10,13,7,14,14,10,7,13,14,8,4,13,15,9,14,11,9,8,1,6,3,15,10,14,1,2,2,1,1,4,1,3,2,2,3
"2363",59136839,"Elçin Qasımov","9/4/2002 (20 years old)","M (R)","Şamaxı","Azeri First League","AZE","No","6/12/2023","6/30/2025","$55K - $550K","Left","Very Strong","Reasonable","6'1""","171 lbs","108","20",88,116,9,13,12,4,13,8,7,9,8,7,8,7,7,15,8,9,8,8,9,11,7,10,13,9,8,8,6,13,9,12,9,12,7,11,9,7,13,15,9,12,11,12,5,7,8,6,9,11,14,3,2,3,1,2,3,2,3,3,1,3
"2364",59010123,"Maqsim Medvedev","9/29/1989 (33 years old)","D (R)","Qarabağ","Azeri Premier League","AZE","No","5/25/2021","6/30/2023","$1K - $10K","Right","Fairly Strong","Very Strong","5'10""","152 lbs","359","12",116,116,10,11,4,7,10,7,13,5,10,13,14,4,15,8,9,15,11,10,15,14,17,10,5,11,14,14,10,16,10,9,8,13,13,15,14,10,6,7,11,16,9,12,5,1,4,3,20,18,13,2,3,3,3,3,1,1,3,1,3,2
"2365",59115344,"Hacıağa Hacılı","1/30/1998 (25 years old)","DM","Qarabağ","Azeri Premier League","AZE","No","7/1/2019","6/30/2023","$0","Right","Reasonable","Very Strong","5'10""","152 lbs","98","1",93,116,8,8,4,7,11,6,8,9,8,9,9,3,13,12,11,10,9,10,8,14,11,5,3,9,12,9,8,12,14,14,9,5,15,14,7,7,15,20,8,10,11,10,10,14,5,3,20,11,14,3,1,2,1,3,4,3,2,4,3,1
"2366",59092086,"Abbas Hüseynov","6/13/1995 (27 years old)","D (RL)","Qarabağ","Azeri Premier League","AZE","No","6/9/2021","6/30/2023","$0 - $85K","Right","Fairly Strong","Very Strong","5'10""","169 lbs","130","6",113,116,8,13,7,4,12,6,10,7,6,10,10,5,13,10,10,9,11,10,14,12,19,10,10,8,11,10,9,10,14,14,10,9,12,14,10,14,12,19,12,13,11,14,5,3,8,7,12,11,20,2,3,3,3,2,1,1,1,2,1,1
"2367",59074070,"Mahir Emreli","7/1/1997 (25 years old)","AM (RL), ST (C)","Dinamo","Croatian First League","AZE","No","2/3/2023","6/30/2026","$160K - $1.6M","Left","Very Strong","Reasonable","6'2""","171 lbs","188","68",114,115,6,9,11,13,13,5,11,13,5,6,8,5,10,13,8,11,10,10,12,8,12,15,6,15,7,6,10,8,13,14,14,14,11,13,11,13,9,13,12,9,6,5,9,7,4,13,6,12,18,3,2,2,2,1,1,2,1,3,3,2
"2368",13227120,"Babacar Diop","9/17/1995 (27 years old)","GK","FC Nouadhibou","Mauritanian D1","MTN","No","7/1/2021","6/30/2024","$0","Right Only","Weak","Very Strong","6'1""","178 lbs","-","-",92,103,5,2,2,1,6,6,1,2,1,1,9,2,3,5,5,10,13,9,7,11,8,3,6,1,11,9,8,7,11,11,7,12,7,13,3,8,10,12,11,9,9,13,7,15,11,6,12,11,20,10,5,14,5,9,11,11,6,12,14,14
"2369",71080268,"Anatoliy Nuriyev","5/20/1996 (27 years old)","M/AM (C)","Sabah (AZE)","Azeri Premier League","AZE","No","3/1/2022","6/30/2025","$140K - $1.4M","Right Only","Weak","Very Strong","6'0""","167 lbs","180","76",112,115,12,10,11,13,12,12,8,9,7,6,14,13,7,13,14,13,14,12,12,14,14,11,13,12,9,11,13,13,12,13,14,11,13,12,13,12,15,15,11,10,13,12,14,10,7,2,13,11,8,2,4,2,1,1,3,2,1,3,1,2
"2370",59007025,"Ruslan Abışov","10/10/1987 (35 years old)","D (C), DM","Zira","Azeri Premier League","AZE","No","6/11/2022","6/30/2023","$0","Right","Reasonable","Very Strong","6'2""","165 lbs","248","24",73,115,3,6,6,8,9,6,13,2,4,11,9,4,13,8,3,11,8,6,9,10,7,5,3,8,10,14,11,12,10,11,9,12,13,8,8,8,10,16,12,12,8,8,5,12,3,8,12,19,12,2,3,2,2,2,1,1,2,2,2,2
"2371",89061394,"Serhat Taşdemir","7/21/2000 (22 years old)","AM (RLC)","Kocaelispor","Turkish 1. League","AZE","No","1/19/2023","6/30/2024","$0 - $5K","Right","Reasonable","Very Strong","5'11""","160 lbs","100","12",70,115,7,9,12,9,12,10,6,8,5,5,10,7,4,12,6,10,8,6,5,7,6,10,6,11,4,10,12,11,11,9,12,8,14,12,9,8,6,20,10,13,12,12,7,9,7,8,6,10,16,2,1,1,2,3,1,1,3,1,3,3
"2372",59115334,"Amin Seydiyev","11/15/1998 (24 years old)","D (R)","Sabah (AZE)","Azeri Premier League","AZE","No","6/30/2020","6/30/2023","$30K - $325K","Right","Fairly Strong","Very Strong","6'0""","160 lbs","115","3",90,114,7,8,3,2,7,2,9,6,6,10,6,1,13,8,14,11,10,8,7,13,8,6,10,6,13,8,4,8,13,13,8,9,15,13,13,6,16,14,11,8,12,10,11,9,12,2,13,9,19,2,3,2,2,1,2,3,3,1,1,2
"2373",59058823,"Namik Ələskərov","2/3/1995 (28 years old)","AM (RLC)","Sabah (AZE)","Azeri Premier League","AZE","No","7/1/2022","6/30/2025","$60K - $600K","Right","Reasonable","Very Strong","5'8""","160 lbs","221","43",105,114,8,12,11,11,14,8,5,7,2,6,11,4,8,10,14,9,2,7,8,14,13,9,7,11,8,7,11,10,14,14,9,7,13,14,13,6,16,12,12,12,10,10,12,15,15,6,12,13,11,2,3,2,2,1,3,2,3,1,2,3
"2374",59135169,"Elvin Cəfərquliyev","10/26/2000 (22 years old)","D/M (L)","Qarabağ","Azeri Premier League","AZE","No","5/26/2021","6/30/2024","$550K - $1.6M","Right","Reasonable","Very Strong","5'11""","160 lbs","101","13",97,114,11,13,11,4,11,9,5,5,1,9,11,1,12,13,11,8,10,9,10,15,2,5,8,9,10,10,9,10,15,13,5,11,10,12,10,7,16,10,12,9,13,12,8,10,9,1,13,11,10,3,1,3,3,3,2,2,2,2,3,2
"2375",2000308575,"Qabil Əlizadə","7/5/2001 (21 years old)","D (C)","Sumqayit","Azeri Premier League","AZE","No","6/12/2023","6/30/2026","$80K - $800K","Right","Reasonable","Very Strong","6'3""","174 lbs","-","-",109,114,5,6,8,7,10,3,15,6,3,15,10,5,15,6,8,14,11,7,11,15,11,5,11,9,8,9,5,10,12,12,10,15,18,12,11,8,15,14,10,12,11,13,14,12,6,4,11,12,11,1,2,1,4,1,2,3,3,1,3,2
"2376",59127591,"Cabir Əmirli","1/6/1997 (26 years old)","D (R)","Sabail","Azeri Premier League","AZE","No","6/5/2022","6/30/2024","$40K - $400K","Right","Fairly Strong","Very Strong","5'10""","158 lbs","113","2",102,114,6,10,6,5,11,1,9,8,8,10,9,1,14,8,6,9,8,7,9,12,5,9,11,6,9,9,10,10,14,14,9,5,13,14,14,8,12,10,13,11,11,12,8,7,9,4,11,10,12,4,2,3,1,1,1,3,1,1,4,2
"2377",70132270,"Ege Bilsel","1/4/2004 (19 years old)","AM (L), ST (C)","Antalyaspor","Turkish Super League","AZE","No","6/1/2022","6/30/2027","$60K - $600K","Right","Weak","Very Strong","5'10""","158 lbs","-","-",75,114,9,11,12,9,10,7,8,10,7,5,9,1,6,11,12,14,7,7,10,6,3,11,12,12,5,7,7,11,13,11,7,8,12,12,9,9,8,15,12,10,12,10,14,1,12,4,10,12,10,1,2,1,3,4,1,3,2,2,2,3
"2378",59074418,"Rahil Məmmədov","11/24/1995 (27 years old)","D (C)","Qarabağ","Azeri Premier League","AZE","No","6/9/2021","6/30/2023","$0 - $40K","Right","Reasonable","Very Strong","6'3""","174 lbs","109","1",103,113,6,3,3,4,9,7,12,8,4,14,9,5,11,8,14,14,10,9,10,14,5,5,11,8,11,8,5,9,14,11,9,11,13,13,12,7,13,17,11,10,10,10,13,4,6,2,13,11,7,4,2,2,1,1,3,2,3,1,3,2
"2379",12022300,"Elmamy Traoré","12/31/1987 (35 years old)","AM (C), ST (C)","ASAC Concorde","Mauritanian D1","MTN","No","1/1/2022","6/30/2024","$0","Right","Reasonable","Very Strong","5'10""","154 lbs","6","-",82,102,5,8,8,15,8,8,15,8,6,8,11,3,3,11,9,9,7,7,8,15,5,9,12,11,9,8,8,10,10,10,7,8,12,9,9,11,10,14,12,11,9,11,6,7,9,5,11,9,13,3,3,3,3,3,1,4,1,3,1,1
"2380",59115336,"Yusif Nəbiyev","9/3/1997 (25 years old)","D (LC)","Kapaz","Azeri Premier League","AZE","No","7/1/2022","6/30/2023","$0","Left","Very Strong","Fairly Strong","5'10""","156 lbs","122","8",88,113,6,12,4,7,8,1,10,5,7,12,5,1,12,8,15,12,9,6,12,7,11,5,10,5,11,8,7,9,14,14,8,7,9,14,14,5,16,13,10,12,9,10,10,11,5,5,10,9,17,4,3,1,1,1,1,3,3,1,1,3
"2381",59135293,"Faiq Hacıyev","5/22/1999 (24 years old)","D (RC), M (R)","Turan","Azeri Premier League","AZE","No","6/12/2023","6/30/2025","$110K - $325K","Right","Reasonable","Very Strong","6'4""","178 lbs","70","1",76,112,3,7,7,6,9,6,9,5,5,11,9,4,13,6,15,9,9,9,9,11,12,5,10,6,9,8,6,9,13,11,8,11,11,12,14,7,13,11,12,11,11,12,12,6,5,7,9,10,18,2,3,3,3,1,3,3,2,4,3,1
"2382",19074791,"Richard","3/20/1989 (34 years old)","M/AM (C)","Qarabağ","Azeri Premier League","AZE","No","6/14/2022","6/30/2023","$500 - $5K","Left Only","Very Strong","Weak","5'10""","149 lbs","325","54",111,112,12,13,12,13,13,11,7,14,6,8,11,12,11,12,12,13,14,12,11,11,13,13,10,14,10,10,11,13,12,13,11,10,12,13,11,12,12,11,11,13,13,12,10,12,8,8,11,14,13,1,3,1,1,1,2,2,2,1,3,1
"2383",59135163,"Rafael Məhərrəmli","10/1/1999 (23 years old)","D/M (R)","Sabail","Azeri Premier League","AZE","No","6/24/2022","6/30/2023","$20K - $190K","Left","Very Strong","Reasonable","5'7""","134 lbs","94","2",88,111,9,14,10,9,12,7,7,5,8,10,9,5,12,10,14,11,8,10,10,10,13,5,7,7,10,7,9,10,15,13,5,8,10,15,9,3,10,12,13,11,12,12,5,9,15,8,10,7,17,3,3,1,2,2,3,2,1,2,4,2
"2384",59115191,"Xəyal Nəcəfov","12/19/1997 (25 years old)","DM, M/AM (C)","Neftçi","Azeri Premier League","AZE","No","7/1/2021","6/30/2024","$14K - $130K","Right","Reasonable","Very Strong","5'6""","132 lbs","163","3",88,111,6,7,8,9,11,6,6,7,2,8,8,3,12,13,6,8,8,8,8,13,16,13,3,8,8,8,8,12,13,13,7,1,13,13,13,3,13,12,11,12,14,11,8,9,14,3,14,11,11,3,1,3,1,3,1,3,1,1,3,2
"2385",37061601,"Ozan Kökcü","8/18/1998 (24 years old)","AM (RLC), ST (C)","FC Eindhoven","Keuken Kampioen Divisie","AZE","Yes","8/4/2022","6/30/2025","$850K - $1.8M","Right","Fairly Strong","Very Strong","5'9""","165 lbs","137","12",107,111,12,12,13,8,12,15,6,12,5,3,12,13,5,12,5,11,11,11,11,11,9,12,7,12,5,11,12,12,11,13,12,5,14,11,11,9,14,19,11,12,11,12,6,5,5,1,12,9,10,2,2,3,3,1,3,3,3,2,2,4
"2386",91133859,"Umut Sönmez","6/20/1993 (29 years old)","AM (RLC)","Fethiyespor","Turkish 2. League Red Group","AZE","Yes","1/12/2023","6/30/2024","$1.5K - $18K","Right","Fairly Strong","Very Strong","6'0""","156 lbs","236","36",70,110,8,10,12,8,11,7,7,6,3,5,11,8,5,12,10,8,6,11,6,7,10,14,6,10,5,8,9,9,9,10,10,10,13,10,10,10,12,13,10,12,10,12,7,9,8,3,8,8,12,3,2,2,3,2,2,3,2,2,2,3
"2387",59074413,"Fəhmin Muradbəyli","3/16/1996 (27 years old)","AM (R)","İravan","Azeri First League","AZE","No","6/12/2023","6/30/2024","$450K - $1.4M","Right","Fairly Strong","Very Strong","5'9""","147 lbs","136","12",104,110,7,10,14,12,9,8,9,10,6,8,14,6,6,13,11,8,5,10,4,14,9,12,12,13,8,9,9,10,14,14,9,7,17,10,14,6,16,12,12,11,10,11,8,13,7,6,10,12,10,1,3,1,3,3,3,3,2,3,2,1
"2388",23331943,"Höccət Haqverdi","2/3/1993 (30 years old)","D (C)","Neftçi","Azeri Premier League","AZE","No","1/9/2023","6/30/2024","$30K - $300K","Right","Fairly Strong","Very Strong","6'0""","167 lbs","183","5",108,110,7,5,7,3,10,3,16,8,5,12,12,7,16,11,11,13,11,14,11,13,11,5,10,11,10,11,10,12,13,12,12,14,11,11,13,7,13,12,12,10,11,11,10,10,11,2,12,11,16,1,2,1,3,2,1,3,3,3,1,2
"2389",92097076,"Barış Ekincier","3/24/1999 (24 years old)","AM (RLC)","SV Waldhof","3. Liga","AZE","Yes","8/31/2021","6/30/2024","$26K - $250K","Left","Very Strong","Strong","5'11""","185 lbs","45","4",95,110,11,11,11,12,11,10,7,10,5,6,11,8,7,12,11,11,11,11,9,8,14,11,9,11,5,11,10,11,10,11,9,10,10,12,11,11,10,15,13,13,12,12,7,11,8,6,11,13,8,1,3,3,3,1,1,1,3,3,3,1
"2390",2000279634,"Mohamed Ali Diadié","10/22/2004 (18 years old)","DM, M (C)","Reims","Ligue 1 Uber Eats","MTN","No","7/1/2022","6/30/2024","$14K - $150K","Right","Reasonable","Very Strong","5'9""","141 lbs","-","-",50,102,5,3,2,6,9,5,5,4,2,6,13,1,10,7,8,7,7,2,7,13,2,5,1,7,6,7,8,9,10,13,4,3,6,12,6,5,11,10,11,12,13,11,9,4,5,4,8,10,17,1,3,1,1,3,1,3,1,1,1,3
"2391",59027673,"Səlahət Ağayev","1/4/1991 (32 years old)","GK","Qabala","Azeri Premier League","AZE","No","6/4/2022","6/30/2023","$0","Right","Fairly Strong","Very Strong","6'3""","174 lbs","241","-",110,110,4,2,3,3,6,8,3,2,1,3,14,3,1,11,12,14,14,12,10,16,10,1,15,2,12,15,12,20,15,18,10,15,13,14,15,15,15,18,13,11,11,11,6,8,7,4,12,13,10,10,7,6,6,10,11,7,10,12,5,7
"2392",59115227,"Vüsal İsgəndərli","11/3/1995 (27 years old)","AM (RL)","Sumqayit","Azeri Premier League","AZE","No","6/28/2022","6/30/2025","$50K - $500K","Right Only","Weak","Very Strong","5'11""","163 lbs","177","23",100,110,10,10,12,11,10,7,9,10,6,5,9,4,6,11,12,9,11,9,9,8,12,10,7,12,8,11,9,12,16,13,12,9,10,15,12,10,12,13,11,12,13,11,11,9,10,4,11,12,15,2,2,3,1,3,1,2,2,2,3,3
"2393",58095899,"Azər Əliyev","5/12/1994 (29 years old)","D/WB (L), M (RL), AM (R)","Neftçi","Azeri Premier League","AZE","No","1/27/2022","6/30/2025","$50K - $475K","Left Only","Very Strong","Weak","5'6""","147 lbs","241","20",106,110,10,10,12,10,11,10,6,13,5,7,11,10,9,13,6,10,11,11,9,10,13,9,8,13,7,12,12,11,14,13,11,5,7,14,13,6,16,14,16,13,7,15,13,5,5,2,11,10,15,2,2,3,1,1,2,3,3,2,3,1
"2394",59115229,"İlkin Muradov","3/5/1996 (27 years old)","DM, M (C)","Sabail","Azeri Premier League","AZE","No","6/15/2020","6/30/2025","$500K - $1.5M","Left","Very Strong","Reasonable","5'9""","149 lbs","133","3",102,110,8,8,5,9,14,8,7,6,7,10,8,6,14,14,14,12,9,10,6,14,9,5,3,7,12,9,10,13,14,14,9,5,11,14,14,7,12,15,13,9,11,9,12,13,12,5,11,12,9,2,2,1,1,2,2,3,1,1,1,2
"2395",59115078,"Roman Hüseynov","12/26/1997 (25 years old)","AM (LC)","Mingäçevir","Azeri First League","AZE","No","6/1/2022","6/30/2025","$75K - $750K","Right","Fairly Strong","Very Strong","5'8""","147 lbs","56","2",85,110,6,7,9,13,13,5,4,8,4,6,13,2,4,13,9,8,5,7,3,12,10,13,12,12,7,7,7,12,13,13,7,5,6,13,12,4,12,18,11,13,8,11,11,6,9,1,13,10,14,2,2,4,2,3,1,3,1,2,2,1
"2396",25062909,"Fərid Nəbiyev","7/22/1999 (23 years old)","AM (RL)","Kapaz","Azeri Premier League","AZE","No","7/23/2022","6/30/2023","$0","Right","Reasonable","Very Strong","5'9""","147 lbs","109","20",92,110,9,13,9,11,15,9,3,13,9,8,9,5,10,13,12,12,9,10,5,11,7,11,9,15,9,10,8,11,12,13,10,9,8,12,8,8,15,12,12,10,13,14,13,5,15,3,14,12,8,4,3,1,1,1,1,2,4,2,1,1
"2397",47019867,"Emilijus Zubas","7/10/1990 (32 years old)","GK","Hapoel Tel-Aviv","Israeli Premier League","LTU","Yes","5/31/2023","5/31/2024","$50K - $500K","Right","Reasonable","Very Strong","6'4""","198 lbs","304","1",108,130,3,1,3,3,5,6,2,2,2,1,8,3,2,4,8,12,12,11,12,11,7,7,8,2,12,10,10,12,9,12,13,16,13,9,11,14,12,15,14,15,17,8,5,12,7,12,12,8,12,11,5,13,13,12,10,11,6,11,13,13
"2398",47102498,"Gvidas Gineitis","4/15/2004 (19 years old)","DM, M (C)","Torino","Italian Serie A","LTU","Yes","3/2/2023","6/30/2026","$400K - $3.9M","Left Only","Very Strong","Weak","6'2""","134 lbs","31","4",100,128,6,7,9,10,9,6,11,10,10,8,12,7,10,11,13,13,12,13,10,12,8,10,10,14,12,12,13,11,12,12,13,13,10,13,12,12,12,13,12,11,11,10,6,14,7,6,12,9,15,2,3,1,3,4,3,1,3,3,3,4
"2399",49048019,"Edgaras Utkus","6/22/2000 (22 years old)","D (C), DM, M (C)","Cercle Brugge","Jupiler Pro League","LTU","Yes","4/7/2023","6/30/2026","$170K - $1.7M","Right","Reasonable","Very Strong","6'3""","169 lbs","27","3",112,128,11,11,12,9,13,12,12,12,8,12,13,11,11,13,11,12,10,11,12,11,13,14,13,13,11,13,12,14,10,12,12,13,13,11,13,13,15,13,14,11,9,13,8,9,13,7,12,14,19,2,3,1,4,3,1,2,2,1,2,2
"2400",150146,"Saulius Mikoliunas","5/2/1984 (39 years old)","D/WB (R)","Žalgiris","Lithuanian A League","LTU","Yes","1/20/2023","12/31/2023","$0 - $35K","Right","Reasonable","Very Strong","5'10""","171 lbs","429","33",100,120,9,13,12,8,12,8,7,12,5,10,13,7,10,13,12,15,9,14,14,15,14,12,13,13,11,9,12,9,10,10,8,5,18,9,9,9,18,7,8,7,15,12,2,10,6,12,20,16,19,3,1,1,3,2,2,3,3,2,3,3
"2401",2000029949,"Abderrahmane Chighaly","4/21/2001 (22 years old)","AM (R), ST (C)","FC Nouadhibou","Mauritanian D1","MTN","No","6/30/2022","6/30/2025","$0","Right","Reasonable","Very Strong","5'9""","138 lbs","-","-",65,102,6,10,9,12,11,5,11,6,5,5,8,5,1,13,14,6,7,4,4,11,5,13,13,9,6,5,3,7,13,13,5,8,12,13,8,6,11,10,14,11,12,9,9,2,5,5,10,12,7,3,1,3,1,1,3,3,1,2,3,2
"2402",47006697,"Vytautas Černiauskas","3/12/1989 (34 years old)","GK","Panevėžys","Lithuanian A League","LTU","Yes","1/1/2023","12/31/2023","$70K - $210K","Left","Very Strong","Reasonable","6'3""","165 lbs","312","-",100,120,5,3,1,1,6,6,10,1,3,2,5,2,2,3,9,11,14,12,11,11,14,3,12,5,12,13,8,11,8,10,13,16,16,7,9,11,12,14,14,17,14,10,3,13,6,2,13,13,15,12,13,13,14,13,8,12,7,13,12,12
"2403",43218092,"Linas Megelaitis","9/9/1998 (24 years old)","DM, M (C)","Viterbese","Italian Promozione Lazio Grp.B","LTU","Yes","7/29/2021","-","$0","Right","Reasonable","Very Strong","5'10""","158 lbs","131","2",93,119,7,9,9,7,10,9,9,9,7,11,11,9,11,11,11,11,12,12,10,11,12,10,9,11,11,11,12,11,12,11,12,9,11,11,12,11,11,8,13,13,12,12,9,11,9,11,9,12,15,1,3,4,3,2,1,1,2,3,2,3
"2404",2000285908,"Jokūbaz Mažionis","6/23/2006 (16 years old)","D (C)","Ipswich","Sky Bet Championship","LTU","Yes","6/12/2023","6/30/2025","$80K - $800K","Right","Reasonable","Very Strong","6'6""","189 lbs","-","-",60,118,6,7,6,2,9,3,10,3,8,11,10,9,15,9,7,8,9,9,8,6,11,5,5,9,7,9,8,10,11,8,10,16,8,6,7,9,8,19,9,11,10,12,8,1,11,2,9,11,19,2,1,2,1,1,2,2,2,2,1,3
"2405",17012660,"Fedor Černych","5/21/1991 (32 years old)","AM (RL), ST (C)","AEL","Cypriot First Division","LTU","Yes","1/8/2023","6/30/2024","$35K - $325K","Right Only","Weak","Very Strong","6'0""","165 lbs","354","59",100,117,9,10,12,12,11,7,12,10,7,7,9,14,7,13,11,12,12,10,12,10,11,8,8,13,5,15,12,15,11,13,12,11,14,11,11,11,15,16,15,12,7,10,6,10,12,9,8,11,14,3,3,1,2,2,2,3,1,1,1,2
"2406",47006522,"Artūras Žulpa","6/10/1990 (33 years old)","DM, M (C)","Aqtóbe","Kazakhstan Premier League","LTU","Yes","4/16/2021","8/1/2023","$0","Right Only","Very Weak","Very Strong","6'2""","176 lbs","352","27",78,116,5,7,7,6,9,7,14,13,7,9,12,10,11,9,13,11,12,13,12,11,12,8,11,10,14,11,9,10,8,9,14,16,11,10,12,12,9,16,8,9,10,7,5,1,7,7,8,11,14,1,2,1,1,1,1,3,1,2,1,2
"2407",47055920,"Marius Adamonis","5/13/1997 (26 years old)","GK","Lazio","Italian Serie A","LTU","Yes","6/15/2020","6/30/2025","$16K - $170K","Right","Reasonable","Very Strong","6'3""","180 lbs","51","-",108,115,3,2,3,2,8,6,9,2,3,3,10,2,3,10,4,8,11,8,11,12,13,1,10,6,12,10,12,10,11,12,10,14,14,10,14,12,10,15,12,14,11,12,8,9,9,3,12,13,14,13,11,14,12,10,13,12,6,11,11,12
"2408",47071041,"Benas Satkus","4/1/2001 (22 years old)","D (C)","Banga","Lithuanian A League","LTU","Yes","7/1/2022","6/30/2025","$50K - $150K","Right","Reasonable","Very Strong","6'3""","180 lbs","11","-",90,115,2,6,7,6,9,3,12,6,8,12,11,6,12,9,11,9,12,9,10,9,13,6,8,7,12,11,10,11,12,9,12,14,10,13,11,12,7,15,14,13,9,10,10,11,7,7,12,10,12,4,3,1,2,3,2,2,2,3,2,3
"2409",47051997,"Justas Lasickas","10/6/1997 (25 years old)","D/WB (R)","Olimpija","Slovenian First League","LTU","Yes","5/31/2022","6/30/2025","$400K - $1.2M","Right","Reasonable","Very Strong","5'9""","141 lbs","205","16",111,114,11,12,14,9,13,9,8,11,8,11,12,9,13,12,9,10,12,12,9,11,13,15,10,12,11,12,12,13,13,11,12,10,10,14,11,10,10,11,12,15,11,11,5,9,10,7,10,13,12,2,1,2,1,1,3,2,3,2,3,2
"2410",47087508,"Kajus Urbietis","4/8/2001 (22 years old)","GK","Pistoiese","Italian Serie D Grp. D","LTU","Yes","1/1/2023","6/30/2024","$0 - $55K","Right Only","Very Weak","Very Strong","6'0""","169 lbs","129","-",75,114,2,1,2,1,8,5,7,3,3,1,9,3,1,8,9,9,12,9,13,9,11,4,8,3,8,8,7,8,10,10,11,10,15,9,11,9,11,18,10,12,10,11,5,10,5,5,10,11,12,12,9,10,10,13,10,11,5,8,10,10
"2411",91203206,"Natanas Žebrauskas","2/18/2002 (21 years old)","D (RC), DM","Fürth","Bundesliga 2","LTU","Yes","7/1/2021","6/30/2027","$22K - $220K","Right Only","Weak","Very Strong","6'1""","160 lbs","72","-",84,111,7,10,5,4,12,8,10,8,8,12,7,5,15,9,13,7,10,9,10,15,17,5,10,8,13,9,7,10,7,10,9,10,9,9,15,8,12,18,9,9,12,14,10,5,13,2,13,12,16,2,1,2,1,2,1,1,3,1,1,2
"2412",85100086,"Houssen Abderrahmane","2/3/1995 (28 years old)","D (LC), WB (L)","Marignane GCB FC","French National","MTN","Yes","7/1/2022","6/30/2024","$16K - $150K","Left","Very Strong","Weak","6'1""","165 lbs","162","13",87,102,5,9,9,5,8,3,8,9,5,11,7,4,10,8,6,14,10,9,10,10,13,5,7,9,11,10,4,11,11,10,13,11,11,10,11,12,10,13,9,11,13,11,10,9,7,5,11,11,16,2,1,3,2,2,1,2,1,3,3,3
"2413",47035844,"Donatas Kazlauskas","3/31/1994 (29 years old)","AM (L), ST (C)","Žalgiris","Lithuanian A League","LTU","Yes","1/11/2022","12/31/2023","$35K - $350K","Right Only","Weak","Very Strong","5'9""","147 lbs","248","60",100,110,9,12,12,11,11,9,5,12,5,5,12,8,5,13,7,11,11,10,10,10,13,15,8,12,9,9,10,12,14,12,12,9,14,13,9,8,10,17,10,13,13,10,12,4,6,2,12,13,20,3,1,3,1,3,1,2,2,2,1,1
"2414",28116655,"Kipras Kazukolovas","11/20/2000 (22 years old)","D (C)","Žalgiris","Lithuanian A League","LTU","Yes","11/18/2021","12/31/2023","$24K - $230K","Right","Reasonable","Very Strong","6'3""","202 lbs","18","3",85,110,4,2,9,7,13,3,6,1,7,10,10,5,12,10,9,11,10,11,11,11,15,6,10,8,16,9,12,10,10,8,10,16,13,9,11,7,13,13,11,10,11,9,10,15,14,3,12,10,13,3,2,3,2,2,1,2,2,1,1,1
"2415",2000055752,"Artemijus Tutyškinas","8/8/2003 (19 years old)","D (LC)","ŁKS Łódź","Polish Second Division","LTU","Yes","3/1/2023","6/30/2026","$55K - $550K","Left Only","Very Strong","Very Weak","6'2""","180 lbs","18","-",86,110,11,10,10,2,10,8,10,9,10,11,10,7,16,9,11,11,11,13,12,11,11,8,11,11,10,12,10,12,11,11,11,12,15,10,11,10,13,14,12,13,11,9,13,6,6,6,13,11,19,3,3,4,3,3,2,2,1,2,4,2
"2416",47040753,"Modestas Vorobjovas","12/30/1995 (27 years old)","M (C)","Chindia Târgovişte","Romanian Second League","LTU","Yes","6/18/2022","6/30/2024","$500K - $1.5M","Right","Weak","Very Strong","5'10""","165 lbs","276","8",106,110,6,10,7,6,11,6,10,10,6,13,12,10,12,10,12,13,13,11,12,12,13,6,10,11,12,15,10,16,12,12,12,10,12,11,15,13,10,15,14,14,13,10,5,10,10,2,13,13,13,2,3,1,3,1,2,3,3,1,3,3
"2417",47005206,"Linas Klimavičius","4/10/1989 (34 years old)","D (C)","Panevėžys","Lithuanian A League","LTU","Yes","1/7/2022","12/31/2023","$0 - $75K","Right Only","Weak","Very Strong","6'3""","198 lbs","292","16",100,110,5,6,6,7,7,8,13,7,8,12,10,8,12,7,14,12,12,12,12,12,14,8,13,5,12,12,8,12,12,12,12,14,13,10,10,13,10,10,10,10,10,10,5,13,12,10,2,10,10,3,3,1,4,3,1,2,1,3,3,1
"2418",31035463,"Paulius Golubickas","8/19/1999 (23 years old)","M/AM (C)","Žalgiris","Lithuanian A League","LTU","Yes","1/6/2023","12/31/2023","$26K - $275K","Right","Fairly Strong","Very Strong","5'8""","138 lbs","103","19",105,110,10,10,11,12,12,10,7,7,8,6,13,4,6,14,8,13,8,12,10,10,13,13,7,13,7,12,12,13,12,14,11,6,15,10,13,6,15,17,11,13,12,11,13,4,5,8,10,13,17,1,2,3,2,2,2,2,2,3,3,2
"2419",43115046,"Vykintas Slivka","4/29/1995 (28 years old)","DM, M (C)","Lamia","Greek Super League 1","LTU","Yes","7/13/2022","6/30/2024","$130K - $1.3M","Right Only","Weak","Very Strong","6'3""","185 lbs","206","9",105,110,8,10,13,10,13,7,11,10,7,9,14,6,9,13,10,11,9,14,11,12,12,11,9,12,11,15,12,13,11,10,14,13,14,11,12,13,12,15,14,15,10,12,5,12,5,5,11,13,15,3,2,1,3,2,2,3,1,2,3,3
"2420",43300840,"Ovidijus Siaulys","7/19/1999 (23 years old)","GK","Entella","Italian Serie C/B","LTU","Yes","10/13/2022","6/30/2024","$18K - $180K","Right","Reasonable","Very Strong","6'5""","171 lbs","39","-",83,108,3,3,2,3,9,2,8,2,2,2,9,1,2,7,10,9,12,9,11,9,10,6,9,9,10,12,8,9,8,9,9,16,13,7,7,8,10,9,10,10,11,9,10,11,7,7,9,12,10,12,10,11,10,10,10,12,10,11,12,13
"2421",92064543,"Gratas Sirgedas","12/17/1994 (28 years old)","M/AM (C)","Kauno Žalgiris","Lithuanian A League","LTU","Yes","1/7/2023","12/31/2023","$12K - $120K","Left","Very Strong","Reasonable","5'9""","149 lbs","119","21",95,105,10,10,13,8,13,9,6,10,6,8,14,9,8,14,8,11,8,11,11,11,13,14,8,13,7,10,13,11,12,10,10,8,8,10,10,8,7,12,12,13,10,10,12,10,5,8,11,13,11,2,2,3,2,3,1,1,3,3,1,3
"2422",29157184,"Titas Krapikas","1/3/1999 (24 years old)","GK","Ternana","Italian Serie B","LTU","Yes","9/2/2021","6/30/2026","$16K - $150K","Right Only","Weak","Very Strong","6'4""","187 lbs","8","-",96,105,3,1,3,1,7,2,4,3,2,1,7,1,1,9,10,10,11,11,10,8,18,8,10,2,11,10,6,10,8,11,15,19,16,8,12,14,1,14,8,17,12,14,2,10,6,3,14,16,16,12,10,12,10,13,14,12,8,12,13,14
"2423",13173469,"Cheikhna Varajou","2/6/1985 (38 years old)","D (C)","Tevragh Zeïna","Mauritanian D1","MTN","No","7/1/2020","6/30/2024","$0","Right","Reasonable","Very Strong","6'1""","171 lbs","-","-",70,101,3,4,2,1,8,1,13,3,2,14,8,3,14,5,13,8,9,7,10,14,16,5,12,6,8,7,7,8,7,7,7,8,13,7,7,7,16,14,8,10,10,11,10,16,9,3,10,11,7,2,3,3,1,3,3,1,3,2,1,2
"2424",47040784,"Edvinas Gertmonas","6/1/1996 (27 years old)","GK","Žalgiris","Lithuanian A League","LTU","Yes","1/3/2023","12/31/2023","$28K - $275K","Right","Reasonable","Very Strong","6'2""","211 lbs","79","-",100,105,4,1,1,2,7,8,1,3,2,2,10,3,2,8,12,14,9,10,15,11,16,1,8,1,14,10,9,8,11,13,10,10,9,11,9,6,14,14,10,9,10,12,6,12,12,6,12,10,11,8,11,15,13,11,15,9,5,12,9,13
"2425",47006704,"Valdemaras Borovskis","5/2/1984 (39 years old)","D/WB (R)","Riteriai","Lithuanian A League","LTU","Yes","6/14/2021","12/31/2023","$0 - $18K","Right","Reasonable","Very Strong","6'0""","163 lbs","401","15",90,105,9,10,5,7,11,7,11,8,10,12,12,7,13,11,8,13,11,11,11,16,4,6,13,8,10,11,10,11,8,8,8,13,10,8,8,8,14,12,13,11,12,11,13,2,10,7,12,12,20,3,2,3,1,3,3,2,2,3,2,1
"2426",27100826,"Domantas Šimkus","2/10/1996 (27 years old)","DM, M (C)","Mura","Slovenian First League","LTU","Yes","8/22/2022","6/30/2025","$70K - $700K","Right","Weak","Very Strong","5'9""","163 lbs","170","7",100,105,12,8,8,8,12,10,8,8,8,8,12,12,12,12,10,11,10,10,11,11,13,12,10,10,10,10,12,15,12,13,10,10,10,10,14,12,10,13,11,13,11,10,5,10,8,7,2,13,7,3,3,2,2,1,1,2,1,2,3,1
"2427",47019930,"Tomas Švedkauskas","6/22/1994 (28 years old)","GK","Hegelmann","Lithuanian A League","LTU","Yes","1/12/2023","12/31/2023","$30K - $300K","Right","Reasonable","Very Strong","6'1""","176 lbs","179","-",95,105,4,3,2,3,9,6,5,3,3,3,9,1,1,9,9,20,10,10,10,10,14,12,11,8,12,11,9,10,9,12,7,13,10,10,7,10,9,19,13,14,12,10,5,8,8,8,11,14,15,9,10,12,12,10,10,10,10,12,12,12
"2428",47006703,"Armantas Vitkauskas","3/23/1989 (34 years old)","GK","Riteriai","Lithuanian A League","LTU","Yes","12/8/2022","12/31/2023","$2.5K - $24K","Right Only","Weak","Very Strong","6'4""","180 lbs","265","-",85,105,3,1,2,3,1,5,1,2,2,3,10,3,2,4,5,10,15,8,11,7,10,3,10,1,9,8,2,7,7,14,8,15,10,9,6,9,10,18,10,11,10,13,5,10,7,3,20,9,14,9,6,11,9,8,11,14,5,9,8,14
"2429",47000485,"Linas Pilibaitis","4/5/1985 (38 years old)","DM, M/AM (C)","Transinvest","Lithuanian I League","LTU","Yes","2/2/2023","12/31/2023","$6K - $16K","Right","Reasonable","Very Strong","6'0""","169 lbs","458","99",85,105,3,3,6,12,14,8,9,8,3,10,12,7,13,9,15,14,8,9,10,15,10,8,8,14,13,13,8,8,8,8,8,11,17,8,7,8,9,15,14,13,9,10,13,10,12,6,11,14,12,2,2,3,2,1,2,1,2,2,1,3
"2430",47003860,"Mantas Kuklys","6/10/1987 (36 years old)","DM, M/AM (C)","FA Šiauliai","Lithuanian A League","LTU","Yes","1/1/2023","12/31/2024","Not for Sale","Right","Reasonable","Very Strong","6'1""","171 lbs","431","81",95,105,9,10,9,12,15,10,10,11,10,12,10,6,12,13,6,9,10,11,11,16,14,15,9,13,12,15,15,12,6,11,6,12,12,11,7,8,11,14,9,11,11,10,10,6,10,8,7,10,8,2,2,1,3,3,2,2,1,2,3,1
"2431",58073889,"Ovidijus Verbickas","7/4/1993 (29 years old)","DM, M (C)","Žalgiris","Lithuanian A League","LTU","Yes","1/7/2023","12/31/2023","$130K - $400K","Right","Reasonable","Very Strong","5'10""","171 lbs","227","38",100,105,10,10,10,8,12,10,8,8,8,11,12,10,11,12,10,10,10,10,10,10,13,8,10,10,10,10,11,15,13,11,11,10,13,12,12,12,10,19,10,13,13,9,5,10,10,5,10,13,15,2,2,3,2,2,2,1,2,3,2,4
"2432",47040684,"Rolandas Baravykas","8/23/1995 (27 years old)","D (RL)","Farul Constanţa","Romanian First League","LTU","Yes","1/4/2023","6/30/2025","$45K - $450K","Right","Reasonable","Very Strong","6'0""","176 lbs","213","4",100,105,8,8,10,6,10,6,8,6,10,11,10,10,12,10,10,12,10,10,11,10,13,8,10,10,12,10,8,15,14,12,10,13,13,12,13,12,10,18,11,13,13,12,5,10,5,6,2,13,20,1,1,3,2,1,1,1,1,2,3,2
"2433",17013997,"Dziugas Bartkus","11/7/1989 (33 years old)","GK","Al-Orobah","Saudi First Division League","LTU","Yes","6/11/2023","6/30/2024","$700K - $1.6M","Right Only","Weak","Very Strong","6'3""","194 lbs","306","1",100,105,3,3,1,3,1,7,1,3,1,3,8,3,2,2,11,11,12,9,9,12,12,2,4,2,12,9,8,8,10,14,9,13,14,8,9,12,11,11,10,13,12,10,15,12,7,5,13,10,14,9,10,12,5,11,9,12,7,13,14,10
"2434",2000028297,"Sid Ahmed Rachid","12/31/1998 (24 years old)","D (LC)","FC Nouadhibou","Mauritanian D1","MTN","No","7/1/2021","6/30/2024","$0","Left","Very Strong","Reasonable","6'0""","169 lbs","-","-",82,101,6,10,5,5,10,1,11,1,8,10,9,2,13,7,15,9,10,5,9,8,8,5,10,6,14,8,6,9,14,13,9,7,11,13,13,10,16,17,9,13,10,8,9,4,12,7,15,11,18,2,2,1,4,1,2,3,2,1,1,2
"2435",43318533,"Augustinas Klimavicius","4/27/2001 (22 years old)","ST (C)","Hegelmann","Lithuanian A League","LTU","Yes","1/21/2022","12/31/2023","$220K - $650K","Right","Reasonable","Very Strong","6'3""","174 lbs","27","7",90,105,7,6,12,10,12,8,10,8,4,6,9,6,3,7,7,9,2,11,9,14,5,10,1,10,9,8,9,10,14,13,9,13,9,13,8,7,15,15,11,9,12,10,5,1,5,5,14,11,14,4,3,3,3,1,1,3,2,3,3,4
"2436",2000053186,"Tomas Kalinauskas","4/27/2000 (23 years old)","M/AM (RLC)","FC Den Bosch","Keuken Kampioen Divisie","LTU","Yes","1/17/2023","6/30/2024","$35K - $350K","Right","Reasonable","Very Strong","5'10""","145 lbs","35","7",89,105,8,8,11,7,8,9,9,8,9,6,7,6,6,10,14,7,8,8,10,9,18,15,5,10,4,8,9,10,13,13,10,8,13,13,12,6,14,15,12,13,12,10,11,1,5,6,12,10,14,2,1,3,2,2,1,1,2,3,2,1
"2437",43086992,"Edvinas Girdvainis","1/17/1993 (30 years old)","D (C)","Kauno Žalgiris","Lithuanian A League","LTU","Yes","1/12/2023","12/31/2023","$40K - $425K","Right","Reasonable","Very Strong","6'2""","180 lbs","240","2",100,105,4,8,6,6,7,2,13,9,4,12,10,4,12,7,15,11,11,11,12,10,10,5,11,10,12,10,4,10,12,11,12,13,12,10,11,11,13,12,11,9,12,10,7,10,9,1,12,12,11,3,2,2,4,2,4,4,1,3,3,2
"2438",47071173,"Karolis Uzela","3/11/2000 (23 years old)","DM, M (C)","RFS","Optibet Virsliga","LTU","Yes","1/25/2022","11/30/2024","$80K - $250K","Right","Reasonable","Very Strong","6'2""","171 lbs","121","21",90,105,9,9,7,9,15,9,9,9,1,12,15,4,14,11,15,11,9,10,11,13,16,5,10,10,14,14,11,9,6,10,5,14,13,10,7,9,14,18,9,11,10,9,5,14,5,6,12,9,18,4,2,1,4,3,4,3,2,1,2,3
"2439",47005232,"Nerijus Valskis","8/4/1987 (35 years old)","ST (C)","Kauno Žalgiris","Lithuanian A League","LTU","Yes","8/4/2022","12/31/2024","Not for Sale","Right","Strong","Very Strong","6'1""","176 lbs","372","133",95,105,9,10,11,12,9,12,8,11,6,2,9,12,3,9,10,12,11,12,11,10,10,8,2,12,9,13,8,12,10,12,12,9,11,10,13,12,2,2,11,12,8,9,12,8,12,5,11,12,5,3,2,1,3,1,1,1,3,1,1,1
"2440",47006705,"Egidijus Vaitkunas","8/8/1988 (34 years old)","D (RL)","FA Šiauliai","Lithuanian A League","LTU","Yes","1/1/2023","12/31/2023","$16K - $45K","Right","Reasonable","Very Strong","5'11""","169 lbs","350","14",100,105,5,13,9,5,11,4,8,4,9,11,11,6,12,11,14,12,11,9,11,15,14,8,10,9,13,10,10,10,12,12,10,11,10,9,12,8,11,10,10,13,12,12,11,9,6,10,13,10,13,2,2,1,3,4,2,1,1,4,4,3
"2441",96129023,"Titas Milašius","12/12/2000 (22 years old)","WB/M (L), AM (RLC)","Podbeskidzie","Polish First Division","LTU","Yes","6/21/2021","6/30/2025","$12K - $110K","Left","Very Strong","Reasonable","5'10""","152 lbs","66","3",86,105,8,8,10,7,9,9,6,10,6,7,10,9,7,10,9,8,12,9,9,9,14,12,7,11,7,12,10,12,12,12,7,9,13,11,12,7,13,13,12,11,9,12,11,9,10,7,10,14,15,3,2,1,1,1,3,2,3,2,3,4
"2442",2000100255,"Dovydas Zala","3/25/2003 (20 years old)","ST (C)","Fløya","Norwegian Third Division Group 6","LTU","Yes","1/6/2023","12/31/2024","$0","Right","Fairly Strong","Very Strong","6'0""","152 lbs","29","13",73,104,3,5,9,10,9,4,9,6,2,5,7,11,7,10,15,12,16,10,5,7,13,6,1,7,5,6,6,13,13,12,10,8,7,13,8,8,9,11,9,12,15,9,13,20,17,8,5,11,14,2,3,1,2,2,2,1,1,3,2,2
"2443",2000294811,"Kipras Olšauskas","5/13/2005 (18 years old)","D (C), DM","Jàbac Terrassa","Spanish U19 Division 2 Group 7","LTU","Yes","7/1/2022","6/30/2025","$0","Right","Strong","Very Strong","6'2""","174 lbs","-","-",75,104,5,5,7,6,10,5,11,6,4,10,11,6,11,9,12,9,11,7,8,9,14,8,10,6,10,11,9,9,9,10,10,13,14,10,9,9,15,12,14,12,14,8,6,12,12,8,12,14,16,3,1,2,1,3,1,2,1,1,3,3
"2444",67241025,"Ernestas Juskevicius","4/16/1999 (24 years old)","GK","Linares","Spanish Federation First Division B","LTU","Yes","6/25/2021","6/30/2024","$60K - $180K","Left","Very Strong","Reasonable","6'2""","176 lbs","59","-",100,104,4,1,1,1,1,8,1,1,1,1,10,3,2,2,12,12,9,9,10,14,7,1,12,3,13,9,8,8,10,10,9,12,13,10,6,5,12,16,11,10,8,11,11,2,7,5,12,9,8,7,7,12,7,13,11,14,5,11,7,14
"2445",87037842,"Allan Banegas","10/4/1993 (29 years old)","DM, M (LC)","Marathón","Liga Nacional de Honduras","HON","No","12/31/2022","6/30/2025","$16K - $160K","Left","Very Strong","Reasonable","5'11""","167 lbs","201","6",89,114,7,9,7,3,12,7,6,7,7,9,11,1,14,9,12,11,8,7,9,14,4,5,4,8,10,8,9,13,10,13,8,11,9,13,8,5,12,12,10,11,11,11,11,1,7,4,10,11,19,1,3,2,2,3,1,1,1,1,3,2
"2446",2000027787,"Mouhsine Bodda","7/18/1997 (25 years old)","DM, M (C)","FC Nouadhibou","Mauritanian D1","MTN","No","6/30/2022","6/30/2024","$0","Left Only","Very Strong","Weak","5'10""","141 lbs","-","-",90,100,4,7,5,8,12,6,3,10,1,10,13,5,14,9,13,8,9,9,9,13,10,5,14,10,8,9,9,13,14,14,8,8,14,14,14,11,13,15,13,12,11,11,6,7,7,4,11,12,14,3,3,1,3,1,1,1,3,3,2,1
"2447",43215544,"Edgaras Dubickas","7/9/1998 (24 years old)","AM (L), ST (C)","Pisa","Italian Serie B","LTU","Yes","1/30/2023","6/30/2026","$0 - $85K","Right Only","Very Weak","Very Strong","6'0""","165 lbs","119","26",100,101,9,12,12,11,12,7,12,10,6,4,12,10,4,12,12,11,10,12,12,11,12,9,11,13,10,13,12,12,13,12,9,11,11,13,13,13,11,12,14,12,10,14,8,12,7,6,12,13,16,2,3,4,1,1,1,2,4,1,3,1
"2448",13232463,"Békaye Wade","4/13/1996 (27 years old)","AM (RL)","AS Douanes (MTN)","Mauritanian D1","MTN","No","10/1/2022","6/30/2025","$0","Left","Very Strong","Reasonable","5'7""","138 lbs","-","-",80,100,4,7,8,10,13,7,7,8,5,5,12,5,5,12,5,10,6,8,7,9,8,11,10,14,7,8,5,4,14,14,8,4,13,14,7,1,14,12,11,10,11,10,6,17,6,6,18,12,10,3,2,3,3,1,2,1,2,3,1,1
"2449",2000034300,"M'Backé N'Diaye","12/19/1994 (28 years old)","GK","Nouakchott Kings","Mauritanian D1","MTN","No","6/15/2020","6/30/2024","$0","Left Only","Very Strong","Weak","6'2""","169 lbs","-","-",89,100,3,3,3,2,2,8,1,2,3,1,7,3,2,5,14,8,15,6,7,13,11,2,11,3,8,7,6,6,13,14,7,9,12,12,6,5,10,16,9,14,12,12,10,1,7,2,11,14,15,7,9,10,11,5,11,12,5,7,13,11
"2450",2000050646,"Sidi Ahmed Hadi","12/12/1992 (30 years old)","M (C)","Al-Bidda","Qatar League","MTN","No","7/1/2018","6/30/2025","$26K - $250K","Right","Reasonable","Very Strong","5'6""","134 lbs","-","-",95,100,8,7,6,8,14,8,5,9,2,14,14,7,10,14,11,10,3,10,8,13,12,5,13,10,9,9,8,13,14,14,9,5,18,14,14,6,15,15,10,11,8,12,5,14,6,8,11,12,7,2,1,1,3,1,2,4,3,2,1,3
"2451",2000079718,"El Mami Tetah","11/12/2001 (21 years old)","AM (RLC)","Alanyaspor","Turkish Super League","MTN","No","1/26/2021","6/30/2025","$0 - $85K","Left Only","Very Strong","Weak","5'7""","138 lbs","25","3",80,100,7,11,11,9,13,8,6,9,7,6,9,4,8,15,8,10,5,8,9,8,15,14,10,11,7,9,9,14,12,14,10,7,8,12,9,6,16,18,12,9,12,11,10,4,8,8,11,11,18,2,3,3,2,2,1,3,3,1,3,3
"2452",13209425,"Hassen Téguédi","12/30/1999 (23 years old)","M/AM (C)","FC Nouadhibou","Mauritanian D1","MTN","No","7/1/2019","6/30/2025","$0","Right","Fairly Strong","Very Strong","5'6""","141 lbs","-","-",80,100,6,3,8,12,13,6,4,11,1,5,13,5,8,12,7,9,3,8,6,11,6,12,3,8,7,7,13,12,11,13,7,2,6,13,7,1,12,17,10,11,11,12,8,7,8,6,9,12,16,1,3,2,2,1,3,1,1,1,3,3
"2453",2000057569,"Bandar Al-Salamah","10/28/2002 (20 years old)","M/AM (R)","Al-Arabi","Kuwaiti Premier League","KUW","No","7/1/2019","6/30/2025","$1.1M - $2.3M","Right Only","Weak","Very Strong","5'10""","152 lbs","44","10",96,138,9,11,13,14,13,9,9,13,9,9,13,12,10,15,14,11,9,15,8,9,17,13,11,11,9,10,10,13,14,8,11,8,10,12,8,5,12,8,12,15,13,11,6,9,6,10,13,15,11,1,3,2,4,2,3,2,3,1,1,4
"2454",1009491,"Bader Al-Motawa","1/10/1985 (38 years old)","AM (RL), ST (C)","Qadsia","Kuwaiti Premier League","KUW","No","6/14/2021","6/30/2025","Not for Sale","Right","Strong","Very Strong","5'9""","145 lbs","271","120",116,135,14,14,13,14,11,14,8,15,3,3,18,18,8,15,4,12,11,13,12,12,16,20,15,10,10,15,14,14,10,12,11,7,15,10,12,10,14,10,13,12,11,11,7,19,7,3,18,13,14,2,1,1,1,4,1,2,3,3,2,3
"2455",23185417,"Saif Al-Hashan","1/29/1990 (33 years old)","M/AM (C)","Al-Arabi","Kuwaiti Premier League","KUW","No","6/27/2022","6/30/2024","$275K - $850K","Left","Very Strong","Reasonable","5'7""","138 lbs","94","17",97,129,12,14,15,13,15,11,8,11,2,4,16,14,6,17,7,10,9,11,16,9,14,17,9,14,11,12,13,14,5,13,13,8,15,10,8,9,16,10,13,8,12,10,6,14,3,3,17,12,18,2,1,2,1,3,3,3,3,2,1,1
"2456",2000082247,"Hussain Ashknani","1/26/2002 (21 years old)","DM, M (C)","Al-Arabi","Kuwaiti Premier League","KUW","No","6/13/2022","6/30/2025","$75K - $750K","Right","Fairly Strong","Very Strong","5'11""","163 lbs","43","-",88,124,8,8,6,9,12,8,7,8,3,14,15,7,15,10,15,14,8,11,7,15,7,5,11,10,7,14,10,13,6,10,9,11,15,10,8,7,15,13,11,10,10,9,9,15,9,5,20,10,13,1,3,1,2,2,2,3,1,2,2,1
"2457",67225567,"Hacen","12/31/1997 (25 years old)","DM, M (C)","Lugo","Spanish Federation First Division A","MTN","No","8/26/2022","6/30/2025","$14K - $140K","Right","Reasonable","Very Strong","5'11""","174 lbs","163","14",99,138,8,9,10,8,13,9,11,9,7,10,13,9,13,13,13,12,13,13,10,12,15,12,9,12,11,12,11,12,9,10,8,11,14,10,12,11,11,10,12,9,11,12,6,13,10,6,14,10,14,3,1,2,3,3,2,2,1,2,1,3
"2458",2000056330,"Mubarak Al-Faneni","1/21/2000 (23 years old)","M (L), AM (RL)","Qadsia","Kuwaiti Premier League","KUW","No","6/5/2023","6/30/2026","$375K - $3.6M","Right","Reasonable","Very Strong","5'6""","130 lbs","43","6",104,122,9,13,12,12,10,8,8,6,8,8,14,6,4,11,10,14,9,10,9,14,14,11,9,11,8,9,7,8,14,14,9,5,15,14,8,1,16,20,12,12,11,12,12,7,5,6,10,12,17,1,2,3,3,1,2,3,2,2,2,3
"2459",23035861,"Khaled Al-Rashidi","4/20/1987 (36 years old)","GK","Qadsia","Kuwaiti Premier League","KUW","No","5/6/2020","6/30/2025","Not for Sale","Right Only","Very Weak","Very Strong","6'1""","165 lbs","175","1",105,120,1,1,3,1,10,5,15,1,3,3,12,3,1,10,2,14,13,13,11,8,13,5,10,12,11,11,9,7,6,12,8,13,16,12,13,12,10,20,11,10,9,10,4,14,5,2,9,10,16,12,15,16,15,15,14,14,9,14,9,11
"2460",2000087157,"Hamad Al-Taweel","7/26/2001 (21 years old)","M/AM (LC)","Khaitan","Kuwaiti Premier League","KUW","No","6/13/2022","6/30/2023","$160K - $475K","Left","Very Strong","Reasonable","6'0""","160 lbs","-","-",72,118,6,7,11,13,13,6,6,6,1,7,9,8,5,8,14,8,3,9,5,11,8,10,11,12,6,7,10,8,13,9,7,5,10,11,8,4,17,17,13,10,11,12,7,1,10,6,11,10,11,1,2,3,3,1,3,1,3,1,2,1
"2461",2000067615,"Hassan Hamdan","8/21/2000 (22 years old)","D (C)","Al-Arabi","Kuwaiti Premier League","KUW","No","7/1/2018","6/30/2024","$55K - $550K","Right","Reasonable","Very Strong","6'2""","176 lbs","30","1",91,117,4,3,5,2,8,3,13,6,3,13,8,6,10,5,12,11,10,8,6,13,8,5,3,7,13,7,5,8,13,11,8,10,12,11,5,9,16,13,13,11,8,10,11,16,9,8,14,13,17,2,1,3,2,3,2,1,2,1,1,1
"2462",23470361,"Ali Jarragh","3/25/1996 (27 years old)","GK","Qadsia","Kuwaiti Premier League","KUW","No","7/14/2022","6/30/2026","$55K - $160K","Right","Weak","Very Strong","5'10""","163 lbs","5","-",77,117,5,1,3,1,4,7,1,2,2,3,9,1,2,6,9,7,15,4,8,13,13,2,12,2,6,7,6,6,11,12,7,3,7,10,3,8,12,19,10,12,12,13,8,5,10,2,13,11,13,7,6,13,5,7,9,13,6,9,10,7
"2463",2000100400,"Othman Al-Dosari","10/18/2002 (20 years old)","ST (C)","Salmiya","Kuwaiti Premier League","KUW","No","5/29/2023","6/30/2024","$140K - $1.4M","Right","Reasonable","Very Strong","6'1""","169 lbs","-","-",79,116,6,3,12,13,13,6,13,7,2,6,7,7,1,10,8,7,5,13,7,8,15,12,2,12,6,6,6,7,12,8,7,10,13,10,12,6,9,20,12,7,8,12,13,11,5,5,10,11,15,3,1,3,1,3,1,1,3,1,1,2
"2464",23079707,"Fahad Al-Enezi","9/1/1988 (34 years old)","M (R), AM (RL)","Naser","Kuwaiti Premier League","KUW","No","7/27/2022","6/30/2023","$0 - $2K","Right","Weak","Very Strong","5'10""","160 lbs","177","31",85,115,9,12,14,12,11,6,12,12,5,6,12,10,6,13,10,10,8,6,11,7,15,17,9,11,11,11,11,13,11,13,12,9,14,10,8,9,18,10,13,8,11,9,13,17,6,11,16,13,7,1,1,2,2,2,1,1,4,1,1,1
"2465",23126921,"Saad Suroor","4/24/1990 (33 years old)","D (L), DM","Tadamun (KUW)","Kuwaiti First Division","KUW","No","7/1/2018","6/30/2024","$50K - $140K","Left","Very Strong","Reasonable","5'11""","163 lbs","-","-",76,115,6,9,6,2,11,7,7,8,7,8,8,3,14,9,9,11,8,7,7,13,11,5,4,7,9,8,9,9,11,11,8,7,12,9,12,7,11,17,8,11,12,13,10,10,5,3,20,11,7,1,3,3,2,3,2,3,4,1,2,2
"2466",2000087152,"Dhari Al-Otaibi","3/31/2002 (21 years old)","GK","Kuwait SC","Kuwaiti Premier League","KUW","No","6/13/2022","6/30/2024","$170K - $1.7M","Right","Reasonable","Very Strong","6'0""","169 lbs","17","-",80,115,4,1,3,3,5,7,1,2,1,1,7,3,3,3,9,6,13,5,13,13,7,3,9,2,8,7,6,5,13,5,7,9,8,11,1,7,12,13,12,8,13,12,10,12,6,4,10,13,11,7,5,13,11,8,13,11,5,7,11,8
"2467",23079776,"Yousef Nasser","10/9/1990 (32 years old)","ST (C)","Kuwait SC","Kuwaiti Premier League","KUW","No","7/15/2019","6/30/2024","$70K - $700K","Right Only","Weak","Very Strong","6'0""","167 lbs","118","92",95,115,5,10,12,14,10,9,13,9,3,12,13,15,12,11,10,12,14,10,13,10,15,11,10,13,4,12,10,13,9,10,15,15,14,10,11,14,13,8,9,9,7,10,6,15,8,8,13,12,13,1,1,4,2,4,2,1,1,1,1,3
"2468",12094914,"Beyatt Lekoueiry","4/11/2005 (18 years old)","M (C)","FC Nouadhibou","Mauritanian D1","MTN","No","7/1/2020","6/30/2024","$0","Left","Very Strong","Reasonable","6'1""","160 lbs","-","-",79,130,7,3,5,3,13,7,7,10,6,10,14,4,8,14,8,8,4,7,8,14,4,5,8,6,8,8,13,11,13,9,4,11,15,12,7,5,11,11,13,11,10,10,5,18,9,5,18,10,14,1,1,3,2,1,2,1,2,2,4,3
"2469",23079553,"Abdulhadi Khamis","12/20/1990 (32 years old)","AM (R), ST (C)","Salmiya","Kuwaiti Premier League","KUW","No","9/8/2022","6/30/2023","$4.5K - $14K","Right Only","Weak","Very Strong","5'10""","156 lbs","98","41",83,114,3,4,10,13,8,5,9,10,1,4,13,11,4,15,7,10,9,10,12,3,14,14,9,13,7,8,6,10,14,16,14,10,11,16,13,8,15,10,13,11,9,10,3,13,4,2,10,9,16,2,2,2,4,3,2,1,1,3,2,3
"2470",2000067996,"Yousef Al-Rashidi","3/18/2000 (23 years old)","AM (RLC)","Kuwait SC","Kuwaiti Premier League","KUW","No","7/19/2021","6/30/2024","$150K - $1.5M","Left","Very Strong","Fairly Strong","5'10""","149 lbs","16","-",84,114,6,7,13,12,13,6,7,9,5,6,11,10,2,13,8,8,1,13,7,8,9,14,4,11,6,7,5,12,13,13,8,6,13,13,7,3,12,16,9,9,12,10,10,9,5,5,17,11,7,1,1,1,3,3,1,1,2,3,3,1
"2471",23151151,"Sulaiman Abdulghafor","2/26/1991 (32 years old)","GK","Al-Arabi","Kuwaiti Premier League","KUW","No","6/14/2021","6/30/2024","$85K - $850K","Right Only","Weak","Very Strong","5'11""","187 lbs","68","-",103,114,3,3,3,3,5,7,2,1,1,3,11,1,2,3,10,10,14,9,11,12,13,2,13,1,13,10,8,9,12,15,6,8,17,9,5,7,9,15,10,14,14,13,6,13,8,4,9,12,7,11,15,14,12,14,10,14,8,9,8,12
"2472",2000072438,"Abdulaziz Al-Besher","1/2/2000 (23 years old)","ST (C)","Al-Arabi","Kuwaiti Premier League","KUW","No","7/2/2022","6/30/2025","$100K - $1M","Right","Reasonable","Very Strong","5'10""","158 lbs","1","-",78,113,6,4,13,13,8,6,13,3,1,6,7,2,2,10,14,13,8,10,7,9,15,10,11,10,7,6,4,7,13,13,7,6,12,13,9,10,11,10,12,10,10,9,7,1,5,6,11,12,16,2,2,2,1,3,2,3,3,1,2,2
"2473",23330437,"Shebeeb Al-Khaldi","8/11/1998 (24 years old)","AM (R), ST (C)","Kazma","Kuwaiti Premier League","KUW","No","7/1/2021","6/30/2026","$1.9M - $3.9M","Right","Reasonable","Very Strong","6'0""","160 lbs","38","29",108,113,9,11,14,15,10,13,11,10,4,5,15,4,2,11,6,11,10,9,8,13,18,12,4,13,10,9,10,14,15,13,15,10,7,15,10,5,11,20,11,12,13,14,5,6,5,4,12,10,13,1,2,1,3,4,2,1,3,1,3,3
"2474",23126987,"Abdulaziz Al-Saleemi","9/29/1991 (31 years old)","M (RC)","Al-Arabi","Kuwaiti Premier League","KUW","No","6/14/2021","6/30/2024","$18K - $190K","Right Only","Weak","Very Strong","5'10""","141 lbs","117","3",76,113,9,10,8,9,11,8,10,9,3,8,12,9,10,10,10,7,11,13,11,6,13,14,8,10,10,16,14,13,10,10,11,14,15,9,11,10,11,15,13,11,11,12,7,15,5,2,14,15,10,4,2,1,4,2,3,3,3,2,1,2
"2475",2000100249,"Abdulaziz Al-Otaibi","9/23/2002 (20 years old)","D (C), DM","Kuwait SC","Kuwaiti Premier League","KUW","No","7/1/2018","6/30/2024","$650K - $1.4M","Right","Reasonable","Very Strong","6'0""","167 lbs","-","-",68,112,6,6,7,7,11,8,10,6,5,10,12,6,13,11,7,10,9,12,8,8,13,5,1,6,11,8,7,10,8,10,9,11,16,9,8,7,11,20,12,12,11,10,7,10,6,8,10,11,12,2,1,1,3,1,2,3,1,3,3,3
"2476",23185415,"Ahmad Al-Dhafeeri","1/9/1992 (31 years old)","M/AM (L)","Kuwait SC","Kuwaiti Premier League","KUW","No","7/30/2022","6/30/2025","Not for Sale","Left Only","Very Strong","Very Weak","5'9""","156 lbs","128","14",101,112,10,11,13,9,11,14,11,13,1,9,15,15,9,12,7,12,10,12,14,10,15,17,4,12,15,15,16,11,11,13,11,11,13,12,12,9,4,18,11,11,11,11,5,15,7,8,14,13,19,1,2,1,1,3,3,2,1,3,1,1
"2477",23150371,"Fahad Al-Hajri","11/10/1991 (31 years old)","D (RC)","Kuwait SC","Kuwaiti Premier League","KUW","No","6/14/2021","6/30/2024","$55K - $550K","Right Only","Very Weak","Very Strong","6'0""","167 lbs","162","17",102,112,3,14,10,6,7,6,17,10,10,15,7,7,15,10,10,7,10,8,12,12,11,14,4,11,12,4,5,10,6,10,9,16,14,14,16,16,13,16,12,14,12,9,3,16,3,2,15,9,19,1,3,3,2,1,2,3,3,2,1,2
"2478",23150707,"Mohammed Al-Fahad","12/29/1994 (28 years old)","AM (C), ST (C)","Sahel","Kuwaiti First Division","KUW","No","1/11/2022","6/30/2023","$500 - $5K","Left","Very Strong","Weak","5'8""","154 lbs","13","8",74,111,1,11,13,14,4,13,9,12,1,8,13,14,7,13,10,10,11,12,13,11,13,14,3,10,9,11,12,7,8,9,8,9,13,12,9,8,10,18,11,12,11,10,3,13,5,7,16,10,9,2,1,4,2,1,3,2,1,1,3,3
"2479",12093969,"Amar Haïdara","11/28/2003 (19 years old)","M (C)","Diambars FC","Senegalese Ligue 1","MTN","No","7/1/2020","7/1/2024","$40K - $120K","Right Only","Weak","Very Strong","5'8""","138 lbs","-","-",85,125,7,5,8,6,14,7,7,10,1,14,14,7,11,14,12,7,8,5,8,14,8,11,10,8,8,8,10,13,14,14,8,2,12,14,8,5,10,17,11,11,10,14,9,15,11,4,12,8,18,1,2,2,3,2,3,1,3,2,2,1
"2480",23150716,"Sultan Al-Enezi","3/29/1992 (31 years old)","DM, M (C)","Al-Arabi","Kuwaiti Premier League","KUW","No","8/17/2021","6/30/2023","$0 - $80K","Left Only","Very Strong","Very Weak","6'1""","154 lbs","109","11",105,111,3,6,9,8,10,9,16,15,5,14,14,9,14,9,14,12,13,7,12,12,13,5,5,10,10,12,11,11,13,11,13,16,13,12,13,15,10,10,9,12,13,8,7,10,8,7,13,11,9,3,2,1,2,2,3,2,3,1,1,1
"2481",2000072468,"Mohammed Daham","2/17/2000 (23 years old)","M (R), AM (RC)","Naser","Kuwaiti Premier League","KUW","No","6/15/2020","6/30/2025","$130K - $1.3M","Right","Reasonable","Very Strong","5'11""","160 lbs","22","18",100,111,8,11,13,15,14,9,8,7,8,7,15,5,9,13,6,11,9,12,8,15,9,11,11,14,7,10,9,12,13,12,10,10,10,12,8,7,18,19,11,11,12,13,14,14,5,7,12,11,13,1,2,2,2,2,2,1,2,1,3,3
"2482",23149898,"Sharidah Al-Sharidah","6/22/1992 (30 years old)","M (C)","Kuwait SC","Kuwaiti Premier League","KUW","No","6/14/2021","6/30/2024","$0","Right","Reasonable","Very Strong","5'11""","163 lbs","80","4",82,110,6,5,5,9,10,8,8,10,5,10,10,7,10,12,15,9,7,8,6,14,11,7,8,10,10,9,9,10,10,10,9,12,12,10,15,9,13,13,12,12,10,10,5,9,11,4,10,11,19,1,1,1,1,3,2,3,3,3,3,2
"2483",23304525,"Salman Abu Ramia","9/11/1994 (28 years old)","AM (R), ST (C)","Naser","Kuwaiti Premier League","KUW","No","6/15/2020","6/30/2023","$9K - $26K","Right Only","Weak","Very Strong","5'10""","158 lbs","85","8",79,110,9,10,8,7,10,6,13,5,1,6,12,10,6,11,12,9,1,8,10,9,6,14,7,8,10,6,7,8,12,13,10,8,7,14,10,6,13,20,12,8,12,14,9,11,4,8,12,11,9,1,1,2,2,2,1,3,2,3,2,4
"2484",2000275167,"Saud Qassim","5/11/2004 (19 years old)","ST (C)","Qadsia","Kuwaiti Premier League","KUW","No","7/1/2022","6/30/2024","$45K - $425K","Left","Very Strong","Reasonable","5'10""","152 lbs","-","-",65,110,4,5,12,12,11,4,12,5,1,4,5,5,2,9,7,12,6,12,5,10,13,10,8,10,3,4,4,5,12,12,5,6,11,12,6,2,7,16,7,12,11,9,9,11,9,5,14,11,11,2,3,2,2,3,1,1,2,3,3,3
"2485",23392641,"Meshal Fawaz","6/2/1998 (25 years old)","M/AM (C)","Naser","Kuwaiti Premier League","KUW","No","6/15/2020","6/30/2023","$26K - $75K","Right","Fairly Strong","Very Strong","6'2""","163 lbs","71","18",94,110,13,12,12,9,10,8,6,12,1,6,13,14,6,12,12,9,5,8,11,12,11,18,3,11,11,12,12,6,10,11,13,13,14,12,11,4,15,15,13,9,12,9,15,14,6,4,15,11,7,1,3,2,3,1,2,1,2,4,3,1
"2486",2000087180,"Osama Al-Enezi","5/18/2003 (20 years old)","GK","Khaitan","Kuwaiti Premier League","KUW","No","6/13/2022","6/30/2024","$75K - $750K","Right","Fairly Strong","Very Strong","6'2""","169 lbs","-","-",67,110,4,3,1,3,1,7,1,1,1,3,8,3,3,1,12,3,11,6,10,13,13,3,13,3,7,6,5,5,6,15,7,12,10,9,1,4,10,14,12,11,11,10,12,9,7,1,10,8,9,6,10,9,7,9,13,6,5,10,10,13
"2487",2000275161,"Muaath Al-Asaimea","4/22/2003 (20 years old)","AM (R)","Salmiya","Kuwaiti Premier League","KUW","No","6/1/2023","6/30/2024","$500K - $1.5M","Right","Reasonable","Very Strong","5'8""","145 lbs","-","-",80,110,7,10,12,9,13,6,6,6,4,6,10,2,7,13,7,8,8,4,7,11,14,14,1,8,5,7,10,11,13,13,7,4,9,13,6,5,11,16,10,13,11,10,12,12,11,7,10,10,18,2,1,1,1,1,3,3,1,2,3,3
"2488",23151022,"Faisal Zayed","10/9/1991 (31 years old)","AM (LC)","Kuwait SC","Kuwaiti Premier League","KUW","No","7/1/2020","6/30/2023","$0 - $45K","Right Only","Very Weak","Very Strong","5'11""","158 lbs","114","32",95,110,14,12,14,8,11,14,11,16,2,10,15,14,6,10,3,9,7,11,12,10,13,14,9,10,13,12,13,13,12,11,11,11,13,13,11,7,13,18,11,11,12,13,7,8,4,7,13,12,8,1,3,1,1,1,1,1,1,1,1,1
"2489",2000018230,"Eid Al-Rashidi","5/25/1999 (24 years old)","M (R), AM (RC)","Qadsia","Kuwaiti Premier League","KUW","No","6/15/2020","6/30/2025","$210K - $2.1M","Right","Reasonable","Very Strong","5'9""","152 lbs","45","9",104,110,7,10,10,9,14,8,6,9,8,8,10,8,7,9,10,10,7,8,8,10,14,9,11,13,8,9,7,13,14,14,12,7,13,14,14,7,9,14,11,10,12,13,7,9,5,6,9,9,10,1,1,2,4,3,2,1,1,3,3,1
"2490",85125688,"Aboubakar Kamara","3/7/1995 (28 years old)","ST (C)","Aris","Greek Super League 1","MTN","Yes","7/1/2022","6/30/2025","$0","Right","Reasonable","Very Strong","5'10""","176 lbs","227","58",115,125,5,10,10,11,10,5,12,11,7,8,12,13,7,10,15,10,16,10,9,9,14,10,6,12,8,13,10,16,15,13,15,10,13,15,13,16,9,6,3,10,12,12,12,12,15,13,10,15,12,2,2,1,4,1,1,1,2,2,3,2
"2491",23413662,"Faisal Saeed","6/16/1994 (28 years old)","D (L)","Qadsia","Kuwaiti Premier League","KUW","No","6/15/2020","6/30/2024","$0","Left Only","Very Strong","Very Weak","6'1""","169 lbs","-","-",78,110,6,13,2,1,9,1,13,7,7,11,6,1,13,8,13,7,9,8,8,10,6,9,5,7,7,8,7,9,14,11,8,16,9,14,14,7,12,12,11,10,13,11,6,11,6,8,14,10,9,1,3,3,3,3,3,2,3,1,2,2
"2492",23109426,"Nasser Faraj","9/24/1990 (32 years old)","AM (R), ST (C)","Kazma","Kuwaiti Premier League","KUW","No","6/14/2021","6/30/2024","$28K - $275K","Right Only","Weak","Very Strong","5'10""","191 lbs","141","48",89,110,7,12,11,12,11,9,12,12,13,6,13,12,6,10,10,9,11,7,12,11,5,9,13,10,10,9,8,12,12,11,9,11,8,12,9,11,13,17,10,11,11,12,5,11,5,5,12,11,16,3,3,2,3,4,3,3,2,2,2,3
"2493",2000086096,"Abdullah Al-Enezi","9/17/2001 (21 years old)","DM, M (C)","Qadsia","Kuwaiti Premier League","KUW","No","6/13/2022","6/30/2024","$150K - $1.5M","Right","Fairly Strong","Very Strong","5'11""","152 lbs","-","-",70,110,6,5,4,3,13,6,6,9,5,6,13,2,12,10,9,8,8,8,7,13,7,5,3,8,6,7,8,12,13,10,3,10,15,10,7,4,17,16,14,8,12,13,9,7,5,3,10,9,18,3,2,1,2,3,2,1,2,3,3,2
"2494",2000067611,"Salman Al-Awadi","5/21/2001 (22 years old)","AM (L), ST (C)","Al-Arabi","Kuwaiti Premier League","KUW","No","7/1/2019","6/30/2023","$24K - $230K","Left","Very Strong","Weak","5'10""","149 lbs","40","4",86,110,7,9,14,10,14,7,7,8,2,7,7,7,2,10,10,12,8,12,8,13,4,10,14,11,8,7,7,12,14,14,5,8,12,12,11,5,10,10,12,10,12,12,8,14,5,3,20,13,9,1,3,2,3,3,4,3,2,2,2,3
"2495",2000057756,"Khaled Al-Ajaji","3/18/1999 (24 years old)","GK","Naser","Kuwaiti Premier League","KUW","No","5/22/2022","6/30/2024","$70K - $700K","Right Only","Weak","Very Strong","5'10""","147 lbs","8","-",80,110,3,3,3,3,1,7,1,3,3,2,7,3,3,3,9,9,10,7,8,13,19,3,9,2,10,7,6,7,10,14,7,8,13,9,6,6,12,12,10,10,12,9,10,9,5,6,10,8,13,11,5,13,9,7,7,13,5,7,9,11
"2496",2000057760,"Othman Al-Shammari","4/4/2000 (23 years old)","DM, M (C)","Jahra","Kuwaiti Premier League","KUW","No","7/29/2021","6/30/2024","$55K - $550K","Right Only","Weak","Very Strong","6'2""","171 lbs","12","-",82,109,3,5,6,4,10,7,7,10,6,9,11,3,12,12,10,11,8,8,9,13,18,6,1,7,13,8,7,12,14,12,8,9,11,14,8,7,13,19,12,12,12,12,11,15,5,3,10,10,10,1,1,3,1,2,2,1,3,3,3,4
"2497",2000057506,"Fawaz Ayedh","2/21/1997 (26 years old)","M (C)","Salmiya","Kuwaiti Premier League","KUW","No","8/19/2021","6/30/2024","$130K - $1.3M","Right","Fairly Strong","Very Strong","5'10""","158 lbs","40","-",93,109,9,6,5,7,14,9,8,8,5,11,13,7,10,11,8,11,5,12,10,15,13,7,12,9,12,14,10,11,11,9,15,6,14,10,11,9,12,12,11,11,12,10,14,10,8,3,14,10,14,2,2,1,2,2,1,1,2,1,3,1
"2498",2000077733,"Yousef Al-Kandari","3/25/1999 (24 years old)","GK","Kazma","Kuwaiti Premier League","KUW","No","7/1/2019","6/30/2024","$200K - $600K","Right","Fairly Strong","Very Strong","5'10""","160 lbs","6","-",73,108,2,3,1,1,1,6,1,3,3,3,9,3,2,4,10,6,12,6,8,13,4,1,12,2,8,7,6,6,10,11,6,5,11,10,6,6,8,10,11,10,12,10,5,13,12,2,14,9,14,5,7,13,6,8,10,10,5,6,8,10
"2499",2000100395,"Fahad Al-Omairi","4/4/2003 (20 years old)","D (C)","Kazma","Kuwaiti Premier League","KUW","No","7/1/2018","6/30/2024","$35K - $350K","Right","Reasonable","Very Strong","6'2""","171 lbs","-","-",66,108,4,3,5,4,4,1,9,2,1,14,5,1,14,6,5,10,8,7,11,7,12,5,1,6,11,6,5,7,9,11,7,14,17,8,9,6,13,13,10,10,11,13,7,9,12,2,11,11,9,2,1,3,3,1,1,4,1,1,3,1
"2500",2000101350,"Yousef Mulla","2/1/2002 (21 years old)","AM (C)","Kazma","Kuwaiti Premier League","KUW","No","7/1/2018","6/30/2025","$90K - $900K","Right","Fairly Strong","Very Strong","5'7""","134 lbs","-","-",64,108,6,3,8,11,10,5,6,14,6,7,8,5,8,10,7,7,4,11,7,11,13,15,9,11,8,7,14,11,7,12,7,4,15,11,7,2,13,20,10,9,10,13,11,12,15,2,5,12,9,2,3,2,2,3,3,1,2,3,3,2
"2501",47006530,"Tadas Eliosius","3/1/1990 (33 years old)","AM (L)","Jonava","Lithuanian I League","LTU","Yes","1/1/2020","12/31/2023","$0 - $85K","Right","Reasonable","Very Strong","6'0""","171 lbs","371","80",85,100,9,13,7,13,11,7,3,10,8,5,13,8,8,12,10,9,7,9,7,9,7,10,10,13,6,9,12,10,11,11,9,11,11,11,13,7,13,10,13,12,11,12,13,4,12,7,18,11,19,3,3,3,1,3,3,2,1,1,2,3
"2502",1036464,"Ringo","11/22/1984 (38 years old)","M/AM (LC)","Al-Khalidiya","Bahrain Premier League","BHR","No","11/10/2020","6/30/2024","$0 - $18K","Left","Very Strong","Weak","5'9""","143 lbs","-","-",90,133,12,10,11,10,11,17,10,14,7,9,13,14,9,11,12,13,10,12,13,13,13,12,8,12,7,9,14,10,9,11,10,8,11,8,9,10,13,14,11,13,11,14,10,11,8,5,11,14,15,4,3,3,4,1,2,1,2,3,1,3
"2503",2000130435,"Detre Bell","3/8/1997 (26 years old)","GK","North Village Rams","Bermudan Premier Division","BER","No","7/1/2022","6/30/2025","$1K - $8K","Right","Reasonable","Very Strong","6'0""","189 lbs","66","-",72,77,4,1,1,2,5,6,1,3,3,1,8,4,2,5,7,11,11,11,9,14,10,3,6,3,10,6,7,7,13,11,8,10,10,11,6,7,11,15,9,11,12,11,8,6,8,3,9,11,12,8,9,11,9,10,8,8,5,10,9,11
"2504",82001256,"Angelo Simmons","7/20/1987 (35 years old)","ST (C)","Dandy Town Hornets","Bermudan Premier Division","BER","No","6/14/2021","6/30/2024","$0","Right","Reasonable","Very Strong","5'11""","167 lbs","57","42",60,75,6,3,7,14,12,12,12,6,4,5,7,6,1,10,10,10,4,10,7,11,14,9,15,14,5,6,7,7,7,7,7,8,9,8,10,7,11,13,11,15,13,13,7,10,14,3,11,10,8,2,3,2,2,3,2,1,1,3,4,2
"2505",82001240,"Shaun Riley","6/29/2004 (18 years old)","D/WB (L)","Somerset Trojans","Bermudan Premier Division","BER","No","6/13/2022","6/30/2024","$0 - $3.5K","Left","Very Strong","Reasonable","6'1""","163 lbs","-","-",52,75,4,10,3,4,5,2,7,6,7,6,9,7,9,8,15,7,7,6,9,14,10,9,4,6,9,8,8,8,9,11,8,15,13,12,8,5,10,12,12,12,9,11,7,10,5,6,15,12,19,2,3,2,3,2,2,3,3,2,1,3
"2506",2000130451,"Azende Furbert","3/18/1998 (25 years old)","D/WB (R)","Dandy Town Hornets","Bermudan Premier Division","BER","No","7/1/2018","6/30/2025","$500 - $7K","Right","Weak","Very Strong","6'1""","169 lbs","-","-",65,75,3,8,1,1,5,1,4,4,6,8,7,1,14,7,14,9,8,7,9,8,7,6,11,6,9,7,4,7,14,13,7,13,12,14,8,8,11,14,10,13,10,9,12,1,11,3,13,11,13,2,3,1,1,3,4,3,1,3,3,2
"2507",2000037752,"Kole Hall","8/22/1998 (24 years old)","AM (R), ST (C)","Chester","Vanarama National League North","BER","No","5/26/2023","6/30/2024","$0 - $24K","Right","Weak","Very Strong","6'3""","189 lbs","73","12",61,75,5,11,9,10,8,4,8,8,1,5,6,7,10,13,8,7,10,7,9,7,5,10,6,10,10,9,8,14,9,8,11,11,9,11,10,12,9,15,10,10,6,10,10,11,3,12,8,4,6,1,2,2,3,3,2,2,1,1,3,1
"2508",82074378,"Tomiko Goater","11/27/1995 (27 years old)","M/AM (C)","Robin Hood (BER)","Bermudan First Division","BER","No","7/1/2018","-","$0","Right","Fairly Strong","Very Strong","5'7""","143 lbs","16","12",63,75,3,1,7,9,9,5,5,7,1,5,11,4,4,12,7,8,4,8,6,13,15,12,9,8,7,6,13,7,13,13,6,1,16,13,3,7,12,19,10,12,12,12,5,6,13,8,7,13,19,2,3,2,2,3,3,2,3,1,2,2
"2509",13162017,"Faruku Miya","11/26/1997 (25 years old)","M (RC), AM (RLC)","Rizespor","Turkish Super League","UGA","No","7/13/2022","6/30/2024","$1M - $2.2M","Right","Reasonable","Very Strong","5'9""","163 lbs","156","38",110,135,10,10,11,11,11,9,7,12,8,8,12,12,7,12,12,12,14,12,11,12,12,13,8,12,10,12,12,12,13,11,13,9,10,12,12,12,11,13,14,7,8,11,9,11,7,7,12,11,7,2,2,3,2,2,2,1,2,3,1,3
"2510",27097480,"Moses Opondo","10/28/1997 (25 years old)","M (C), AM (R)","AC Horsens","NordicBet Liga","UGA","Yes","6/30/2022","6/30/2026","$110K - $1.1M","Right","Reasonable","Very Strong","5'8""","158 lbs","172","11",104,131,6,9,13,10,11,8,7,10,7,10,11,10,8,12,15,10,13,10,9,9,12,16,8,11,9,11,11,14,13,14,11,7,15,13,13,12,14,15,14,12,9,14,10,13,10,4,10,14,19,3,1,1,3,2,3,2,2,1,2,1
"2511",2000210632,"Basil Tuma","4/24/2005 (18 years old)","AM (R), ST (C)","Reading","Sky Bet League One","UGA","Yes","2/1/2022","6/30/2024","$150K - $1.5M","Right","Fairly Strong","Very Strong","6'0""","152 lbs","-","-",75,130,5,7,11,12,6,1,3,10,1,2,7,2,5,9,11,4,5,3,5,7,4,10,7,11,5,6,6,10,17,12,4,6,9,16,6,4,10,17,10,11,13,11,13,8,14,6,8,14,7,2,2,1,3,2,3,2,3,2,1,2
"2512",2000250059,"John Dembe","7/3/2005 (17 years old)","ST (C)","KCCA","Uganda Premier League","UGA","No","7/1/2022","6/30/2028","$0","Right Only","Weak","Very Strong","6'3""","165 lbs","-","-",74,127,6,6,8,11,9,6,11,7,4,5,7,10,6,9,10,11,8,8,10,10,14,10,6,11,8,8,7,10,13,9,10,12,16,13,10,11,8,14,8,12,12,11,11,1,6,6,10,14,10,3,3,1,1,1,1,2,3,1,1,1
"2513",23088154,"Jamal Rashid","11/7/1988 (34 years old)","M (L), AM (LC), ST (C)","Al-Ahli Club","Bahrain Premier League","BHR","No","10/16/2020","6/30/2023","$0","Left Only","Very Strong","Weak","5'7""","143 lbs","-","-",95,132,11,11,12,7,11,14,4,11,1,4,12,10,5,12,4,10,11,10,11,10,15,13,9,10,4,7,12,8,13,11,6,4,12,13,11,6,12,10,8,11,12,10,8,14,12,8,15,15,9,1,3,2,3,1,3,2,1,2,2,3
"2514",29086218,"Uche Ikpeazu","2/28/1995 (28 years old)","ST (C)","Konyaspor","Turkish Super League","UGA","No","8/13/2022","6/30/2024","$160K - $1.6M","Right","Reasonable","Very Strong","6'3""","211 lbs","262","47",110,125,4,8,9,14,11,6,15,11,9,8,10,12,8,10,16,9,14,9,9,9,16,12,11,12,7,13,7,15,12,11,13,15,12,14,14,18,8,8,11,12,11,5,7,14,13,10,9,16,8,1,1,2,2,1,1,3,2,2,3,2
"2515",2000059435,"Derrick Kakooza","10/23/2002 (20 years old)","ST (C)","ENPPI","Egyptian Premier League","UGA","No","1/31/2023","7/31/2025","$0","Right","Fairly Strong","Very Strong","6'2""","169 lbs","13","2",85,125,6,4,13,13,13,6,9,7,1,6,7,7,2,9,13,9,8,11,6,9,9,9,7,5,7,6,6,7,13,12,6,13,12,13,12,5,13,18,10,12,10,13,10,3,6,6,15,13,17,2,1,1,3,1,1,2,2,2,1,1
"2516",65000934,"Denis Onyango","5/15/1985 (38 years old)","GK","Sundowns","South African Premier Soccer League","UGA","No","6/14/2021","6/30/2024","$0 - $26K","Right Only","Very Weak","Very Strong","6'2""","182 lbs","268","1",115,123,3,5,8,4,9,12,11,8,15,10,11,8,10,14,12,12,14,14,10,11,11,11,9,6,12,4,5,9,10,9,9,13,10,9,11,14,3,8,7,12,8,5,4,11,8,8,12,11,13,11,12,14,7,16,12,15,14,16,13,17
"2517",2000202044,"Sadat Anaku","12/9/2000 (22 years old)","ST (C)","Dundee United","cinch Championship","UGA","No","8/25/2022","6/30/2024","$40K - $400K","Left","Very Strong","Reasonable","5'11""","154 lbs","13","-",88,120,7,8,13,8,11,8,15,9,4,8,7,4,6,12,12,11,4,7,7,9,14,9,9,10,5,8,9,12,13,14,8,10,7,13,11,12,12,18,13,11,12,11,13,3,7,7,16,11,14,2,1,1,1,1,1,4,2,3,1,3
"2518",13103083,"Jamal Salim Magoola","5/27/1995 (28 years old)","GK","Richards Bay","South African Premier Soccer League","UGA","No","7/1/2022","6/30/2024","$3K - $30K","Right","Reasonable","Very Strong","5'11""","160 lbs","45","-",100,118,2,3,3,3,2,6,1,1,2,2,14,1,2,4,15,12,13,7,8,14,7,2,10,1,11,9,8,8,14,15,9,11,14,13,4,8,10,20,14,11,11,10,7,1,5,5,7,9,19,10,15,13,13,7,14,14,5,10,6,14
"2519",13228854,"Aziz Kayondo","10/6/2002 (20 years old)","D (L)","Leganés B","Spanish Federation Third Group 7","UGA","No","1/3/2023","6/30/2027","$0 - $100K","Left Only","Very Strong","Weak","5'9""","147 lbs","16","1",80,118,6,10,2,1,10,2,9,7,8,15,11,1,13,9,13,8,10,8,10,13,7,5,1,8,10,9,9,13,10,10,10,8,9,11,8,8,11,17,12,12,11,11,9,12,8,4,12,12,11,3,1,2,2,1,3,2,4,3,3,2
"2520",92032199,"Herbert Bockhorn","1/31/1995 (28 years old)","D/WB (RL)","Magdeburg","Bundesliga 2","UGA","Yes","7/1/2022","6/30/2024","$55K - $550K","Right","Reasonable","Very Strong","5'10""","167 lbs","181","13",113,118,6,10,13,7,11,7,8,7,14,10,11,6,11,11,13,11,13,10,9,9,11,12,6,12,10,13,10,12,14,13,9,8,12,15,14,10,16,14,14,13,11,8,10,11,10,5,12,11,7,2,1,2,4,1,3,3,3,1,2,2
"2521",13224190,"Najib Yiga","12/18/2002 (20 years old)","AM (LC), ST (C)","Vipers SC","Uganda Premier League","UGA","No","7/1/2018","6/30/2024","$16K - $170K","Left","Very Strong","Reasonable","5'10""","152 lbs","-","-",76,117,5,7,12,9,11,5,7,6,5,5,12,3,4,12,9,4,1,7,7,12,7,13,11,6,6,6,8,7,12,12,3,5,8,12,11,3,9,19,11,10,13,10,7,10,13,7,13,11,13,3,1,3,1,2,2,2,3,1,1,3
"2522",2000085061,"Musa Ramathan","11/13/2001 (21 years old)","D (C), DM","Vyškov","-","UGA","No","2/4/2022","6/30/2024","$220K - $650K","Left","Very Strong","Reasonable","6'0""","165 lbs","20","2",85,117,6,7,5,9,11,8,11,6,5,11,7,2,16,9,15,11,10,7,6,11,10,5,6,7,11,9,7,11,11,11,10,9,14,11,12,6,15,16,11,9,14,11,11,1,15,3,15,10,15,1,2,1,2,1,1,3,2,3,3,2
"2523",13224183,"Jack Komakech","7/31/2002 (20 years old)","GK","Vipers SC","Uganda Premier League","UGA","No","7/1/2021","6/30/2026","$6K - $65K","Right Only","Weak","Very Strong","6'0""","165 lbs","-","-",73,116,4,3,1,2,3,5,1,2,2,1,10,1,1,5,5,8,10,3,11,12,1,1,4,2,7,7,6,6,12,11,7,9,13,11,5,6,12,20,13,11,13,11,9,7,5,6,11,10,17,8,13,12,12,8,13,13,5,9,11,11
"2524",1020294,"Sayed Mohamed Adnan","2/5/1983 (40 years old)","D (RC)","Hidd","Bahrain Premier League","BHR","No","8/13/2022","6/30/2024","$0 - $35K","Right","Weak","Very Strong","6'2""","187 lbs","197","43",84,130,5,5,8,4,9,12,10,10,7,11,9,12,13,10,15,11,13,12,11,10,15,16,13,9,12,10,7,11,8,9,13,13,14,7,9,11,7,10,18,14,14,19,3,13,8,2,14,13,14,3,1,1,2,1,1,3,3,1,2,3
"2525",2000085050,"Faisal Wabyoona","6/22/2003 (19 years old)","M/AM (C)","KCCA","Uganda Premier League","UGA","No","7/1/2022","6/30/2027","$20K - $200K","Right","Fairly Strong","Very Strong","5'9""","149 lbs","-","-",77,116,6,5,8,13,13,6,6,13,1,3,13,7,9,12,13,4,2,8,6,11,13,12,1,8,9,7,13,12,13,10,5,5,13,9,7,4,13,18,9,12,11,13,15,12,13,6,9,9,9,3,3,3,3,1,2,2,1,3,2,2
"2526",2000276084,"Alex Yiga","6/22/2006 (16 years old)","AM (RLC)","KCCA","Uganda Premier League","UGA","No","7/1/2022","6/30/2026","$0 - $65K","Left","Very Strong","Reasonable","6'0""","147 lbs","-","-",65,116,5,10,11,12,14,6,5,8,1,4,9,5,7,9,7,6,7,6,3,12,10,8,2,12,7,7,6,10,9,13,7,13,12,12,6,4,10,17,10,14,13,8,7,4,9,2,1,10,16,3,3,1,3,3,2,2,3,3,2,3
"2527",29163918,"Elvis Bwomono","11/29/1998 (24 years old)","D (RLC), WB (R)","ÍBV","Icelandic Premier Division","UGA","No","5/12/2022","10/31/2023","$0 - $95K","Right Only","Weak","Very Strong","5'9""","156 lbs","140","2",104,115,5,10,11,5,9,4,9,5,5,11,10,5,10,9,6,9,9,12,9,13,13,6,7,12,10,13,9,14,14,13,11,6,13,13,14,10,4,13,9,12,11,11,5,8,5,2,10,10,14,2,2,2,3,1,2,3,1,3,3,1
"2528",13203604,"Timothy Awany","8/6/1996 (26 years old)","D (C)","S.C. Ashdod","Israeli Premier League","UGA","No","3/2/2021","5/31/2024","$130K - $1.3M","Right Only","Weak","Very Strong","5'9""","165 lbs","133","5",101,115,7,8,11,7,10,6,11,6,9,11,10,7,12,9,11,8,12,12,13,11,12,5,9,10,12,10,10,13,10,14,14,8,12,11,12,14,7,15,9,13,11,10,5,1,8,8,11,10,18,1,4,1,1,2,1,2,2,2,3,4
"2529",2000085053,"Kenneth Ssemakula","11/4/2002 (20 years old)","D (C), DM","SC Villa","Uganda Premier League","UGA","No","7/1/2021","6/30/2025","$30K - $95K","Right Only","Very Weak","Very Strong","6'2""","182 lbs","-","-",83,115,9,8,2,6,8,9,11,9,8,11,11,5,16,9,6,10,9,16,11,11,11,5,10,8,11,10,9,11,7,11,6,15,8,8,10,10,11,16,11,11,11,9,11,4,10,3,11,11,19,1,3,1,2,1,2,3,2,2,1,2
"2530",2000085060,"Bobosi Byaruhanga","12/3/2001 (21 years old)","DM, M (C)","Austin II","MLS Next Pro Western Conference","UGA","No","8/31/2022","6/30/2024","$50K - $500K","Right","Weak","Very Strong","6'1""","178 lbs","-","-",92,114,10,9,7,9,12,11,9,11,5,8,13,9,12,9,8,12,9,14,12,12,1,5,9,8,10,11,13,10,12,12,12,10,12,11,12,11,13,13,12,11,10,11,13,11,5,2,11,8,7,3,1,4,4,1,3,4,2,1,2,3
"2531",13222886,"James Begisa","9/27/2002 (20 years old)","D/WB (R)","URA","Uganda Premier League","UGA","No","7/30/2022","6/30/2024","$0","Right","Fairly Strong","Very Strong","6'0""","165 lbs","-","-",80,114,6,10,9,5,11,2,11,9,5,8,14,5,14,10,11,14,10,8,9,16,15,5,11,9,11,10,8,15,9,6,10,10,13,9,10,6,16,12,12,10,11,12,9,9,15,5,11,10,15,1,2,2,2,2,2,3,3,2,1,2
"2532",93024993,"Ronald Mukiibi","9/16/1991 (31 years old)","D (RC), WB (R)","Utsiktens BK","Swedish First Division Elite","UGA","Yes","1/20/2023","12/31/2024","Not for Sale","Right","Weak","Very Strong","6'2""","187 lbs","177","10",95,113,6,9,7,6,11,5,12,7,9,11,12,9,12,11,13,12,13,11,11,11,11,5,6,10,12,11,10,10,10,9,13,13,13,10,12,12,8,9,9,13,10,11,15,8,11,11,11,10,7,2,2,3,2,3,3,3,1,3,1,1
"2533",2000141949,"Donato Okello","1/1/1998 (25 years old)","DM, M (C)","UPDF","Uganda Premier League","UGA","No","7/1/2021","6/30/2024","$0","Right","Fairly Strong","Very Strong","5'8""","145 lbs","-","-",60,112,2,3,7,7,13,5,5,10,2,7,7,5,7,13,8,7,7,7,7,13,3,5,12,5,8,7,11,9,13,13,7,4,8,13,5,3,13,10,9,11,10,8,10,11,6,8,18,10,12,3,1,1,1,2,3,1,3,2,1,3
"2534",13162744,"Taddeo Lwanga","5/21/1994 (29 years old)","DM, M (C)","AS Arta","Djiboutian Premier Division","UGA","No","8/20/2022","6/30/2024","$0","Right","Weak","Very Strong","6'0""","165 lbs","43","1",101,112,7,8,10,7,11,7,10,10,8,12,11,10,13,11,13,12,14,11,10,12,14,6,12,10,12,11,12,14,11,11,12,13,14,11,12,13,12,13,14,12,9,13,8,12,9,7,10,12,11,1,1,3,2,4,3,3,1,1,3,1
"2535",7880453,"Mohamed Hussain","7/31/1980 (42 years old)","D (C)","Al-Ahli Club","Bahrain Premier League","BHR","No","11/10/2020","6/30/2024","$8K - $22K","Left Only","Very Strong","Weak","5'11""","154 lbs","187","6",97,130,5,9,7,6,10,13,14,15,6,13,9,16,14,9,16,10,15,10,8,8,15,6,8,8,14,13,8,15,8,8,14,13,14,9,12,15,7,10,13,12,10,14,5,10,12,4,10,13,12,1,3,2,2,2,4,3,2,1,2,1
"2536",13165676,"Richard Kassaga","7/4/1993 (29 years old)","D (C)","O. Béja","Ligue Professionnelle 1","UGA","No","2/25/2022","6/30/2025","$80K - $800K","Right Only","Weak","Very Strong","6'2""","187 lbs","82","4",109,111,8,8,7,6,9,8,13,7,5,13,13,8,15,10,12,13,10,11,13,11,11,6,1,5,13,12,11,14,12,9,11,12,11,13,16,14,5,16,13,13,12,11,10,7,9,2,8,11,10,1,2,2,1,3,3,1,3,2,3,1
"2537",2000300136,"Brian Mato","8/28/2003 (19 years old)","D/WB (R)","NEC FC","Uganda Premier League","UGA","No","1/25/2023","6/30/2025","$0","Right","Weak","Very Strong","5'10""","156 lbs","-","-",58,110,6,11,7,2,12,4,7,7,6,9,9,5,11,9,6,8,8,7,9,6,12,5,11,8,9,8,9,9,10,13,8,9,10,13,8,6,11,19,8,12,11,9,7,18,6,7,15,11,20,2,2,1,3,1,1,1,3,3,3,3
"2538",13162762,"Ismail Watenga","5/15/1995 (28 years old)","GK","Sundowns","South African Premier Soccer League","UGA","No","1/1/2023","6/30/2024","$0 - $45K","Right","Reasonable","Very Strong","6'0""","167 lbs","23","-",102,110,4,1,1,1,1,8,2,2,1,3,15,2,2,6,8,11,12,5,11,10,3,1,10,3,15,10,9,9,13,8,10,12,10,14,7,8,10,20,11,13,11,11,12,5,10,3,14,14,10,11,11,13,5,15,10,15,5,13,10,15
"2539",93089436,"Alexis Bbakka","9/13/1995 (27 years old)","ST (C)","FC Rosengård","Swedish Second Division South Götaland","UGA","Yes","2/3/2023","11/30/2023","$0 - $10K","Right","Strong","Very Strong","6'0""","171 lbs","202","88",74,110,5,5,9,9,10,7,11,9,5,5,5,7,5,10,10,5,10,8,8,8,12,10,5,10,5,8,5,8,12,7,13,10,11,12,11,13,3,14,12,10,10,7,15,5,6,4,11,10,14,4,3,2,1,1,3,1,2,3,1,2
"2540",2000299339,"Denis Kisiriko","1/24/2006 (17 years old)","ST (C)","URA","Uganda Premier League","UGA","No","6/12/2023","6/30/2025","$0","Right","Fairly Strong","Very Strong","6'0""","163 lbs","-","-",50,110,3,3,6,13,13,1,13,6,1,5,6,6,3,11,5,9,7,9,6,8,6,11,5,13,6,5,4,6,8,7,6,7,10,7,5,6,6,20,11,12,12,9,10,10,10,3,5,10,18,3,2,3,3,1,3,2,3,4,3,4
"2541",13222876,"Bright Anukani","6/26/2000 (22 years old)","AM (RLC)","Vipers SC","Uganda Premier League","UGA","No","7/1/2021","6/30/2024","$22K - $220K","Right Only","Weak","Very Strong","5'8""","141 lbs","-","-",88,110,11,10,12,10,10,9,7,12,8,6,12,11,7,10,10,12,10,11,12,12,11,11,8,11,8,12,13,12,11,12,10,8,12,11,11,8,14,15,12,10,9,11,12,9,7,3,10,10,16,3,2,1,3,2,3,2,3,2,3,2
"2542",13196464,"Allan Okello","7/4/2000 (22 years old)","AM (RC), ST (C)","Vipers SC","Uganda Premier League","UGA","No","6/12/2023","6/30/2024","$26K - $275K","Left Only","Very Strong","Weak","5'8""","136 lbs","33","3",92,110,9,10,12,10,13,10,10,10,4,6,12,8,5,13,9,12,7,11,11,8,16,13,1,9,4,8,13,10,13,14,10,4,10,12,9,7,12,20,12,10,11,11,7,17,7,8,12,12,9,3,1,3,2,1,1,3,2,1,2,1
"2543",2000303391,"Innocent Kitimbo","10/13/2001 (21 years old)","M/AM (C)","Bright Stars","Uganda Premier League","UGA","No","7/1/2022","6/30/2025","$0","Right","Fairly Strong","Very Strong","5'7""","132 lbs","-","-",61,109,4,3,7,11,12,5,5,7,1,7,10,4,7,11,15,7,7,3,7,10,4,11,9,7,4,7,6,11,13,13,5,5,15,13,6,1,12,10,11,12,12,11,12,17,12,8,11,7,11,2,3,2,2,2,3,3,2,2,1,3
"2544",29084506,"Bevis Mugabi","5/1/1995 (28 years old)","D (RC)","Motherwell","cinch Premiership","UGA","No","2/18/2022","5/31/2024","$55K - $550K","Right Only","Weak","Very Strong","6'2""","182 lbs","159","9",104,109,4,8,13,5,10,5,13,7,9,14,5,8,14,8,9,11,15,8,9,10,13,9,8,6,10,12,8,13,13,9,10,17,11,12,10,15,15,6,13,16,13,15,7,12,9,3,12,14,18,1,3,1,3,2,3,4,3,1,2,3
"2545",28121688,"Giosuè Bellagambi","11/8/2001 (21 years old)","GK","Huddersfield","Sky Bet Championship","UGA","Yes","1/26/2022","6/30/2024","$0 - $95K","Right","Fairly Strong","Very Strong","6'3""","169 lbs","32","-",65,109,3,2,1,3,9,3,3,3,3,1,9,4,3,9,12,7,9,10,6,6,4,3,10,1,7,9,8,8,10,12,11,13,12,10,10,10,9,16,12,11,10,12,9,11,6,3,8,12,10,10,9,11,10,9,11,9,8,7,8,13
"2546",23088497,"Abdulwahab Ali","6/4/1984 (39 years old)","M (C), AM (RC)","Muharraq","Bahrain Premier League","BHR","No","6/14/2021","6/30/2024","$3K - $9K","Right","Weak","Very Strong","5'11""","165 lbs","23","1",97,129,6,9,12,11,11,7,11,10,1,1,10,10,5,11,11,11,11,13,9,10,17,15,7,12,7,12,12,12,13,10,9,10,11,11,11,12,11,15,11,12,11,11,7,14,8,7,14,16,9,4,1,4,1,2,2,1,1,3,4,1
"2547",2000038751,"Cryspus Kusiima","1/7/2002 (21 years old)","GK","Kitara","Uganda Premier League","UGA","No","1/17/2023","6/30/2025","$0","Right","Reasonable","Very Strong","6'0""","171 lbs","-","-",70,109,4,1,2,2,2,6,1,1,2,1,8,3,2,7,11,7,9,8,8,13,5,1,6,2,11,8,5,7,10,7,8,6,9,5,4,6,11,15,10,13,11,11,7,10,6,6,10,8,18,10,6,14,9,11,13,14,5,11,10,5
"2548",13167120,"Khalid Aucho","8/8/1993 (29 years old)","DM, M (C)","Young Africans","Tanzanian Mainland Premier Division","UGA","No","8/7/2021","6/30/2025","$95K - $950K","Left","Very Strong","Reasonable","5'11""","163 lbs","159","13",109,109,6,7,9,10,12,8,10,11,8,11,12,10,13,11,6,12,12,13,13,11,11,5,13,10,12,13,12,12,11,12,12,11,14,11,12,13,13,11,11,10,11,9,5,15,8,3,10,12,13,2,4,3,1,1,1,2,4,2,1,2
"2549",2000085049,"Denis Ssenyondwa","4/13/2003 (20 years old)","GK","URA","Uganda Premier League","UGA","No","7/1/2022","6/30/2025","$0","Right Only","Very Weak","Very Strong","6'5""","180 lbs","-","-",62,108,1,3,1,1,1,1,1,3,2,1,9,2,2,1,6,4,14,5,10,12,6,3,4,1,10,5,4,4,12,8,5,15,17,11,1,7,9,12,9,8,13,11,13,12,7,2,11,9,7,9,8,12,5,7,6,10,5,10,8,12
"2550",2000229698,"Elvis Mwanje","3/1/2004 (19 years old)","M/AM (C)","KCCA","Uganda Premier League","UGA","No","9/9/2021","6/30/2027","$0 - $140K","Right","Fairly Strong","Very Strong","6'0""","158 lbs","13","-",66,108,5,5,7,10,13,4,5,7,4,4,12,3,6,12,14,6,7,7,5,7,13,12,11,7,5,6,13,7,13,13,4,10,10,12,5,3,7,13,12,11,11,11,6,4,5,3,7,11,20,1,1,1,2,2,3,2,3,1,2,2
"2551",13176358,"Halid Lwaliwa","8/22/1998 (24 years old)","D (C)","Bregalnica","North Macedonian First League","UGA","No","7/1/2022","6/14/2024","$55K - $550K","Right","Reasonable","Very Strong","5'9""","147 lbs","20","-",96,108,4,2,3,8,9,1,9,8,1,14,8,3,11,5,6,10,10,8,11,13,10,5,10,8,14,8,6,9,14,14,9,5,9,14,14,6,17,20,9,11,11,13,7,9,7,5,13,11,8,2,2,2,1,2,3,1,1,1,2,2
"2552",13109510,"Alex Kakuba","6/12/1991 (32 years old)","D/WB (L)","Alcains","Portuguese Castelo Branco First Division","UGA","No","9/1/2022","6/30/2023","$0","Left Only","Very Strong","Weak","5'10""","156 lbs","181","3",91,108,11,12,10,6,11,7,8,10,11,8,9,8,11,11,13,12,12,9,8,8,13,12,10,11,8,13,9,11,14,14,11,8,15,14,12,7,8,12,12,16,10,10,6,9,8,6,9,12,13,3,3,2,4,1,2,1,2,3,1,3
"2553",2000246520,"Enock Luyima","6/11/2004 (19 years old)","D/WB (L)","Vipers SC","Uganda Premier League","UGA","No","7/1/2022","6/30/2024","$0","Left","Very Strong","Reasonable","6'1""","169 lbs","-","-",53,108,7,13,8,4,11,2,7,5,1,8,9,7,11,9,6,9,8,8,13,8,7,9,14,5,8,7,9,9,10,9,3,14,12,8,9,6,13,16,11,11,11,13,9,6,6,2,10,10,10,3,1,1,1,3,2,1,3,1,1,2
"2554",13219235,"James Jarieko","11/3/2003 (19 years old)","M/AM (C)","Onduparaka","Ugandan Big League","UGA","No","7/1/2021","6/30/2023","$0","Right","Reasonable","Very Strong","5'9""","147 lbs","-","-",60,107,4,7,10,11,14,3,4,7,6,7,9,3,7,14,11,9,7,4,6,12,6,13,13,9,5,7,8,8,9,13,2,6,15,12,9,5,9,10,10,12,11,12,8,3,11,1,15,13,13,3,4,1,2,1,3,1,1,3,2,3
"2555",2000078811,"Edward Kizza","12/17/1998 (24 years old)","ST (C)","Pittsburgh","USSL Championship Eastern Conference","UGA","No","1/13/2023","11/30/2023","$18K - $180K","Right","Reasonable","Very Strong","5'9""","171 lbs","43","7",91,107,10,7,9,12,9,6,11,10,5,7,9,9,6,9,15,11,12,11,12,10,9,12,12,11,8,10,10,11,12,12,14,8,10,11,13,12,10,20,8,9,12,12,11,10,9,2,9,12,9,3,2,2,3,3,1,3,1,1,2,3
"2556",13203600,"Allan Kyambadde","1/15/1996 (27 years old)","AM (RC), ST (C)","El Dakhleya","Egyptian Premier League","UGA","No","9/27/2022","7/31/2024","$35K - $325K","Right","Reasonable","Very Strong","6'0""","163 lbs","58","-",96,106,9,9,14,11,14,9,10,14,2,9,13,6,5,12,12,12,9,7,9,13,19,15,8,13,9,10,8,11,11,13,10,10,12,13,10,5,12,10,12,11,10,12,11,9,9,2,11,11,7,4,2,3,2,1,1,3,2,1,2,1
"2557",23088766,"Mohammed Al-Alawi","10/13/1989 (33 years old)","AM (C), ST (C)","Al-Najma Club","Bahrain Premier League","BHR","No","9/23/2020","6/30/2024","$0 - $9K","Right","Reasonable","Very Strong","5'10""","163 lbs","-","-",87,125,6,5,10,11,10,6,7,10,5,7,13,12,6,11,12,10,12,10,10,12,10,9,11,10,6,14,12,14,10,11,12,7,11,10,11,8,10,10,9,10,13,9,13,12,8,4,13,9,13,2,2,1,1,2,3,3,3,3,1,2
"2558",2000200715,"Travis Mutyaba","8/7/2005 (17 years old)","AM (RLC)","SC Villa","Uganda Premier League","UGA","No","7/1/2021","6/30/2024","$3.5K - $35K","Left Only","Very Strong","Very Weak","5'5""","125 lbs","-","-",80,106,11,11,13,11,12,13,4,12,5,6,12,3,5,13,13,8,8,11,8,5,15,9,3,10,6,11,7,9,14,13,13,5,5,14,10,2,11,11,10,9,10,10,7,4,11,4,16,8,19,1,1,3,3,1,1,3,3,3,1,3
"2559",2000250106,"Shafiq Magogo","3/15/2004 (19 years old)","M/AM (C)","UPDF","Uganda Premier League","UGA","No","7/1/2021","6/30/2025","$0","Right","Reasonable","Very Strong","5'9""","147 lbs","-","-",60,106,3,1,7,8,11,5,5,7,3,4,11,2,8,11,13,3,7,4,7,13,10,11,6,7,6,6,11,4,13,13,6,8,14,13,6,4,10,14,11,10,9,13,12,13,5,8,9,9,17,3,3,1,3,1,3,3,2,3,2,2
"2560",13111022,"Sula Matovu","7/17/1992 (30 years old)","AM (L)","Mirbat","Omani Lower Division","UGA","No","8/3/2021","6/30/2024","$0 - $24K","Left Only","Very Strong","Weak","5'6""","143 lbs","27","7",96,105,7,6,11,10,9,7,9,11,5,4,9,11,5,14,8,7,10,9,11,8,12,10,4,11,8,12,8,11,16,15,12,11,14,16,12,13,9,12,8,7,10,9,9,6,7,7,6,11,9,3,1,3,1,3,3,2,1,3,2,2
"2561",13129883,"Joseph Ochaya","12/14/1993 (29 years old)","D/WB (L)","Arab Contractors","Egyptian Premier League","UGA","No","9/17/2022","7/31/2025","$14K - $130K","Left Only","Very Strong","Weak","6'2""","165 lbs","11","3",97,105,8,13,8,3,10,4,7,2,7,11,7,6,14,10,7,9,11,10,11,15,10,5,10,8,9,10,7,10,13,14,10,12,12,15,8,10,17,14,10,11,11,12,7,10,10,7,11,11,8,3,1,1,3,2,1,1,2,1,2,1
"2562",65039918,"Allan Kateregga","6/3/1994 (29 years old)","M (L), AM (LC)","Eloi-Lupopo","DR Congo Premier Division A","UGA","No","7/31/2020","6/30/2024","$140K - $1.4M","Left","Very Strong","Fairly Strong","5'9""","147 lbs","11","1",102,105,7,11,14,7,13,8,7,7,5,8,10,5,10,12,8,11,5,11,7,11,6,18,5,13,7,9,11,4,15,11,10,9,15,13,10,6,15,16,12,11,10,11,5,16,8,4,20,13,17,2,2,2,3,2,3,1,3,3,1,3
"2563",2000232813,"Denis Kiggundu","5/15/2000 (23 years old)","GK","Vipers SC","Uganda Premier League","UGA","No","7/1/2019","6/30/2025","$18K - $55K","Right","Reasonable","Very Strong","6'1""","165 lbs","-","-",81,105,3,1,2,1,1,7,1,1,1,1,5,1,3,4,11,8,13,4,7,12,5,3,12,1,8,6,2,5,12,13,5,12,6,12,5,4,12,15,9,11,12,12,7,5,11,7,5,10,11,5,5,12,14,5,11,12,5,10,9,12
"2564",49050739,"Kayne Bonnevie","7/22/2001 (21 years old)","GK","OL","French National 3 - Group K","GUY","Yes","6/13/2022","6/30/2026","$6K - $60K","Left Only","Very Strong","Weak","6'3""","196 lbs","-","-",98,134,3,2,3,1,9,6,5,2,3,1,9,3,1,8,10,9,14,10,8,14,13,2,7,2,9,8,5,8,9,10,11,14,12,9,10,11,1,12,11,10,10,12,8,4,14,4,20,12,17,10,9,11,12,12,10,8,5,11,12,13
"2565",28010395,"Matthew Briggs","3/6/1991 (32 years old)","D (LC), WB/M (L)","Horsham","English Isthmian League Premier Division","GUY","No","6/1/2023","-","$0","Left","Very Strong","Reasonable","6'0""","167 lbs","219","8",80,130,6,10,9,8,12,5,8,7,8,11,11,8,10,12,6,9,12,10,10,9,13,10,9,12,11,11,10,10,8,12,11,11,13,11,13,13,12,12,13,11,13,11,11,9,8,3,8,10,11,2,3,2,2,3,3,2,4,1,2,4
"2566",29067788,"Callum Harriott","3/4/1994 (29 years old)","M/AM (RL)","Yeovil","Vanarama National League South","GUY","No","3/21/2023","6/30/2024","$18K - $180K","Left","Very Strong","Reasonable","5'6""","160 lbs","194","31",87,128,12,11,13,11,10,11,3,11,3,5,9,11,6,11,10,9,9,11,9,8,14,12,6,11,6,9,11,11,12,13,11,5,12,12,9,8,11,8,12,8,8,12,14,10,5,5,11,10,15,3,1,4,1,3,3,3,3,2,3,4
"2567",28122939,"Nathan Moriah-Welsh","3/18/2002 (21 years old)","D (R), M/AM (RC)","Bournemouth","English Premier Division","GUY","No","8/1/2021","6/30/2024","$24K - $250K","Right","Reasonable","Very Strong","5'8""","152 lbs","38","3",87,125,7,5,10,8,10,5,6,5,3,6,10,7,8,9,7,9,9,8,9,9,12,12,8,9,9,12,10,13,14,11,10,7,12,12,12,10,11,18,12,10,11,10,6,15,5,7,8,12,16,1,2,2,3,1,2,1,1,1,1,3
"2568",1020291,"Sayed Jaffar","8/25/1985 (37 years old)","GK","Muharraq","Bahrain Premier League","BHR","No","7/16/2022","6/30/2024","$500 - $4K","Right Only","Weak","Very Strong","6'3""","167 lbs","-","-",103,123,3,3,3,3,8,4,2,1,1,2,5,2,3,4,5,12,8,9,12,11,2,2,11,2,13,11,10,9,11,12,11,12,14,10,10,12,10,17,10,8,12,13,9,7,8,1,17,9,8,11,8,14,7,12,11,13,13,13,11,10
"2569",28111383,"Stephen Duke-McKenna","8/17/2000 (22 years old)","M (C), AM (RLC)","QPR","Sky Bet Championship","GUY","Yes","8/27/2019","6/30/2026","$70K - $700K","Right","Reasonable","Very Strong","5'7""","143 lbs","39","3",99,125,10,12,12,7,9,13,5,8,9,8,10,7,8,12,14,11,12,11,10,9,12,12,1,12,7,12,11,13,12,11,13,7,12,13,11,7,18,4,10,8,11,12,6,11,12,6,10,10,15,2,1,2,1,2,1,4,2,3,1,3
"2570",28116315,"Bayli Spencer-Adams","6/26/2001 (21 years old)","D (C)","Leicester","Sky Bet Championship","GUY","No","10/15/2021","6/30/2026","$2.5K - $26K","Right","Weak","Very Strong","6'3""","191 lbs","8","-",85,120,7,5,3,6,6,4,14,6,7,10,8,4,10,8,10,9,9,7,10,8,11,5,14,4,10,12,9,11,11,9,8,14,9,12,12,13,18,17,11,11,12,10,9,6,13,4,18,11,15,3,3,1,3,1,3,2,4,3,3,2
"2571",2000087109,"Omari Glasgow","11/22/2003 (19 years old)","WB/M (R), AM (RL), ST (C)","Chicago II","MLS Next Pro Eastern Conference","GUY","No","3/24/2022","12/31/2024","$1.2M - $2.6M","Right Only","Weak","Very Strong","5'9""","152 lbs","21","8",87,118,12,12,10,14,14,7,8,8,6,4,14,13,7,11,9,9,7,8,6,7,10,11,1,8,7,5,6,10,15,12,10,7,12,12,8,8,10,19,12,12,12,9,10,10,9,4,3,12,14,1,3,4,1,2,2,3,2,2,3,1
"2572",29179318,"Terence Vancooten","12/29/1997 (25 years old)","D (RC), DM","Stevenage","Sky Bet League One","GUY","No","6/15/2020","6/30/2024","$35K - $350K","Right","Fairly Strong","Very Strong","6'4""","169 lbs","153","-",97,115,5,5,9,5,9,4,12,5,7,12,11,7,13,10,11,11,10,15,9,9,12,9,6,7,12,11,10,11,12,10,12,14,10,12,11,12,9,13,11,10,8,10,14,9,6,4,11,10,10,2,1,2,3,2,4,1,3,1,1,2
"2573",223133,"Elliot Bonds","3/23/2000 (23 years old)","DM, M (C)","Cheltenham","Sky Bet League One","GUY","No","7/19/2022","6/30/2025","$180K - $550K","Left","Very Strong","Reasonable","5'10""","165 lbs","96","4",90,115,10,12,10,8,10,6,9,10,6,10,12,4,12,7,10,10,11,12,10,11,16,5,6,10,10,10,11,12,12,11,9,9,14,12,10,11,8,20,11,10,14,11,4,14,6,4,10,10,17,1,3,2,3,3,1,3,2,3,1,2
"2574",89061100,"Liam Gordon","5/15/1999 (24 years old)","D/WB (L)","Walsall","Sky Bet League Two","GUY","No","7/1/2022","6/30/2024","$24K - $250K","Left Only","Very Strong","Weak","6'0""","167 lbs","145","13",94,110,7,10,10,8,11,7,9,10,10,8,9,4,10,11,9,9,14,10,11,9,7,9,7,10,10,13,10,13,14,13,10,8,12,14,12,9,12,6,5,9,8,8,5,8,7,2,11,8,6,2,2,3,2,2,3,1,2,2,3,4
"2575",28025342,"David Stephens","10/8/1991 (31 years old)","D (C)","Boreham Wood","Vanarama National League","GUY","No","3/10/2022","6/30/2024","$0 - $22K","Right Only","Very Weak","Very Strong","6'4""","202 lbs","369","8",71,107,1,2,6,4,5,2,14,2,4,15,5,7,12,3,10,7,9,9,10,3,11,1,12,4,15,12,5,10,5,10,14,17,5,6,6,17,1,14,14,13,12,17,12,4,7,2,12,12,8,3,1,2,1,3,3,4,2,3,1,3
"2576",82083819,"Jeremy Garrett","1/1/2000 (23 years old)","D (C)","GDF","Guyanese Elite League","GUY","No","1/1/2021","6/30/2025","$3.5K - $35K","Right","Reasonable","Very Strong","6'0""","174 lbs","-","-",80,105,2,1,1,2,7,1,12,5,1,9,7,4,13,5,13,12,9,7,11,9,18,5,14,6,9,11,3,13,11,10,9,10,15,11,11,12,16,14,12,17,13,10,5,16,5,2,13,16,12,3,2,2,1,3,3,2,2,3,1,2
"2577",82003209,"Gregory Richardson","6/16/1982 (40 years old)","AM (LC), ST (C)","Fruta Conquerors","Guyanese Elite League","GUY","No","7/1/2018","6/30/2024","$2.5K - $8K","Right","Weak","Very Strong","5'7""","156 lbs","55","14",70,104,8,8,11,10,10,8,9,6,8,6,8,6,7,11,15,9,12,9,9,8,12,12,8,12,7,10,9,13,12,9,12,7,13,12,10,8,10,14,11,12,11,9,8,11,7,2,9,12,9,2,2,1,2,4,1,1,2,1,1,2
"2578",82001903,"Shawn Bishop","9/15/1979 (43 years old)","DM, M (C)","Alpha Utd","Guyanese Regional Member Associations","GUY","No","6/14/2021","6/30/2024","$500 - $3K","Right","Reasonable","Very Strong","5'9""","152 lbs","-","-",79,104,6,5,6,6,16,8,9,7,5,13,12,5,14,16,5,9,9,11,9,12,14,5,9,10,13,10,12,13,6,6,6,6,13,6,8,6,12,12,11,13,10,9,10,6,13,5,12,11,18,1,1,2,3,1,1,4,3,4,1,1
"2579",23087760,"Fahad Shwaiter","1/18/1990 (33 years old)","M/AM (R)","Muharraq","Bahrain Premier League","BHR","No","6/14/2021","6/30/2024","$0 - $7K","Right","Weak","Very Strong","5'7""","141 lbs","-","-",82,120,7,6,11,7,10,7,6,5,10,7,9,10,8,10,8,8,11,10,10,8,15,11,5,9,8,11,9,11,12,13,4,5,11,14,10,4,12,20,12,10,12,17,10,12,10,8,10,16,13,3,2,1,1,1,3,4,1,1,3,1
"2580",20045025,"Jordan Dover","12/14/1994 (28 years old)","D/WB/M (R)","Simcoe County Rovers FC","League1 Ontario","GUY","No","11/30/2021","-","$0","Right Only","Weak","Very Strong","5'8""","152 lbs","147","6",94,104,9,11,10,6,9,9,5,4,9,10,8,7,15,11,6,11,10,8,9,8,4,5,9,10,11,8,9,13,14,14,10,8,12,12,13,9,14,18,11,10,11,13,7,19,7,4,20,10,11,2,1,2,1,3,2,1,3,3,3,2
"2581",20020037,"Quillan Roberts","9/13/1994 (28 years old)","GK","Western Suburbs","New Zealand Central League","GUY","No","3/7/2023","-","$0","Right Only","Weak","Very Strong","6'0""","194 lbs","98","-",86,102,2,3,3,1,5,3,1,2,2,2,7,3,1,6,5,11,12,8,10,14,16,1,12,1,11,8,7,7,12,10,13,10,17,9,7,14,9,18,11,9,12,12,8,11,10,2,20,12,19,9,11,11,14,9,9,9,14,10,12,10
"2582",42101871,"Gideon Akkauwa","8/15/2000 (22 years old)","D (C), DM, M (C)","Maccabi Petach-Tikva","Israeli Premier League","GUY","No","7/10/2022","-","$9K - $90K","Right","Reasonable","Very Strong","5'11""","167 lbs","131","3",90,101,6,7,6,4,11,8,9,10,5,13,13,3,14,10,9,12,9,9,8,10,17,5,11,9,10,9,9,13,11,11,5,11,13,11,13,10,14,12,12,11,14,11,5,7,11,8,12,13,9,1,2,2,2,3,1,1,1,1,2,2
"2583",2000260325,"Tyrice Dennis","3/26/2004 (19 years old)","M/AM (R)","Agatash Utd","Guyanese Regional Member Associations","GUY","No","7/1/2021","-","$0","Right","Reasonable","Very Strong","5'6""","123 lbs","-","-",72,98,6,11,8,9,13,7,5,4,4,7,12,7,6,8,10,9,8,7,8,13,13,8,10,7,7,8,10,13,12,10,8,2,13,11,11,1,12,10,11,12,12,12,10,4,8,3,15,11,17,1,1,2,3,3,1,3,4,2,4,2
"2584",2000087030,"Nicolai Andrews","4/8/2002 (21 years old)","D (C)","Santos (GUY)","Guyanese Elite League","GUY","No","7/1/2020","6/30/2025","$0 - $80K","Right","Reasonable","Very Strong","6'0""","167 lbs","-","-",67,97,1,3,1,2,5,1,12,5,1,13,6,1,12,4,8,12,8,5,5,12,11,5,10,5,13,5,1,6,12,10,6,7,12,8,3,8,12,13,12,11,12,13,5,1,5,4,10,13,18,2,3,3,3,3,2,4,1,3,1,1
"2585",72039083,"Emery Welshman","11/9/1991 (31 years old)","AM (RL), ST (C)","Sigma FC","League1 Ontario","GUY","No","12/31/2022","-","$0","Right","Reasonable","Very Strong","5'11""","180 lbs","190","47",88,96,8,9,10,12,9,8,9,9,10,5,9,7,4,9,8,6,9,6,5,7,12,12,4,11,10,10,9,10,15,10,14,10,9,13,13,14,12,13,9,13,10,8,15,13,10,4,11,9,16,2,2,1,2,3,4,3,3,3,2,2
"2586",30001293,"Pernell Schultz","4/7/1994 (29 years old)","AM (RC), ST (C)","Police (GUY)","Guyanese Elite League","GUY","No","7/1/2020","6/30/2024","$35K - $100K","Right","Reasonable","Very Strong","6'1""","160 lbs","-","-",84,95,6,6,12,13,9,6,7,8,4,5,13,5,5,13,9,9,5,7,7,11,2,13,10,10,7,7,10,8,13,13,7,7,17,13,13,5,8,12,9,11,12,11,5,3,5,3,8,12,14,3,1,2,3,3,2,2,4,1,2,2
"2587",2000164314,"Sese Norville","8/5/2000 (22 years old)","GK","Milerock","Guyanese Elite League","GUY","No","6/15/2020","6/30/2024","$0 - $65K","Right","Weak","Very Strong","6'0""","163 lbs","15","-",70,95,3,2,1,1,1,5,1,2,2,3,7,3,1,2,6,10,9,7,12,13,6,2,1,2,12,7,6,6,10,14,7,6,13,11,4,5,11,13,12,11,9,13,8,17,15,6,13,13,9,6,6,13,5,5,12,13,5,8,8,8
"2588",45038987,"Trayon Bobb","11/5/1993 (29 years old)","M/AM (L)","Uitvlugt Warriors","Guyanese Regional Member Associations","GUY","No","6/1/2023","-","$0","Left","Very Strong","Fairly Strong","5'6""","147 lbs","35","2",80,95,8,11,12,13,13,6,2,7,3,4,8,2,7,13,14,8,8,6,7,7,8,13,6,9,5,7,6,5,15,13,6,2,14,14,6,7,13,10,10,13,11,11,10,13,5,7,19,13,7,1,1,2,3,3,1,2,2,3,1,2
"2589",82083828,"Kelsey Benjamin","12/15/2000 (22 years old)","M/AM (L), ST (C)","GDF","Guyanese Elite League","GUY","No","7/1/2020","6/30/2025","$0 - $110K","Left","Very Strong","Fairly Strong","5'7""","143 lbs","-","-",78,95,7,9,12,14,10,7,8,8,7,7,14,5,8,11,8,8,8,10,7,8,14,15,7,11,6,8,7,9,14,10,8,5,12,14,6,5,10,18,9,14,10,11,5,11,6,1,16,11,15,3,3,2,4,2,1,2,2,2,2,2
"2590",29199844,"Hashim Sayed","4/3/1998 (25 years old)","ST (C)","Riffa","Bahrain Premier League","BHR","No","6/18/2019","6/30/2023","$0","Right","Fairly Strong","Very Strong","5'10""","163 lbs","-","-",90,118,6,3,13,13,13,7,13,7,5,6,8,6,1,13,15,8,9,10,8,8,10,13,7,13,8,7,6,8,13,13,8,7,12,13,13,13,11,18,10,14,11,10,13,11,5,8,12,14,15,3,1,2,1,3,1,3,1,2,3,2
"2591",28067792,"Anthony Jeffrey","10/3/1994 (28 years old)","AM (RL), ST (C)","Billericay","English Isthmian League Premier Division","GUY","No","7/1/2022","6/30/2024","$0","Right Only","Very Weak","Very Strong","5'9""","156 lbs","192","16",75,95,6,5,12,6,6,5,3,7,4,2,7,4,5,5,9,5,4,6,6,8,9,14,2,11,2,7,5,15,16,13,10,4,11,16,6,13,5,5,5,7,5,4,12,6,7,16,8,7,8,1,4,2,2,3,2,3,3,1,3,1
"2592",2000203760,"Nicholai Andrews","11/3/2002 (20 years old)","D/WB (L)","Santos (GUY)","Guyanese Elite League","GUY","No","7/1/2019","6/30/2025","$0 - $70K","Left","Very Strong","Reasonable","5'10""","154 lbs","-","-",68,94,6,11,4,1,13,4,8,5,3,9,9,4,15,9,14,9,9,8,11,12,14,5,5,6,7,8,3,8,13,10,8,8,14,10,8,7,12,20,10,10,11,13,5,9,8,2,11,11,12,2,1,3,2,1,1,1,3,4,2,4
"2593",20501433,"Jonathan Grant","10/15/1993 (29 years old)","D/WB/M (R)","York United FC","Canadian Premier League","GUY","No","3/8/2023","11/30/2023","$30K - $90K","Right Only","Weak","Very Strong","6'2""","171 lbs","105","9",86,94,6,9,8,6,7,9,10,6,9,11,10,6,12,9,11,10,13,10,8,9,11,6,11,10,11,12,9,12,11,12,12,10,10,11,10,15,7,18,12,9,13,11,14,7,7,5,11,12,14,3,2,3,3,3,2,3,1,2,3,4
"2594",2000272414,"Marcus Wilson","4/19/2002 (21 years old)","D/WB/M/AM (R)","Santos (GUY)","Guyanese Elite League","GUY","No","7/1/2020","6/30/2025","$0","Right","Reasonable","Very Strong","5'9""","152 lbs","-","-",78,94,5,8,7,14,8,7,7,6,6,8,12,7,9,9,8,10,8,9,8,12,7,11,11,9,5,8,6,9,14,14,8,7,14,14,5,8,16,14,11,10,12,11,14,8,10,7,13,11,10,2,3,1,2,1,2,1,2,2,2,3
"2595",45024735,"Kelvin Smith","7/20/1985 (37 years old)","D (C)","Matura","TT Premier Football League Tier 2","GUY","No","6/14/2021","6/30/2024","$0","Right","Fairly Strong","Very Strong","6'4""","185 lbs","-","-",65,93,2,1,3,2,7,1,11,5,4,10,6,1,13,3,15,9,8,7,9,14,18,6,7,6,8,6,6,7,6,4,7,16,13,8,6,7,12,12,8,10,9,11,11,5,10,6,8,12,10,3,2,3,3,2,1,1,3,2,3,3
"2596",2000203753,"Ronaldo Blair","9/13/2003 (19 years old)","GK","Caledonia Utd","TT Premier Football League Tier 1","GUY","No","1/1/2023","6/30/2024","$5K - $14K","Right","Reasonable","Very Strong","6'5""","185 lbs","-","-",78,92,2,2,1,1,1,6,1,1,2,3,5,2,2,4,10,7,15,7,11,14,19,2,6,3,8,8,7,7,11,13,7,14,13,6,2,6,9,14,11,10,9,11,14,1,5,5,6,11,15,9,13,14,15,6,7,9,5,9,6,14
"2597",82003103,"Anthony Abrams","10/3/1979 (43 years old)","ST (C)","Fruta Conquerors","Guyanese Elite League","GUY","No","6/14/2021","6/30/2024","$0 - $2K","Either","Very Strong","Very Strong","5'11""","160 lbs","22","14",65,90,7,5,5,15,14,7,15,8,1,6,8,6,1,9,5,12,4,14,6,11,15,7,7,11,8,7,6,8,5,5,5,12,14,5,5,5,9,17,10,10,10,13,7,16,15,1,19,11,15,2,1,2,3,3,1,1,2,3,3,3
"2598",2000087037,"Ryan Hackett","9/11/1999 (23 years old)","M (L), AM (LC)","GDF","Guyanese Elite League","GUY","No","1/2/2021","6/30/2025","$30K - $95K","Left","Very Strong","Fairly Strong","5'10""","154 lbs","-","-",71,90,5,8,8,11,11,5,1,5,3,5,9,7,7,9,10,7,4,6,7,12,15,10,11,10,5,7,5,11,12,12,6,5,10,12,6,3,13,17,9,13,13,12,5,3,5,1,6,13,8,3,2,2,4,1,2,3,1,2,3,3
"2599",82083859,"Denzil Fordyce","10/23/1997 (25 years old)","M (L), AM (RL), ST (C)","Brittons Hill","BFA Digicel Premier League","GUY","No","6/15/2020","12/31/2024","$0 - $1.5K","Left","Very Strong","Fairly Strong","5'6""","132 lbs","-","-",67,90,6,11,7,7,8,5,7,2,3,4,12,2,4,9,15,7,7,9,6,6,9,9,6,10,5,6,5,7,13,13,6,3,12,13,12,3,9,18,10,11,11,10,9,9,8,8,7,13,10,2,2,1,2,2,1,2,2,2,2,3
"2600",82000278,"Walter Moore","9/1/1984 (38 years old)","D/WB (L)","FF Jaro","Finnish First Division","GUY","No","4/1/2023","11/30/2024","Not for Sale","Left Only","Very Strong","Very Weak","5'10""","156 lbs","193","12",80,90,12,10,12,7,10,10,7,8,4,11,8,5,9,11,13,12,10,9,9,9,10,12,12,8,11,10,11,10,13,12,10,11,10,10,11,10,9,6,10,8,5,8,5,5,8,5,10,5,15,1,2,4,1,2,1,1,3,1,1,1
"2601",23035747,"Abbas Ayyad","5/11/1987 (36 years old)","D/WB (RL)","Al-Ahli Club","Bahrain Premier League","BHR","No","6/10/2023","6/30/2024","$0 - $2.5K","Right","Strong","Very Strong","5'11""","156 lbs","-","-",94,118,9,8,11,5,8,7,5,8,12,8,9,8,12,10,11,12,12,8,11,11,16,10,8,10,7,11,7,13,13,13,7,7,14,13,13,6,13,13,12,9,11,11,9,12,8,7,12,10,13,1,3,1,1,3,3,2,1,4,3,3
"2602",2000203852,"Jemar Harrigan","4/6/2002 (21 years old)","AM (L)","Police (GUY)","Guyanese Elite League","GUY","No","7/1/2021","6/30/2025","$0 - $100K","Left","Very Strong","Reasonable","5'8""","143 lbs","-","-",70,88,7,11,12,9,12,5,5,6,5,5,10,6,6,10,10,5,6,7,1,9,8,11,11,9,5,6,7,10,12,12,6,3,12,12,6,4,10,19,11,10,9,11,5,7,13,3,12,10,11,1,1,2,3,3,2,1,1,1,3,2
"2603",37064529,"Jari Koenraat","9/26/1995 (27 years old)","M/AM (R)","Achilles Veen","Dutch Vierde Divisie C","GUY","Yes","7/1/2022","-","$0","Right","Weak","Very Strong","6'3""","178 lbs","51","15",77,88,8,8,8,6,7,7,12,6,9,5,10,7,6,9,6,7,7,6,7,9,8,11,6,9,6,10,10,11,12,10,9,13,10,11,13,12,7,12,12,11,11,11,9,8,6,7,6,10,20,3,2,3,1,3,2,3,1,1,1,2
"2604",82071612,"Jamaal Harvey","8/8/1994 (28 years old)","M (RC), AM (R)","Caledonia Utd","TT Premier Football League Tier 1","GUY","No","6/15/2020","6/30/2024","$0","Right","Reasonable","Very Strong","6'2""","171 lbs","1","-",72,86,6,10,11,12,12,5,5,7,3,3,10,4,7,12,9,5,1,4,6,12,8,13,2,8,5,6,8,11,12,12,6,8,9,12,12,5,13,19,13,9,10,11,11,10,6,3,20,11,14,3,1,2,1,2,3,3,3,3,3,1
"2605",2000087022,"Shawn Adonis","5/14/2002 (21 years old)","GK","Slingerz","Guyanese Regional Member Associations","GUY","No","7/1/2022","6/30/2024","$0 - $50K","Right","Weak","Very Strong","6'2""","171 lbs","-","-",71,85,2,2,2,1,1,7,1,2,1,1,7,3,3,1,11,7,15,7,10,13,14,1,10,1,8,7,4,6,12,10,7,7,12,13,1,6,12,20,10,10,11,14,11,5,5,1,11,7,15,8,6,13,12,9,7,13,5,11,7,7
"2606",30001253,"Sheldon Holder","9/30/1991 (31 years old)","ST (C)","Caledonia Utd","TT Premier Football League Tier 1","GUY","No","6/14/2021","6/30/2024","$2K - $6K","Right","Reasonable","Very Strong","6'6""","205 lbs","-","-",80,85,2,6,13,13,13,5,13,7,5,5,7,6,1,13,9,11,8,10,7,9,14,13,13,13,6,6,6,7,11,8,2,15,5,8,10,10,8,15,10,10,8,11,7,4,10,5,11,9,7,1,2,4,1,3,3,3,3,3,2,1
"2607",82071622,"Kareem Knights","10/31/1996 (26 years old)","M/AM (C)","Georgetown","Guyanese Regional Member Associations","GUY","No","6/15/2020","-","$0","Right","Reasonable","Very Strong","6'2""","165 lbs","3","-",70,83,5,4,7,8,12,5,3,9,1,4,12,3,5,11,9,8,4,4,6,8,15,12,10,9,7,6,9,11,12,11,6,12,15,11,12,4,14,14,12,11,11,14,10,5,5,7,9,9,9,3,1,3,1,2,3,2,3,3,2,3
"2608",82077196,"Kevin Laybe","1/1/1998 (25 years old)","D (C)","Caledonia Utd","TT Premier Football League Tier 1","GUY","No","6/15/2020","6/30/2024","$0","Right","Fairly Strong","Very Strong","6'1""","160 lbs","-","-",68,82,1,1,1,1,4,1,13,1,1,13,6,1,13,1,13,11,8,5,7,11,8,5,9,5,10,5,1,6,13,8,6,10,15,12,7,4,10,12,8,12,12,11,7,5,6,4,14,11,7,4,3,3,2,1,3,3,3,3,1,3
"2609",2000087033,"Jobe Caesar","1/16/2000 (23 years old)","M/AM (R)","GDF","Guyanese Elite League","GUY","No","7/1/2019","6/30/2025","$30K - $95K","Right","Reasonable","Very Strong","5'10""","154 lbs","-","-",72,82,5,10,12,9,7,3,1,3,5,5,7,4,4,12,7,7,7,7,6,8,4,13,8,11,5,6,7,10,12,12,6,5,5,12,12,3,9,7,8,8,9,8,7,13,15,12,12,14,20,3,2,3,2,2,1,1,2,1,2,3
"2610",30001209,"Quincy Adams","1/7/1989 (34 years old)","D (RC), WB (R)","Slingerz","Guyanese Regional Member Associations","GUY","No","6/1/2022","6/30/2024","$2.5K - $8K","Right","Reasonable","Very Strong","5'10""","158 lbs","-","-",74,80,5,12,6,5,9,2,11,2,7,8,6,1,14,8,7,9,9,6,8,14,5,5,9,5,8,8,3,8,8,11,8,7,16,10,9,7,12,15,11,11,10,11,11,17,8,7,10,9,8,4,3,3,3,1,3,3,3,3,3,4
"2611",82083804,"Alex Murray","10/21/1992 (30 years old)","GK","Caledonia Utd","TT Premier Football League Tier 1","GUY","No","8/1/2019","6/30/2024","$0 - $6K","Right","Fairly Strong","Very Strong","6'0""","165 lbs","9","-",80,80,2,3,1,2,3,7,1,3,2,3,8,2,2,2,10,9,15,7,8,13,9,2,9,3,11,7,6,6,13,5,6,5,13,12,6,6,11,19,12,9,12,13,7,11,8,2,10,8,10,9,7,13,9,9,12,13,5,8,8,8
"2612",47071177,"Artur Dolznikov","6/6/2000 (23 years old)","AM (RL), ST (C)","Kauno Žalgiris","Lithuanian A League","LTU","Yes","1/1/2023","12/31/2023","$140K - $425K","Right","Reasonable","Very Strong","5'9""","134 lbs","124","17",90,100,7,9,13,10,13,7,9,8,4,6,13,7,4,12,6,8,8,11,8,12,15,12,13,10,7,8,7,9,13,13,7,7,14,13,7,6,11,20,10,9,10,11,14,3,5,4,12,11,16,2,2,4,1,3,1,1,2,1,1,3
"2613",23035761,"Abbas Ahmed","6/13/1983 (39 years old)","GK","Sitra","Bahrain Premier League","BHR","No","7/8/2022","6/30/2024","$1.5K - $5K","Right Only","Weak","Very Strong","5'11""","178 lbs","-","-",80,117,3,2,3,1,6,4,1,1,1,3,9,3,3,4,10,7,13,7,9,13,8,1,13,1,10,11,6,6,5,7,3,12,9,5,1,12,11,19,10,8,12,11,12,14,6,2,20,10,8,10,11,11,8,12,10,12,5,11,10,10
"2614",30001300,"Daniel Wilson","11/1/1993 (29 years old)","M/AM (C), ST (C)","Western Tigers","Guyanese Elite League","GUY","No","7/1/2021","6/30/2025","$0 - $95K","Right","Reasonable","Very Strong","6'2""","160 lbs","26","3",80,80,6,6,10,7,10,6,8,7,1,7,12,4,6,10,15,11,8,6,7,10,12,15,13,12,6,7,11,8,13,10,7,11,15,11,13,6,13,16,10,14,11,10,5,3,10,12,12,12,15,3,3,2,1,1,3,3,2,2,3,1
"2615",30001301,"Akel Clarke","10/25/1988 (34 years old)","GK","Slingerz","Guyanese Regional Member Associations","GUY","No","1/1/2023","6/30/2024","$9K - $26K","Right","Reasonable","Very Strong","6'2""","169 lbs","26","-",80,80,4,3,2,2,5,7,1,1,1,2,10,3,1,2,8,12,14,5,12,8,9,3,12,2,9,8,7,3,10,6,8,14,16,8,3,5,10,18,10,9,13,12,5,14,10,1,11,12,13,11,5,11,5,5,9,14,9,13,9,14
"2616",2000203754,"Shemar Fraser","6/3/1998 (25 years old)","D (C)","Police (GUY)","Guyanese Elite League","GUY","No","7/1/2021","6/30/2025","$0 - $100K","Right","Reasonable","Very Strong","6'2""","171 lbs","16","2",74,80,2,4,1,4,6,1,10,2,1,12,6,1,11,1,7,7,8,4,9,12,8,5,5,5,12,5,1,7,12,12,6,12,12,12,12,5,12,18,11,15,13,11,11,7,6,1,10,13,16,3,2,3,1,1,4,1,2,2,1,2
"2617",82003097,"Devon Millington","12/11/1983 (39 years old)","AM (R), ST (C)","Western Tigers","Guyanese Elite League","GUY","No","6/14/2021","6/30/2024","$2K - $6K","Right","Reasonable","Very Strong","5'11""","165 lbs","-","-",65,80,7,10,7,15,15,7,11,5,1,7,10,9,7,15,8,10,5,10,8,12,8,13,10,14,6,7,6,9,7,7,7,9,11,7,7,7,8,10,10,11,11,10,10,15,5,5,20,12,13,1,1,1,2,2,2,1,3,3,1,1
"2618",2000164310,"Chris Macey","12/16/1999 (23 years old)","ST (C)","GDF","Guyanese Elite League","GUY","No","7/1/2020","6/30/2025","$0 - $90K","Right","Fairly Strong","Very Strong","5'9""","156 lbs","-","-",72,80,5,2,12,12,12,5,12,4,3,2,6,8,2,7,5,7,7,10,4,10,9,11,9,10,5,5,6,6,12,11,8,7,13,10,7,8,11,16,10,13,11,13,6,14,12,5,10,10,7,1,2,2,3,1,3,1,1,4,2,2
"2619",2000203762,"Leo Lovell","12/6/1996 (26 years old)","WB/M/AM (L)","Den Amstel","Guyanese Elite League","GUY","No","7/1/2019","6/30/2024","$0 - $75K","Left","Very Strong","Reasonable","5'3""","121 lbs","-","-",75,80,6,11,10,9,13,6,6,5,6,6,10,4,8,13,8,8,5,4,6,13,10,13,14,10,7,7,7,8,13,13,8,2,8,13,8,1,14,10,9,11,9,10,5,11,5,8,13,12,19,2,3,2,1,2,2,3,2,2,1,2
"2620",2000302501,"Winilson Lopes","3/28/2007 (16 years old)","AM (RL)","Sporting CP","Portuguese Premier League","STP","No","6/13/2022","6/30/2026","$450K - $1.4M","Right Only","Weak","Very Strong","5'11""","154 lbs","-","-",72,133,7,9,12,8,10,6,7,6,5,5,9,4,6,12,9,10,8,9,8,8,11,15,7,11,6,9,10,9,13,12,9,8,13,12,8,9,13,10,12,12,8,11,9,9,7,7,10,14,18,2,2,1,2,1,1,1,3,3,3,4
"2621",55014715,"Luís Leal","5/29/1987 (36 years old)","AM (RL), ST (C)","Arsenal (Sarandí)","Argentine Premier Division","STP","Yes","1/22/2023","12/31/2024","Not for Sale","Right","Reasonable","Very Strong","5'9""","165 lbs","397","122",114,130,9,8,11,13,11,12,14,13,7,6,11,14,7,11,11,11,11,13,9,12,12,13,7,13,7,9,9,13,12,12,14,11,14,12,12,13,13,14,14,11,13,13,7,10,8,5,8,11,13,2,1,1,3,2,1,1,2,1,1,3
"2622",55067778,"Harramiz","8/3/1990 (32 years old)","AM (RL), ST (C)","Torreense","Portuguese Second League","STP","Yes","1/31/2023","6/30/2024","$50K - $500K","Right","Reasonable","Very Strong","5'11""","160 lbs","350","84",110,119,7,8,13,13,10,7,12,11,4,6,10,12,7,12,13,11,13,7,11,11,12,14,11,12,7,10,11,12,14,12,13,10,14,14,11,11,13,10,12,11,10,7,5,11,10,9,13,11,11,3,1,3,2,3,3,2,2,1,2,3
"2623",2000075049,"Ricardo Fernandes","8/28/2002 (20 years old)","D/WB (L)","Estoril Praia","Portuguese Premier League","STP","Yes","8/1/2022","6/30/2024","$210K - $650K","Left Only","Very Strong","Weak","5'8""","147 lbs","5","-",82,116,3,10,12,6,11,1,7,4,7,9,9,6,14,13,12,8,8,8,7,13,13,5,8,6,7,8,9,9,14,13,8,2,11,14,13,6,10,16,10,10,11,9,13,6,12,7,10,12,14,3,1,3,3,3,3,3,1,2,3,3
"2624",23087890,"Abdulla Abdo","3/27/1988 (35 years old)","AM (RLC)","Manama","Bahrain Premier League","BHR","No","9/10/2022","6/30/2024","$0 - $9K","Left Only","Very Strong","Weak","5'7""","149 lbs","18","7",95,115,10,12,13,8,12,12,4,11,1,3,12,11,4,13,11,12,11,9,12,13,16,15,8,11,8,14,13,11,12,14,6,4,12,14,13,4,11,13,14,15,12,11,14,15,11,8,15,16,15,3,3,2,3,2,3,3,1,1,1,3
"2625",83334902,"Ronaldo Lumungo","7/11/2001 (21 years old)","AM (RL)","Benfica CB","Portugal Championship - Group C","STP","No","8/20/2022","6/30/2024","$0 - $35K","Right Only","Weak","Very Strong","5'10""","158 lbs","67","15",85,112,6,10,11,10,10,6,8,8,5,5,9,12,8,12,9,9,10,8,7,9,12,13,4,10,7,12,8,12,13,13,9,8,13,14,11,8,11,11,10,9,7,8,6,9,8,9,12,13,10,3,1,2,2,2,2,1,3,3,2,2
"2626",83278602,"Gué","9/23/2001 (21 years old)","AM (RL), ST (C)","Skellefteå FF","Swedish Second Division Norrland","STP","Yes","1/27/2023","11/30/2023","$0 - $12K","Right Only","Weak","Very Strong","5'7""","160 lbs","55","25",78,110,4,6,11,9,8,5,6,8,5,3,7,8,7,9,11,6,11,7,8,8,13,12,4,11,5,10,6,10,14,14,8,6,11,13,11,7,8,9,10,10,10,8,10,3,9,5,9,10,12,2,4,1,2,2,2,2,2,3,1,4
"2627",2000104467,"Rogério Fernandes","8/28/2002 (20 years old)","D/WB/M (R)","Praiense","Portuguese Azores League","STP","Yes","1/30/2023","-","$0","Right Only","Weak","Very Strong","5'7""","136 lbs","22","1",79,110,9,11,12,8,11,6,5,7,10,8,8,5,8,11,11,8,11,8,6,7,12,10,6,11,7,10,7,11,13,13,8,5,11,13,13,6,12,13,12,11,12,9,5,13,12,4,12,11,9,1,2,2,3,3,1,2,3,3,3,3
"2628",55082786,"Marcos Barbeiro","7/29/1995 (27 years old)","D/WB (R), AM (RC)","Real","Portugal Championship - Group D","STP","Yes","7/1/2019","6/30/2024","$12K - $120K","Right Only","Weak","Very Strong","5'8""","127 lbs","216","22",93,109,8,10,11,9,12,8,8,8,5,6,10,10,4,12,8,11,10,12,8,9,11,13,7,13,7,11,11,12,13,12,9,5,12,13,11,5,12,17,8,12,11,12,4,8,4,2,8,12,11,1,2,2,1,2,2,2,3,1,2,3
"2629",83140114,"Pedro Mateus","9/27/1996 (26 years old)","GK","AD Sanjoanense","Portuguese Third Division - North","STP","Yes","7/25/2022","6/30/2024","$0 - $7K","Left Only","Very Strong","Weak","6'3""","182 lbs","157","-",85,105,2,1,2,2,7,4,6,2,2,1,8,2,2,8,5,7,12,12,10,11,11,3,7,1,13,11,9,8,9,11,11,11,13,7,7,10,9,17,9,11,12,13,12,8,5,6,14,8,18,11,13,12,14,13,11,12,8,12,8,9
"2630",2000137930,"Adjakson Ramos","10/8/2002 (20 years old)","D (C)","Lusitano Évora","Portugal Championship - Group D","STP","No","7/30/2022","6/30/2024","$0","Right","Weak","Very Strong","6'0""","176 lbs","30","-",70,90,4,6,8,4,7,3,11,5,10,13,7,1,10,6,13,8,11,8,6,7,11,4,7,6,10,12,6,12,12,10,12,11,13,12,10,12,14,17,11,14,11,13,15,5,10,5,9,12,16,1,2,1,3,2,2,2,2,2,1,1
"2631",83158230,"Mimi","10/7/1996 (26 years old)","D/WB/M (L)","Oriental Dragon","Portuguese Setúbal First Division","STP","Yes","7/1/2022","-","$0","Left Only","Very Strong","Very Weak","5'5""","125 lbs","130","2",73,90,6,11,10,5,8,6,5,7,9,7,7,3,10,10,7,7,8,9,7,8,10,8,3,10,8,10,7,10,13,13,10,8,13,13,12,7,9,11,10,10,6,11,2,8,3,7,8,8,9,1,2,2,1,4,2,2,2,1,3,2
"2632",2000264261,"Sérgio Male","5/8/2004 (19 years old)","AM (RL)","Sp. do Príncipe","Príncipe Division 1","STP","No","1/1/2021","12/31/2023","$0","Right","Reasonable","Very Strong","6'1""","163 lbs","-","-",51,85,7,10,9,7,6,5,5,4,4,2,13,1,5,10,8,5,5,10,2,6,16,12,13,9,2,6,7,7,13,9,6,9,8,12,5,3,7,12,10,12,9,12,7,8,13,7,10,14,12,1,2,2,3,1,2,1,1,1,1,1
"2633",95057580,"Vander","10/12/1995 (27 years old)","M/AM (RL)","UDRA","São Tomé Division 1","STP","No","5/30/2020","12/31/2023","$0","Left","Very Strong","Weak","5'9""","152 lbs","30","2",65,85,7,10,13,9,10,5,1,4,5,3,8,2,6,11,11,7,2,7,6,10,13,13,9,12,5,7,3,11,12,10,6,7,10,10,13,6,11,15,10,10,11,10,10,11,9,1,10,11,7,1,2,1,2,2,1,2,1,2,2,1
"2634",55068756,"Leonildo Soares","8/7/1992 (30 years old)","D/WB/M/AM (R)","Moitense","Portuguese Setúbal First Division","STP","Yes","8/26/2022","-","$0","Right Only","Weak","Very Strong","5'9""","167 lbs","233","31",78,84,6,8,11,10,8,10,5,3,15,6,7,10,9,10,8,10,12,7,6,5,15,15,10,11,7,7,5,11,13,12,11,6,12,13,11,8,15,12,10,18,12,14,2,15,2,5,10,15,15,2,2,2,2,2,3,3,3,1,1,1
"2635",2000184699,"Mohamed Marhoon","7/25/2000 (22 years old)","GK","Malikiya","Bahrain First Division","BHR","No","7/1/2018","6/30/2024","$1K - $9K","Right","Reasonable","Very Strong","6'4""","171 lbs","-","-",81,115,3,2,1,1,1,8,1,1,2,2,9,1,2,3,12,10,11,7,10,13,13,2,1,3,10,7,6,6,13,15,7,10,15,13,2,5,10,17,10,11,11,13,7,7,10,5,12,11,9,10,8,10,12,7,8,13,5,11,10,13
"2636",83324862,"Mauro Santos","7/13/2000 (22 years old)","M/AM (L)","Barreirense","Portugal Championship - Group D","STP","No","2/1/2023","-","$0","Left Only","Very Strong","Weak","6'0""","167 lbs","22","1",67,83,6,10,8,5,8,4,6,6,9,10,8,8,9,9,7,7,13,6,9,8,12,7,4,10,9,11,5,12,12,12,6,8,11,12,10,7,11,11,10,12,11,11,9,6,6,7,9,11,11,1,1,2,1,2,1,2,3,4,2,3
"2637",2000251906,"Kelve Semedo","5/9/2004 (19 years old)","ST (C)","Ac. Viseu","Portuguese Second League","STP","Yes","7/1/2022","6/30/2026","$0 - $10K","Right","Reasonable","Very Strong","5'9""","154 lbs","-","-",65,81,4,1,13,13,12,5,11,6,4,4,6,2,2,13,6,5,7,6,6,11,6,13,9,13,4,5,5,6,13,12,6,7,14,13,6,4,7,17,10,14,10,13,7,7,8,6,15,8,8,1,2,1,1,1,3,3,1,1,2,1
"2638",55063201,"José Semedo","7/15/1992 (30 years old)","AM (L), ST (C)","Sacavenense","Portuguese Lisbon First Division","STP","Yes","7/1/2022","-","$0","Left Only","Very Strong","Weak","5'9""","149 lbs","128","50",77,81,5,8,11,13,9,13,7,11,4,5,9,11,6,11,7,8,9,11,8,10,12,6,6,11,6,8,8,9,14,10,11,7,10,12,11,11,11,10,10,11,13,12,11,8,6,1,9,9,18,1,2,1,2,2,1,3,2,1,3,3
"2639",55061987,"Jessi Tati","4/16/1991 (32 years old)","AM (RL), ST (C)","Ançã FC","Portuguese Coimbra First Division","STP","Yes","1/1/2023","-","$0","Right Only","Very Weak","Very Strong","6'0""","171 lbs","259","73",65,80,6,7,7,8,8,6,7,8,4,6,8,6,5,9,13,6,8,6,6,6,14,9,7,8,2,8,7,11,12,11,9,8,14,13,10,10,12,12,12,14,11,11,6,10,6,6,11,13,13,2,2,3,2,3,3,2,3,3,4,3
"2640",2000057401,"Carlos Metzger","9/21/2001 (21 years old)","AM (RL)","Xavelhas","Portuguese Madeira First Division","STP","No","7/1/2022","-","$0","Left","Very Strong","Weak","6'1""","180 lbs","21","1",53,80,7,11,13,6,13,5,1,2,5,4,5,2,6,8,13,8,1,5,5,4,4,11,9,8,5,7,8,11,9,9,6,8,10,12,7,3,10,19,11,9,12,10,13,3,5,6,20,11,13,2,3,3,3,1,1,1,2,2,2,3
"2641",2000042463,"Pogba","7/16/2000 (22 years old)","M (C)","Deportivo Mongomo","Premier Division - Continental","STP","No","7/1/2022","6/30/2025","$0","Right","Reasonable","Very Strong","5'10""","149 lbs","-","-",57,80,3,4,3,5,12,2,3,7,1,4,10,2,8,12,10,6,1,6,3,11,10,5,13,6,8,6,9,11,12,12,5,5,14,12,7,4,11,15,12,10,11,14,11,2,7,8,15,13,7,3,3,1,2,1,3,1,3,2,1,2
"2642",83197852,"Ebanilson","10/7/1999 (23 years old)","AM (R), ST (C)","Amora","Portuguese Third Division - South","STP","Yes","6/9/2023","6/30/2024","$0 - $6K","Right Only","Weak","Very Strong","5'9""","143 lbs","102","19",72,79,5,9,11,10,8,4,8,9,4,5,9,6,6,10,8,7,9,8,7,6,11,11,4,11,5,9,7,10,13,12,11,7,12,13,10,7,10,12,9,11,12,13,12,6,7,8,10,11,14,2,1,1,1,1,3,3,1,3,3,2
"2643",83287445,"Vavá","4/23/1998 (25 years old)","AM (RL)","Fabril do Barreiro","Portugal Championship - Group D","STP","Yes","8/1/2021","6/30/2024","$3K - $8K","Right","Weak","Very Strong","5'9""","136 lbs","104","21",75,79,9,9,11,10,11,6,7,8,4,6,7,5,6,11,7,8,7,10,6,8,11,10,4,11,5,11,8,10,12,12,7,8,11,12,11,7,12,13,10,10,11,9,6,14,9,4,7,11,16,2,2,1,2,2,3,1,3,2,3,1
"2644",2000042663,"Geoxking","12/14/2001 (21 years old)","AM (RLC)","Águias de Camarate","Portuguese Lisbon Second Division","STP","No","7/1/2021","-","$0","Left","Very Strong","Weak","5'8""","158 lbs","53","11",50,75,5,9,9,10,12,4,2,4,4,4,9,1,5,11,6,6,6,3,5,10,14,12,10,7,4,5,5,6,12,12,5,1,6,12,5,1,13,10,13,8,12,10,14,17,8,3,20,12,19,3,1,2,1,2,3,2,1,4,1,2
"2645",55074154,"Valter Rocha","8/19/1991 (31 years old)","M/AM (L), ST (C)","Dereham","English Eastern Counties Premier Division","STP","Yes","7/1/2022","6/30/2024","$0 - $12K","Left Only","Very Strong","Weak","6'2""","180 lbs","214","67",50,75,5,8,10,10,5,3,3,3,3,3,4,2,4,10,8,7,7,8,6,13,18,13,10,7,5,6,4,7,12,9,6,13,12,13,8,5,8,15,11,10,14,12,10,4,10,7,9,11,7,2,1,3,2,3,1,4,1,3,4,3
"2646",64048956,"Mohamed Marhoon","2/12/1998 (25 years old)","M/AM (LC)","Kuwait SC","Kuwaiti Premier League","BHR","No","6/30/2019","6/30/2025","$26K - $250K","Left","Very Strong","Fairly Strong","5'8""","149 lbs","16","8",105,115,5,10,13,11,14,8,5,8,8,8,11,7,8,14,5,10,5,11,7,14,15,13,6,13,9,9,12,13,14,14,9,5,11,14,9,6,12,19,11,10,12,10,9,16,15,8,13,10,17,2,3,4,3,3,2,3,2,4,1,1
"2647",83154704,"Edmílson Viegas","10/29/1996 (26 years old)","M (L), AM (LC)","Città dei Sassi","Italian Eccellenza Basilicata","STP","Yes","12/2/2022","6/30/2023","$0","Left Only","Very Strong","Very Weak","5'10""","154 lbs","78","5",55,75,3,7,13,10,7,5,4,3,4,4,12,6,6,10,12,6,6,9,6,7,11,12,1,9,5,6,7,5,13,13,6,8,13,13,10,3,11,13,9,12,12,9,5,10,14,1,3,12,14,2,2,1,1,2,2,3,3,2,1,3
"2648",2000010499,"Vavá","2/1/1997 (26 years old)","D/WB (R), AM (RL)","Alfarim","Portuguese Setúbal First Division","STP","Yes","7/19/2022","-","$0","Right Only","Weak","Very Strong","5'9""","138 lbs","137","5",52,72,4,7,5,5,9,4,4,4,4,4,8,1,6,6,7,3,6,3,4,6,16,12,7,7,6,5,2,7,12,12,5,4,12,12,12,5,10,12,12,12,10,10,12,3,8,1,18,13,14,4,1,2,2,1,2,3,3,3,2,1
"2649",83205040,"Gil Eanes","6/21/1996 (26 years old)","AM (RL), ST (C)","Tocha","Portuguese Coimbra First Division","STP","Yes","11/1/2022","-","$0","Right Only","Weak","Very Strong","5'11""","171 lbs","159","49",63,72,5,6,9,9,9,6,10,8,5,5,7,7,6,10,13,10,10,9,6,6,14,12,6,11,5,6,6,7,11,10,11,10,14,13,10,10,12,14,12,12,10,11,5,12,9,10,12,13,12,4,1,1,3,1,3,1,3,1,2,3
"2650",83110062,"Luís Selemane","5/1/1995 (28 years old)","AM (RL)","Malveira","Portuguese Lisbon First Division","STP","No","7/1/2022","-","$0","Right Only","Weak","Very Strong","5'7""","125 lbs","156","8",67,72,6,9,12,5,11,4,3,5,3,3,10,1,2,9,12,6,6,6,3,10,4,10,11,10,4,6,7,11,12,12,5,1,9,12,12,4,10,19,10,11,11,12,8,12,9,4,19,8,17,1,2,3,3,1,3,1,2,3,3,2
"2651",2000056608,"José Soares","5/14/2001 (22 years old)","AM (RL)","Fornos de Algodres","Portuguese Guarda First Division","STP","Yes","7/1/2022","-","$0","Left Only","Very Strong","Weak","5'8""","143 lbs","26","2",58,71,6,8,11,8,8,4,6,6,3,4,6,4,5,9,7,7,8,6,4,5,6,12,4,11,5,8,7,7,13,13,7,7,11,13,9,5,11,10,11,12,12,14,6,3,12,6,8,11,8,2,3,2,2,3,1,2,3,3,4,3
"2652",83191688,"Aldair Santos","9/4/1989 (33 years old)","M (C)","RSD Jette","Belgian Second Amateur Division ACFF C","STP","No","6/14/2021","6/30/2024","$0","Right","Fairly Strong","Very Strong","5'3""","121 lbs","105","8",62,70,1,1,2,6,13,1,4,8,1,13,11,2,7,11,10,5,3,7,6,13,4,5,7,5,6,7,11,11,11,10,6,1,12,9,11,1,14,14,14,10,12,11,6,8,12,4,12,12,11,2,2,1,1,2,3,2,1,1,4,3
"2653",13145184,"Zé","12/22/1991 (31 years old)","AM (RL), ST (C)","Inter Bom-Bom","São Tomé Division 1","STP","No","1/1/2023","12/31/2023","$0","Right Only","Weak","Very Strong","6'0""","163 lbs","-","-",65,70,7,12,7,9,10,5,9,7,6,5,11,4,8,10,15,11,2,12,7,9,12,8,13,11,7,8,8,9,15,8,8,12,14,10,7,6,9,12,13,11,12,13,5,8,6,6,10,9,18,1,2,1,3,2,3,2,1,3,1,3
"2654",83221027,"Izidson Neves","5/4/1995 (28 years old)","AM (R), ST (C)","Travanca","Portuguese Viseu Second Division","STP","Yes","7/1/2022","-","$0","Right Only","Very Weak","Very Strong","5'10""","154 lbs","74","14",59,68,2,5,9,11,9,5,8,6,3,4,8,4,2,10,14,10,5,6,6,8,5,13,10,9,5,6,7,8,13,12,4,4,12,13,13,5,10,13,10,12,10,12,5,13,13,5,12,11,20,2,2,4,1,3,2,2,2,1,3,3
"2655",83229273,"Joary Dumby","12/18/1996 (26 years old)","ST (C)","Cova-Gala","Portuguese Coimbra Second Division","STP","No","9/3/2022","-","$0","Right Only","Weak","Very Strong","6'5""","189 lbs","103","26",52,67,4,1,8,12,12,3,5,3,1,4,4,7,1,9,6,7,6,12,5,6,9,10,11,12,4,4,4,5,12,9,5,13,8,10,8,7,11,14,9,14,10,12,10,4,9,6,12,13,13,1,3,3,2,1,3,1,4,1,1,2
"2656",13160387,"Lúcio Oliveira","11/26/1992 (30 years old)","D (C), DM","Lagoa","Portuguese Algarve First Division","STP","Yes","7/1/2022","-","$0","Right Only","Weak","Very Strong","6'1""","167 lbs","128","1",63,67,1,4,1,2,7,3,10,4,1,8,7,1,13,6,15,7,8,5,4,13,10,5,12,2,10,5,6,7,11,11,6,12,12,12,12,7,15,16,9,10,9,10,5,1,8,1,9,10,15,3,2,2,3,3,3,3,1,2,2,3
"2657",23035773,"Ahmed Abdulla","4/1/1987 (36 years old)","D/WB/M/AM (L)","Al-Khalidiya","Bahrain Premier League","BHR","No","5/14/2021","6/30/2024","$0","Left Only","Very Strong","Weak","5'8""","176 lbs","-","-",94,114,11,8,13,8,12,9,7,8,8,8,9,10,10,11,10,11,8,11,12,11,16,11,7,11,7,8,11,9,13,13,7,6,11,14,10,8,12,17,11,10,12,15,13,13,5,5,11,16,12,3,3,1,3,2,1,3,2,3,1,1
"2658",2000021769,"Auleocárcio","7/10/1998 (24 years old)","D/WB/M/AM (L)","Lagoa","Portuguese Algarve First Division","STP","No","9/1/2022","-","$0","Left","Very Strong","Weak","5'7""","149 lbs","90","16",58,66,6,9,7,8,8,5,5,2,4,6,9,3,6,9,11,5,6,6,7,8,17,9,2,8,7,6,7,7,13,11,6,5,12,12,12,3,13,13,8,14,10,11,10,14,9,6,7,11,17,2,3,1,3,2,2,2,3,3,1,3
"2659",2000264285,"Kota","5/22/1998 (25 years old)","D/WB (L)","Sp. Praia Cruz","São Tomé Division 1","STP","No","1/1/2019","12/31/2023","$0","Left","Very Strong","Weak","5'11""","149 lbs","-","-",50,65,2,9,5,4,10,1,2,2,1,7,4,5,10,7,14,5,8,6,4,11,16,5,5,3,8,6,6,7,13,13,6,10,11,13,12,7,12,17,13,13,11,9,6,7,10,4,8,10,11,1,3,1,1,3,3,2,1,2,4,2
"2660",13145186,"Jocy","1/19/1991 (32 years old)","M (C)","Inter Bom-Bom","São Tomé Division 1","STP","No","1/1/2023","12/31/2023","$0","Right","Reasonable","Very Strong","5'10""","158 lbs","-","-",60,65,5,1,3,6,13,1,4,7,2,9,14,1,8,13,11,7,7,6,7,13,6,5,14,9,10,7,9,7,9,6,7,4,13,6,7,6,11,13,13,11,10,12,7,10,9,6,13,13,12,3,3,3,2,2,2,3,1,1,4,3
"2661",2000107466,"Denilson Silva","7/2/1998 (24 years old)","D (C), DM, M (C)","Mazara Calcio","Italian Eccellenza Sicilia Grp.A","STP","Yes","1/11/2023","-","$0","Right Only","Weak","Very Strong","6'0""","187 lbs","41","1",53,65,4,4,8,8,8,5,12,3,4,11,7,5,12,7,14,10,10,8,5,5,12,5,6,7,7,8,8,10,12,8,10,10,15,12,12,12,10,18,11,10,11,13,5,7,6,6,7,11,7,1,1,1,3,1,3,2,1,3,3,3
"2662",83323905,"Bruma","4/9/1996 (27 years old)","M (C)","Trancoso","Portuguese Guarda First Division","STP","No","7/1/2022","-","$0","Right","Reasonable","Very Strong","6'5""","182 lbs","55","8",55,65,2,2,5,2,9,1,4,8,1,8,12,1,8,9,7,7,5,5,4,7,13,5,12,6,5,6,10,10,12,12,5,11,12,12,12,6,11,15,13,10,11,13,14,13,9,8,14,12,8,3,2,2,3,2,1,3,3,3,1,1
"2663",2000218481,"Jeremias Pedroso","1/25/2002 (21 years old)","ST (C)","Idanhense","Portuguese Castelo Branco First Division","STP","No","7/1/2022","-","$0","Right Only","Weak","Very Strong","6'1""","165 lbs","21","-",51,65,3,1,11,13,10,5,12,3,3,5,6,4,3,6,15,6,6,6,6,9,16,10,4,4,6,5,2,6,13,12,6,7,15,13,7,7,10,14,10,12,12,10,12,8,5,1,9,13,9,1,1,1,1,2,2,2,3,2,3,2
"2664",13231346,"Iniesta","10/21/1992 (30 years old)","AM (RL)","Agrosport Clube","São Tomé Division 1","STP","No","1/1/2022","-","$0","Right","Reasonable","Very Strong","6'1""","165 lbs","-","-",55,64,5,9,7,10,11,5,1,2,5,5,10,4,2,6,5,9,6,5,6,6,17,11,12,8,5,6,4,11,13,9,6,8,13,12,12,4,10,10,11,12,12,11,10,5,10,4,9,12,19,3,1,2,1,2,4,3,2,2,3,2
"2665",2000193913,"Elias Varela","5/19/2000 (23 years old)","D/WB (R)","Minas de Argozelo","Portuguese Bragança First Division","STP","No","8/1/2022","-","$0","Right Only","Weak","Very Strong","5'11""","143 lbs","19","1",55,64,3,8,6,3,9,1,5,1,6,8,7,3,12,8,9,10,8,7,11,8,7,8,2,6,9,7,5,7,14,14,7,8,15,14,7,5,10,11,13,12,12,12,5,6,12,1,13,11,10,1,4,2,2,1,4,1,2,3,1,3
"2666",2000107430,"Jamil Pires","1/22/1997 (26 years old)","DM, M (C)","Brejos de Azeitão","Portuguese Setúbal Second Division","STP","Yes","7/1/2022","-","$0","Right","Weak","Very Strong","6'3""","143 lbs","111","11",55,62,6,6,6,6,11,3,6,8,5,8,8,4,13,8,12,6,4,8,8,12,14,5,7,4,11,7,7,12,8,11,7,15,14,10,7,7,10,16,12,9,9,12,5,12,11,2,9,12,19,3,1,2,4,3,3,3,2,2,3,2
"2667",2000181195,"Anastácio","2/16/1997 (26 years old)","GK","6 de Setembro","São Tomé Division 1","STP","No","1/1/2023","12/31/2023","$0","Right","Strong","Very Strong","6'1""","167 lbs","-","-",55,62,2,1,2,1,2,5,1,3,1,1,7,3,1,2,13,9,10,5,11,6,12,2,9,1,7,6,5,5,12,6,6,9,6,11,5,4,11,11,11,13,9,9,5,5,5,7,8,13,20,5,10,8,9,8,7,13,5,7,7,13
"2668",1036398,"Mohammed Sanad","4/11/1987 (36 years old)","D (RC)","Busaiteen","Bahrain Premier League","BHR","No","6/14/2021","6/30/2024","$0","Right","Reasonable","Very Strong","5'11""","167 lbs","-","-",83,113,5,9,6,7,9,1,8,5,7,6,9,5,12,8,12,13,7,8,13,14,5,5,13,7,13,8,8,9,9,8,8,6,11,13,9,12,11,20,9,11,10,10,7,7,12,6,16,10,8,3,2,1,2,1,2,3,1,2,2,3
"2669",2000218477,"Pedrinho","7/6/2004 (18 years old)","DM, M (C)","Idanhense","Portuguese Castelo Branco First Division","STP","No","7/1/2022","-","$0","Right Only","Weak","Very Strong","6'1""","160 lbs","20","1",52,60,7,7,3,8,14,7,5,9,4,8,8,4,7,12,13,10,7,9,9,13,7,5,7,7,6,8,7,8,12,10,8,12,10,9,11,5,12,20,11,12,11,12,8,3,9,5,18,12,20,3,3,3,2,3,4,2,1,3,3,3
"2670",83229689,"Keidy Santos","8/28/1995 (27 years old)","AM (RC)","Vit. Riboque","São Tomé Division 1","STP","No","6/30/2018","12/31/2023","$0","Right","Reasonable","Very Strong","6'0""","154 lbs","19","4",52,60,3,7,5,9,11,1,1,5,4,2,4,1,4,6,5,6,3,5,5,9,3,15,5,7,2,5,7,6,12,12,5,7,14,12,10,2,12,15,13,10,9,11,8,17,11,7,11,13,9,2,1,3,1,2,1,1,2,3,3,2
"2671",13145179,"Ivonaldo","5/5/1993 (30 years old)","D (R)","Inter Bom-Bom","São Tomé Division 1","STP","No","1/1/2022","-","$0","Right","Weak","Very Strong","6'0""","165 lbs","-","-",55,60,3,9,1,6,7,1,7,4,2,7,7,1,11,7,13,8,8,5,9,12,7,5,14,4,10,7,5,3,13,11,7,11,7,13,8,5,14,14,9,10,11,11,9,8,15,7,7,12,14,4,3,3,1,1,1,1,1,1,3,2
"2672",2000226733,"Alfredo Prazeres","9/22/1999 (23 years old)","M/AM (L)","Piães","Portuguese Viseu Second Division","STP","No","7/1/2022","-","$0","Left Only","Very Strong","Very Weak","5'10""","154 lbs","41","8",50,60,5,8,9,9,11,6,3,7,6,4,9,2,4,10,7,10,7,10,6,11,13,9,12,13,4,8,5,11,14,8,2,6,10,10,6,4,14,19,13,12,12,10,8,3,8,4,16,9,16,1,2,1,3,3,1,2,2,1,1,1
"2673",2000264258,"Kley","6/18/1991 (31 years old)","D/WB (R)","UDRA","São Tomé Division 1","STP","No","1/1/2023","12/31/2023","$0","Right","Weak","Very Strong","6'1""","167 lbs","-","-",55,58,5,12,7,1,10,2,7,7,6,9,7,1,11,9,12,8,4,7,10,15,14,5,6,7,8,8,6,8,8,12,8,10,15,8,9,6,10,15,11,11,11,12,5,14,11,4,19,13,15,1,2,2,2,1,4,3,3,1,4,1
"2674",13231325,"Dilson","11/17/1994 (28 years old)","D/WB (L)","Trindade FC","São Tomé Division 1","STP","No","1/1/2023","12/31/2023","$0","Left","Very Strong","Weak","5'10""","156 lbs","-","-",55,58,5,6,3,3,6,1,6,3,5,5,7,1,8,6,5,5,5,3,6,11,5,5,9,4,7,6,6,6,13,13,6,4,15,13,10,7,12,10,12,12,11,10,10,1,8,3,10,11,13,4,3,3,2,1,3,3,1,3,3,3
"2675",2000161872,"Solomon Tweh","8/30/2004 (18 years old)","M (C)","Guédiawaye FC","Senegalese Ligue 1","LBR","No","7/1/2021","6/30/2025","$22K - $230K","Right","Weak","Very Strong","6'0""","163 lbs","19","1",88,130,8,5,7,11,10,7,7,12,1,10,14,7,12,15,15,13,9,9,9,15,12,8,9,13,8,14,9,9,8,8,12,7,14,12,11,8,13,20,11,11,13,12,12,11,15,1,13,12,19,3,2,2,3,1,1,1,2,2,3,2
"2676",13162051,"Oscar","7/19/1998 (24 years old)","D/WB (L), DM, M (C)","Slavia Prague","Czech First Division","LBR","No","5/29/2021","6/30/2025","$110K - $1.1M","Left","Very Strong","Fairly Strong","5'9""","145 lbs","170","17",121,130,7,11,14,8,14,12,7,7,8,4,14,12,7,14,7,14,9,13,13,12,12,15,6,12,12,10,11,10,15,16,12,7,8,15,13,9,16,13,12,12,6,9,12,9,8,9,13,12,8,2,2,3,4,3,3,3,1,2,2,3
"2677",13211564,"Allen Njie","7/26/1999 (23 years old)","DM, M (C)","Aarau","Swiss Challenge League","LBR","No","7/1/2021","6/30/2024","$55K - $550K","Left Only","Very Strong","Weak","6'1""","171 lbs","80","4",102,128,6,7,10,7,12,7,12,10,10,11,13,4,12,13,14,13,13,10,11,9,14,8,8,12,12,13,12,13,12,11,13,12,14,12,13,13,14,12,12,15,10,14,8,3,13,3,8,12,14,1,1,3,3,1,2,1,2,1,1,3
"2678",92099010,"Mohammed Kamara","10/31/1997 (25 years old)","AM (RL), ST (C)","Hapoel Haifa","Israeli Premier League","LBR","No","5/22/2023","5/31/2024","$230K - $2.3M","Right","Reasonable","Very Strong","6'0""","165 lbs","98","25",113,125,5,11,14,10,13,7,7,9,4,4,11,10,8,15,13,12,11,12,10,11,12,16,6,15,6,10,10,12,13,14,10,12,15,14,11,12,15,16,12,13,12,10,5,11,8,8,15,11,12,1,3,3,1,3,1,1,3,2,4,1
"2679",23088430,"Allawi","8/11/1985 (37 years old)","AM (C), ST (C)","Malikiya","Bahrain First Division","BHR","No","11/7/2020","6/30/2024","$0 - $6K","Right","Weak","Very Strong","5'11""","167 lbs","18","12",89,113,6,5,12,13,9,4,10,11,4,5,9,12,1,11,15,11,14,12,9,10,17,14,7,11,2,10,9,9,13,11,9,10,12,12,10,9,5,10,11,13,9,11,7,13,12,7,13,19,16,3,3,2,1,3,2,1,3,2,4,1
"2680",27006533,"Sekou Oliseh","6/5/1990 (33 years old)","M (R), AM (RL)","LISCR","Liberian Premier League","LBR","No","11/15/2020","6/30/2024","$0","Right Only","Weak","Very Strong","5'11""","154 lbs","116","11",84,120,6,10,13,6,13,7,9,9,4,6,10,10,3,14,12,9,10,7,9,7,11,14,3,13,7,8,9,12,13,13,10,9,14,13,10,8,9,13,13,5,10,8,11,11,4,13,10,14,15,4,3,1,1,1,1,3,2,3,1,1
"2681",13114862,"Sam Johnson","5/6/1993 (30 years old)","ST (C)","Vasalunds IF","Swedish First Division North","LBR","No","5/1/2023","11/30/2023","$0","Right","Weak","Very Strong","5'11""","163 lbs","222","79",77,120,5,8,9,9,10,7,10,9,7,4,9,10,4,11,11,10,12,11,11,10,11,12,7,11,6,9,9,9,11,11,12,10,12,12,9,12,7,10,11,6,11,9,14,14,7,12,9,10,11,2,1,1,1,2,2,3,2,2,1,1
"2682",13234277,"Sampson Dweh","10/10/2001 (21 years old)","D (C)","Vyškov","Czech Second Division","LBR","No","7/26/2022","6/30/2025","$55K - $170K","Right Only","Weak","Very Strong","6'1""","178 lbs","11","1",90,120,4,7,5,4,8,4,12,4,7,12,8,3,14,7,14,11,15,11,8,9,17,4,6,9,10,12,6,12,13,9,10,14,12,14,13,12,15,15,11,11,11,10,10,13,12,3,12,11,11,3,3,2,1,3,3,3,2,2,1,3
"2683",28118046,"Mohammed Sangaré","12/28/1998 (24 years old)","D (C), DM, M (C)","Accrington","Sky Bet League Two","LBR","No","7/1/2022","6/30/2024","$18K - $190K","Left","Very Strong","Weak","6'3""","182 lbs","24","-",90,120,5,7,10,10,9,7,8,9,7,7,10,7,10,9,13,10,9,8,9,10,13,9,8,10,9,11,6,11,11,15,8,13,9,11,10,11,10,15,10,8,11,10,13,10,9,8,9,10,17,3,2,2,2,2,3,3,1,2,3,2
"2684",37071040,"Mark Pabai","9/30/2000 (22 years old)","D/WB (R)","Koper","Slovenian First League","LBR","Yes","6/11/2023","6/30/2025","$120K - $1.2M","Right Only","Weak","Very Strong","6'2""","182 lbs","78","3",99,119,6,11,11,5,12,4,6,9,8,12,12,2,13,12,15,12,11,11,8,8,11,5,7,13,12,14,11,11,13,11,12,7,12,13,11,12,14,14,13,12,9,8,7,1,5,6,20,12,10,2,2,1,2,3,3,3,1,2,1,1
"2685",93108375,"Justin Salmon","1/25/1999 (24 years old)","DM, M (C)","Degerfors IF","Swedish Premier Division","LBR","Yes","7/6/2021","12/31/2023","$5K - $50K","Right","Reasonable","Very Strong","6'0""","158 lbs","122","16",95,115,9,12,10,9,12,9,6,8,7,9,11,8,8,12,10,11,11,11,11,10,12,12,10,12,11,11,11,11,12,12,11,8,12,13,13,10,7,13,13,12,12,11,6,10,7,2,12,11,12,3,3,1,3,1,2,3,1,1,3,3
"2686",2000201186,"Divine Teah","4/19/2006 (17 years old)","M (C), AM (RLC)","Nimba Utd","Liberian Second Division","LBR","No","7/1/2021","6/30/2024","$0","Left","Very Strong","Reasonable","6'0""","154 lbs","-","-",75,113,7,9,8,11,13,7,7,9,4,7,14,1,9,8,10,4,8,4,7,9,12,7,2,9,4,9,11,9,14,12,9,9,11,14,7,5,12,14,11,8,9,12,11,11,9,7,8,11,10,1,1,1,1,3,2,1,2,2,1,2
"2687",13170677,"Terrence Tisdell","3/16/1998 (25 years old)","AM (R)","Sumqayit","Azeri Premier League","LBR","No","12/12/2022","6/30/2025","$0","Left","Very Strong","Weak","5'10""","154 lbs","104","13",95,110,7,10,12,8,11,8,7,10,4,4,8,7,5,10,9,7,12,7,8,8,12,13,5,8,5,10,7,13,15,12,8,9,12,15,13,8,12,19,11,9,8,11,4,8,8,1,9,13,12,1,3,3,3,2,2,2,1,2,1,3
"2688",93054646,"Peter Wilson","10/9/1996 (26 years old)","ST (C)","Jerv","Norwegian First Division","LBR","Yes","8/31/2022","12/31/2023","$0 - $26K","Right Only","Weak","Very Strong","6'0""","163 lbs","160","30",100,110,8,8,11,10,11,11,10,8,10,11,8,8,8,11,9,8,11,10,10,10,12,9,2,14,5,12,9,12,15,12,8,12,12,15,13,12,5,10,11,11,11,11,6,7,7,5,10,11,14,1,2,3,3,2,1,2,2,1,3,2
"2689",12077786,"Alloy Brown","11/11/1996 (26 years old)","AM (R), ST (C)","Nimba Kwado","Liberian Premier League","LBR","No","7/1/2020","6/30/2024","$0","Right","Fairly Strong","Very Strong","5'10""","152 lbs","12","8",84,110,3,8,13,9,13,6,12,8,1,4,10,5,2,13,5,6,6,9,7,8,2,13,12,10,7,7,10,8,13,13,7,4,17,13,12,6,13,14,11,9,10,11,6,7,12,3,11,12,15,3,2,2,2,3,1,2,2,3,2,1
"2690",27143570,"Mohamed Al-Hardan","10/6/1997 (25 years old)","DM, M (C)","Al-Khalidiya","Bahrain Premier League","BHR","No","6/19/2021","6/30/2024","$0 - $65K","Right","Weak","Very Strong","6'0""","158 lbs","12","-",90,112,7,11,9,7,10,8,11,8,7,12,11,6,13,9,9,11,11,10,13,11,11,4,12,9,12,13,11,13,9,9,11,10,11,10,14,8,7,7,11,14,12,12,5,11,4,6,14,12,12,2,3,2,2,2,1,2,2,2,1,1
"2691",13114858,"Kpah Sherman","2/3/1991 (32 years old)","ST (C)","Pahang","Malaysian Super League","LBR","No","1/17/2023","11/30/2024","Not for Sale","Right","Strong","Very Strong","5'11""","176 lbs","118","65",95,109,3,6,11,13,12,4,7,6,1,7,5,14,1,6,12,14,8,12,9,10,12,7,14,11,8,8,6,9,12,12,11,9,12,12,13,13,10,14,10,13,12,13,6,5,8,4,12,11,11,1,3,3,1,1,1,3,3,1,2,1
"2692",93057506,"Seth Kanteh Hellberg","8/19/1995 (27 years old)","M/AM (C)","IK Brage","Swedish First Division Elite","LBR","Yes","1/20/2022","12/31/2023","$26K - $275K","Right","Reasonable","Very Strong","5'10""","171 lbs","184","29",100,109,10,11,12,8,12,10,9,11,6,6,13,10,6,12,13,11,10,13,11,11,5,12,6,11,8,11,12,12,12,13,11,9,14,12,12,11,6,6,5,4,12,8,5,9,11,19,12,8,11,1,3,4,1,1,1,2,4,1,2,1
"2693",13103998,"Omega Roberts","12/12/1989 (33 years old)","D (C)","Dunav (SB)","Serbian Zone League","LBR","No","1/27/2023","-","$0","Right","Weak","Very Strong","6'4""","187 lbs","72","-",78,108,7,7,7,6,9,7,13,1,4,10,9,2,11,6,17,9,15,10,9,8,13,5,8,6,11,8,8,8,9,11,12,13,14,10,12,13,10,5,7,5,10,8,8,10,16,18,13,14,12,1,3,3,1,2,1,2,1,3,2,2
"2694",13234281,"Brandon Debah","5/19/2002 (21 years old)","M (C)","LPRC Oilers","Liberian Premier League","LBR","No","1/1/2019","6/30/2024","$0","Right","Reasonable","Very Strong","5'6""","132 lbs","-","-",63,106,6,6,5,5,14,6,6,8,2,6,10,2,9,10,13,10,1,8,8,9,4,5,5,8,8,7,13,11,14,13,7,5,12,14,7,2,13,18,11,12,12,11,14,11,13,8,20,12,15,1,1,1,2,4,1,2,4,1,3,2
"2695",13211566,"Ashley Williams","10/30/2000 (22 years old)","GK","LISCR","Liberian Premier League","LBR","No","1/1/2020","6/30/2024","$0","Left","Very Strong","Fairly Strong","5'11""","171 lbs","1","-",83,105,3,3,1,1,3,7,1,3,2,3,9,1,2,3,8,11,5,8,10,14,16,3,14,2,8,8,7,7,9,14,8,10,9,9,6,4,12,14,9,12,12,11,13,8,8,1,14,10,13,9,9,14,6,9,12,8,5,10,14,14
"2696",29233761,"Nohan Kenneh","1/10/2003 (20 years old)","D (C), DM, M (C)","Hibernian","cinch Premiership","LBR","No","7/1/2022","6/30/2025","$300K - $900K","Left","Very Strong","Fairly Strong","6'3""","174 lbs","31","1",103,105,3,5,10,8,11,4,9,10,5,10,10,4,12,11,14,12,11,11,10,10,13,12,6,9,10,12,13,15,11,12,12,13,14,13,13,15,13,12,11,14,15,10,4,10,4,2,11,13,15,1,2,3,1,2,2,2,2,4,1,3
"2697",25053186,"Sylvanus Nimely","9/4/1998 (24 years old)","AM (R), ST (C)","Surxon","Uzbekistan Superleague","LBR","No","2/15/2023","12/31/2024","$20K - $200K","Right","Reasonable","Very Strong","5'10""","160 lbs","155","27",100,105,9,8,12,12,12,6,6,8,5,5,9,6,8,11,9,11,11,10,10,8,18,10,5,13,7,11,10,11,14,12,11,8,11,14,14,9,10,15,8,10,11,11,10,11,7,5,12,12,17,3,2,2,1,3,1,4,4,3,2,1
"2698",2000243541,"Mark Gibson","9/13/2000 (22 years old)","AM (RL)","Rivers United","Nigerian Premier League","LBR","No","12/1/2022","6/30/2024","$140K - $425K","Right","Reasonable","Very Strong","5'10""","147 lbs","13","1",93,104,7,12,11,11,13,5,8,5,7,7,8,5,6,12,12,7,7,10,9,13,15,15,13,7,7,8,8,9,13,13,9,6,15,13,9,5,18,14,12,11,14,12,13,12,6,4,19,9,11,1,1,2,2,1,2,3,3,1,3,2
"2699",2000220675,"Albert Korvah","5/2/1999 (24 years old)","AM (RC)","Rivers United","Nigerian Premier League","LBR","No","9/23/2022","6/30/2025","$12K - $110K","Right","Reasonable","Very Strong","5'7""","171 lbs","20","3",93,104,6,7,11,8,9,6,7,7,6,6,9,2,5,12,13,8,7,8,7,9,12,13,4,12,4,7,7,11,13,13,12,5,14,15,12,13,13,10,9,12,9,12,5,4,7,7,13,12,20,2,1,1,1,1,3,3,1,2,2,3
"2700",2000311649,"Sheikh Sesay","4/4/2002 (21 years old)","M (C)","Gaborone Utd","Botswanan Premier Division","LBR","No","6/12/2023","6/30/2025","$16K - $50K","Right","Reasonable","Very Strong","5'9""","154 lbs","-","-",65,104,5,2,4,7,14,6,6,8,4,11,13,4,8,10,8,6,4,7,7,13,6,5,3,11,8,8,13,11,9,10,6,7,12,7,6,6,11,11,12,13,11,10,13,2,8,5,9,9,15,3,3,3,3,1,3,3,2,3,4,2
"2701",2000156670,"Ebrahim Al-Khatal","5/11/2000 (23 years old)","M/AM (C), ST (C)","Manama","Bahrain Premier League","BHR","No","1/1/2022","6/30/2024","$0 - $35K","Right","Reasonable","Very Strong","5'9""","149 lbs","-","-",90,110,8,6,9,14,11,8,10,10,2,9,9,4,4,9,12,10,7,8,9,9,2,8,14,14,10,9,11,10,14,14,9,8,12,14,7,7,12,20,10,12,9,11,5,5,5,1,13,10,11,4,1,2,2,1,2,2,2,3,1,4
"2702",37046273,"Brem Soumaoro","8/8/1996 (26 years old)","D (C), DM, M (C)","York United FC","Canadian Premier League","LBR","Yes","2/1/2023","11/30/2023","$60K - $180K","Right Only","Weak","Very Strong","6'2""","169 lbs","120","1",91,101,7,8,11,5,11,11,11,6,3,11,11,3,9,12,12,9,12,11,9,12,13,5,8,11,12,10,10,10,12,12,11,10,15,13,14,12,11,13,12,15,10,14,15,8,11,6,11,12,12,2,3,2,3,3,1,1,3,1,3,3
"2703",30034047,"Abu Kamara","4/1/1997 (26 years old)","ST (C)","Kuching","Malaysian Super League","LBR","No","1/1/2023","11/30/2023","$3K - $28K","Right","Fairly Strong","Very Strong","6'2""","171 lbs","185","110",89,101,6,4,13,13,13,4,11,3,2,4,7,7,4,12,5,12,5,7,6,10,7,12,6,13,5,6,7,7,13,13,7,10,13,13,12,8,9,16,12,13,11,9,5,1,7,2,8,12,19,2,1,3,1,3,3,2,1,2,1,1
"2704",36076046,"Arago Jamal","8/28/1993 (29 years old)","D/WB/M (L)","Al-Ahly Benghazi","Libyan First Division","LBR","No","2/1/2023","6/30/2024","$0 - $26K","Left","Very Strong","Reasonable","5'8""","138 lbs","150","2",87,101,8,12,9,5,9,7,7,3,7,8,8,3,9,9,14,8,8,9,9,8,13,8,11,6,9,9,8,9,14,14,9,6,15,14,14,5,11,18,11,11,6,10,12,5,7,4,14,11,13,3,2,2,1,2,2,2,2,1,2,1
"2705",13230332,"Jeremy Saygbe","6/1/2001 (22 years old)","D (R)","Marbella","Spanish Federation Second Group 4","LBR","No","3/1/2022","6/30/2025","$0 - $35K","Right","Reasonable","Very Strong","5'9""","152 lbs","9","1",75,100,5,13,6,7,13,4,8,7,8,9,9,6,14,9,15,9,10,9,6,11,4,5,12,8,13,9,8,9,11,13,9,7,11,14,6,7,13,17,13,9,13,11,6,11,9,1,10,12,10,1,2,1,2,3,2,1,3,3,2,2
"2706",37045868,"Moussa Sanoh","7/20/1995 (27 years old)","AM (R)","FC Eindhoven","Keuken Kampioen Divisie","LBR","Yes","7/1/2022","6/30/2024","$45K - $450K","Right Only","Weak","Very Strong","5'9""","158 lbs","193","21",95,100,8,12,11,10,11,7,9,8,4,5,9,6,6,12,11,8,12,7,8,7,11,13,5,12,7,13,10,12,14,13,11,9,8,13,10,12,9,10,13,12,8,12,5,8,10,8,6,10,13,1,4,2,1,2,1,3,3,2,3,3
"2707",2000054101,"Joseph Melto","10/29/2003 (19 years old)","ST (C)","LISCR","Liberian Premier League","LBR","No","6/13/2022","6/30/2024","$0","Right","Fairly Strong","Very Strong","6'2""","174 lbs","-","-",71,100,6,3,13,13,13,6,8,6,1,3,7,7,2,12,9,9,6,7,7,8,17,12,9,11,7,6,5,7,12,11,3,11,15,13,7,9,10,20,11,10,9,11,5,9,8,3,16,11,7,2,3,1,3,2,3,2,1,3,1,3
"2708",13170781,"Stephen Seameh","3/25/1997 (26 years old)","M/AM (C)","Black Bulls","Mozambican Premier Division","LBR","No","1/15/2022","12/31/2023","$8K - $24K","Left","Very Strong","Reasonable","6'0""","154 lbs","81","7",81,100,6,6,8,8,13,6,1,5,3,7,7,1,8,13,11,8,7,7,7,13,3,13,12,8,8,7,11,10,13,11,7,10,11,13,13,4,10,10,13,9,11,11,10,14,7,3,11,11,18,3,2,2,3,1,3,2,3,3,3,1
"2709",67103539,"Joel Johnson","9/20/1992 (30 years old)","D/WB (RL)","Charlotte Independence","United States Soccer Leagues Division One","LBR","Yes","2/14/2023","11/30/2023","$16K - $170K","Right","Weak","Very Strong","5'8""","160 lbs","319","8",97,99,6,12,9,8,12,7,9,8,12,12,14,6,11,11,14,10,12,6,9,8,9,8,8,12,8,13,8,13,12,10,11,8,16,14,14,10,18,16,12,12,9,10,4,12,12,7,13,12,11,3,1,1,1,2,1,4,2,2,3,3
"2710",13234302,"Kelvin Potis","4/22/2000 (23 years old)","M/AM (RL)","Oslo Football Academy","Senegalese Ligue 2","LBR","No","1/2/2020","6/30/2024","$0 - $65K","Right Only","Weak","Very Strong","5'10""","163 lbs","-","-",82,98,8,11,11,12,11,7,1,6,6,5,13,5,8,13,11,9,8,7,8,14,4,12,12,10,7,8,7,9,14,14,8,5,15,14,5,4,15,20,11,11,9,11,9,16,8,6,12,13,11,2,2,2,2,2,1,1,3,2,1,3
"2711",13138955,"Prince Saydee","2/20/1996 (27 years old)","AM (RL)","Hartford","USSL Championship Eastern Conference","LBR","No","1/19/2022","11/30/2023","$12K - $120K","Left Only","Very Strong","Weak","5'11""","165 lbs","73","6",88,98,8,9,9,10,12,7,8,8,8,8,13,6,4,12,6,10,9,12,9,10,13,10,4,8,8,14,9,10,13,10,10,11,10,14,8,11,13,15,10,11,9,9,9,9,13,1,11,10,11,3,2,2,1,2,4,2,3,2,2,2
"2712",64048961,"Abdulrahman Ahmedi","4/16/1998 (25 years old)","M (C)","Muharraq","Bahrain Premier League","BHR","No","7/1/2019","6/30/2024","$8K - $24K","Right","Reasonable","Very Strong","5'9""","134 lbs","-","-",85,110,6,3,6,5,14,5,7,7,1,10,14,4,6,9,8,9,4,9,5,14,11,9,5,12,8,8,9,13,14,14,8,9,15,14,12,6,14,12,9,11,10,13,11,4,6,3,9,10,13,1,1,4,3,2,4,1,3,3,3,3
"2713",2000026231,"Sanney Geleya Carlos","12/7/2000 (22 years old)","AM (RL), ST (C)","Operário Lagoa","Portuguese Azores League","LBR","No","9/1/2022","-","$0","Right Only","Weak","Very Strong","5'9""","145 lbs","9","1",71,96,3,6,10,10,12,5,6,6,4,5,7,2,5,10,8,5,2,7,6,11,13,11,2,12,5,6,7,7,15,12,6,3,17,13,12,5,11,16,12,11,10,9,7,8,6,4,19,13,16,1,1,2,1,1,3,1,3,3,2,1
"2714",67228305,"Wynney de Souza","12/27/1996 (26 years old)","GK","Progresul Spartac","Romanian Second League","LBR","Yes","7/28/2022","6/30/2024","$45K - $130K","Left","Very Strong","Reasonable","6'3""","178 lbs","85","-",70,95,4,2,3,1,1,6,1,3,3,2,7,2,1,1,11,11,10,8,13,14,18,1,13,1,11,8,7,7,10,10,8,15,8,9,7,6,10,15,9,11,10,13,11,18,5,6,10,7,13,10,5,9,7,7,7,10,4,10,9,12
"2715",59009020,"Isaac Pupo","10/23/1985 (37 years old)","M (C), AM (LC)","Nimba Utd","Liberian Second Division","LBR","No","1/2/2020","6/30/2024","$0","Left","Very Strong","Reasonable","6'2""","165 lbs","72","9",70,95,12,11,8,6,7,9,5,7,4,10,12,6,9,9,8,8,8,11,10,10,9,8,6,12,12,11,11,11,8,8,10,11,12,10,11,13,9,10,10,8,10,7,3,8,6,10,12,11,6,2,3,2,2,3,2,1,2,2,2,3
"2716",37078327,"Ayouba Kosiah","7/22/2001 (21 years old)","ST (C)","Beerschot","Belgian Challenger Pro League","LBR","Yes","2/1/2023","6/30/2025","$7K - $70K","Left","Very Strong","Reasonable","6'2""","187 lbs","30","1",84,95,4,6,9,11,8,4,11,7,5,6,9,14,6,12,4,13,7,8,7,9,13,11,7,13,5,9,13,12,11,9,13,14,12,11,10,14,4,8,14,13,11,6,4,8,5,4,8,13,8,2,2,2,3,1,2,1,2,1,3,3
"2717",42020152,"Gizzie Dorbor","2/28/1987 (36 years old)","D (LC), DM, M (C)","Tseirey Kfar Kana","Israeli A League North Division","LBR","No","7/1/2022","-","$0","Left","Very Strong","Reasonable","5'7""","156 lbs","376","6",60,95,3,3,7,9,5,5,8,5,7,10,9,3,9,9,13,10,12,10,8,9,11,5,11,3,10,11,4,12,9,9,10,3,12,8,13,12,13,6,6,10,9,14,6,12,13,6,11,7,16,3,1,3,1,1,1,1,3,2,3,2
"2718",13170821,"Sholee Quiah","4/7/1998 (25 years old)","AM (RL), ST (C)","Invincible Eleven","Liberian Premier League","LBR","No","7/1/2021","6/30/2024","$0","Left","Very Strong","Reasonable","5'6""","134 lbs","-","-",75,95,6,9,9,11,7,4,8,5,5,6,13,4,2,12,6,9,8,10,6,11,8,12,7,12,6,7,6,8,13,11,7,1,13,13,11,4,11,15,13,10,10,12,8,15,9,5,11,13,16,1,2,3,1,3,3,3,3,2,3,3
"2719",2000249877,"Bill Wilson","1/20/2002 (21 years old)","ST (C)","Vëllaznimi","Kosovan First League Group A","LBR","No","1/31/2023","6/30/2024","$35K - $110K","Right","Reasonable","Very Strong","6'2""","167 lbs","11","7",67,93,5,6,13,13,12,5,11,6,2,5,6,6,5,9,14,10,7,9,5,9,6,13,2,13,1,5,6,6,13,10,6,10,13,12,5,4,11,17,10,10,10,12,12,6,10,8,12,7,16,1,3,1,2,3,4,4,2,1,4,1
"2720",13230338,"Terry Sackor","4/1/1993 (30 years old)","ST (C)","Al-Kawkab","Saudi Second Division Group A","LBR","No","8/20/2022","6/30/2023","$0 - $60K","Right Only","Weak","Very Strong","5'11""","156 lbs","2","-",88,93,7,5,14,12,11,7,12,5,6,7,8,5,2,13,5,13,3,12,5,12,10,12,9,13,7,7,6,8,14,13,8,11,13,13,10,6,10,13,11,14,10,9,5,8,9,7,8,11,17,3,2,1,1,2,1,2,1,3,2,1
"2721",2000246202,"Israel Hallie","6/29/2002 (20 years old)","ST (C)","2 Korriku","Kosovan First League Group B","LBR","No","1/29/2021","6/30/2024","$0 - $95K","Right","Fairly Strong","Very Strong","6'0""","156 lbs","9","-",71,91,6,3,12,13,13,4,8,5,1,6,7,5,1,11,8,7,6,6,2,6,5,12,3,13,7,6,6,7,13,13,7,6,13,13,8,4,10,18,10,9,9,9,8,10,12,8,17,13,20,3,3,1,2,3,3,1,2,2,1,2
"2722",13129199,"Marcus Macauley","10/27/1991 (31 years old)","M/AM (C), ST (C)","PDRM","Malaysian Super League","LBR","No","1/22/2023","11/30/2023","$2.5K - $22K","Right","Reasonable","Very Strong","6'1""","171 lbs","46","7",84,91,6,7,5,12,14,7,9,9,3,8,11,8,7,13,14,9,4,8,7,14,14,12,13,13,9,8,6,9,12,8,8,9,12,9,12,7,10,18,10,10,12,13,13,12,7,8,11,10,14,1,1,2,1,4,2,2,3,3,1,1
"2723",47021190,"Ernestas Veliulis","8/22/1992 (30 years old)","AM (RL)","Panevėžys","Lithuanian A League","LTU","Yes","1/20/2023","12/31/2023","$30K - $300K","Right","Reasonable","Very Strong","5'11""","156 lbs","325","58",95,100,8,12,10,9,12,7,7,7,6,7,10,4,5,13,5,9,5,8,8,10,12,13,9,12,5,8,8,12,13,13,8,9,16,13,10,5,16,13,12,12,12,9,8,10,7,4,14,12,9,2,2,4,2,2,2,3,2,2,2,3
"2724",64048955,"Abbas Al-Asfoor","3/2/1999 (24 years old)","M (C)","Riffa","Bahrain Premier League","BHR","No","7/19/2021","6/30/2025","$1K - $9K","Right","Reasonable","Very Strong","5'10""","152 lbs","-","-",94,110,7,7,4,8,12,7,7,7,3,12,13,5,9,13,11,10,8,6,6,9,16,9,13,11,11,8,9,12,13,13,8,7,14,13,13,9,14,11,10,10,13,11,13,2,9,7,9,13,8,3,3,2,1,3,4,2,1,4,2,3
"2725",2000158661,"Moses Meah","1/12/2005 (18 years old)","AM (R), ST (C)","Cece United","Liberian Premier League","LBR","No","7/1/2020","6/30/2024","$0","Right","Reasonable","Very Strong","5'11""","160 lbs","-","-",65,91,8,10,7,13,11,6,13,7,6,6,14,8,7,10,8,7,5,10,4,8,9,9,1,9,5,7,8,8,10,11,7,7,10,11,7,6,8,11,9,12,9,10,5,1,9,3,9,12,20,1,2,1,3,1,2,3,2,1,2,2
"2726",2000152538,"Mehnpaine Dolo","8/31/1998 (24 years old)","D (RC)","LPRC Oilers","Liberian Premier League","LBR","No","7/1/2020","6/30/2024","$0","Right","Reasonable","Very Strong","5'6""","136 lbs","-","-",75,90,6,11,5,6,4,2,11,9,1,11,9,5,16,8,12,10,10,9,11,8,17,7,7,9,16,9,8,10,9,11,10,3,8,10,6,7,13,16,11,12,10,11,9,14,6,6,20,11,11,1,2,3,3,4,1,2,1,2,1,2
"2727",2000181036,"David Paytoe","6/23/2000 (22 years old)","D/WB (R)","Freeport (LBR)","Liberian Premier League","LBR","No","7/1/2019","6/30/2024","$0","Right","Fairly Strong","Very Strong","6'0""","163 lbs","-","-",65,90,4,8,5,3,7,1,6,5,5,7,7,4,7,7,6,7,7,6,10,13,2,6,13,2,8,6,6,6,13,13,4,9,11,13,8,6,14,16,12,10,8,11,10,14,11,3,9,9,10,2,2,1,2,1,1,4,1,3,3,2
"2728",2000059535,"Emmanuel Ernest","12/30/2000 (22 years old)","ST (C)","Al-Orooba Club","UAE First Division","LBR","No","1/24/2023","6/30/2025","$16K - $170K","Right Only","Weak","Very Strong","6'1""","171 lbs","45","11",70,90,6,5,7,9,8,6,12,8,6,6,7,9,8,7,9,9,11,8,7,8,10,6,5,11,7,7,6,15,9,7,13,12,7,10,11,14,5,9,9,9,7,7,8,7,6,5,8,10,11,2,1,3,2,1,2,1,3,2,1,1
"2729",2000181037,"Alexander Duweh","2/18/2001 (22 years old)","D (C), DM","Freeport (LBR)","Liberian Premier League","LBR","No","7/1/2019","6/30/2024","$0","Right","Reasonable","Very Strong","5'7""","136 lbs","-","-",55,90,1,4,1,1,6,4,12,2,4,10,6,2,12,5,15,12,6,5,5,12,16,5,5,4,9,4,4,6,12,12,5,5,15,12,2,2,11,17,11,8,9,11,10,8,13,1,10,11,15,3,2,3,3,1,1,1,3,1,3,1
"2730",13103809,"Saylee Swen","2/29/1984 (39 years old)","GK","LPRC Oilers","Liberian Premier League","LBR","No","6/14/2021","6/30/2024","$0","Right","Weak","Very Strong","6'2""","176 lbs","-","-",65,90,5,3,1,3,1,7,1,2,2,2,11,2,2,3,7,11,14,4,13,9,5,2,8,1,10,7,6,6,6,15,6,11,12,5,3,6,12,11,11,11,11,8,12,12,11,7,13,12,14,8,12,6,9,12,10,13,5,9,11,7
"2731",86032178,"Jaime Moreno","5/30/1995 (28 years old)","ST (C)","SJK","Finnish Premier League","NCA","Yes","1/2/2023","11/15/2023","$30K - $300K","Right","Reasonable","Very Strong","6'0""","163 lbs","223","85",105,123,7,7,10,13,11,8,12,9,6,9,10,13,6,10,13,13,16,12,13,13,16,8,12,10,6,14,8,15,12,12,12,11,13,11,14,11,2,12,15,14,18,15,13,12,6,6,13,14,14,3,3,2,2,1,2,4,2,1,2,2
"2732",80026554,"Luis Copete","2/12/1989 (34 years old)","D (C), DM","Diriangén","Primera Division Nicaraguense","NCA","No","5/31/2022","6/30/2024","$0 - $16K","Right","Weak","Very Strong","6'0""","185 lbs","251","23",107,115,4,7,5,5,8,4,12,8,10,12,10,6,12,10,13,12,10,11,11,11,13,4,14,8,14,12,11,13,13,10,12,13,12,12,14,13,10,3,11,10,12,11,8,13,10,8,13,10,15,2,2,3,2,3,1,2,1,2,2,3
"2733",78074434,"Jorge Betancur","8/19/1991 (31 years old)","AM (RC)","Managua","Primera Division Nicaraguense","NCA","No","1/3/2022","6/30/2024","$0 - $75K","Right","Reasonable","Very Strong","6'2""","178 lbs","291","36",113,115,10,15,15,14,12,10,11,12,10,8,11,7,10,11,12,12,9,12,12,12,4,11,13,12,10,13,12,12,11,10,10,13,14,11,13,11,16,20,2,12,10,10,10,10,5,3,15,11,11,3,3,2,2,3,2,3,3,3,1,2
"2734",20045076,"Jacob Montes","10/20/1998 (24 years old)","M/AM (C)","BOT","Brazilian National First Division","NCA","No","8/12/2022","12/31/2024","$0 - $6K","Right","Reasonable","Very Strong","5'11""","160 lbs","21","1",83,115,8,4,12,9,10,12,8,7,5,10,11,10,9,10,15,10,7,11,10,9,12,13,15,14,9,13,10,11,12,10,11,12,11,12,10,9,18,14,1,13,13,13,10,4,6,6,11,12,11,2,1,2,1,3,2,1,1,1,3,3
"2735",2000018183,"Mohammed Adel Hasan","9/20/1996 (26 years old)","D/WB (R)","Al-Khalidiya","Bahrain Premier League","BHR","No","6/2/2021","6/30/2024","$1K - $10K","Right","Fairly Strong","Very Strong","5'8""","145 lbs","-","-",94,110,5,10,8,3,9,1,9,3,8,7,8,5,12,9,11,8,10,8,9,14,15,5,1,6,9,9,6,9,14,14,9,7,12,14,12,6,13,13,11,8,12,12,9,11,8,7,9,11,10,2,3,1,2,4,1,2,2,2,4,3
"2736",86007375,"Juan Barrera","5/2/1989 (34 years old)","AM (RLC)","Real Estelí","Primera Division Nicaraguense","NCA","No","12/10/2022","6/30/2024","$500 - $7K","Right","Strong","Very Strong","5'9""","154 lbs","355","78",107,115,7,7,10,11,10,11,6,9,7,8,8,8,8,10,13,11,11,10,11,11,12,14,15,11,10,11,11,12,13,15,10,8,7,12,12,11,6,6,13,12,8,14,12,13,12,7,14,14,13,1,3,3,3,3,1,4,2,3,2,3
"2737",53140931,"Matias Belli Moldskred","8/12/1997 (25 years old)","M (C), AM (LC), ST (C)","Sandnes Ulf","Norwegian First Division","NCA","Yes","8/31/2022","12/31/2024","$4.5K - $45K","Right Only","Weak","Very Strong","5'9""","152 lbs","166","37",96,111,12,11,13,12,13,10,5,8,5,6,12,10,7,13,8,11,9,10,9,10,13,13,8,12,6,12,14,10,12,13,10,7,9,11,12,10,11,7,13,13,13,10,12,2,8,6,13,12,17,2,1,4,4,3,3,1,1,2,1,3
"2738",78044448,"Richard Rodríguez","7/13/1992 (30 years old)","D (LC), WB/M (L)","Liberia","Primera División de Costa Rica","NCA","No","5/31/2022","6/30/2024","$0","Left Only","Very Strong","Weak","5'11""","174 lbs","300","20",93,110,9,12,11,8,12,12,13,7,4,11,10,6,10,12,5,10,12,11,10,9,11,9,5,10,11,12,10,12,9,10,12,11,11,12,12,12,15,10,8,12,11,11,5,6,7,5,9,8,18,3,2,3,1,1,2,4,2,1,2,2
"2739",86006839,"Raúl Leguías","10/9/1981 (41 years old)","AM (C), ST (C)","Municipal Turrialba","Liga de Ascenso de Costa Rica","NCA","No","5/31/2020","6/30/2024","$3K - $30K","Right","Strong","Very Strong","5'10""","174 lbs","141","48",98,108,10,8,6,16,13,13,13,8,5,7,11,11,8,14,12,11,10,12,11,13,2,14,12,15,11,10,10,12,6,12,6,11,12,9,7,6,13,15,7,9,11,3,7,9,7,3,16,12,8,1,2,2,2,2,3,4,2,3,3,2
"2740",80032258,"Byron Bonilla","8/30/1993 (29 years old)","M/AM (L)","Real Estelí","Primera Division Nicaraguense","NCA","No","10/15/2022","6/30/2024","$0 - $90K","Left","Very Strong","Reasonable","5'9""","156 lbs","143","11",98,107,9,13,6,14,11,9,9,10,7,9,14,6,8,15,12,9,6,11,10,14,10,13,8,12,9,8,10,13,11,8,10,7,12,11,15,7,13,14,2,11,12,11,6,9,8,7,18,12,20,2,1,2,2,2,2,1,3,2,3,2
"2741",2000137266,"Miguel Rodríguez","6/13/2003 (19 years old)","GK","Diriangén","Primera Division Nicaraguense","NCA","No","6/30/2022","7/31/2024","$0 - $35K","Left","Very Strong","Strong","6'2""","182 lbs","30","-",76,107,2,3,2,2,7,4,2,3,3,2,12,1,3,4,12,9,10,7,8,8,18,1,2,2,10,10,9,9,11,12,7,12,15,9,4,12,11,9,12,11,10,10,9,14,11,3,10,9,10,9,8,11,9,10,11,11,5,7,10,9
"2742",2000079333,"Juan Luis Peréz","6/29/1999 (23 years old)","D (LC)","Alajuelense","Primera División de Costa Rica","NCA","No","12/8/2022","12/31/2024","$190K - $550K","Left","Very Strong","Reasonable","6'2""","171 lbs","89","5",99,107,6,12,4,9,11,1,11,7,9,10,7,5,11,9,10,13,10,10,11,15,5,7,10,6,12,9,8,8,15,15,10,9,12,15,7,7,12,13,6,12,10,13,6,2,7,6,12,12,14,3,1,2,1,1,1,2,1,1,2,2
"2743",80028756,"Douglas Forvis","5/17/1992 (31 years old)","GK","Real Estelí","Primera Division Nicaraguense","NCA","No","6/30/2022","6/30/2024","$0 - $65K","Right","Reasonable","Very Strong","6'3""","176 lbs","164","-",97,106,4,3,3,1,5,5,1,1,2,1,11,3,3,2,5,11,11,8,12,12,19,2,5,2,13,9,7,7,11,15,8,10,11,9,2,6,13,17,1,11,10,11,5,7,5,3,9,10,20,7,8,13,11,10,8,14,5,12,14,8
"2744",80030803,"Bryan Rodríguez","9/23/1996 (26 years old)","GK","Santa Ana (CRC)","Liga de Ascenso de Costa Rica","NCA","No","7/1/2022","6/30/2025","$0","Right","Reasonable","Very Strong","5'9""","149 lbs","47","-",96,105,3,1,2,3,6,7,1,2,2,1,13,3,3,2,11,10,15,4,10,14,12,3,7,3,11,9,8,8,12,12,9,9,15,12,3,7,12,10,2,10,10,9,14,5,12,1,11,11,9,9,8,14,7,10,11,14,5,10,8,11
"2745",2000061863,"Nendali Mendoza","5/20/1999 (24 years old)","DM, M (C)","Escorpiones","Liga de Ascenso de Costa Rica","NCA","No","7/1/2021","6/30/2025","$0","Right","Reasonable","Very Strong","5'10""","156 lbs","18","-",96,105,7,4,5,5,13,7,7,13,2,10,13,4,13,10,14,9,9,9,8,13,8,5,9,7,13,8,12,12,12,13,8,8,13,13,7,7,17,12,1,11,11,11,12,2,10,4,19,11,19,4,1,3,1,2,3,2,1,2,1,1
"2746",64046257,"Saleh Abdulhamid","4/8/1982 (41 years old)","D (C)","Busaiteen","Bahrain Premier League","BHR","No","1/1/2020","6/30/2024","$0","Right","Reasonable","Very Strong","6'0""","171 lbs","-","-",92,110,9,5,6,4,7,6,11,3,6,16,7,5,13,7,5,11,11,11,15,12,17,5,11,9,15,10,8,11,6,6,6,10,7,6,6,6,17,15,12,10,13,11,8,2,13,5,9,10,17,2,2,3,2,2,2,2,3,3,1,3
"2747",80031826,"Ariagner Smith","12/13/1998 (24 years old)","ST (C)","Panevėžys","Lithuanian A League","NCA","No","1/19/2023","12/31/2024","$100K - $1M","Right","Reasonable","Very Strong","6'2""","174 lbs","159","31",100,105,9,9,10,12,12,8,13,10,1,9,10,12,10,10,13,10,4,9,7,11,14,10,12,10,7,9,9,10,12,11,11,14,12,12,14,13,14,7,10,13,12,13,11,9,12,3,9,12,8,1,1,3,2,1,1,3,2,2,1,1
"2748",5430372,"Denis Espinoza","8/25/1983 (39 years old)","GK","Walter Ferreti","Primera Division Nicaraguense","NCA","No","6/14/2021","6/30/2024","$0 - $6K","Either","Very Strong","Very Strong","5'11""","165 lbs","340","2",90,102,4,2,3,2,2,6,1,1,3,2,9,2,3,3,11,8,10,8,9,14,14,3,10,1,11,9,8,8,6,15,6,8,15,6,6,6,12,6,12,11,6,15,5,9,7,7,13,10,12,9,8,6,7,11,13,11,5,12,8,13
"2749",80030534,"Christian Reyes","11/2/1995 (27 years old)","D (C), DM","Pérez Zeledón","Primera División de Costa Rica","NCA","No","5/31/2021","6/30/2025","$0 - $120K","Right","Reasonable","Very Strong","5'10""","163 lbs","195","10",95,101,4,7,6,5,6,8,14,6,3,14,5,3,8,8,6,14,10,7,11,14,12,5,13,8,14,7,7,10,13,9,9,8,15,10,13,10,13,10,9,10,10,11,6,7,5,5,12,11,18,3,1,1,3,1,3,1,1,3,1,2
"2750",80024743,"Carlos Montenegro","1/7/1991 (32 years old)","D (C), DM","Barrio México","Costa Rican Lower Division","NCA","No","1/4/2022","6/30/2024","$3.5K - $35K","Right","Reasonable","Very Strong","5'11""","165 lbs","138","10",91,101,7,3,8,5,8,8,14,6,2,13,7,3,14,8,11,11,9,9,10,14,16,5,12,8,12,8,5,11,13,9,9,6,11,8,13,7,9,11,7,12,12,10,14,7,7,3,11,10,17,2,2,2,3,3,2,2,2,4,2,3
"2751",2000031218,"Brayan Marín","6/21/1996 (26 years old)","D/WB/M (L)","Jicaral - Sercoba","Liga de Ascenso de Costa Rica","NCA","No","12/31/2022","6/30/2024","$0","Left","Very Strong","Reasonable","6'4""","180 lbs","31","1",92,101,7,10,8,5,10,9,3,7,9,11,8,4,10,11,13,10,9,8,9,15,10,5,10,9,10,10,10,11,15,13,10,14,14,15,8,8,17,16,2,9,13,10,11,11,5,8,12,12,10,2,1,3,1,2,1,2,2,2,3,3
"2752",80028917,"Marlon Lopez","11/2/1992 (30 years old)","DM, M (C)","Real Estelí","Primera Division Nicaraguense","NCA","No","6/14/2021","6/30/2024","$22K - $70K","Right","Reasonable","Very Strong","5'9""","158 lbs","259","25",90,100,8,8,6,8,9,8,8,9,7,9,10,6,13,14,14,10,6,10,10,14,12,5,5,9,12,9,7,13,14,14,9,8,13,14,8,6,15,13,11,12,9,12,12,12,11,5,12,10,12,1,1,1,3,2,1,2,1,2,3,3
"2753",87037590,"Cyril Errington","3/30/1992 (31 years old)","D (RC), WB (R)","Junior Managua","Liga de Ascenso de Nicaragua","NCA","No","5/31/2020","6/30/2024","$0 - $75K","Right","Reasonable","Very Strong","6'0""","174 lbs","72","-",90,100,5,7,8,5,10,7,10,6,8,12,10,3,10,6,7,11,10,9,11,14,4,5,14,8,13,9,9,9,9,12,9,8,12,11,11,7,16,7,8,11,12,12,9,8,5,1,17,12,12,4,1,3,1,3,2,2,3,3,1,1
"2754",5375211,"Rudel Calero","12/20/1982 (40 years old)","ST (C)","Boer FC","Lower Leagues","NCA","No","6/14/2021","6/30/2024","$500 - $3K","Right","Fairly Strong","Very Strong","5'10""","158 lbs","96","37",95,100,10,6,7,16,16,10,14,10,5,10,8,7,5,14,11,13,8,15,11,13,14,11,8,15,11,10,8,11,7,7,7,9,15,7,7,7,10,8,12,12,7,15,6,13,5,8,11,13,12,2,3,2,3,1,3,3,2,3,3,2
"2755",67006180,"Dani Cadena","2/9/1987 (36 years old)","AM (C), ST (C)","Universidad UNAM","Primera Division Nicaraguense","NCA","Yes","5/31/2022","6/30/2024","$0","Right","Reasonable","Very Strong","5'10""","160 lbs","169","62",90,100,9,9,9,15,15,8,12,11,4,9,10,7,9,12,5,10,5,11,10,15,2,10,14,13,10,9,10,10,10,8,10,7,15,10,8,9,12,16,7,8,11,9,13,14,6,7,20,13,7,1,4,2,3,3,1,1,3,2,2,2
"2756",80001533,"Francisco Flores","4/2/1988 (35 years old)","WB/M (L)","Diriangén","Primera Division Nicaraguense","NCA","No","6/30/2022","6/30/2024","$3.5K - $10K","Left","Very Strong","Reasonable","5'7""","132 lbs","341","16",98,99,10,14,6,9,13,7,10,10,10,11,11,8,9,12,13,14,10,12,11,14,10,5,10,12,9,11,10,12,9,12,7,5,15,11,12,5,12,8,11,10,6,11,6,12,10,7,11,9,10,3,1,3,3,3,2,2,3,1,2,3
"2757",64048952,"Ahmed Bughammar","12/30/1997 (25 years old)","D (C)","Al-Khalidiya","Bahrain Premier League","BHR","No","6/1/2021","6/30/2024","$0 - $65K","Left","Very Strong","Reasonable","5'11""","165 lbs","-","-",95,110,4,3,4,6,7,1,8,5,4,13,8,4,11,7,8,11,10,8,11,13,12,7,6,8,11,7,1,8,13,14,8,9,10,13,10,10,16,16,9,13,13,13,5,7,5,1,13,13,14,3,2,3,3,1,3,2,1,1,2,2
"2758",80012160,"Jose Carrion","3/20/1989 (34 years old)","D (RL)","Junior Managua","Liga de Ascenso de Nicaragua","NCA","No","12/31/2019","6/30/2024","$0 - $10K","Right","Fairly Strong","Very Strong","5'11""","163 lbs","97","1",80,97,6,11,5,6,7,1,7,8,4,11,10,3,10,10,7,9,10,10,12,11,9,5,10,8,11,10,10,10,10,12,7,12,7,12,12,7,14,6,10,8,3,11,9,12,12,6,19,8,11,1,3,3,3,3,2,3,3,1,1,4
"2759",80033979,"Emmanuel García","8/12/1997 (25 years old)","AM (RLC)","Juventus (NCA)","Liga de Ascenso de Nicaragua","NCA","No","7/1/2018","6/30/2024","$0","Right Only","Weak","Very Strong","5'9""","147 lbs","122","7",70,96,3,8,9,6,12,5,3,7,1,5,8,4,5,12,15,6,7,6,6,12,9,13,12,10,4,6,6,11,12,12,4,6,10,12,12,3,15,5,1,12,9,10,12,6,6,5,9,11,13,3,1,1,3,1,2,3,3,1,3,2
"2760",80012246,"Efren Guerrero","9/19/1987 (35 years old)","M (RLC)","CD Sebaco","Lower Leagues","NCA","No","6/14/2021","6/30/2024","$0 - $6K","Right Only","Weak","Very Strong","6'0""","167 lbs","56","-",88,96,10,14,7,9,15,9,5,7,9,10,11,9,10,11,13,10,1,10,9,15,11,8,6,11,7,10,15,13,12,9,10,13,10,9,9,7,13,5,9,10,11,12,8,12,11,2,5,11,11,1,1,3,1,1,2,3,2,2,1,4
"2761",80032636,"Randall Aguinaga","12/20/1997 (25 years old)","GK","Puntarenas FC","Primera División de Costa Rica","NCA","No","7/1/2021","6/30/2024","$0","Right","Reasonable","Very Strong","6'0""","174 lbs","10","-",90,96,3,3,3,3,1,8,1,1,1,1,9,3,1,4,7,13,12,9,10,8,9,3,14,1,7,9,8,8,14,8,5,10,13,10,5,6,12,2,5,9,13,12,8,7,10,4,20,13,16,10,7,14,12,7,11,14,6,10,14,14
"2762",80030138,"Jason Downs","10/9/1996 (26 years old)","D (C), DM","Universidad UNAM","Primera Division Nicaraguense","NCA","No","5/31/2020","6/30/2024","$0","Right","Reasonable","Very Strong","6'2""","171 lbs","105","1",74,96,5,2,2,2,8,1,12,2,1,11,7,2,8,7,13,7,5,7,8,13,6,5,12,4,13,6,7,7,8,9,7,11,15,11,12,7,16,15,12,12,12,10,13,5,8,2,11,12,18,2,2,1,4,1,2,2,3,1,3,3
"2763",80034048,"Luis Gaitán","1/19/1998 (25 years old)","D (RLC)","Juventus (NCA)","Liga de Ascenso de Nicaragua","NCA","No","5/31/2022","6/30/2024","$0 - $9K","Left","Very Strong","Reasonable","6'1""","169 lbs","56","1",71,96,7,10,6,1,8,6,11,6,3,10,7,2,11,3,15,9,9,7,11,9,6,5,12,6,9,7,6,7,13,13,7,10,13,12,12,6,11,8,8,12,12,10,7,7,6,2,9,11,13,2,3,2,1,4,2,2,2,2,3,1
"2764",43275083,"Kayro Flores Heatley","4/1/1998 (25 years old)","ST (C)","Anzio","Italian Serie D Grp. G","NCA","Yes","6/12/2023","6/30/2024","$3K - $30K","Right Only","Weak","Very Strong","6'0""","171 lbs","119","14",73,95,5,8,8,10,10,9,12,8,7,5,11,7,7,9,8,9,12,11,10,9,12,8,10,9,7,12,8,12,11,9,14,12,11,12,12,11,13,12,18,13,10,12,6,10,9,6,9,13,18,1,3,1,1,1,1,3,2,3,2,1
"2765",80032101,"Erling Moran","12/24/1984 (38 years old)","M/AM (C)","Chinandega","Liga de Ascenso de Nicaragua","NCA","No","6/14/2021","6/30/2024","$1.5K - $4K","Right","Reasonable","Very Strong","5'6""","134 lbs","204","19",78,95,6,7,8,12,15,8,6,8,7,7,13,6,9,11,10,10,8,8,6,11,17,9,14,12,9,9,15,14,8,8,8,3,15,8,9,3,11,7,7,9,12,14,12,10,12,2,11,10,18,4,2,2,3,1,1,1,1,2,1,3
"2766",80012234,"Justo Llorente","2/27/1984 (39 years old)","GK","Ocotal","Primera Division Nicaraguense","NCA","No","12/31/2022","6/30/2024","$0 - $10K","Left","Very Strong","Reasonable","5'9""","169 lbs","297","-",90,95,3,1,3,1,3,7,2,2,3,1,9,1,1,8,9,13,14,5,13,15,9,1,6,3,14,9,6,5,7,7,7,7,7,7,4,7,10,6,3,12,12,13,14,11,8,3,10,10,13,9,13,7,10,8,15,15,5,11,13,10
"2767",80033487,"Agenor Báez","12/18/1997 (25 years old)","M/AM (C)","Managua","Primera Division Nicaraguense","NCA","No","6/15/2020","6/30/2024","$1K - $10K","Right","Reasonable","Very Strong","5'9""","165 lbs","238","28",73,95,2,4,7,9,12,5,4,5,1,3,9,6,6,8,15,10,3,12,4,12,7,15,9,9,7,6,12,11,12,12,6,4,12,12,12,4,14,7,1,12,11,11,7,7,6,1,13,12,11,2,2,2,1,2,3,3,1,1,2,3
"2768",64048951,"Sayed Ameen","3/7/1999 (24 years old)","D (R)","Al-Ahli Club","Bahrain Premier League","BHR","No","2/1/2023","6/30/2024","$1K - $8K","Right","Fairly Strong","Very Strong","6'0""","163 lbs","-","-",81,108,7,8,2,5,8,3,8,6,4,10,8,4,9,8,10,8,9,8,7,11,4,9,9,4,10,8,3,8,14,14,6,9,8,14,7,11,12,16,10,11,11,10,13,10,8,8,12,10,16,3,3,2,3,3,1,1,3,4,3,4
"2769",80030129,"Berman Cruz","7/1/1991 (31 years old)","D (RC)","CD Sebaco","Lower Leagues","NCA","No","6/14/2021","6/30/2024","$14K - $40K","Right","Reasonable","Very Strong","6'0""","165 lbs","20","-",84,94,9,12,8,4,7,8,11,6,8,9,9,2,15,8,12,13,10,9,10,10,13,5,9,7,7,8,5,9,7,12,9,11,9,10,14,8,12,5,8,13,12,11,7,8,8,4,11,10,16,1,1,3,3,1,2,3,3,1,1,3
"2770",80034001,"Dexter Diaz","9/13/1996 (26 years old)","M (RLC)","Matagalpa","Primera Division Nicaraguense","NCA","No","7/1/2022","6/30/2024","$14K - $40K","Right Only","Weak","Very Strong","5'9""","163 lbs","75","-",73,94,7,8,9,7,14,6,7,6,7,8,8,1,6,9,8,11,6,5,5,10,3,5,2,8,5,8,9,11,14,14,8,8,12,14,13,5,12,15,10,13,12,12,15,17,8,8,9,12,16,2,2,2,4,3,3,3,2,1,3,2
"2771",2000224908,"Freddy Ortiz Díaz","11/22/2005 (17 years old)","AM (R)","Servette","Swiss Promotion League","NCA","Yes","7/1/2022","6/30/2025","$0 - $50K","Right","Fairly Strong","Very Strong","5'10""","143 lbs","-","-",61,93,6,10,10,8,7,5,6,7,4,3,10,2,3,9,11,3,7,6,4,8,5,9,9,9,3,6,6,7,13,13,7,7,11,13,4,3,7,8,8,11,10,11,6,8,5,4,16,11,14,3,3,3,1,1,4,1,2,1,1,2
"2772",80032125,"Eliezer Gonzalez","7/20/1994 (28 years old)","DM, M (C)","Juventus (NCA)","Liga de Ascenso de Nicaragua","NCA","No","6/15/2020","6/30/2024","$8K - $24K","Right","Reasonable","Very Strong","5'9""","160 lbs","72","-",76,91,6,6,5,6,11,6,6,5,2,6,12,4,9,10,11,10,8,8,6,13,11,5,6,7,11,7,13,12,13,13,7,4,9,13,13,10,15,11,8,10,12,9,6,4,9,8,17,11,13,3,2,1,1,3,1,4,3,1,2,4
"2773",80034117,"Keveen Torres","5/19/1998 (25 years old)","D (C), DM","Santa Ana (CRC)","Liga de Ascenso de Costa Rica","NCA","No","7/1/2022","6/30/2025","$0","Right","Reasonable","Very Strong","5'11""","158 lbs","24","1",85,91,3,3,5,5,6,7,10,6,2,11,9,5,14,6,15,10,9,8,7,13,10,5,13,7,12,5,6,9,13,12,8,11,18,11,11,8,11,11,8,13,11,11,5,3,11,3,9,11,20,1,1,2,3,2,1,2,2,2,3,1
"2774",80033450,"Mario Macanche","5/31/1995 (28 years old)","D (C), DM","H & H Export","Primera Division Nicaraguense","NCA","No","7/1/2022","6/30/2024","$0 - $40K","Right","Reasonable","Very Strong","5'11""","158 lbs","10","-",73,91,5,6,4,3,8,6,13,5,1,9,5,1,9,7,6,9,8,7,8,11,8,5,9,6,13,7,7,11,13,13,7,10,14,13,9,6,15,5,8,12,11,12,5,16,7,8,10,11,14,2,1,3,2,3,3,1,3,3,3,1
"2775",80012239,"Jessie Lopez","10/24/1990 (32 years old)","M (LC)","Chinandega","Liga de Ascenso de Nicaragua","NCA","No","5/31/2019","6/30/2024","$1.5K - $14K","Left","Very Strong","Reasonable","5'6""","147 lbs","161","2",87,91,9,14,10,7,15,8,3,10,7,9,8,3,7,11,12,7,9,11,9,9,18,8,10,8,6,9,13,14,11,12,9,3,12,11,12,6,11,14,7,13,12,9,6,1,8,2,13,11,12,4,2,1,2,1,3,2,1,3,1,3
"2776",80012680,"Josué Quijano","3/10/1991 (32 years old)","D/WB (RL)","Real Estelí","Primera Division Nicaraguense","NCA","No","6/14/2021","6/30/2024","$0 - $30K","Right","Reasonable","Very Strong","5'4""","136 lbs","295","8",85,90,6,11,10,5,11,2,8,6,9,11,11,2,16,11,10,12,9,10,11,14,8,8,9,10,10,10,7,10,12,11,10,1,16,10,8,1,14,15,9,10,12,11,12,16,12,1,11,12,12,2,3,3,1,1,3,3,3,3,2,1
"2777",80027571,"Alexis Somarribas","5/11/1994 (29 years old)","M/AM (C)","Walter Ferreti","Primera Division Nicaraguense","NCA","No","12/31/2020","6/30/2024","$1K - $8K","Left","Very Strong","Reasonable","5'9""","163 lbs","221","36",80,90,6,5,8,10,10,6,5,9,1,5,8,4,8,8,7,10,7,6,7,10,14,8,11,11,6,7,10,8,13,13,7,5,15,13,13,4,15,9,7,12,10,10,7,6,10,4,13,12,14,2,2,1,1,1,2,1,2,2,1,2
"2778",80030178,"Franklin Gomez","10/1/1986 (36 years old)","GK","Nandasmo","Lower Leagues","NCA","No","6/14/2021","6/30/2024","$0 - $8K","Right","Reasonable","Very Strong","5'11""","165 lbs","28","-",80,90,2,3,1,1,6,5,1,1,1,1,8,1,3,7,15,9,13,8,10,14,12,3,6,3,11,8,7,7,9,13,8,7,12,9,6,6,11,13,10,10,12,10,5,13,9,6,15,13,15,8,5,9,11,9,11,11,5,8,12,12
"2779",64046930,"Khaled Faisal","2/10/2000 (23 years old)","M (C)","Al-Najma Club","Bahrain Premier League","BHR","No","6/15/2020","6/30/2024","$0 - $16K","Right","Reasonable","Very Strong","5'9""","149 lbs","-","-",63,108,3,1,6,6,6,5,5,6,4,9,13,2,7,11,8,6,6,5,6,12,16,7,5,10,6,7,10,11,13,13,6,4,8,13,6,4,9,19,10,9,12,8,5,5,8,1,7,13,18,2,2,3,4,2,3,3,3,3,1,1
"2780",36114689,"Armando Goufas","2/2/1995 (28 years old)","M (L), AM (RL)","Aris Petroupolis","Greek National C Division Group 4","NCA","Yes","8/26/2022","6/30/2024","$12K - $35K","Left","Very Strong","Weak","5'7""","143 lbs","189","27",75,90,7,6,12,6,12,7,8,11,6,11,8,10,6,12,12,7,13,7,8,7,13,13,4,9,6,10,8,13,12,13,8,6,12,13,12,6,13,13,10,12,13,6,9,10,4,7,7,16,9,2,1,2,2,2,2,3,1,2,3,1
"2781",80034009,"Hayder Calero","9/29/1997 (25 years old)","D (RLC)","Walter Ferreti","Primera Division Nicaraguense","NCA","No","5/31/2019","6/30/2024","$6K - $18K","Right","Reasonable","Very Strong","5'5""","141 lbs","189","13",75,90,6,9,6,2,7,4,10,3,7,8,8,6,11,4,8,11,9,8,9,14,4,5,6,7,11,3,7,5,14,14,8,2,9,14,9,3,10,11,8,11,10,11,14,9,12,7,11,10,8,2,4,2,1,2,1,3,3,1,3,3
"2782",80012219,"German Umaña","6/6/1985 (38 years old)","DM","San Francisco","Lower Leagues","NCA","No","6/14/2021","6/30/2024","$0 - $1.5K","Right","Reasonable","Very Strong","5'8""","167 lbs","73","-",80,90,8,7,4,9,7,8,6,10,1,11,9,8,9,7,13,13,8,8,12,15,16,5,6,8,12,9,12,13,8,8,8,8,12,8,8,8,10,18,4,11,11,13,7,9,11,6,10,10,10,1,3,2,1,1,1,3,3,1,3,2
"2783",80033564,"Dshon Forbes","7/9/1997 (25 years old)","AM (RL)","Diriangén","Primera Division Nicaraguense","NCA","No","5/31/2022","6/30/2024","$0 - $55K","Right","Reasonable","Very Strong","6'0""","158 lbs","128","58",75,90,6,10,10,8,13,6,3,2,6,5,6,7,7,13,13,8,7,12,7,12,5,13,11,7,6,7,8,7,13,13,6,6,10,13,9,4,11,13,1,11,12,9,11,13,7,4,9,9,18,2,3,3,2,3,2,2,1,3,3,1
"2784",2000081051,"Keylon Batiz","2/1/2004 (19 years old)","AM (RL), ST (C)","TOM","Brazilian National Second Division","NCA","No","7/1/2020","6/30/2025","$2.5K - $24K","Right","Reasonable","Very Strong","5'10""","154 lbs","46","12",81,90,7,12,13,8,14,4,7,6,4,5,12,5,5,9,9,8,8,8,7,10,5,10,5,7,6,8,9,9,11,12,8,5,6,12,6,5,8,4,7,13,14,10,11,5,10,6,9,9,11,1,3,3,1,1,2,3,2,2,2,3
"2785",80033455,"Kevin González","2/23/1995 (28 years old)","D/WB (L)","Managua","Primera Division Nicaraguense","NCA","No","5/31/2021","6/30/2024","$500 - $6K","Left","Very Strong","Reasonable","5'9""","152 lbs","140","4",74,90,4,10,8,5,12,2,7,6,4,8,8,6,12,9,10,10,6,6,9,9,4,6,8,8,9,8,7,8,14,14,8,9,8,14,5,6,12,11,3,11,13,11,11,1,15,8,13,11,13,1,1,1,1,1,4,1,1,2,3,1
"2786",13170056,"Ali Mohamed","10/7/1995 (27 years old)","DM, M (RC)","Maccabi Haifa","Israeli Premier League","NIG","No","6/22/2021","5/31/2024","$425K - $4.2M","Right","Weak","Very Strong","5'8""","143 lbs","241","6",125,132,5,10,14,6,13,2,7,5,8,12,13,5,15,14,12,15,14,14,14,13,14,16,9,13,14,16,11,17,13,14,13,7,12,12,17,13,13,12,14,13,7,8,11,13,9,10,12,13,16,1,2,3,3,1,2,3,2,1,1,2
"2787",13232502,"Youssouf Oumarou","2/16/1993 (30 years old)","DM, M/AM (C)","US Monastir","Ligue Professionnelle 1","NIG","No","7/1/2021","6/30/2025","$45K - $450K","Right Only","Weak","Very Strong","6'3""","176 lbs","51","14",114,120,7,9,10,11,11,9,14,9,9,8,13,13,12,11,10,13,12,10,11,13,10,5,15,15,12,15,11,14,13,9,15,15,14,14,15,15,5,11,11,10,11,9,7,12,11,3,11,8,14,2,3,3,1,3,2,3,4,2,3,1
"2788",13221055,"Kairou Amoustapha","1/1/2001 (22 years old)","M/AM (R), ST (C)","Cancún","Mexican Expansion League","NIG","No","10/3/2021","6/30/2024","$3K - $30K","Left","Very Strong","Fairly Strong","5'10""","160 lbs","51","6",80,120,9,8,7,8,6,9,8,16,8,7,8,11,8,8,9,8,8,9,8,7,14,9,9,9,8,9,9,11,11,9,10,10,12,14,14,12,11,12,10,14,10,13,10,10,8,1,7,13,20,3,2,2,2,4,1,1,2,3,3,3
"2789",2000045007,"Naim-Nhour Van Attenhoven","1/31/2003 (20 years old)","GK","VAFC","French National 3 - Group G","NIG","Yes","1/31/2023","6/30/2024","$30K - $325K","Left Only","Very Strong","Weak","6'1""","169 lbs","7","-",85,120,3,1,3,1,4,5,1,2,1,1,11,2,2,1,9,11,15,8,9,13,14,3,9,1,10,8,7,6,13,10,8,13,11,11,1,6,10,20,12,9,13,12,12,19,12,3,10,10,9,10,6,13,5,8,10,10,9,14,10,10
"2790",2000178105,"Khalifa Ahmed","5/23/2002 (21 years old)","ST (C)","Muharraq","Bahrain Premier League","BHR","No","7/1/2020","6/30/2024","$14K - $45K","Right","Fairly Strong","Very Strong","5'5""","130 lbs","-","-",72,107,7,4,11,14,9,7,10,8,1,4,8,6,3,11,11,12,6,10,8,9,16,10,11,14,5,7,8,8,8,12,8,1,12,12,13,2,9,16,9,9,9,11,11,9,11,5,9,8,18,3,2,3,3,2,4,2,1,1,3,2
"2791",13193906,"Djibrilla Ibrahim Mossi","3/2/2002 (21 years old)","D (C)","Rijeka","Croatian First League","NIG","No","7/1/2022","6/30/2024","$28K - $275K","Right Only","Weak","Very Strong","6'4""","205 lbs","11","1",87,120,3,5,6,4,9,1,13,7,1,11,8,6,12,7,11,10,11,9,8,9,6,5,11,5,11,12,6,8,9,6,10,17,8,11,9,15,13,18,12,9,12,13,9,14,12,7,10,9,17,2,1,1,3,1,2,2,3,2,1,2
"2792",13193896,"Najeeb Yakubu","5/1/2000 (23 years old)","D/WB (RL), M (R)","Vorskla","Ukrainian Premier League","NIG","No","9/4/2018","6/30/2024","$110K - $1.1M","Right Only","Weak","Very Strong","6'0""","158 lbs","70","2",103,120,6,11,9,11,10,9,7,9,8,10,12,4,11,12,9,9,10,11,9,9,2,10,10,9,9,11,11,11,14,13,10,13,13,15,13,14,3,18,13,13,12,10,5,8,9,3,10,11,12,3,3,1,3,2,1,3,2,2,1,3
"2793",2000242842,"Alhabab Abdou","8/24/2003 (19 years old)","D (LC)","AS Police (NIG)","Nigerien Premier Division","NIG","No","7/1/2020","6/30/2025","$0 - $28K","Left","Very Strong","Reasonable","5'8""","154 lbs","-","-",73,119,7,14,3,3,9,4,10,7,8,10,9,7,15,9,7,6,10,9,12,11,10,5,14,6,9,8,9,5,14,10,10,3,15,11,9,8,11,15,12,10,12,9,9,8,6,2,20,9,9,3,2,4,2,3,3,3,3,1,2,3
"2794",63027394,"Daniel Soungolé Souné","2/26/1995 (28 years old)","DM","Brozany","Czech Third Division CFL B","NIG","No","7/28/2022","6/30/2024","$24K - $250K","Right","Reasonable","Very Strong","5'9""","152 lbs","65","-",92,119,6,7,12,6,12,8,9,12,9,11,12,9,12,12,9,8,10,13,9,8,10,13,6,8,8,5,6,11,14,15,13,9,10,14,15,10,9,10,10,10,10,10,11,8,8,10,10,14,12,1,2,1,1,3,2,1,3,3,3,2
"2795",67246312,"Yac Diori","8/9/1997 (25 years old)","D (RC)","Castellón","Spanish Federation First Division B","NIG","No","7/22/2021","6/30/2024","$18K - $180K","Right","Reasonable","Very Strong","5'11""","174 lbs","112","7",93,119,6,11,7,7,9,3,11,3,3,13,6,3,13,7,9,10,10,8,10,13,18,5,5,7,13,7,2,8,13,13,8,5,12,13,13,6,10,17,10,10,12,11,10,16,13,6,11,12,18,1,1,2,2,1,4,2,3,3,1,3
"2796",2000242686,"Ibrahim Oumarou","1/1/2002 (21 years old)","ST (C)","AS-GNN","Nigerien Premier Division","NIG","No","8/1/2022","6/30/2025","$0 - $110K","Right","Fairly Strong","Very Strong","6'0""","163 lbs","-","-",75,118,6,6,13,13,13,3,11,7,1,6,6,3,4,13,5,6,5,7,7,11,12,13,5,8,7,6,7,7,13,13,7,5,11,13,7,5,12,18,10,8,12,10,11,8,10,5,15,10,16,2,3,2,1,3,3,2,2,2,2,2
"2797",13221070,"Moumouni Darankoum","8/7/2002 (20 years old)","DM, M (C)","Sheriff Tiraspol","Moldovan Divizia A Group A","NIG","No","7/1/2021","12/31/2025","$160K - $1.6M","Right","Fairly Strong","Very Strong","6'1""","171 lbs","4","-",95,118,6,7,4,9,13,7,8,12,5,9,13,4,11,14,11,9,9,10,10,13,16,5,9,9,9,9,14,12,14,11,4,10,12,9,7,7,11,14,13,10,12,10,9,4,14,2,11,11,13,3,3,2,2,3,1,3,1,3,3,4
"2798",18022060,"Moussa Maazou","8/25/1988 (34 years old)","M/AM (R), ST (C)","FC Bassin Piennois","French Regional Divisions","NIG","No","8/27/2022","-","$0","Right Only","Weak","Very Strong","6'2""","171 lbs","405","131",90,115,4,10,9,12,10,8,13,10,5,6,9,13,3,10,12,8,14,10,11,9,10,10,9,11,7,10,7,12,12,11,14,14,14,13,12,13,8,14,12,10,10,10,8,13,10,8,10,13,8,2,1,1,1,3,1,2,1,2,3,1
"2799",13221052,"Issah Salou","2/4/1999 (24 years old)","DM, M (LC)","Skive IK","2. Division","NIG","No","6/18/2022","6/30/2024","$0 - $28K","Right Only","Weak","Very Strong","5'9""","158 lbs","50","-",74,115,4,5,6,7,8,2,10,5,6,10,9,6,9,9,14,9,10,10,9,9,3,2,10,6,9,10,9,12,12,12,9,6,17,11,11,12,10,15,13,14,11,11,3,10,10,4,9,10,11,3,1,2,1,1,1,2,3,3,2,3
"2800",13211588,"Yusif Moussa","9/4/1998 (24 years old)","DM, M (RC)","Ilves","Finnish Premier League","NIG","No","7/1/2021","11/15/2023","$22K - $210K","Right Only","Very Weak","Very Strong","5'9""","154 lbs","49","2",91,114,9,11,11,11,11,7,7,7,7,10,12,9,10,12,9,11,10,11,8,10,12,10,11,11,12,16,12,13,13,14,8,8,7,12,13,8,13,15,12,13,10,7,5,14,7,4,14,12,13,2,1,4,1,2,3,3,3,1,2,4
"2801",23409071,"Ahmed Saleh","1/11/1998 (25 years old)","AM (C), ST (C)","Muharraq","Bahrain Premier League","BHR","No","6/21/2019","6/30/2024","$1K - $9K","Right","Reasonable","Very Strong","5'8""","132 lbs","-","-",80,107,7,6,11,11,10,7,13,6,5,7,9,6,8,10,15,8,7,7,8,11,18,9,13,11,7,4,7,9,14,14,8,6,12,14,14,6,10,18,12,11,11,13,6,15,5,3,9,11,7,1,3,2,3,3,2,3,2,2,1,2
"2802",8750081,"Kassaly Daouda","8/19/1983 (39 years old)","GK","Katsina Utd","Nigerian Premier League","NIG","No","6/14/2021","9/1/2023","$3K - $8K","Right Only","Very Weak","Very Strong","6'3""","178 lbs","65","-",98,113,5,2,1,3,2,6,2,2,1,1,12,2,3,7,6,10,13,10,13,15,16,3,11,3,14,10,9,9,7,13,16,13,14,8,7,15,12,19,9,12,12,11,11,3,15,1,14,11,13,12,9,7,9,14,8,15,5,8,10,15
"2803",13221054,"Amadou Sabo","5/30/2000 (23 years old)","M/AM (C)","Club Africain","Ligue Professionnelle 1","NIG","No","10/28/2021","6/30/2024","$45K - $450K","Right","Reasonable","Very Strong","5'10""","147 lbs","53","5",98,112,8,8,13,8,12,8,5,9,8,9,14,8,10,13,12,11,9,11,7,12,16,15,6,12,10,13,12,11,13,12,11,9,12,11,11,7,14,13,10,13,10,9,5,5,9,1,10,10,19,1,3,2,1,1,1,3,2,2,1,2
"2804",13176266,"Victorien Adebayor","11/12/1996 (26 years old)","AM (RC), ST (C)","RS Berkane","Botola Pro 1","NIG","No","8/1/2022","6/30/2025","$0","Left","Very Strong","Reasonable","6'0""","165 lbs","37","20",100,111,6,10,13,12,13,8,10,5,6,7,13,3,9,13,12,11,4,9,9,13,9,13,9,10,9,8,6,10,13,13,9,8,13,14,12,7,12,19,11,11,11,15,11,10,9,1,20,12,20,2,2,1,2,2,2,1,1,2,2,2
"2805",12094372,"Moustapha Sabo","9/14/2004 (18 years old)","DM, M (C)","Hammarby IF","Swedish Premier Division","NIG","No","1/8/2023","7/14/2027","$30K - $325K","Right","Reasonable","Very Strong","5'9""","152 lbs","16","1",93,111,9,12,8,8,12,10,8,8,6,9,12,8,9,12,10,10,10,12,11,11,13,7,8,11,9,9,12,10,12,12,10,7,10,12,12,9,9,12,12,12,12,9,5,3,6,5,12,12,12,1,1,2,2,1,3,4,4,1,3,1
"2806",2000076495,"Djibril Goumey","7/14/2000 (22 years old)","AM (RL), ST (C)","Zakho","Iraqi Premier League","NIG","No","1/7/2023","6/30/2025","$0","Right","Reasonable","Very Strong","6'1""","163 lbs","-","-",85,110,7,12,13,7,11,3,7,5,6,6,9,6,5,13,9,8,7,8,7,8,16,13,12,10,6,7,8,6,13,11,13,12,8,11,11,4,13,20,10,10,10,13,5,3,10,5,19,10,16,2,1,3,1,2,3,2,1,3,3,2
"2807",2000030614,"Hassane Amadou","6/26/2000 (22 years old)","DM, M (C)","Burgos","Spanish Second Division","NIG","No","7/1/2022","6/30/2024","$0 - $130K","Right","Reasonable","Very Strong","6'3""","174 lbs","90","-",87,110,6,5,7,5,10,6,6,13,3,11,13,6,13,9,11,10,8,5,8,13,5,7,9,7,8,7,9,12,13,11,7,14,12,12,10,5,17,13,12,11,11,10,9,10,6,8,20,11,7,2,1,1,2,1,2,2,1,2,2,2
"2808",34009233,"Olivier Bonnes","2/7/1990 (33 years old)","DM, M (C)","Hwaseong","Korean K3 League","NIG","Yes","3/1/2020","12/31/2024","$0","Right Only","Very Weak","Very Strong","6'2""","176 lbs","112","4",60,110,3,5,8,3,9,7,10,8,5,9,9,5,10,10,14,9,15,9,9,8,14,9,10,11,10,13,10,13,10,10,13,15,14,10,10,12,8,14,14,14,10,13,9,14,13,6,13,13,13,3,2,2,2,1,2,3,1,3,1,3
"2809",12093271,"Issa Djibrilla","1/1/1996 (27 years old)","M (L), AM (RL)","Zira","Azeri Premier League","NIG","No","1/1/2023","6/30/2025","$40K - $425K","Left","Very Strong","Reasonable","5'7""","132 lbs","53","11",100,110,6,10,13,10,11,5,6,10,2,6,9,5,6,13,8,9,10,10,9,10,11,13,5,12,6,9,8,11,15,12,10,5,9,14,11,8,12,18,8,11,13,9,7,13,7,3,14,13,18,1,1,2,3,1,1,2,3,1,1,1
"2810",2000076550,"Daniel Sosah","9/21/1998 (24 years old)","AM (RL), ST (C)","Kryvbas","Ukrainian Premier League","NIG","No","3/17/2023","6/30/2025","$35K - $375K","Right","Reasonable","Very Strong","5'10""","171 lbs","49","16",100,110,4,6,12,12,12,6,9,6,6,4,10,12,7,14,14,10,14,8,8,12,5,12,8,14,6,8,10,12,13,13,10,9,16,13,12,10,12,15,10,11,11,8,3,10,14,5,9,10,9,3,2,2,1,2,1,2,1,2,3,3
"2811",13129405,"Ousmane Diabaté","7/9/1994 (28 years old)","DM, M (C)","Al-Olympic","Libyan First Division","NIG","No","8/25/2022","6/30/2024","$0","Right","Reasonable","Very Strong","6'1""","180 lbs","8","-",100,109,6,8,4,7,14,8,8,11,7,10,13,5,14,14,9,10,6,8,8,13,2,5,4,9,9,8,9,9,14,14,9,14,7,14,7,10,10,18,13,11,13,11,14,9,8,8,9,11,10,3,2,3,1,1,2,2,2,1,2,2
"2812",23267424,"Thiago Fernandes","5/20/1990 (33 years old)","ST (C)","Hidd","Bahrain Premier League","BHR","No","7/28/2022","6/30/2024","$0 - $45K","Right","Fairly Strong","Very Strong","6'1""","187 lbs","50","72",99,106,6,4,12,14,14,8,14,6,3,8,9,5,3,9,13,14,4,10,7,14,8,8,5,14,7,8,6,9,8,11,5,10,15,8,12,9,12,16,13,9,10,11,6,7,5,1,20,10,12,1,1,2,2,2,2,3,1,3,3,3
"2813",2000158637,"Hassan Seidou Boubacar","5/20/2002 (21 years old)","D (R)","US GN","Nigerien Premier Division","NIG","No","7/1/2020","6/30/2025","$26K - $75K","Right","Reasonable","Very Strong","5'8""","143 lbs","-","-",70,109,5,8,3,4,9,3,7,6,4,10,7,3,8,7,15,7,9,7,9,10,5,5,14,5,7,7,5,8,13,13,6,6,12,13,13,5,13,17,10,14,11,8,8,9,12,1,12,11,17,3,2,3,3,1,2,4,3,1,3,3
"2814",2000131530,"Abdel Rahim Alhassane","1/1/2002 (21 years old)","D (L)","R. Majadahonda","Spanish Federation First Division A","NIG","No","7/1/2020","6/30/2025","$20K - $210K","Left","Very Strong","Reasonable","6'0""","165 lbs","38","-",93,108,8,11,9,4,9,4,10,3,7,13,10,4,14,8,10,7,9,10,13,15,19,6,12,8,11,10,5,10,13,11,9,8,8,13,11,8,16,15,10,10,10,13,14,4,8,8,14,9,15,3,3,4,1,3,1,3,2,3,3,3
"2815",2000269968,"Alhabib Hassane Abdou","8/24/2003 (19 years old)","D (LC)","AS Douanes (NIG)","Nigerien Premier Division","NIG","No","7/1/2022","6/30/2025","$0 - $35K","Left","Very Strong","Reasonable","5'8""","154 lbs","-","-",70,107,6,11,7,7,9,2,9,7,7,11,6,5,14,8,15,9,9,7,5,14,8,5,11,7,10,8,7,9,7,11,9,7,12,9,13,6,12,16,10,12,11,13,5,6,8,5,11,10,15,1,3,2,1,2,3,2,2,1,2,1
"2816",13193987,"Sountalma Sidibé","1/20/2002 (21 years old)","M/AM (R)","Cotonsport","Cameroonian MTN Elite One Group B","NIG","No","8/26/2021","6/30/2024","$1K - $8K","Right","Reasonable","Very Strong","5'10""","147 lbs","-","-",70,106,6,11,5,8,11,4,1,2,5,6,11,2,7,13,5,3,8,8,6,3,8,13,7,11,6,7,7,12,13,13,13,7,14,13,10,3,12,16,12,11,13,12,6,3,13,1,11,11,13,1,3,1,2,4,1,1,3,2,1,1
"2817",13145207,"Abdoulaye Katakoré","3/26/1993 (30 years old)","D (RC)","AS Douanes (NIG)","Nigerien Premier Division","NIG","No","10/1/2020","6/30/2025","$0","Right","Reasonable","Very Strong","6'2""","165 lbs","9","-",87,106,5,10,7,7,9,1,14,4,6,13,6,4,12,7,13,13,9,8,8,9,9,5,10,7,12,7,6,8,14,11,8,13,13,14,13,7,15,19,11,13,11,12,10,14,12,2,10,8,18,2,3,3,3,4,3,2,3,3,1,1
"2818",2000158620,"Moussa Kassa","11/11/1999 (23 years old)","DM, M (C)","US GN","Nigerien Premier Division","NIG","No","7/1/2020","6/30/2025","$0 - $50K","Right Only","Weak","Very Strong","6'0""","149 lbs","-","-",83,105,8,8,9,8,14,7,8,10,2,7,10,5,12,12,10,10,8,8,10,15,15,5,6,9,11,9,13,13,12,12,9,12,12,11,8,6,16,19,9,13,11,12,10,10,6,1,11,11,17,1,4,4,3,3,3,3,1,4,3,2
"2819",12007283,"Daouda Kamilou","12/29/1987 (35 years old)","ST (C)","Cotonsport","Cameroonian MTN Elite One Group B","NIG","No","6/14/2021","6/30/2024","$0 - $1.5K","Right Only","Weak","Very Strong","5'7""","160 lbs","24","10",80,105,6,6,11,12,11,8,10,10,6,4,8,12,4,10,13,11,12,10,9,9,7,10,14,12,4,8,8,11,11,11,10,11,15,11,11,10,11,12,12,11,12,11,7,6,6,3,11,11,12,3,2,3,3,3,4,3,4,2,3,2
"2820",13128058,"Mohamed Bachar","12/22/1992 (30 years old)","D/WB (R)","AS Douanes (NIG)","Nigerien Premier Division","NIG","No","6/14/2021","6/30/2025","$0 - $20K","Right Only","Weak","Very Strong","5'11""","154 lbs","-","-",72,105,4,12,6,1,13,2,7,5,3,8,8,1,13,8,13,6,9,4,8,12,7,5,11,6,8,7,7,7,13,13,7,8,10,13,12,4,13,11,10,12,10,11,6,15,15,6,12,14,17,2,3,2,3,4,3,1,4,3,3,1
"2821",13115030,"Mahamane Cissé","12/27/1993 (29 years old)","M (L), AM (RL)","AS Otôho","Congolese Championnat National","NIG","No","6/30/2021","12/31/2023","$16K - $170K","Right Only","Weak","Very Strong","5'11""","149 lbs","15","2",95,105,10,12,14,14,14,8,7,9,8,7,10,6,7,12,5,10,5,10,8,13,7,11,9,13,8,7,10,10,13,13,7,9,10,13,9,6,11,20,9,13,10,9,13,10,9,8,9,10,11,1,3,1,2,3,2,3,3,1,2,3
"2822",13206205,"Boubacar Haïnikoye","1/1/1998 (25 years old)","AM (C), ST (C)","US GN","Nigerien Premier Division","NIG","No","12/29/2021","6/30/2025","$45K - $140K","Right","Reasonable","Very Strong","6'0""","163 lbs","34","4",92,105,8,10,12,9,14,6,12,8,3,8,10,4,8,12,13,10,8,10,8,14,4,11,14,14,8,8,9,10,14,13,5,7,12,14,9,7,12,11,11,12,12,13,14,14,12,5,18,11,14,1,2,3,4,2,1,4,1,3,1,2
"2823",2000006353,"Khalifa Issa","12/26/2001 (21 years old)","M (C)","Manama","Bahrain Premier League","BHR","No","6/1/2022","6/30/2024","$14K - $40K","Right","Reasonable","Very Strong","5'9""","156 lbs","-","-",72,106,7,6,4,8,10,7,7,7,1,8,13,7,8,11,11,8,8,6,7,11,5,6,1,12,9,8,12,12,11,12,6,5,10,11,7,7,14,13,10,12,10,10,9,6,11,6,13,12,13,1,1,2,2,1,1,2,2,3,4,1
"2824",49034274,"Seybou Koïta","4/15/1994 (29 years old)","ST (C)","Oman","Omani Professional League","NIG","No","2/5/2023","6/30/2024","$0 - $60K","Right Only","Weak","Very Strong","5'11""","169 lbs","68","10",98,104,5,8,11,11,10,7,10,8,3,5,11,12,5,9,8,12,13,14,11,12,12,11,7,13,11,12,10,13,13,12,12,13,11,12,10,14,8,10,10,12,8,10,8,12,9,7,11,12,10,2,2,2,1,1,4,1,2,2,4,3
"2825",2000269962,"Samaila Salifou","1/31/2005 (18 years old)","AM (R), ST (C)","AS Police (NIG)","Nigerien Premier Division","NIG","No","7/1/2022","6/30/2025","$0 - $16K","Right","Reasonable","Very Strong","5'7""","134 lbs","-","-",62,103,8,11,12,14,12,6,8,8,5,4,13,7,3,13,11,9,3,11,4,10,12,12,3,9,5,7,8,8,7,9,7,4,12,12,9,2,10,16,13,9,12,10,13,14,8,6,8,11,18,3,3,2,2,3,3,1,1,1,1,4
"2826",13230826,"Abdoul Magid Moumouni","5/10/1994 (29 years old)","DM, M/AM (C)","Al-Shorta","Iraqi Premier League","NIG","No","6/11/2023","7/31/2025","$22K - $220K","Right","Reasonable","Very Strong","6'0""","171 lbs","62","7",103,103,8,7,10,11,14,6,8,10,7,10,12,3,14,14,15,13,6,7,8,14,14,13,12,10,13,9,9,13,14,14,9,6,7,14,8,7,13,19,10,11,11,14,11,17,12,3,12,10,11,1,3,2,3,1,3,1,3,2,2,3
"2827",2000243663,"Ahmed Lamine Niandou","3/1/2003 (20 years old)","DM, M (C)","Chabab Houara","Moroccan Lower Leagues","NIG","No","1/11/2023","-","$0","Right","Reasonable","Very Strong","6'1""","174 lbs","-","-",75,101,6,3,5,3,14,7,7,11,4,9,10,3,14,14,7,8,8,4,6,14,10,5,2,6,7,8,7,11,12,10,8,13,13,11,7,7,12,15,12,12,12,11,11,13,12,2,10,14,7,1,3,1,2,3,1,3,3,3,1,3
"2828",13110876,"Kader Amadou","4/5/1989 (34 years old)","D (R)","AS SONIDEP","Nigerien Lower Divisions","NIG","No","6/14/2021","6/30/2024","$0 - $50K","Right Only","Weak","Very Strong","5'11""","163 lbs","-","-",88,100,6,13,7,7,10,4,10,3,9,10,7,3,15,6,9,11,10,10,15,14,19,7,6,8,11,10,9,10,8,13,10,12,12,12,13,7,14,14,12,11,12,10,8,5,12,8,11,12,10,1,3,3,3,4,3,2,3,2,2,3
"2829",12012674,"Souleymane Sakou","11/19/1984 (38 years old)","M/AM (C)","AS SONIDEP","Nigerien Lower Divisions","NIG","No","7/1/2019","6/30/2024","$0 - $5K","Right","Reasonable","Very Strong","6'0""","171 lbs","-","-",82,100,9,9,7,11,11,9,8,11,8,10,11,8,10,16,11,13,7,8,10,14,4,13,8,11,11,11,11,11,9,9,9,11,9,8,9,7,10,13,12,13,11,8,9,14,11,7,11,11,16,2,1,3,2,2,3,2,2,3,1,3
"2830",13193949,"Ibrahim Marou","1/1/2000 (23 years old)","AM (R), ST (C)","AS-FAN","Nigerien Premier Division","NIG","No","7/1/2020","6/30/2024","$16K - $50K","Right","Reasonable","Very Strong","5'7""","143 lbs","1","-",81,100,4,7,14,14,14,7,13,9,4,6,12,7,4,12,6,9,7,12,8,12,2,11,11,14,8,8,5,9,14,12,4,6,11,13,5,2,8,14,11,10,7,13,5,9,8,2,10,12,11,2,2,4,4,3,1,3,1,2,1,1
"2831",2000173506,"Abdel Nasser Chaibou","1/3/2000 (23 years old)","DM, M (C)","US GN","Nigerien Premier Division","NIG","No","7/1/2020","6/30/2025","$0 - $50K","Right","Reasonable","Very Strong","5'10""","156 lbs","-","-",80,100,3,6,7,8,14,6,4,9,2,9,11,3,13,11,6,10,8,4,9,13,16,5,8,9,10,8,14,13,9,12,8,4,13,13,8,7,10,10,12,10,11,11,11,7,13,5,12,10,12,2,2,3,1,2,3,1,2,2,1,1
"2832",2000158639,"Abdulhamid Abdullahi","7/20/2000 (22 years old)","D (L)","US GN","Nigerien Premier Division","NIG","No","7/1/2020","6/30/2025","$1.5K - $16K","Left","Very Strong","Reasonable","5'7""","138 lbs","-","-",73,100,5,12,6,8,9,3,9,7,4,6,9,3,12,9,9,6,10,9,12,9,3,5,15,8,9,9,9,9,15,12,9,4,11,15,7,4,9,14,11,10,14,9,11,4,14,1,9,12,17,3,3,1,2,4,1,3,3,2,1,3
"2833",2000073235,"Carlos Djouram","6/30/1999 (23 years old)","GK","AC Sèmassi","Togolese First Division","NIG","No","7/1/2021","6/30/2024","$0","Right","Fairly Strong","Very Strong","6'2""","174 lbs","-","-",80,100,3,3,1,3,5,6,1,2,2,2,9,3,3,6,9,12,8,8,7,13,15,2,14,1,9,8,7,7,9,7,8,10,10,8,4,6,10,18,10,11,11,9,5,10,5,6,13,11,10,11,12,14,9,9,13,10,5,14,6,12
"2834",47092223,"Matas Dedura","5/17/2002 (21 years old)","D (C)","Be1 NFA","Lithuanian I League","LTU","Yes","3/1/2023","12/31/2024","$4.5K - $45K","Right","Reasonable","Very Strong","6'2""","185 lbs","44","1",65,100,2,1,2,5,6,1,12,4,1,13,6,2,10,3,7,10,8,5,5,13,11,5,9,3,13,5,5,6,9,10,6,10,15,7,5,8,13,16,13,9,11,12,6,5,12,2,8,10,13,3,1,1,1,1,1,1,1,3,3,2
"2835",64046261,"Mohamed Matar","3/20/1996 (27 years old)","D (C)","Busaiteen","Bahrain Premier League","BHR","No","1/1/2020","6/30/2025","$8K - $24K","Right","Reasonable","Very Strong","6'2""","178 lbs","-","-",86,106,5,6,3,5,7,6,12,7,6,14,7,1,13,2,13,11,9,7,14,14,18,5,12,3,10,7,1,8,12,10,8,9,9,11,9,8,11,13,13,13,9,9,9,12,5,6,19,12,10,2,3,1,1,1,2,1,2,3,3,3
"2836",2000269979,"Oumarou Diadje","1/1/2005 (18 years old)","AM (RLC)","Al-Wasl","UAE Professional League","NIG","No","7/1/2022","6/30/2026","$250K - $2.5M","Right","Strong","Very Strong","5'10""","154 lbs","-","-",85,100,8,11,13,14,9,8,9,10,5,6,8,7,7,13,14,7,5,7,10,10,15,13,11,12,6,9,11,10,13,12,6,9,10,11,6,6,10,16,12,10,10,10,12,13,11,2,16,13,18,3,2,3,3,2,2,3,4,1,3,2
"2837",13131698,"Amadou Wonkoye","5/19/1994 (29 years old)","M (R), AM (RC)","Horoya AC","Guinean Premier Division","NIG","No","6/15/2020","6/30/2024","$0 - $50K","Left Only","Very Strong","Weak","5'9""","143 lbs","-","-",96,100,7,11,11,13,11,8,5,8,7,7,12,7,6,12,15,9,4,7,9,8,5,15,12,10,8,9,7,13,14,14,9,7,18,14,13,6,13,13,11,13,13,11,5,13,6,2,18,11,19,1,2,3,1,2,1,1,4,1,2,1
"2838",13221051,"Ismael Souley","7/18/2000 (22 years old)","D (C), DM","AS Police (NIG)","Nigerien Premier Division","NIG","No","7/1/2018","6/30/2025","$1.5K - $16K","Right","Fairly Strong","Very Strong","6'3""","185 lbs","-","-",72,100,6,8,5,7,10,8,10,9,4,10,6,5,15,8,10,10,9,9,10,6,3,5,3,7,10,9,4,10,10,10,8,17,8,10,10,9,16,18,10,10,11,8,13,14,7,4,20,12,10,3,3,2,3,1,4,1,1,1,1,1
"2839",2000040833,"Zakaria Jr. Lambo","1/19/1999 (24 years old)","ST (C)","RAAL La Louvière","Belgian First National Amateur Division","NIG","Yes","7/1/2022","6/30/2026","$50K - $150K","Right Only","Weak","Very Strong","6'0""","176 lbs","127","42",96,100,4,5,8,11,12,4,12,10,4,11,10,8,7,11,5,15,12,11,11,10,14,13,8,13,10,9,7,10,13,12,14,13,9,13,12,12,10,14,12,11,10,9,7,9,5,7,12,14,13,3,3,3,2,3,2,2,4,1,2,3
"2840",13173912,"Ismaël Inoussa","5/9/1994 (29 years old)","D (C)","AS SONIDEP","Nigerien Lower Divisions","NIG","No","1/1/2020","6/30/2024","$0 - $110K","Right","Reasonable","Very Strong","5'10""","156 lbs","3","-",90,100,4,2,6,6,9,1,14,7,1,13,6,2,13,8,5,8,10,6,14,14,16,5,8,7,11,8,3,9,14,14,9,7,14,14,7,8,10,10,10,13,11,10,6,14,13,1,9,12,19,3,2,2,2,1,3,2,3,4,1,3
"2841",2000119190,"Salifou Massaoudi","7/26/2003 (19 years old)","D (C)","AS-FAN","Nigerien Premier Division","NIG","No","7/1/2020","6/30/2025","$0 - $10K","Either","Very Strong","Very Strong","5'7""","143 lbs","-","-",58,99,5,4,4,8,7,4,10,4,5,10,9,7,16,3,13,10,9,15,9,9,7,5,9,4,7,8,3,9,8,10,7,4,7,9,10,4,11,12,11,12,12,11,11,12,13,5,9,9,17,2,3,2,1,1,1,2,2,2,2,3
"2842",20045048,"Tomás Romero","12/19/2000 (22 years old)","GK","Toronto FC","Major League Soccer","SLV","No","11/17/2022","12/31/2023","$350K - $3.5M","Right Only","Weak","Very Strong","6'2""","191 lbs","61","-",97,132,5,3,3,1,3,7,2,2,3,3,10,3,3,6,11,13,11,6,10,15,17,3,11,1,11,10,9,9,8,12,12,12,11,8,9,14,11,9,2,13,11,11,7,12,12,5,14,11,9,9,13,12,8,12,11,10,6,11,13,12
"2843",2000013190,"Mayer Gil","9/7/2003 (19 years old)","AM (L), ST (C)","Alianza Petrolera","Colombian First Division","SLV","No","7/9/2022","12/31/2024","$150K - $1.5M","Right","Weak","Very Strong","5'9""","149 lbs","46","16",90,130,7,11,10,13,13,7,9,8,7,5,11,8,8,13,6,7,9,9,6,12,14,13,12,11,5,8,6,9,13,11,8,7,11,13,13,6,11,14,9,10,13,10,11,7,6,3,11,12,15,2,1,3,3,1,2,2,3,1,3,1
"2844",20041485,"Eric Calvillo","1/2/1998 (25 years old)","M/AM (C)","El Paso","USSL Championship Western Conference","SLV","No","1/11/2022","12/31/2023","$325K - $1M","Right","Fairly Strong","Very Strong","5'7""","152 lbs","109","12",101,129,8,9,11,9,12,9,8,10,5,11,12,4,11,11,7,9,12,10,11,9,9,7,4,10,10,11,11,14,14,12,11,7,10,13,12,8,5,1,1,12,10,12,2,7,5,6,7,13,10,3,1,1,2,1,3,1,1,1,1,1
"2845",18116376,"Brayan Gil","6/28/2001 (21 years old)","ST (C)","Deportes Tolima","Colombian First Division","SLV","No","11/10/2022","12/31/2025","$200K - $2M","Right","Reasonable","Very Strong","6'0""","163 lbs","134","44",110,127,8,10,12,12,12,7,12,10,4,4,12,11,5,12,9,12,12,12,11,12,10,11,7,12,8,12,10,13,13,12,12,11,12,13,12,13,10,11,1,12,11,11,5,1,8,2,12,10,12,3,3,3,2,4,3,1,1,2,3,1
"2846",64050114,"Ali Haram","12/11/1988 (34 years old)","DM, M (C)","Riffa","Bahrain Premier League","BHR","No","7/1/2018","6/30/2024","$0 - $10K","Right","Fairly Strong","Very Strong","6'0""","156 lbs","-","-",103,106,9,9,5,7,15,9,9,7,4,12,13,9,14,13,15,13,10,9,11,12,6,5,10,11,12,10,14,11,9,11,10,8,12,11,12,8,14,19,13,13,10,11,11,7,5,3,11,11,13,1,2,2,1,3,1,2,2,3,3,1
"2847",87002193,"Rodolfo Zelaya","7/3/1988 (34 years old)","ST (C)","Alianza (SLV)","El Salvador Primera División","SLV","No","7/1/2020","6/30/2023","$5K - $14K","Right","Fairly Strong","Very Strong","5'9""","154 lbs","369","167",112,125,9,9,13,13,13,9,11,8,7,9,11,7,8,14,13,12,11,11,14,11,12,13,12,13,9,8,11,13,12,13,11,7,13,13,13,11,15,12,13,6,10,11,5,18,5,14,17,8,15,1,1,2,1,2,2,1,2,2,1,1
"2848",87029862,"Andrés Flores","1/20/1995 (28 years old)","WB/M/AM (L)","FAS","El Salvador Primera División","SLV","No","5/31/2019","6/30/2024","$65K - $650K","Left","Very Strong","Fairly Strong","5'8""","130 lbs","307","2",97,122,9,8,12,8,13,6,9,6,6,8,11,6,8,13,11,11,11,11,11,10,15,9,10,12,8,11,9,11,13,13,8,5,13,13,13,8,12,13,1,12,8,11,5,4,5,1,12,12,17,1,2,1,1,1,1,1,1,2,2,3
"2849",87037325,"Roberto Domínguez","5/9/1997 (26 years old)","D (RC), WB (R)","FAS","El Salvador Primera División","SLV","No","7/1/2022","6/30/2024","$230K - $700K","Right","Reasonable","Very Strong","6'2""","180 lbs","249","3",100,122,7,10,7,5,10,5,10,8,2,11,9,5,10,9,8,13,10,9,11,10,3,6,8,7,8,9,8,9,14,14,9,12,10,14,14,12,16,6,11,10,8,10,10,12,10,7,9,9,13,2,2,1,4,2,3,3,3,3,1,1
"2850",20049252,"Christian Sorto","1/19/2000 (23 years old)","M/AM (RL)","Miami FC","USSL Championship Eastern Conference","SLV","No","12/28/2021","11/30/2023","$110K - $1.1M","Right","Reasonable","Very Strong","5'11""","147 lbs","78","8",93,121,10,9,9,7,10,13,6,12,10,8,10,5,7,10,12,12,9,12,11,11,18,7,8,14,10,11,12,13,13,11,11,7,16,12,8,8,15,12,7,12,11,12,6,17,8,1,14,14,11,2,2,1,1,2,4,3,4,3,1,1
"2851",8830395,"Néstor Manuel Sánchez","11/12/1982 (40 years old)","D (RL)","Topiltzín","El Salvador Segunda División","SLV","No","6/14/2021","6/30/2024","$500 - $3K","Left","Very Strong","Reasonable","6'0""","167 lbs","-","-",72,121,7,11,5,5,12,3,10,8,9,11,10,4,12,10,8,10,10,5,11,16,20,5,15,8,12,10,8,10,7,7,5,12,12,7,7,7,11,15,8,8,13,12,10,13,9,1,7,10,14,2,1,3,1,1,1,2,2,1,1,3
"2852",2000101546,"Luis Styven Vásquez","10/29/2002 (20 years old)","AM (L), ST (C)","LA Firpo","El Salvador Primera División","SLV","No","12/31/2021","6/30/2024","$130K - $1.3M","Left","Very Strong","Reasonable","5'8""","147 lbs","50","8",84,120,7,8,13,14,12,7,9,8,5,7,8,9,3,13,9,9,8,10,8,8,4,12,6,13,7,7,9,9,14,14,8,7,17,14,7,7,12,2,2,13,11,13,5,4,12,7,9,11,20,2,1,3,1,3,3,1,2,3,2,1
"2853",87037025,"Rudy Clavel","10/10/1996 (26 years old)","D (RC), WB (R)","FAS","El Salvador Primera División","SLV","No","5/31/2021","6/30/2024","$100K - $300K","Right","Reasonable","Very Strong","5'11""","160 lbs","235","12",91,120,4,8,5,9,11,2,14,4,6,12,9,5,13,6,6,13,10,9,9,10,12,5,9,9,15,10,4,10,15,12,10,7,15,12,8,10,14,5,3,11,10,11,10,13,15,8,20,10,17,2,3,2,1,3,4,2,1,3,2,1
"2854",87037128,"Iván Barahona","3/27/1995 (28 years old)","DM, M (C)","Once Deportivo","El Salvador Primera División","SLV","No","5/31/2021","6/30/2025","$60K - $600K","Right","Reasonable","Very Strong","5'8""","147 lbs","268","19",90,120,8,8,5,8,13,8,8,9,6,12,11,6,12,8,10,11,9,10,10,9,4,5,10,9,14,9,14,12,14,14,8,3,14,14,9,7,11,4,11,9,14,12,12,7,8,6,14,10,9,2,1,1,1,1,3,1,2,2,2,4
"2855",37071198,"Enrico Hernández","2/23/2001 (22 years old)","AM (RLC), ST (C)","Cartagena","Spanish Second Division","SLV","Yes","7/10/2022","6/30/2026","$30K - $300K","Right","Weak","Very Strong","5'10""","149 lbs","17","3",100,120,7,9,14,13,11,11,8,9,7,8,12,3,6,13,12,12,13,11,7,14,9,13,6,7,6,12,10,12,13,13,12,7,14,13,8,11,14,9,11,10,13,10,3,12,5,8,9,9,13,1,3,3,2,1,4,2,1,1,2,1
"2856",8830491,"Nelson Bonilla","9/11/1990 (32 years old)","ST (C)","Chiangrai Utd","Thai League","SLV","No","1/1/2023","6/30/2024","$0","Right Only","Weak","Very Strong","5'10""","154 lbs","269","103",106,119,6,10,14,15,14,5,12,10,5,5,11,10,5,14,11,13,10,14,11,14,12,13,8,14,10,6,12,9,11,12,11,9,13,10,10,10,10,10,11,13,12,5,5,10,6,13,14,14,6,1,3,1,3,1,3,3,2,1,1,3
"2857",64048954,"Hamad Al-Shamsan","9/29/1997 (25 years old)","D (C)","Riffa","Bahrain Premier League","BHR","No","7/1/2018","6/30/2025","$0 - $40K","Right","Fairly Strong","Very Strong","5'10""","154 lbs","-","-",86,106,4,1,3,1,5,1,13,1,1,13,7,1,13,2,8,11,9,7,8,13,10,5,4,6,11,6,1,7,13,13,7,5,7,13,9,9,14,14,8,10,11,10,11,12,14,7,18,12,8,3,2,3,1,3,3,2,2,2,3,1
"2858",87034272,"Mauricio Cuéllar","6/17/1995 (27 years old)","D (C)","Isidro Metapán","El Salvador Primera División","SLV","No","5/31/2022","6/30/2024","$45K - $425K","Right","Reasonable","Very Strong","6'1""","152 lbs","136","3",85,119,4,2,3,5,8,2,14,5,2,14,8,6,10,7,13,9,9,7,9,12,3,5,9,4,9,7,6,8,13,12,8,14,7,13,12,10,12,1,3,8,10,11,5,16,9,5,9,12,20,1,1,1,3,3,3,2,2,1,2,1
"2859",20046569,"Marlon Vargas","1/12/2001 (22 years old)","AM (RC)","Colorado","Major League Soccer","SLV","No","1/13/2023","12/31/2023","$900K - $2M","Right Only","Weak","Very Strong","5'5""","136 lbs","88","16",88,116,7,9,9,7,14,7,6,8,7,7,12,7,7,14,10,9,4,14,3,7,10,15,4,8,7,13,7,9,15,14,12,4,14,12,11,6,16,1,9,8,11,12,15,6,15,6,11,12,12,3,3,1,2,2,2,2,2,1,3,1
"2860",87035822,"Jairo Henríquez","8/31/1993 (29 years old)","AM (RL), ST (C)","Colorado Springs","USSL Championship Western Conference","SLV","No","6/1/2022","11/30/2023","$70K - $700K","Right","Reasonable","Very Strong","5'6""","143 lbs","272","18",100,116,7,10,13,14,13,8,8,11,8,5,12,4,6,13,12,7,7,11,11,10,13,12,3,11,8,9,8,12,13,13,12,5,12,14,8,7,13,12,2,8,11,12,6,11,11,4,11,11,15,2,4,1,2,3,1,1,3,1,3,4
"2861",87018614,"Óscar Cerén","10/26/1991 (31 years old)","M/AM (RLC)","Isidro Metapán","El Salvador Primera División","SLV","No","7/1/2022","6/30/2024","$150K - $1.5M","Right","Fairly Strong","Very Strong","5'7""","136 lbs","400","72",107,115,9,9,13,11,13,9,9,8,7,10,12,3,9,14,11,11,9,11,12,11,7,11,10,11,9,11,11,14,14,13,7,3,13,13,13,7,14,11,9,13,10,12,4,13,6,7,12,11,19,3,4,2,2,2,2,1,2,3,2,3
"2862",87037609,"Adalberto Hernández","8/22/1996 (26 years old)","WB/M/AM (L)","U.E.S","-","SLV","No","6/15/2020","6/30/2025","$130K - $400K","Left","Very Strong","Fairly Strong","5'7""","154 lbs","26","1",84,115,8,11,8,4,13,6,6,6,4,6,7,4,8,13,13,11,8,8,8,8,4,13,11,11,3,7,6,8,13,13,7,2,7,13,12,2,13,12,12,13,12,13,12,3,10,2,20,11,16,3,3,3,3,2,1,3,3,2,4,3
"2863",87018627,"Darwin Cerén","12/31/1989 (33 years old)","DM, M (C)","Águila","El Salvador Primera División","SLV","No","12/31/2022","6/30/2024","$28K - $275K","Right","Fairly Strong","Very Strong","5'10""","165 lbs","304","23",111,115,12,9,13,11,13,8,8,10,8,11,14,9,12,13,11,11,10,10,12,10,12,10,14,12,11,11,11,14,13,14,9,6,14,12,12,9,17,5,6,11,9,13,4,12,19,11,13,12,11,3,1,1,1,1,1,1,1,1,1,1
"2864",2000088942,"Roberto Molina","1/28/2001 (22 years old)","AM (R), ST (C)","Indy Eleven","USSL Championship Eastern Conference","SLV","No","5/18/2023","11/30/2024","$130K - $1.3M","Left","Very Strong","Weak","5'9""","145 lbs","44","3",87,115,7,7,13,13,12,7,9,8,5,7,11,7,8,9,12,4,4,8,8,9,12,8,8,11,7,8,8,10,14,14,9,8,14,13,11,7,12,19,7,13,8,10,5,8,7,8,20,12,9,1,1,1,1,2,3,1,3,1,1,2
"2865",87001242,"Óscar Jiménez","4/18/1979 (44 years old)","DM, M (C)","U.E.S","-","SLV","No","6/14/2021","6/30/2024","$16K - $160K","Right","Reasonable","Very Strong","5'7""","165 lbs","318","2",98,115,10,10,11,9,11,5,11,5,9,13,11,8,11,11,14,11,13,11,12,10,14,4,12,11,11,12,10,13,12,12,12,9,13,13,13,11,10,5,4,12,10,11,5,10,9,1,12,12,8,3,2,2,2,1,4,2,2,1,1,3
"2866",87032494,"Bryan Tamacas","2/21/1994 (29 years old)","WB/M/AM (RL)","Oakland","USSL Championship Western Conference","SLV","No","2/9/2023","11/30/2024","$250K - $2.6M","Left","Very Strong","Fairly Strong","5'9""","158 lbs","261","16",101,115,8,10,12,5,13,5,7,8,9,7,10,11,5,13,8,12,10,6,10,10,10,9,8,12,10,13,10,10,13,13,8,6,8,12,9,8,10,10,10,12,10,8,8,12,10,8,11,13,12,2,2,2,2,3,4,1,3,1,3,2
"2867",87017140,"Kevin Santamaria","8/10/1991 (31 years old)","M/AM (RL)","Comerciantes","Peruvian Second Division","SLV","No","2/19/2023","12/31/2023","$0 - $50K","Left","Very Strong","Reasonable","5'9""","160 lbs","326","70",109,115,15,13,14,10,12,12,8,12,8,9,13,12,8,13,7,9,8,9,9,11,9,13,9,12,8,12,13,12,13,13,9,7,10,13,11,8,14,12,8,10,11,11,6,12,6,4,12,13,9,1,3,2,2,3,4,1,3,4,1,1
"2868",64046932,"Ali Madan","11/30/1995 (27 years old)","M (R), AM (RC)","Riffa","Bahrain Premier League","BHR","No","10/1/2020","6/30/2024","$14K - $130K","Left Only","Very Strong","Weak","5'6""","143 lbs","50","13",100,105,8,12,13,10,12,8,8,8,8,8,14,14,7,15,13,11,9,12,7,8,10,13,4,14,8,13,14,13,13,13,12,2,16,12,12,6,12,17,10,12,12,12,6,12,11,6,14,10,10,3,2,3,1,2,3,4,1,2,2,2
"2869",87034520,"Narciso Orellana","1/28/1995 (28 years old)","DM, M/AM (C)","Alianza (SLV)","El Salvador Primera División","SLV","No","6/15/2020","6/30/2024","$50K - $475K","Right","Reasonable","Very Strong","5'5""","147 lbs","356","14",90,114,7,7,9,11,11,7,4,5,7,9,13,7,11,13,6,12,9,6,8,8,18,15,13,9,8,8,12,12,13,10,8,4,5,13,13,5,12,9,7,12,12,11,13,1,8,8,10,12,12,1,3,1,4,2,3,3,2,1,3,3
"2870",87011548,"Rúsvel Saravia","7/28/1988 (34 years old)","ST (C)","El Vencedor","Lower Leagues","SLV","No","7/1/2019","6/30/2024","$0 - $80K","Right","Reasonable","Very Strong","5'9""","145 lbs","44","15",96,113,8,6,7,14,10,8,14,9,1,7,7,8,7,14,6,11,9,11,9,14,15,13,7,14,9,8,8,9,9,10,9,7,15,10,11,11,10,5,1,13,11,13,9,6,11,4,14,11,12,3,1,2,3,1,2,2,1,3,1,3
"2871",87035583,"Álvaro Lizama","5/24/1995 (28 years old)","M (RC), AM (R)","Platense (SLV)","El Salvador Primera División","SLV","No","12/31/2022","6/30/2024","$26K - $275K","Right","Reasonable","Very Strong","5'9""","156 lbs","250","11",87,112,6,8,11,9,13,4,5,8,6,5,10,5,7,13,10,8,8,5,5,13,7,13,13,12,6,7,10,12,13,13,6,5,11,13,12,8,12,20,4,12,13,11,11,13,9,3,13,10,13,2,2,2,1,2,3,4,4,2,2,2
"2872",87001240,"Josué Flores","5/13/1988 (35 years old)","WB (L), DM, M/AM (L)","Suchitepéquez","Primera División de Ascenso Guatemala","SLV","No","7/1/2022","6/30/2024","$14K - $150K","Left","Very Strong","Reasonable","5'8""","141 lbs","390","69",101,112,10,10,12,11,13,12,11,8,9,8,12,4,9,12,9,11,9,11,10,10,16,14,13,11,10,9,11,12,12,13,10,6,9,12,12,10,13,13,12,10,11,10,8,13,5,4,15,9,11,4,1,2,1,3,2,3,3,1,2,1
"2873",87037180,"Brayan Landaverde","5/27/1995 (28 years old)","DM, M/AM (C)","FAS","El Salvador Primera División","SLV","No","12/31/2018","6/30/2024","$50K - $475K","Right","Reasonable","Very Strong","5'9""","147 lbs","249","17",89,111,4,1,8,7,13,6,6,6,1,7,10,4,11,12,13,11,8,8,8,10,15,12,3,8,9,7,12,11,13,13,7,7,7,13,7,10,12,14,1,12,11,11,10,9,5,7,13,9,19,2,2,3,3,1,2,2,3,2,3,3
"2874",2000034137,"Jeremy Garay","4/1/2003 (20 years old)","DM, M (C)","D.C. United","Major League Soccer","SLV","No","7/2/2021","12/31/2024","$1.7M - $3.6M","Right","Reasonable","Very Strong","5'9""","149 lbs","68","1",88,111,11,12,10,6,10,11,7,5,9,9,12,7,9,11,7,9,9,10,10,10,9,8,12,11,9,8,11,11,12,11,10,9,14,12,13,9,14,12,12,10,13,12,8,7,10,6,9,14,7,2,1,2,1,3,2,3,3,2,3,3
"2875",72051188,"Álex Roldán","7/28/1996 (26 years old)","D/WB (R), M (RC)","Seattle","Major League Soccer","SLV","No","1/20/2022","12/31/2024","$1.5M","Right","Reasonable","Very Strong","5'10""","156 lbs","152","4",111,111,13,14,12,9,11,11,9,7,8,12,11,4,12,13,8,10,10,9,13,11,11,7,5,10,8,11,11,12,12,12,11,9,13,13,12,8,14,6,6,12,9,9,7,4,8,6,10,6,10,2,3,3,3,2,1,3,3,2,3,3
"2876",72046491,"Josh Pérez","1/21/1998 (25 years old)","AM (RLC)","Montevarchi","Italian Serie D Grp. E","SLV","Yes","2/8/2023","6/30/2025","$10K - $110K","Left","Very Strong","Weak","5'5""","141 lbs","92","8",92,111,6,11,11,10,12,7,8,8,4,5,11,11,5,12,9,7,6,8,7,8,10,11,5,10,5,9,9,12,14,15,13,6,11,13,10,7,9,10,10,11,13,10,11,9,10,10,7,13,8,3,2,3,2,2,1,2,1,3,1,1
"2877",2200151,"Juan Palma","2/27/1986 (37 years old)","D (C), DM","Titán","El Salvador Segunda División","SLV","No","6/14/2021","6/30/2024","$2.5K - $26K","Right","Reasonable","Very Strong","5'9""","145 lbs","5","-",92,110,7,8,3,6,14,6,14,8,6,11,8,6,14,10,15,12,9,10,11,14,6,5,9,9,13,8,5,13,8,8,8,6,15,7,8,7,11,8,8,11,11,11,6,13,14,7,14,10,13,2,2,3,1,3,2,3,2,3,3,2
"2878",87036980,"Nicolás Pacheco","4/7/1995 (28 years old)","GK","San Salvador","-","SLV","No","7/8/2022","6/30/2024","$45K - $425K","Right","Reasonable","Very Strong","5'10""","165 lbs","67","-",88,110,4,3,3,1,4,7,1,2,3,2,9,2,1,4,14,13,12,7,11,14,5,3,8,3,13,8,7,7,13,10,8,7,16,14,7,7,11,9,8,10,8,9,8,14,8,1,10,12,13,7,5,14,7,10,12,12,5,7,10,9
"2879",2000178277,"Hamad Yaser","2/24/2000 (23 years old)","WB (L)","Riffa","Bahrain Premier League","BHR","No","7/1/2019","6/30/2025","$9K - $28K","Left Only","Very Strong","Very Weak","5'9""","149 lbs","-","-",80,105,6,9,6,4,12,2,4,6,5,7,9,5,7,11,10,10,5,7,9,12,12,6,1,8,9,8,4,9,14,14,8,5,6,14,14,5,10,12,12,13,12,12,12,7,15,2,17,12,12,3,1,3,2,3,1,2,3,1,1,1
"2880",72038785,"Eriq Zavaleta","8/2/1992 (30 years old)","D (C)","LA Galaxy","Major League Soccer","SLV","No","2/7/2023","12/31/2024","$750K - $1.7M","Right","Fairly Strong","Very Strong","6'1""","185 lbs","170","3",107,110,5,8,11,12,11,8,14,9,6,11,11,7,13,11,11,10,12,10,9,9,10,7,11,12,12,13,8,13,13,10,12,14,13,12,14,14,16,14,13,12,12,12,13,9,8,7,11,12,14,1,3,1,3,1,3,1,1,1,2,3
"2881",72026329,"Pablo Punyed","4/18/1990 (33 years old)","D (L), M/AM (C)","Víkingur R.","Icelandic Premier Division","SLV","Yes","4/1/2022","12/31/2025","Not for Sale","Left","Very Strong","Reasonable","5'8""","160 lbs","219","23",102,110,9,11,7,13,11,9,3,10,9,11,11,8,15,8,5,10,10,11,11,12,13,11,9,11,10,10,14,11,13,10,8,7,11,11,8,8,14,7,5,12,13,9,11,9,10,3,13,10,8,2,1,2,1,2,1,4,1,1,2,2
"2882",87001402,"Moisés García","6/26/1990 (32 years old)","D (LC), WB (L)","Águila","El Salvador Primera División","SLV","No","5/31/2021","6/30/2024","$0","Left","Very Strong","Reasonable","5'9""","152 lbs","470","16",100,110,9,9,10,8,11,5,12,3,6,11,11,7,11,11,12,11,12,10,11,11,2,7,12,9,10,12,9,12,13,12,10,10,14,13,13,9,12,6,4,12,10,10,6,13,13,7,12,10,7,2,2,1,1,1,1,1,3,2,3,2
"2883",72039096,"Amando Moreno","9/10/1995 (27 years old)","AM (RL), ST (C)","New Mexico","USSL Championship Western Conference","SLV","No","6/10/2021","11/30/2023","$60K - $600K","Right","Reasonable","Very Strong","5'7""","145 lbs","100","27",93,110,8,7,12,12,11,6,11,8,3,6,8,9,5,11,9,9,11,9,11,8,6,11,6,12,9,8,8,12,13,14,11,6,8,14,10,8,7,3,7,11,8,9,4,10,4,3,11,12,7,3,1,1,1,1,3,1,2,1,3,1
"2884",20049246,"Alexis Cerritos","10/2/2000 (22 years old)","AM (C), ST (C)","Fuego FC","United States Soccer Leagues Division One","SLV","No","5/4/2022","11/30/2023","$75K - $750K","Right Only","Weak","Very Strong","5'10""","174 lbs","47","3",83,110,3,8,8,13,11,6,8,8,1,6,13,5,6,13,9,7,7,10,6,13,6,15,2,13,7,7,6,12,13,13,8,7,15,13,7,7,9,11,2,13,10,10,6,11,9,3,11,13,14,3,2,2,1,2,1,3,1,1,1,1
"2885",87037550,"Diego Galdamez","8/26/1994 (28 years old)","M (L), AM (LC)","Atlético Marte","El Salvador Segunda División","SLV","No","12/31/2022","6/30/2024","$0","Left","Very Strong","Reasonable","5'7""","143 lbs","271","22",92,110,8,11,11,8,11,7,3,6,7,7,13,5,7,9,14,6,9,10,7,12,3,11,9,13,6,8,10,10,13,13,8,5,11,13,11,4,10,13,10,11,12,11,13,11,7,7,9,11,7,1,1,3,1,3,1,2,2,1,2,1
"2886",87018625,"Rodrigo Rivera","8/15/1993 (29 years old)","DM, M/AM (C)","FAS","El Salvador Primera División","SLV","No","12/31/2021","6/30/2024","$240K - $700K","Right","Fairly Strong","Very Strong","5'9""","152 lbs","321","17",96,109,11,9,12,9,12,9,9,8,7,9,11,7,11,12,13,11,13,9,12,10,13,8,12,9,8,12,10,13,12,12,9,6,13,12,13,10,13,15,6,10,12,12,6,11,11,3,12,11,13,1,3,3,2,1,1,3,1,1,1,3
"2887",87031402,"Santos Ortiz","1/22/1990 (33 years old)","M (RLC)","Águila","El Salvador Primera División","SLV","No","6/14/2021","6/30/2024","$16K - $170K","Right","Reasonable","Very Strong","5'9""","141 lbs","378","31",91,109,7,11,11,7,10,4,8,7,8,10,11,5,9,14,7,10,7,11,9,11,9,5,6,11,10,10,9,14,13,11,10,6,8,11,13,7,16,9,2,10,10,9,8,9,7,7,10,9,13,2,4,2,1,2,1,1,3,2,2,3
"2888",87001828,"Carlos Portillo","4/24/1989 (34 years old)","GK","Once Lobos","El Salvador Segunda División","SLV","No","6/14/2021","6/30/2024","$75K - $750K","Right","Fairly Strong","Very Strong","5'7""","130 lbs","-","-",90,109,4,1,2,3,4,6,2,3,3,1,9,3,2,3,9,10,13,10,9,15,12,1,14,2,14,10,9,8,12,11,10,3,12,11,3,3,13,8,12,10,9,11,12,2,9,6,12,11,17,11,12,12,10,11,14,10,5,10,12,6
"2889",87041674,"Ronald Rodríguez","9/22/1998 (24 years old)","D (RC)","Águila","El Salvador Primera División","SLV","No","10/24/2022","6/30/2024","$120K - $1.2M","Right","Reasonable","Very Strong","6'1""","171 lbs","165","10",94,108,8,12,6,9,9,6,11,7,7,10,10,9,12,9,12,9,11,11,10,9,11,5,11,9,11,10,10,12,12,12,11,12,12,12,12,12,12,14,3,10,10,9,9,5,12,1,9,13,20,3,2,1,3,1,1,3,2,3,2,3
"2890",2000140099,"Omar Abdulbaset","5/19/2000 (23 years old)","D (R)","Budaiya","Bahrain First Division","BHR","No","7/1/2020","6/30/2024","$500 - $4.5K","Right","Reasonable","Very Strong","5'10""","156 lbs","-","-",75,105,5,12,1,4,8,1,8,2,4,10,8,3,11,8,6,10,9,8,10,13,9,7,9,7,9,8,8,8,14,14,8,6,8,14,10,6,12,14,8,11,9,10,6,9,8,5,10,11,15,4,2,1,2,1,2,1,3,2,1,2
"2891",87037594,"Carlos Martínez","2/9/1995 (28 years old)","WB/M (L)","U.E.S","-","SLV","No","6/15/2020","6/30/2025","$55K - $550K","Right","Reasonable","Very Strong","5'7""","138 lbs","56","3",86,108,7,11,9,7,8,7,7,4,7,8,9,4,7,10,13,7,7,9,9,11,8,9,13,8,6,8,9,9,14,14,8,6,13,14,14,3,16,13,1,10,12,10,13,10,15,8,20,13,19,3,3,1,2,2,3,1,2,1,3,4
"2892",87001830,"Luís Miguel Rosales","1/1/1988 (35 years old)","WB (L)","Once Lobos","El Salvador Segunda División","SLV","No","6/14/2021","6/30/2024","$0 - $35K","Left","Very Strong","Reasonable","5'8""","149 lbs","-","-",77,108,6,10,8,4,15,2,9,6,9,8,10,8,8,14,14,12,6,10,13,10,3,9,6,9,11,10,9,10,12,10,10,8,14,10,9,9,10,5,7,11,12,11,5,5,6,4,9,11,17,1,2,3,1,3,2,2,1,1,4,1
"2893",87037513,"William Torres","2/8/1993 (30 years old)","GK","Platense (SLV)","El Salvador Primera División","SLV","No","12/31/2022","6/30/2024","$160K - $475K","Left","Very Strong","Reasonable","5'11""","171 lbs","145","-",87,108,1,2,2,2,3,3,1,2,1,3,12,1,1,7,6,10,13,8,10,14,4,3,12,3,10,8,7,7,12,8,7,8,6,11,5,5,11,8,2,11,10,12,12,12,14,2,18,11,15,8,5,12,13,12,11,8,5,7,8,14
"2894",2000101573,"Harold Osorio","8/20/2002 (20 years old)","M/AM (C)","Chicago II","MLS Next Pro Eastern Conference","SLV","No","8/10/2022","12/31/2025","$950K - $2M","Right","Weak","Very Strong","5'10""","145 lbs","18","2",89,108,9,12,9,11,15,9,7,9,3,8,14,7,10,10,10,11,2,13,9,15,2,7,2,10,9,15,12,11,8,12,8,9,11,9,7,6,15,7,4,11,12,10,10,8,8,5,10,10,18,4,3,3,2,2,3,2,1,3,3,2
"2895",87001205,"Benji Villalobos","7/15/1988 (34 years old)","GK","Águila","El Salvador Primera División","SLV","No","6/14/2021","6/30/2024","$80K - $250K","Right Only","Weak","Very Strong","5'11""","165 lbs","432","2",100,108,4,1,3,1,12,8,3,1,3,2,11,12,2,12,13,10,13,12,12,12,13,3,10,2,11,12,9,9,12,12,12,11,14,13,4,11,13,10,3,13,10,12,6,6,11,3,14,10,15,12,13,11,4,9,12,10,8,11,9,11
"2896",87031420,"Iván Castro","5/1/1994 (29 years old)","M/AM (R), ST (C)","LA Firpo","El Salvador Primera División","SLV","No","6/30/2022","6/30/2024","$60K - $600K","Right","Reasonable","Very Strong","5'7""","147 lbs","288","10",89,108,7,7,11,12,10,7,10,6,1,6,6,6,6,8,15,11,4,7,8,13,15,7,10,12,7,8,7,9,14,14,8,3,14,14,8,7,10,6,3,10,11,12,12,8,7,8,10,9,9,1,3,1,1,3,1,3,3,1,1,3
"2897",2000121593,"Danley Jean-Jacques","5/20/2000 (23 years old)","DM, M (C)","FC Metz","Ligue 1 Uber Eats","HAI","No","3/10/2023","6/30/2027","$1.9M - $3.9M","Right","Weak","Very Strong","6'0""","158 lbs","31","-",117,131,7,11,11,10,13,8,8,13,7,11,13,9,12,11,16,12,14,9,11,13,14,9,9,12,13,15,13,15,13,13,14,10,13,11,14,12,7,10,12,12,8,11,8,10,13,10,11,13,12,1,2,3,3,1,3,1,3,2,1,3
"2898",82088742,"Bachmy Joseph","9/7/2001 (21 years old)","M (C), AM (RLC), ST (C)","AS Capoise","Haitian Championnat National D1","HAI","No","5/1/2019","12/31/2025","$0 - $70K","Right","Fairly Strong","Very Strong","5'10""","152 lbs","8","2",77,128,5,8,10,11,11,6,8,8,1,6,12,6,7,13,6,6,8,7,7,12,15,13,11,10,7,7,10,8,7,11,7,7,13,11,8,4,11,11,10,13,12,12,14,4,5,2,16,13,8,3,1,2,2,4,1,1,3,2,3,1
"2899",2000178996,"Stevenson Jeudi","10/17/2004 (18 years old)","AM (C), ST (C)","Violette","Haitian Championnat National D1","HAI","No","7/1/2022","12/31/2024","$0 - $100K","Right","Reasonable","Very Strong","6'1""","156 lbs","6","3",82,125,7,6,12,10,12,7,10,4,3,5,9,5,5,13,5,9,8,10,3,11,1,13,6,8,7,7,12,9,14,14,8,14,8,14,6,6,10,11,13,12,11,8,13,15,10,7,15,11,20,3,1,2,4,1,3,2,1,2,3,2
"2900",82050160,"Ricardo Adé","5/21/1990 (33 years old)","D (C)","Liga de Quito","Ecuadorian Serie A","HAI","No","11/28/2022","12/31/2025","Not for Sale","Right Only","Weak","Very Strong","6'3""","182 lbs","147","3",124,125,4,7,8,5,10,6,15,6,8,15,10,5,13,8,13,13,12,12,12,11,15,7,13,8,15,14,7,13,11,12,14,14,15,13,10,16,9,13,12,13,8,10,5,10,13,6,14,11,16,3,4,3,3,4,2,1,3,2,1,2
"2901",23155682,"Mohammed Sayyar","2/16/1991 (32 years old)","DM, M (C)","Al-Arabi","Qatar Stars League","BHR","No","10/1/2020","6/30/2024","$90K - $900K","Right","Reasonable","Very Strong","5'10""","152 lbs","123","3",90,105,7,7,5,8,15,4,9,7,5,12,13,6,12,11,5,12,10,11,11,9,13,5,10,10,12,13,10,14,10,8,11,9,9,10,9,10,6,15,11,13,12,10,10,16,12,5,18,11,9,1,3,1,2,3,2,2,2,2,3,1
"2902",82081418,"Ronaldo Damus","9/12/1999 (23 years old)","AM (R), ST (C)","San Diego","USSL Championship Western Conference","HAI","No","3/17/2022","12/31/2025","$45K - $475K","Right","Weak","Very Strong","5'10""","171 lbs","91","44",90,125,6,7,11,11,9,6,9,10,6,5,7,8,7,9,11,9,12,11,10,9,13,9,6,13,7,9,8,9,14,13,13,10,12,13,13,12,6,10,10,10,10,9,7,1,9,5,9,13,12,1,4,1,1,1,2,2,3,3,3,1
"2903",34008821,"Hervé Bazile","3/18/1990 (33 years old)","M/AM (RL)","Ilvamaddalena","Italian Eccellenza Sardegna","HAI","Yes","1/13/2023","6/30/2023","$0","Left Only","Very Strong","Weak","5'11""","171 lbs","240","37",76,124,6,9,12,9,10,12,7,13,6,4,11,6,5,11,7,8,9,9,7,9,12,14,7,10,7,10,8,12,12,12,11,10,9,12,9,11,10,14,14,11,12,14,12,11,7,9,11,9,15,4,3,2,1,2,1,1,2,1,1,3
"2904",8442435,"Johny Placide","1/29/1988 (35 years old)","GK","SC Bastia","Ligue 2 BKT","HAI","Yes","6/3/2023","6/30/2025","Not for Sale","Right","Weak","Very Strong","5'11""","185 lbs","278","-",110,124,1,1,9,1,10,1,9,2,3,3,11,1,1,7,9,13,13,14,13,11,13,6,12,5,11,12,9,10,10,12,11,12,12,8,11,14,1,14,14,10,11,14,8,15,9,7,12,13,12,11,13,10,11,13,14,13,14,11,12,11
"2905",72051178,"Frantzdy Pierrot","3/29/1995 (28 years old)","ST (C)","Maccabi Haifa","Israeli Premier League","HAI","No","7/1/2022","5/31/2025","$400K - $3.9M","Right","Weak","Very Strong","6'4""","205 lbs","171","57",110,124,9,9,9,12,9,9,13,11,7,5,11,12,6,11,13,12,15,12,12,10,15,10,8,12,5,12,10,12,10,11,15,15,14,13,13,16,11,11,9,12,10,8,8,10,10,7,12,14,15,3,3,1,3,1,3,1,4,4,2,1
"2906",67296144,"Kensly Vázquez","2/8/2003 (20 years old)","ST (C)","Cádiz B","Spanish Federation Second Group 4","HAI","Yes","10/24/2022","6/30/2026","$80K - $800K","Right","Weak","Very Strong","5'10""","171 lbs","32","4",83,123,4,5,9,11,13,6,13,6,3,6,7,7,1,9,15,13,8,8,5,12,10,9,4,12,7,6,2,7,13,13,7,7,10,13,6,13,11,13,9,11,10,9,12,7,9,7,15,14,12,2,2,1,2,3,2,1,2,3,1,3
"2907",19165169,"Carlens Arcus","6/28/1996 (26 years old)","D/WB (R)","Vitesse","Eredivisie","HAI","No","7/1/2022","6/30/2025","$2M - $4.2M","Right Only","Weak","Very Strong","5'9""","160 lbs","218","5",115,120,8,11,10,7,12,7,10,7,13,8,13,9,13,11,12,10,13,11,10,10,10,8,8,13,8,14,12,14,14,13,11,10,15,15,15,13,13,12,10,10,11,8,3,9,10,5,11,13,9,3,1,2,1,2,3,1,3,1,3,3
"2908",85121512,"Duckens Nazon","4/7/1994 (29 years old)","ST (C)","CSKA-Sofia","Bulgarian First League","HAI","Yes","7/6/2022","6/30/2025","$325K - $3.3M","Right","Reasonable","Very Strong","5'11""","180 lbs","176","61",119,120,5,8,11,14,11,7,11,11,8,6,12,13,7,12,14,12,12,11,13,10,13,12,12,13,8,11,9,12,15,12,14,11,11,14,13,14,9,6,6,7,12,9,8,12,7,11,13,13,15,1,1,4,3,2,4,1,2,1,2,4
"2909",2000269009,"Tony Algarin","1/20/2007 (16 years old)","GK","FC Metz","Ligue 1 Uber Eats","HAI","Yes","7/1/2022","6/30/2026","$375K - $1.1M","Right","Reasonable","Very Strong","6'3""","160 lbs","-","-",67,120,4,2,3,3,2,8,1,2,1,1,8,1,1,4,14,6,14,3,5,11,15,1,2,1,6,6,5,5,13,8,6,14,13,12,1,5,6,10,10,11,13,10,11,5,8,2,8,12,15,4,12,13,13,5,11,10,5,9,11,11
"2910",20049212,"Shanyder Borgelin","10/19/2001 (21 years old)","ST (C)","Inter Miami II","MLS Next Pro Eastern Conference","HAI","No","2/16/2023","12/31/2024","$130K - $1.3M","Right Only","Weak","Very Strong","6'4""","185 lbs","61","16",89,120,8,11,11,12,14,10,13,9,4,8,11,6,8,12,15,16,8,12,7,9,8,13,3,10,11,10,9,11,7,10,10,16,10,8,8,15,10,15,10,11,9,11,5,15,5,8,9,10,16,2,4,3,3,1,3,3,3,1,2,1
"2911",2000063004,"Richardson Thomas","5/16/2002 (21 years old)","M/AM (R)","Arcahaie","Haitian Championnat National D1","HAI","No","6/13/2022","12/31/2025","$0 - $95K","Right","Fairly Strong","Very Strong","5'4""","121 lbs","3","1",83,120,5,9,11,14,14,5,7,3,7,7,14,9,6,10,11,6,8,10,8,14,11,14,12,14,7,8,12,12,14,8,3,3,12,12,7,1,16,19,11,13,9,15,12,8,9,5,6,9,16,2,3,1,1,3,2,3,1,1,2,2
"2912",2000178088,"Salman Jasem","8/23/2000 (22 years old)","GK","A'ali","Bahrain First Division","BHR","No","8/16/2022","-","$0","Right","Reasonable","Very Strong","6'2""","167 lbs","-","-",71,105,2,3,3,1,1,4,1,3,2,2,7,3,1,1,10,10,14,6,9,12,12,1,12,1,11,6,4,5,10,13,6,6,14,8,1,4,11,11,9,13,12,13,14,12,11,7,15,12,13,6,7,12,8,7,7,8,5,8,8,6
"2913",27161076,"Don Deedson","2/11/2001 (22 years old)","AM (R), ST (C)","Hobro IK","NordicBet Liga","HAI","No","8/5/2019","12/31/2023","$65K - $650K","Left","Very Strong","Fairly Strong","5'10""","154 lbs","78","19",102,118,7,10,11,11,11,6,8,12,5,5,10,8,6,11,7,11,9,11,10,10,10,9,6,12,5,10,10,10,14,13,10,9,10,14,9,11,9,20,12,13,14,10,3,8,10,1,11,12,11,2,2,3,3,3,1,1,1,1,1,2
"2914",27109702,"Jeppe Simonsen","11/21/1995 (27 years old)","D (RLC), WB (RL)","Podbeskidzie","Polish First Division","HAI","Yes","1/31/2022","6/30/2024","$14K - $140K","Right","Reasonable","Very Strong","6'0""","165 lbs","171","13",109,118,7,11,9,10,10,5,11,10,5,11,11,6,11,12,10,11,10,11,10,11,8,12,6,10,10,11,10,12,13,14,12,12,12,13,12,11,17,12,12,13,12,9,10,10,9,4,10,10,10,1,1,3,1,1,3,3,3,3,1,3
"2915",82050159,"Wilde-Donald Guerrier","3/31/1989 (34 years old)","D/WB/M (L)","Zira","Azeri Premier League","HAI","Yes","1/26/2023","6/30/2023","$500 - $5K","Left Only","Very Strong","Weak","5'11""","158 lbs","195","41",110,117,8,12,12,11,11,9,11,10,5,11,9,8,12,11,16,10,13,10,9,10,13,14,7,14,11,12,7,14,14,13,13,12,15,15,14,12,12,6,11,9,6,5,7,12,12,13,12,14,14,2,2,2,2,3,1,4,3,2,3,2
"2916",82087936,"Steeven Saba","2/24/1993 (30 years old)","DM, M (C)","Violette","Haitian Championnat National D1","HAI","No","7/1/2022","12/31/2023","$0 - $65K","Right","Reasonable","Very Strong","5'7""","145 lbs","-","-",100,117,10,5,9,10,11,9,10,13,8,11,12,8,13,12,9,16,10,12,11,16,18,5,12,10,11,11,14,8,8,10,11,7,8,7,13,5,11,17,10,15,12,10,10,1,11,8,12,10,13,3,3,1,3,3,2,2,1,1,3,2
"2917",82070082,"Derrick Etienne Jr.","11/25/1996 (26 years old)","AM (RLC), ST (C)","Atlanta United","Major League Soccer","HAI","No","1/1/2023","12/31/2025","$250K - $2.5M","Right","Weak","Very Strong","5'10""","171 lbs","234","35",114,117,7,9,12,10,12,13,6,8,4,7,11,8,9,13,13,10,13,9,10,8,12,15,11,12,9,10,11,12,15,13,12,9,11,14,11,10,11,12,14,9,9,13,4,8,8,4,10,8,12,1,3,2,2,3,2,3,2,4,2,2
"2918",43054602,"Fafà Picault","2/23/1991 (32 years old)","AM (RL), ST (C)","Nashville","Major League Soccer","HAI","No","11/9/2022","12/31/2023","$150K - $1.5M","Right","Reasonable","Very Strong","5'8""","169 lbs","254","64",113,116,9,10,14,12,12,8,9,9,5,6,11,7,7,12,14,9,12,10,10,9,12,15,7,12,7,12,10,12,15,14,10,8,13,14,10,7,10,9,13,8,12,10,7,10,5,11,8,16,14,3,2,1,1,3,3,2,2,2,3,2
"2919",85067355,"Jeff Louis","8/8/1992 (30 years old)","AM (RLC)","Mirebalais","Haitian Championnat National D1","HAI","No","1/1/2020","-","$0","Left","Very Strong","Weak","5'10""","154 lbs","136","20",86,116,7,10,12,9,11,9,5,11,5,4,10,9,4,12,7,10,8,11,8,7,9,12,6,12,6,10,7,11,13,13,11,8,10,12,9,10,10,15,9,10,10,10,16,7,11,6,8,10,12,4,1,3,2,3,1,2,1,4,3,3
"2920",2000063007,"Junior Lumage","8/2/1999 (23 years old)","DM, M (C)","Arcahaie","Haitian Championnat National D1","HAI","No","1/1/2019","12/31/2025","$3.5K - $35K","Right","Reasonable","Very Strong","5'8""","154 lbs","-","-",85,116,5,7,5,3,14,6,7,9,5,12,14,5,11,10,13,10,8,6,7,14,15,5,11,7,10,8,7,12,11,12,11,2,12,11,7,10,12,15,10,12,11,13,6,15,10,8,9,10,11,3,2,3,3,3,4,3,3,1,3,2
"2921",85012291,"Soni Mustivar","2/12/1990 (33 years old)","DM","FC Gueugnon","French National 3 - Group J","HAI","Yes","7/22/2022","6/30/2023","$500 - $4K","Right","Reasonable","Very Strong","5'9""","169 lbs","276","7",102,116,9,9,9,6,11,7,11,11,7,13,11,8,13,12,13,13,13,12,11,10,12,9,12,10,13,14,11,12,12,13,12,8,14,12,14,13,9,13,13,13,11,14,8,13,13,7,10,12,10,2,3,3,3,2,1,3,4,3,1,4
"2922",2000011366,"Jayro Jean","6/22/1998 (24 years old)","M/AM (RL)","Real Santa Cruz","Bolivian Premier Division","HAI","No","1/1/2023","12/31/2024","$45K - $425K","Right","Reasonable","Very Strong","5'8""","138 lbs","90","19",102,115,9,11,12,12,10,10,10,11,10,10,10,9,10,12,12,11,8,12,11,10,4,15,4,10,10,12,10,11,13,12,12,7,15,12,12,7,15,14,11,12,10,12,13,4,7,3,16,11,15,3,3,2,1,1,2,1,2,1,3,1
"2923",64048949,"Yusuf Habib","10/9/1998 (24 years old)","GK","Bahrain","Bahrain First Division","BHR","No","7/7/2022","6/30/2024","$6K - $20K","Right","Reasonable","Very Strong","6'4""","213 lbs","-","-",70,105,3,3,3,3,3,5,1,2,2,2,8,3,1,2,13,10,9,6,7,12,5,1,11,2,8,6,5,5,11,11,3,12,9,11,5,7,11,19,13,12,12,11,8,8,5,8,6,10,7,7,9,12,12,9,10,12,5,5,11,8
"2924",2000070326,"François Dulysse","4/13/1999 (24 years old)","D (C)","Fuego FC","United States Soccer Leagues Division One","HAI","No","2/12/2022","11/30/2023","$55K - $550K","Right","Reasonable","Very Strong","6'1""","178 lbs","31","-",86,115,5,3,2,4,10,2,11,2,3,11,10,9,16,5,15,11,10,14,11,8,2,5,8,7,10,9,6,10,8,11,11,12,7,11,10,13,12,10,11,12,10,11,7,14,12,6,17,13,15,4,1,1,3,1,2,2,1,2,2,3
"2925",20049286,"Delentz Pierre","11/16/2000 (22 years old)","D (C)","Real Monarchs","MLS Next Pro Western Conference","HAI","No","1/6/2023","12/31/2024","$70K - $700K","Right","Weak","Very Strong","6'1""","191 lbs","52","4",89,115,7,8,5,7,9,5,10,9,9,12,11,7,9,4,8,12,10,13,12,9,6,5,8,10,11,10,10,11,12,12,14,14,12,12,8,15,13,18,15,10,11,10,11,12,5,7,20,9,20,1,2,3,3,3,1,1,1,2,3,2
"2926",14006010,"Judelin Aveska","10/21/1987 (35 years old)","D (RC)","Hang Yuan","Chinese Taipei Football Premier League","HAI","No","12/31/2019","12/31/2023","$0 - $12K","Right","Weak","Very Strong","6'0""","178 lbs","176","4",92,115,6,9,8,6,6,6,13,6,8,12,8,10,12,6,16,12,15,10,10,9,14,6,10,6,10,13,6,13,10,10,12,14,12,10,11,14,16,11,12,10,10,10,4,12,14,4,12,15,15,1,3,3,2,3,3,2,4,3,3,2
"2927",2000025433,"Carl Sainté","8/9/2002 (20 years old)","DM","North Texas","MLS Next Pro Western Conference","HAI","No","11/3/2022","12/31/2024","$650K - $1.4M","Right","Weak","Very Strong","6'0""","176 lbs","9","-",82,115,8,8,7,5,15,6,8,10,5,10,15,1,10,13,10,13,9,8,10,8,10,5,9,8,13,14,12,10,8,10,12,11,12,13,8,12,16,11,11,12,12,11,5,14,12,6,12,10,16,2,3,1,1,1,1,2,1,2,1,3
"2928",48048204,"Alexandre Pierre","2/25/2001 (22 years old)","GK","Strasbourg","Ligue 1 Uber Eats","HAI","Yes","5/5/2021","6/30/2024","$0 - $40K","Right","Reasonable","Very Strong","6'3""","182 lbs","-","-",78,114,4,2,2,2,3,6,1,1,3,3,9,1,1,2,8,11,14,7,6,13,6,2,13,2,7,7,6,6,11,5,7,13,15,10,1,12,12,16,11,9,10,11,12,2,7,5,11,11,13,9,12,11,11,6,12,13,5,8,11,11
"2929",49044764,"Johab Pascal","3/10/2000 (23 years old)","M (RC)","Bordeaux","Ligue 2 BKT","HAI","Yes","6/15/2020","6/30/2027","$0 - $40K","Right","Reasonable","Very Strong","5'7""","143 lbs","-","-",82,114,7,9,9,9,10,7,6,7,1,8,14,2,6,12,11,9,2,8,8,12,6,7,12,7,8,8,8,12,14,14,8,3,14,13,7,2,12,19,11,11,10,11,8,14,9,7,10,12,15,2,1,2,3,1,4,3,3,2,1,4
"2930",72044589,"Zachary Herivaux","2/1/1996 (27 years old)","DM, M (C)","Tampa Bay","USSL Championship Eastern Conference","HAI","No","12/8/2022","11/30/2023","$250K - $750K","Right","Reasonable","Very Strong","6'1""","160 lbs","100","3",98,114,9,9,13,10,11,9,9,10,3,10,11,10,10,12,12,12,11,10,11,9,12,7,11,9,9,10,9,16,14,13,7,12,15,11,14,10,11,10,8,6,6,6,1,7,6,12,11,12,12,1,1,2,1,1,1,3,1,1,1,1
"2931",2000097157,"Gamaël Dorvil","12/4/2001 (21 years old)","AM (RL), ST (C)","FC Rouen","French National","HAI","No","1/22/2022","6/30/2025","$75K - $220K","Left Only","Very Strong","Weak","5'10""","123 lbs","6","-",88,113,4,8,11,10,11,8,10,10,6,6,12,4,5,14,8,11,8,9,9,14,13,12,5,11,8,9,10,10,12,11,9,7,13,12,11,8,12,12,14,14,11,13,12,11,5,3,12,13,15,2,3,3,2,2,3,1,2,2,2,1
"2932",2000275869,"Steeve Louis-Jean","9/6/2004 (18 years old)","D (R), DM, M (C)","Austin II","MLS Next Pro Western Conference","HAI","No","3/24/2023","12/31/2024","$750K - $1.7M","Right","Weak","Very Strong","5'6""","134 lbs","-","-",79,112,8,11,9,7,11,9,9,10,5,13,9,6,15,6,15,12,15,9,7,6,6,5,5,10,9,15,11,13,12,13,10,5,13,14,8,5,12,11,10,8,13,12,11,5,13,2,9,12,15,1,4,2,2,1,3,2,3,2,3,2
"2933",43591746,"Christopher Attys","3/13/2001 (22 years old)","DM, M (RC), AM (C)","Trento","Italian Serie C/A","HAI","Yes","1/6/2023","6/30/2024","$35K - $375K","Right Only","Very Weak","Very Strong","6'4""","178 lbs","46","4",94,111,6,10,12,7,11,8,12,10,10,11,12,9,11,11,10,11,11,10,11,12,7,5,11,10,13,13,11,11,13,12,12,12,12,11,11,10,13,11,9,12,13,11,8,7,12,1,11,11,9,3,1,1,2,3,3,3,1,3,2,3
"2934",64048959,"Hamza Al-Juban","4/17/2000 (23 years old)","M/AM (R)","Muharraq","Bahrain Premier League","BHR","No","7/1/2018","6/30/2024","$1K - $10K","Right","Reasonable","Very Strong","6'2""","176 lbs","-","-",87,105,7,10,14,13,12,7,3,7,6,5,11,2,5,10,6,9,3,7,8,10,14,9,5,11,7,8,9,9,14,14,8,10,13,14,9,7,13,10,11,10,10,13,10,17,13,2,11,10,9,2,2,3,1,2,1,1,3,3,1,3
"2935",2000033161,"Garven Metusala","12/31/1999 (23 years old)","D (C)","Forge FC","Canadian Premier League","HAI","No","6/23/2021","11/30/2023","$110K - $350K","Right","Reasonable","Very Strong","6'1""","178 lbs","85","3",89,110,6,8,8,9,9,7,11,2,11,11,10,5,12,8,10,11,9,10,10,9,15,7,8,10,12,12,6,13,10,9,10,11,12,10,12,12,10,17,15,15,11,12,12,10,8,6,12,12,18,2,4,2,2,3,1,1,2,2,3,3
"2936",14006011,"Sony Nordé","7/27/1989 (33 years old)","AM (LC)","Terengganu","Malaysian Super League","HAI","No","11/24/2022","11/30/2024","Not for Sale","Left Only","Very Strong","Weak","5'9""","156 lbs","166","38",99,110,9,8,13,11,12,11,8,10,4,3,8,12,6,13,9,11,11,12,7,8,14,19,13,9,3,12,12,11,15,12,10,9,12,14,14,10,8,14,15,14,10,10,8,11,5,5,10,15,16,2,3,2,2,2,1,3,2,3,3,2
"2937",2000251760,"Bryan Destin","2/26/2006 (17 years old)","ST (C)","Inter Miami II","MLS Next Pro Eastern Conference","HAI","No","5/6/2023","12/31/2024","$120K - $1.2M","Right","Reasonable","Very Strong","5'10""","174 lbs","4","-",71,109,7,4,10,15,11,8,10,5,5,6,10,4,1,10,11,9,9,11,6,8,18,8,9,13,6,8,8,12,12,10,15,5,10,9,8,7,7,11,10,11,12,13,5,9,7,1,14,10,17,3,1,1,2,3,1,1,2,2,4,3
"2938",2000025432,"Fredler Christophe","1/11/2002 (21 years old)","AM (RLC)","Strasbourg","French National 3 - Group I","HAI","No","6/30/2022","6/30/2025","$24K - $240K","Left","Very Strong","Weak","5'9""","152 lbs","-","-",82,107,5,8,11,9,14,7,7,9,5,7,14,3,8,12,11,7,6,9,8,9,10,9,4,8,8,8,10,9,13,13,8,8,12,13,7,7,12,14,8,12,10,11,6,6,5,5,20,14,14,3,1,2,4,3,3,2,3,4,2,3
"2939",2000025478,"Dany Jean","11/28/2002 (20 years old)","AM (L), ST (C)","Strasbourg","French National 3 - Group I","HAI","No","6/16/2022","6/30/2025","$45K - $450K","Left","Very Strong","Reasonable","5'7""","141 lbs","2","-",90,107,10,10,12,11,12,10,12,8,10,9,12,4,7,11,10,9,10,9,11,16,8,8,8,12,10,11,10,12,12,8,10,4,10,10,12,4,11,20,11,12,9,9,5,8,13,3,12,11,9,2,3,1,3,1,1,3,2,1,3,1
"2940",48044559,"Garissone Innocent","4/16/2000 (23 years old)","GK","Eupen","Jupiler Pro League","HAI","Yes","9/1/2022","6/30/2025","$18K - $190K","Right Only","Weak","Very Strong","6'4""","198 lbs","13","-",92,107,3,3,2,2,4,6,1,1,2,3,10,3,2,4,10,13,13,8,11,12,12,3,9,1,11,10,9,9,10,12,10,14,8,11,5,13,13,13,9,13,8,11,6,1,5,5,9,10,17,12,5,13,6,11,15,8,5,8,10,12
"2941",2000110165,"Mondy Prunier","12/22/1999 (23 years old)","ST (C)","FC Versailles 78","French National","HAI","No","8/3/2022","6/30/2025","$160K - $475K","Right Only","Weak","Very Strong","6'2""","176 lbs","67","40",98,107,7,7,11,11,11,10,12,11,10,7,11,2,7,11,13,14,10,11,10,15,9,9,12,14,10,10,9,11,12,10,12,14,12,12,9,14,7,11,11,10,11,12,12,14,13,8,12,9,12,2,3,3,3,1,3,2,3,3,1,3
"2942",84102963,"Alex Jr.","12/5/1993 (29 years old)","D/WB/M (L)","Telavi","Georgian National League","HAI","No","2/24/2023","12/31/2023","$0","Left Only","Very Strong","Very Weak","5'9""","152 lbs","166","10",81,106,12,12,11,4,11,12,4,6,12,8,11,4,8,12,12,11,10,8,11,11,12,10,4,11,8,11,9,13,13,11,7,7,12,13,12,6,10,10,13,13,10,11,5,10,13,6,10,13,13,1,2,1,3,4,3,1,3,1,3,2
"2943",82088692,"Sténio Laurent","12/30/1998 (24 years old)","D (C)","FICA","Haitian Championnat National D1","HAI","No","3/3/2020","12/31/2025","$0 - $110K","Right","Reasonable","Very Strong","5'11""","165 lbs","-","-",82,106,3,3,4,3,7,5,12,1,1,12,7,1,13,6,8,8,9,7,12,13,15,5,4,4,13,6,4,7,13,13,7,10,7,13,10,7,14,16,9,10,12,11,11,15,7,1,19,10,16,4,3,3,1,2,1,2,3,1,2,2
"2944",48034661,"Jean Ambrose","9/27/1993 (29 years old)","D (C), DM, M (C)","Paron FC","French Regional Divisions","HAI","Yes","7/1/2020","-","$0","Right Only","Weak","Very Strong","6'4""","196 lbs","31","-",84,106,6,7,6,5,9,9,12,9,9,11,9,2,13,8,14,10,12,10,9,9,10,9,12,8,10,11,8,12,8,7,13,16,14,11,12,15,11,10,12,12,13,12,7,10,11,12,10,10,10,1,2,3,3,2,3,1,1,3,3,3
"2945",47052141,"Eligijus Jankauskas","6/22/1998 (24 years old)","AM (RL), ST (C)","FA Šiauliai","Lithuanian A League","LTU","Yes","1/1/2022","12/31/2023","$130K - $400K","Left","Very Strong","Reasonable","5'10""","149 lbs","161","26",95,100,7,9,13,9,11,7,8,6,7,7,12,3,8,9,5,11,9,6,7,11,16,9,9,9,7,8,6,9,13,13,8,6,9,13,13,5,11,11,12,11,10,11,12,2,13,7,12,10,10,2,1,2,3,1,4,1,3,2,2,4
"2946",64048936,"Mahdi Al-Humaidan","5/19/1993 (30 years old)","ST (C)","Al-Khalidiya","Bahrain Premier League","BHR","No","7/1/2021","6/30/2024","$26K - $250K","Right","Fairly Strong","Very Strong","5'10""","154 lbs","-","-",100,105,8,6,10,14,14,8,10,4,2,8,8,9,8,12,7,10,4,14,9,13,9,11,3,9,7,8,5,9,14,14,9,8,15,14,7,10,9,20,11,9,14,12,9,10,15,3,7,11,11,1,3,4,3,3,1,1,2,1,2,3
"2947",2000010571,"Shelton Guillaume","10/21/1997 (25 years old)","AM (RL), ST (C)","AS Beauvais Oise","French National 2 - C","HAI","Yes","7/22/2022","6/30/2025","$500 - $4K","Right Only","Weak","Very Strong","5'7""","145 lbs","117","67",88,106,8,9,11,11,10,9,5,9,3,3,9,10,3,11,5,10,12,9,10,6,11,14,8,10,7,7,9,7,14,9,7,5,11,14,8,8,11,12,10,12,10,10,5,10,12,1,13,14,12,3,1,3,3,4,2,2,3,1,2,3
"2948",2000285924,"Hussain Al-Qassab","5/15/2002 (21 years old)","M/AM (C)","Shabab Club","Bahrain Premier League","BHR","No","7/1/2020","6/30/2025","$0 - $35K","Right","Fairly Strong","Very Strong","5'10""","158 lbs","-","-",77,105,6,6,8,10,13,3,6,6,6,5,10,5,8,9,14,4,7,8,7,13,9,9,10,8,3,7,7,8,12,13,8,8,11,10,13,5,14,19,11,12,11,10,7,7,12,6,20,10,14,1,1,3,1,1,1,1,1,3,2,1
"2949",64050120,"Jasim Al-Shaikh","2/1/1996 (27 years old)","M/AM (C)","Riffa","Bahrain Premier League","BHR","No","10/14/2020","6/30/2024","$14K - $140K","Right","Reasonable","Very Strong","5'10""","160 lbs","-","-",93,105,8,5,10,11,13,8,8,9,4,7,12,3,7,11,11,9,6,9,9,14,9,15,12,12,10,9,9,7,14,14,9,5,9,14,12,7,15,11,8,11,12,10,5,15,8,7,12,11,11,4,4,1,1,4,1,3,3,2,1,1
"2950",64047104,"Habib Haroon","10/5/2000 (22 years old)","DM, M (LC)","Terengganu","Malaysian Super League","BHR","No","1/1/2023","11/30/2024","$22K - $210K","Right","Reasonable","Very Strong","5'7""","141 lbs","45","3",86,104,7,7,9,8,14,7,5,9,1,9,13,5,10,9,10,7,8,9,9,14,15,5,13,9,9,8,9,13,14,10,6,6,13,10,8,4,16,11,9,14,10,12,5,11,9,3,20,11,8,2,2,2,1,3,2,1,4,2,3,1
"2951",64046260,"Mohammed Al-Banna","10/17/1989 (33 years old)","ST (C)","Muharraq","Bahrain Premier League","BHR","No","6/14/2021","6/30/2024","$0 - $7K","Right","Fairly Strong","Very Strong","5'7""","149 lbs","-","-",96,104,9,6,8,15,15,5,11,7,8,5,9,5,5,10,15,12,9,8,10,14,3,8,12,15,10,8,9,10,13,9,9,3,8,10,9,10,12,18,11,10,8,12,13,1,12,8,16,12,20,3,2,4,3,2,3,2,1,2,1,4
"2952",64048958,"Faisal Al-Isa","12/26/1999 (23 years old)","ST (C)","Muharraq","Bahrain Premier League","BHR","No","7/1/2018","6/30/2024","$0 - $35K","Right","Reasonable","Very Strong","5'10""","156 lbs","-","-",77,104,3,4,10,13,10,5,11,4,4,5,7,8,1,7,5,9,3,9,6,12,9,9,1,13,7,6,5,7,13,13,7,3,10,13,9,4,11,13,11,12,9,13,12,8,11,8,9,11,9,3,2,2,3,1,2,2,2,2,1,1
"2953",28030709,"Nahki Wells","6/1/1990 (33 years old)","ST (C)","Bristol City","Sky Bet Championship","BER","No","12/23/2022","6/30/2025","Not for Sale","Right","Fairly Strong","Very Strong","5'7""","154 lbs","452","139",116,135,3,14,13,15,13,11,10,11,1,2,10,15,6,11,8,13,11,12,11,12,12,13,15,14,4,13,9,13,12,13,13,6,14,13,12,12,8,7,6,18,14,5,2,13,7,3,12,16,13,2,4,1,3,3,3,2,1,1,3,1
"2954",2000131351,"Ajani Burchall","11/5/2004 (18 years old)","M/AM (L)","Aston Villa","English Premier Division","BER","No","11/10/2021","6/30/2024","$24K - $230K","Left Only","Very Strong","Weak","5'7""","134 lbs","1","-",68,118,6,8,13,13,13,5,5,6,5,1,11,4,6,9,6,7,7,7,3,13,12,9,8,11,5,7,8,11,13,10,5,5,9,12,6,2,12,11,9,9,9,12,8,7,11,2,16,9,17,1,2,3,1,3,2,3,2,3,2,2
"2955",72052956,"Justin Donawa","6/27/1996 (26 years old)","M/AM (R)","Solihull Moors","Vanarama National League","BER","No","10/27/2020","6/30/2024","$0","Right Only","Very Weak","Very Strong","5'10""","154 lbs","99","15",67,115,4,8,11,9,8,4,10,6,12,5,7,4,5,8,5,6,9,6,6,6,15,8,4,9,5,10,6,10,15,11,10,9,18,13,10,10,10,16,12,15,10,10,5,7,5,2,7,15,15,1,3,1,1,2,3,1,2,4,4,2
"2956",2000239335,"Deniche Hill","3/11/2004 (19 years old)","D/WB (L)","Leicester","Sky Bet Championship","BER","No","12/20/2022","6/30/2024","$12K - $110K","Left","Very Strong","Reasonable","5'8""","141 lbs","-","-",82,106,6,11,10,6,9,3,9,8,8,10,6,2,9,10,11,8,9,6,10,10,10,5,6,6,8,14,7,12,13,15,15,5,17,14,12,5,12,13,12,12,8,11,11,1,6,3,16,9,15,1,2,3,1,1,2,1,3,3,3,2
"2957",1020335,"Ismail Abdullatif","9/11/1986 (36 years old)","ST (C)","Al-Khalidiya","Bahrain Premier League","BHR","No","6/26/2021","6/30/2024","$1.5K - $14K","Right","Reasonable","Very Strong","6'0""","169 lbs","139","67",108,135,9,10,13,13,12,10,13,10,3,8,9,13,8,13,6,12,8,12,9,9,14,14,7,13,7,12,10,12,14,15,11,12,12,15,12,9,9,9,12,15,6,12,13,15,6,10,13,14,17,1,2,3,4,1,3,1,3,2,3,4
"2958",29173382,"Milan Butterfield","1/24/1998 (25 years old)","DM, M (C)","Alfreton","Vanarama National League North","BER","No","7/1/2021","6/30/2024","$0","Right Only","Weak","Very Strong","6'4""","180 lbs","90","3",54,105,4,8,6,6,8,6,9,8,6,8,10,4,9,8,6,7,8,7,8,9,8,6,7,7,10,11,8,10,8,9,9,14,12,9,14,10,9,11,10,11,8,12,12,9,6,9,11,11,14,1,1,1,3,2,1,2,3,2,3,2
"2959",72048216,"Zeiko Lewis","6/3/1994 (29 years old)","AM (RLC)","Sacramento","USSL Championship Western Conference","BER","No","12/22/2021","11/30/2023","$80K - $800K","Left Only","Very Strong","Weak","5'6""","147 lbs","153","30",98,103,10,9,12,10,9,6,9,10,10,7,11,10,6,10,6,8,6,8,8,7,13,13,14,9,6,8,9,13,16,15,12,6,16,15,8,8,11,15,9,10,9,12,10,15,7,3,8,11,15,2,3,2,2,1,4,3,2,1,3,2
"2960",29125549,"Djair Parfitt-Williams","10/1/1996 (26 years old)","AM (RLC), ST (C)","Ilves","Finnish Premier League","BER","No","1/1/2022","11/15/2023","$40K - $110K","Right Only","Weak","Very Strong","5'6""","141 lbs","69","11",83,100,8,10,12,9,12,11,9,6,6,9,7,6,8,9,10,7,10,7,6,8,15,6,6,9,5,7,8,10,13,12,7,7,14,13,14,7,10,11,11,10,10,13,10,8,15,6,6,12,14,1,2,3,2,3,2,3,3,3,1,2
"2961",2000020900,"Remy Coddington","3/6/2004 (19 years old)","AM (C)","West Ham","English Premier Division","BER","No","7/1/2022","6/30/2023","$0","Left","Very Strong","Reasonable","5'5""","127 lbs","-","-",60,99,2,6,11,8,10,6,5,8,1,4,9,2,3,13,6,5,7,8,7,6,13,12,6,11,7,8,5,11,14,13,4,4,13,13,6,3,12,13,11,11,10,11,13,10,7,5,20,12,15,3,1,3,2,3,1,3,1,3,1,3
"2962",82085697,"Quinaceo Hunt","1/21/2000 (23 years old)","GK","Pickering","English Northern Counties East Premier Division","BER","No","12/9/2022","6/30/2024","$4K - $12K","Right","Reasonable","Very Strong","5'9""","147 lbs","22","-",51,95,2,2,2,3,4,3,1,2,1,1,10,1,2,1,11,9,13,6,9,13,16,3,9,3,12,6,5,5,11,5,6,7,13,10,2,3,11,15,11,11,11,11,11,5,6,4,8,13,18,4,6,13,9,9,7,13,10,6,10,3
"2963",29086955,"Jonté Smith","7/10/1994 (28 years old)","ST (C)","St. George's Colts","Bermudan Premier Division","BER","No","10/5/2022","-","$0","Right Only","Weak","Very Strong","6'2""","160 lbs","227","83",65,95,4,8,9,10,8,5,9,8,4,6,9,10,3,8,5,8,6,8,9,8,6,8,5,11,5,9,7,8,12,10,9,12,9,13,10,12,5,20,10,10,11,5,10,8,2,8,13,11,7,4,4,2,2,1,3,2,3,2,3,1
"2964",2000083412,"Camajé Easton-Smith","3/24/2004 (19 years old)","D (C)","North Village Rams","Bermudan Premier Division","BER","No","6/13/2022","6/30/2025","$0 - $18K","Right","Reasonable","Very Strong","6'1""","163 lbs","2","-",62,94,2,1,3,5,2,6,14,3,1,14,7,1,13,1,8,9,8,5,11,11,15,5,11,5,13,6,4,7,8,11,7,9,13,11,5,4,12,13,12,15,12,11,13,13,7,5,15,10,7,3,1,1,3,2,1,3,1,2,1,3
"2965",2000204906,"Riley Robinson","2/9/2005 (18 years old)","DM, M (C)","BAA Wanderers","Bermudan First Division","BER","No","7/1/2020","-","$0","Right","Weak","Very Strong","5'6""","127 lbs","-","-",63,93,7,5,4,6,11,7,5,10,2,7,12,3,13,11,9,6,8,8,6,15,18,5,10,7,7,8,6,12,13,10,7,3,16,10,7,3,12,13,11,11,11,9,9,13,6,3,10,13,15,3,1,2,3,2,3,3,1,3,3,3
"2966",2000172230,"Ryan Belboda","12/22/2003 (19 years old)","AM (RC)","Dubai City","UAE First Division","BER","No","7/1/2021","-","$0","Right","Reasonable","Very Strong","5'7""","134 lbs","-","-",51,93,4,8,9,10,12,4,4,6,3,1,5,3,1,7,7,2,6,5,5,5,17,12,11,10,4,6,9,11,12,12,4,2,12,12,6,2,13,12,9,11,13,8,11,18,10,6,8,8,10,1,2,3,2,3,2,3,2,3,1,1
"2967",82000998,"Jemeiko Jennings","9/15/1981 (41 years old)","D (C)","North Village Rams","Bermudan Premier Division","BER","No","6/14/2021","6/30/2024","$0","Right","Fairly Strong","Very Strong","5'7""","149 lbs","-","-",58,91,2,1,4,3,7,1,13,5,1,15,8,3,15,7,8,11,8,6,12,11,11,6,11,7,15,7,5,8,5,5,5,7,8,5,5,5,14,16,12,11,11,10,7,4,11,3,10,13,15,2,2,1,1,1,2,1,1,3,2,3
"2968",23154928,"Rashed Al-Hooti","12/24/1989 (33 years old)","D/WB (L)","Muharraq","Bahrain Premier League","BHR","No","7/22/2021","6/30/2024","$0 - $12K","Left Only","Very Strong","Weak","5'7""","134 lbs","-","-",96,135,10,10,10,6,10,8,6,8,11,10,9,2,12,10,11,9,13,10,10,10,12,10,12,10,9,10,9,12,15,15,4,4,13,15,12,5,12,8,10,12,13,13,7,7,6,3,12,10,7,3,3,2,2,1,1,3,2,1,3,3
"2969",82085776,"Liam Evans","5/1/1997 (26 years old)","D (C), DM","Robin Hood (BER)","Bermudan First Division","BER","No","6/15/2020","-","$0","Right","Strong","Very Strong","6'3""","174 lbs","-","-",65,91,1,3,4,4,6,4,10,5,1,12,6,1,11,2,14,8,4,4,6,12,6,5,13,4,11,4,6,10,7,12,5,10,15,12,7,6,16,19,12,10,12,10,7,5,5,3,5,11,13,1,2,1,2,3,1,2,3,3,3,3
"2970",82085832,"Keishon Bean","2/19/2000 (23 years old)","ST (C)","North Village Rams","Bermudan Premier Division","BER","No","7/1/2019","6/30/2025","$0 - $35K","Right","Reasonable","Very Strong","5'9""","154 lbs","-","-",70,90,6,4,13,13,9,6,13,5,1,6,6,8,2,11,10,9,5,9,4,11,8,11,1,11,7,6,5,7,13,12,7,7,13,13,4,8,11,19,13,11,10,12,7,8,8,7,12,10,8,3,2,2,2,2,1,2,1,2,2,2
"2971",82001232,"Keishen Bean","3/17/1987 (36 years old)","M/AM (C), ST (C)","BAA Wanderers","Bermudan First Division","BER","No","6/14/2021","-","$0","Right","Reasonable","Very Strong","5'9""","167 lbs","61","17",65,90,4,6,8,10,7,6,8,7,2,7,7,13,3,8,14,10,6,7,5,14,9,9,11,10,6,7,11,8,11,11,7,6,7,14,8,14,8,10,13,8,10,9,10,7,5,4,8,11,11,1,3,4,3,2,3,3,2,1,1,3
"2972",82001004,"Jahnai Raynor","9/20/1985 (37 years old)","D (C)","PHC Zebras","Bermudan Premier Division","BER","No","6/14/2021","6/30/2024","$0","Right","Reasonable","Very Strong","6'0""","165 lbs","-","-",58,90,4,2,1,1,5,1,14,1,1,12,7,1,14,6,5,12,8,7,8,9,9,5,11,6,12,6,6,7,7,7,7,9,12,7,6,6,13,16,11,11,12,11,7,14,10,2,18,9,15,1,3,1,1,1,3,3,2,2,2,2
"2973",2000083408,"Sincere Hall","6/12/2004 (18 years old)","AM (RL), ST (C)","Hull","Sky Bet Championship","BER","No","5/11/2022","6/30/2024","$26K - $275K","Right Only","Weak","Very Strong","5'9""","141 lbs","-","-",68,88,7,9,12,9,9,6,5,8,8,4,8,5,4,10,5,6,5,9,7,7,8,7,4,10,4,5,6,12,12,12,6,7,17,13,8,5,7,17,12,9,9,11,6,7,11,6,14,13,20,3,3,2,4,3,3,3,1,1,1,2
"2974",29235189,"Keziah Martin","5/21/2000 (23 years old)","M/AM (C)","Boston Utd","Vanarama National League North","BER","No","5/26/2023","6/30/2024","$7K - $22K","Left","Very Strong","Reasonable","5'10""","171 lbs","56","2",61,87,2,5,9,2,10,8,8,6,2,5,11,5,10,13,9,10,10,12,13,9,12,6,7,8,7,10,11,12,7,9,10,8,8,9,11,11,10,12,12,13,13,12,2,7,3,2,15,12,7,1,3,1,3,2,3,4,3,2,2,2
"2975",82085786,"Jahkari Furbert","3/6/1999 (24 years old)","M/AM (RLC)","BAA Wanderers","Bermudan First Division","BER","No","6/15/2020","-","$0","Left","Very Strong","Reasonable","5'4""","130 lbs","-","-",67,85,5,5,8,8,9,5,5,5,5,5,6,4,3,6,15,5,4,7,6,13,15,10,10,9,6,7,8,12,13,13,6,2,12,13,11,1,13,12,9,12,10,12,10,2,8,3,10,12,11,3,2,2,2,1,2,3,3,1,2,1
"2976",2000288445,"Harry Twite","6/17/2005 (17 years old)","D (C)","King's Lynn","Vanarama National League North","BER","No","6/12/2023","6/30/2024","$3K - $9K","Right","Weak","Very Strong","6'4""","178 lbs","-","-",50,85,6,5,7,2,6,2,12,9,9,10,9,2,11,9,7,8,9,7,6,7,4,5,4,5,9,9,6,11,11,8,10,15,15,9,8,8,10,11,10,13,10,9,13,9,7,5,19,12,9,3,1,3,3,3,3,3,1,2,3,2
"2977",29221284,"Kane Crichlow","8/21/2000 (22 years old)","M/AM (C)","Episkopi","Greek National C Division Group 4","BER","No","7/27/2022","6/30/2024","$0 - $14K","Right","Reasonable","Very Strong","5'3""","123 lbs","13","1",65,85,6,6,10,8,9,4,4,10,6,7,7,4,8,11,15,11,7,5,8,13,5,11,1,7,5,7,14,12,10,12,14,4,12,11,9,5,11,12,11,13,11,11,13,17,15,8,14,16,13,2,2,3,3,3,3,1,3,1,2,1
"2978",82085895,"Jahtino Richardson-Martin","12/23/1997 (25 years old)","D (C)","Dandy Town Hornets","Bermudan Premier Division","BER","No","6/15/2020","6/30/2025","$500 - $5K","Right","Fairly Strong","Very Strong","6'1""","176 lbs","-","-",60,84,1,1,4,1,6,1,8,4,4,13,4,1,13,3,12,11,7,5,10,11,18,5,14,4,11,5,1,6,12,10,6,10,11,8,3,10,12,20,12,9,9,12,7,5,5,7,8,12,13,3,2,4,3,2,1,3,1,1,3,1
"2979",23087767,"Sayed Dhiya Saeed","7/17/1992 (30 years old)","AM (RL)","Al-Khalidiya","Bahrain Premier League","BHR","No","7/17/2021","6/30/2024","$4.5K - $45K","Left","Very Strong","Reasonable","5'9""","152 lbs","-","-",103,135,11,11,12,10,12,8,7,11,5,6,11,11,7,11,8,11,10,13,12,11,16,14,5,11,5,9,11,9,13,15,5,6,11,13,13,7,8,15,13,11,12,10,11,12,7,2,12,15,9,2,1,1,3,2,3,1,2,2,1,2
"2980",2000204904,"Daniel Cook","10/6/2003 (19 years old)","D/WB (L)","Robin Hood (BER)","Bermudan First Division","BER","No","7/1/2022","-","$0","Left","Very Strong","Reasonable","5'10""","156 lbs","-","-",67,84,7,15,7,8,11,5,10,4,9,11,11,5,11,11,7,9,9,10,7,11,11,5,4,8,8,10,7,10,10,12,10,11,14,11,9,8,10,14,9,13,10,12,13,7,7,8,10,13,14,3,1,3,3,3,3,1,2,3,1,1
"2981",82001221,"Cymande Davis","7/22/1993 (29 years old)","GK","Dandy Town Hornets","Bermudan Premier Division","BER","No","6/15/2020","6/30/2025","$0","Right","Fairly Strong","Very Strong","6'0""","158 lbs","-","-",51,83,3,2,1,1,1,5,1,2,3,1,7,2,2,1,9,6,13,5,10,10,15,3,4,3,9,5,4,4,12,11,5,6,8,12,4,3,8,10,12,14,11,8,11,15,13,6,10,11,13,6,13,12,7,6,6,7,5,9,7,11
"2982",82001128,"Nakia Smith","8/7/2000 (22 years old)","AM (C), ST (C)","North Village Rams","Bermudan Premier Division","BER","No","6/15/2020","6/30/2025","$0 - $4.5K","Right","Fairly Strong","Very Strong","5'5""","127 lbs","-","-",50,82,6,7,6,13,11,6,8,6,1,6,4,7,3,11,9,10,1,10,7,12,8,10,10,13,7,5,7,8,11,8,7,5,16,8,6,3,10,20,9,10,7,10,12,7,7,7,20,10,15,2,3,2,3,3,1,1,2,3,2,3
"2983",82001056,"Zane Hendrickson","11/27/1998 (24 years old)","GK","North Village Rams","Bermudan Premier Division","BER","No","6/15/2020","6/30/2025","$0","Right","Reasonable","Very Strong","6'3""","176 lbs","-","-",53,81,2,2,1,2,3,7,1,1,1,3,5,2,2,1,10,6,9,5,4,12,16,1,8,2,6,5,4,4,10,15,6,11,13,8,4,5,8,16,13,12,10,11,9,7,7,1,11,10,16,2,9,10,14,6,11,8,5,5,8,12
"2984",82001367,"Kevin Jennings","1/9/1999 (24 years old)","ST (C)","North Village Rams","Bermudan Premier Division","BER","No","6/15/2020","6/30/2025","$0 - $1.5K","Right","Reasonable","Very Strong","5'6""","132 lbs","-","-",50,81,1,3,13,13,6,4,10,6,3,5,6,4,3,9,13,7,7,8,6,10,15,13,9,11,5,5,5,7,9,13,6,1,14,13,12,1,9,11,11,13,9,8,6,4,13,6,10,11,15,2,3,3,2,3,2,2,1,1,1,3
"2985",20035074,"Dante Leverock","11/4/1992 (30 years old)","D (C)","Robin Hood (BER)","Bermudan First Division","BER","No","7/1/2021","-","$0","Right Only","Weak","Very Strong","6'4""","191 lbs","114","13",74,81,4,5,6,6,8,6,12,4,8,9,8,5,10,4,16,10,14,7,8,9,4,4,10,7,11,12,7,10,10,9,9,13,12,10,10,14,5,11,10,8,10,11,5,8,15,3,8,12,20,1,3,1,2,3,3,1,2,3,3,1
"2986",82001135,"Jamaul Boyles","6/24/2000 (22 years old)","M (C)","North Village Rams","Bermudan Premier Division","BER","No","6/15/2020","6/30/2025","$0 - $2K","Right","Reasonable","Very Strong","6'4""","182 lbs","-","-",54,81,4,3,4,7,13,1,6,10,4,4,7,5,5,14,13,4,6,8,7,11,16,5,13,7,8,7,14,11,7,11,7,12,9,10,6,7,11,16,11,9,10,12,13,6,11,6,11,10,11,2,2,1,2,1,1,3,1,1,1,1
"2987",82085503,"Tre' Ming","4/11/1994 (29 years old)","D (C), DM, M (C)","Southampton Rangers","Bermudan First Division","BER","No","9/1/2020","-","$0","Right","Strong","Very Strong","5'9""","152 lbs","9","1",75,80,6,3,2,3,13,6,8,7,1,9,12,1,13,8,12,6,7,6,9,13,4,5,8,5,11,7,5,8,13,11,7,7,14,10,5,6,12,18,12,9,10,11,6,14,10,4,11,11,19,3,1,3,3,2,1,2,3,3,3,3
"2988",72017695,"Antwan Russell","11/6/1986 (36 years old)","ST (C)","Robin Hood (BER)","Bermudan First Division","BER","No","6/14/2021","-","$0","Right Only","Weak","Very Strong","5'9""","154 lbs","40","41",80,80,2,5,7,10,8,4,10,9,1,3,6,11,2,9,10,10,8,10,10,11,14,6,8,14,4,6,6,10,15,11,10,8,11,13,8,9,3,14,10,10,9,13,5,9,4,12,15,14,12,3,3,3,1,3,3,3,1,1,2,3
"2989",72009521,"Casey Castle","8/22/1991 (31 years old)","D/WB/M/AM (R)","Robin Hood (BER)","Bermudan First Division","BER","No","7/1/2018","-","$0","Right","Reasonable","Very Strong","5'7""","136 lbs","16","-",69,80,6,8,4,8,7,6,1,6,3,6,7,1,7,7,5,6,7,8,6,8,18,12,3,11,6,3,8,9,12,12,7,5,13,14,14,6,10,15,10,11,11,8,12,8,14,2,15,14,18,2,4,3,3,2,3,3,2,3,3,2
"2990",23093734,"Mohammed Al-Romaihi","9/9/1990 (32 years old)","ST (C)","Riffa","Bahrain Premier League","BHR","No","2/9/2022","6/30/2024","$0 - $60K","Right","Weak","Very Strong","6'1""","158 lbs","3","-",92,135,7,8,13,10,11,10,10,11,1,7,8,9,7,12,11,12,7,8,9,9,13,9,10,10,6,11,9,10,12,11,10,13,12,13,10,8,14,20,10,9,10,11,7,15,15,5,11,8,17,1,1,2,2,2,1,3,1,1,2,2
"2991",2000204909,"Enrique Russell","2/5/2000 (23 years old)","ST (C)","Totton & Eling","English Wessex League Division One","BER","No","8/1/2022","7/1/2023","$0","Right","Strong","Very Strong","6'1""","167 lbs","20","5",65,80,5,4,8,13,7,5,13,2,1,4,5,1,3,10,8,10,7,6,3,6,5,10,9,10,5,5,1,6,13,13,6,7,7,13,3,5,8,13,10,12,13,10,6,14,13,4,8,13,15,1,3,2,3,1,3,2,3,3,1,3
"2992",28013419,"Reggie Lambe","2/4/1991 (32 years old)","M/AM (RLC)","AFC Sudbury","English Southern League Premier Central","BER","No","2/3/2023","6/30/2024","$0","Right Only","Weak","Very Strong","5'7""","149 lbs","299","36",71,80,6,11,12,10,9,9,5,9,4,8,11,11,9,9,9,7,6,9,8,8,3,12,6,11,8,10,9,12,12,10,9,6,12,11,9,7,13,16,11,12,14,12,6,9,8,6,10,12,13,4,1,1,1,2,2,2,3,1,3,3
"2993",2000130439,"Eusebio Blankendal","11/3/1998 (24 years old)","GK","Dandy Town Hornets","Bermudan Premier Division","BER","No","6/15/2020","6/30/2025","$500 - $7K","Right","Fairly Strong","Very Strong","6'2""","171 lbs","-","-",65,79,4,3,1,2,1,7,1,3,2,1,4,3,1,3,6,9,12,5,10,12,13,2,11,3,8,5,1,3,12,14,5,12,9,11,1,4,11,19,9,11,10,12,9,11,11,3,20,11,7,6,6,12,8,5,6,12,5,8,10,6
"2994",82001145,"Rohaan Simons","5/6/2001 (22 years old)","ST (C)","Somerset Trojans","Bermudan Premier Division","BER","No","6/15/2020","6/30/2024","$2K - $5K","Right","Reasonable","Very Strong","5'11""","152 lbs","-","-",53,79,4,3,9,12,12,4,9,4,1,2,5,6,1,8,10,11,2,11,2,8,14,9,11,4,5,4,5,5,12,12,5,8,15,12,7,2,11,17,11,11,13,10,11,3,10,3,10,11,20,2,2,2,1,1,2,2,1,3,3,1
"2995",82001250,"Dennis Russell","3/7/2002 (21 years old)","D (L)","PHC Zebras","Bermudan Premier Division","BER","No","6/13/2022","6/30/2025","$0 - $4K","Left","Very Strong","Fairly Strong","6'1""","165 lbs","-","-",50,78,5,9,6,3,9,1,6,1,6,10,5,2,9,5,9,7,6,7,11,8,5,6,7,6,7,7,7,7,9,14,7,10,15,14,4,6,15,13,12,11,11,11,7,10,10,4,20,11,13,3,3,3,1,2,2,2,2,1,2,2
"2996",90071849,"Jaylon Bather","12/31/1992 (30 years old)","D (LC)","PHC Zebras","Bermudan Premier Division","BER","No","7/1/2020","6/30/2025","$16K - $50K","Left","Very Strong","Reasonable","6'2""","182 lbs","37","-",75,78,6,9,8,3,10,4,8,8,4,11,10,2,6,8,13,9,10,9,7,12,9,5,5,8,15,7,8,5,7,9,7,12,8,9,8,9,12,10,11,8,12,11,5,10,4,4,17,13,17,2,1,3,3,3,3,3,3,3,1,2
"2997",2000130450,"Jomei Bean-Lindo","5/9/1998 (25 years old)","D/WB (L)","Dandy Town Hornets","Bermudan Premier Division","BER","No","7/1/2019","6/30/2025","$0 - $26K","Left","Very Strong","Fairly Strong","6'0""","165 lbs","-","-",67,78,6,11,5,1,8,1,7,2,6,6,8,2,9,8,12,8,4,5,8,12,14,5,9,5,7,7,4,7,14,14,5,7,10,14,10,6,10,19,11,13,14,12,15,17,6,8,8,12,17,3,3,1,1,3,1,3,3,3,3,3
"2998",2000130527,"Chae Brangman","2/12/1995 (28 years old)","ST (C)","Robin Hood (BER)","Bermudan First Division","BER","No","7/1/2019","-","$0","Right","Reasonable","Very Strong","6'2""","185 lbs","-","-",67,78,3,2,10,13,13,5,13,5,1,3,4,10,1,8,10,9,3,13,6,8,2,8,4,13,5,5,6,6,12,10,6,7,15,11,7,4,9,17,10,12,11,12,13,6,10,4,10,10,18,3,1,3,3,1,2,1,2,1,1,3
"2999",82001110,"Heyes Wolfe","11/8/2000 (22 years old)","M/AM (L)","Devonshire Cougars","Bermudan Premier Division","BER","No","6/15/2020","6/30/2025","$0 - $5K","Left","Very Strong","Weak","5'11""","156 lbs","-","-",50,77,6,11,9,8,9,5,1,6,1,5,6,4,4,5,8,7,4,5,6,11,15,11,3,13,5,6,6,7,12,9,6,10,14,12,10,6,18,11,9,13,12,13,8,9,12,5,20,12,17,3,1,3,1,3,3,2,2,2,3,3
"3000",28123240,"Ne-Jai Tucker","8/20/2002 (20 years old)","AM (RC)","Burnley","English Premier Division","BER","No","7/7/2021","6/30/2023","$0","Right","Reasonable","Very Strong","5'10""","154 lbs","-","-",62,77,5,5,10,7,12,5,2,7,2,4,9,1,5,7,15,3,6,7,6,9,10,7,10,9,4,7,8,11,13,12,6,8,5,12,6,3,12,13,13,12,12,13,9,10,11,1,8,9,8,2,2,2,3,1,3,1,3,1,2,1
"3001",2000063013,"Kervens Jolicoeur","8/25/2002 (20 years old)","AM (R), ST (C)","Albion San Diego","National Independent Soccer Association","HAI","No","1/1/2022","12/31/2023","$100K - $300K","Right","Fairly Strong","Very Strong","5'9""","156 lbs","9","1",78,106,7,10,9,14,8,4,9,8,1,5,8,4,5,8,9,7,6,7,8,6,11,7,8,10,8,7,9,9,14,9,3,7,11,12,9,6,12,13,12,13,13,8,11,14,12,6,11,10,18,1,1,1,2,2,1,1,3,2,1,3
"3002",59006085,"Mirlan Murzaev","3/29/1990 (33 years old)","AM (RL), ST (C)","MHDN FC","Indian National Football League","KGZ","No","12/27/2022","6/30/2024","$16K - $45K","Right","Fairly Strong","Very Strong","6'0""","187 lbs","173","50",92,120,6,9,12,13,15,14,9,15,3,2,12,12,2,16,6,12,4,14,9,9,11,11,8,6,12,7,9,9,10,6,9,8,11,10,10,11,10,19,10,12,15,9,13,15,8,5,10,12,12,1,3,2,1,3,3,1,3,2,2,3
"3003",23034795,"Leung Kwun Chung","4/1/1992 (31 years old)","D (LC), DM","Eastern","Hong Kong Premier League","HKG","No","8/1/2022","6/30/2025","Not for Sale","Left Only","Very Strong","Weak","5'10""","171 lbs","210","11",72,78,13,7,5,4,6,7,11,10,5,11,7,8,10,5,12,9,9,8,9,8,13,4,13,3,12,11,4,10,10,7,10,10,11,9,10,9,11,19,8,10,10,11,5,12,6,12,13,13,15,2,1,1,1,1,4,2,3,3,1,1
"3004",23041464,"Ngan Lok Fung","1/26/1993 (30 years old)","DM, M (C)","Lee Man","Hong Kong Premier League","HKG","No","7/1/2022","6/30/2024","$0 - $50K","Right","Weak","Very Strong","5'9""","167 lbs","114","5",68,78,4,8,5,5,12,8,8,7,7,10,8,3,9,7,13,8,11,8,12,15,12,5,12,10,9,10,10,12,10,7,9,6,12,7,11,9,14,20,12,10,12,11,8,5,15,1,16,12,12,2,2,1,1,3,3,1,2,4,1,3
"3005",23232172,"Ngan Cheuk Pan","1/22/1998 (25 years old)","DM, M (C)","Kitchee","Hong Kong Premier League","HKG","No","9/1/2020","6/30/2025","$0 - $50K","Right","Reasonable","Very Strong","5'10""","158 lbs","20","2",69,77,4,5,1,6,10,4,6,7,1,9,10,3,12,9,14,6,3,7,7,12,12,5,12,7,9,6,11,11,13,13,6,7,12,13,13,6,15,14,9,12,12,11,7,3,11,6,20,11,15,2,3,4,2,1,2,2,4,2,4,2
"3006",23196619,"Cheng Siu Kwan","1/13/1997 (26 years old)","AM (RC)","Lee Man","Hong Kong Premier League","HKG","No","7/1/2022","6/30/2024","$1.5K - $14K","Either","Very Strong","Very Strong","5'7""","149 lbs","120","6",68,77,2,7,7,6,6,5,2,6,2,5,8,1,4,7,11,7,6,7,7,11,7,14,11,7,5,6,7,7,13,13,6,6,14,13,12,1,11,10,10,10,6,12,12,6,11,5,9,6,17,1,3,3,1,1,3,3,1,2,3,2
"3007",23164421,"Chan Ka Ho","1/27/1996 (27 years old)","GK","Lee Man","Hong Kong Premier League","HKG","No","7/1/2022","6/30/2024","$18K - $50K","Right","Reasonable","Very Strong","5'11""","178 lbs","50","-",67,77,4,3,3,2,1,5,1,2,1,1,9,3,3,1,11,5,15,5,9,8,6,1,13,1,8,6,5,5,12,9,3,10,11,12,3,7,9,15,13,13,11,12,11,2,8,6,13,13,14,12,6,10,12,11,7,10,5,7,8,13
"3008",23196643,"Rémi Dujardin","6/23/1997 (25 years old)","D (C), DM, M (C)","DD Tengyue","Chinese National First Division","HKG","Yes","4/6/2023","12/31/2023","$500 - $3.5K","Right Only","Weak","Very Strong","6'3""","180 lbs","6","-",54,77,5,5,4,1,7,5,6,7,1,8,8,4,10,7,12,8,12,6,8,10,13,5,6,6,10,7,7,9,13,11,6,10,15,13,6,7,9,17,9,11,11,10,9,10,10,2,12,11,11,2,4,2,1,1,3,2,3,3,2,3
"3009",64045981,"Oday Dabbagh","12/3/1998 (24 years old)","AM (L), ST (C)","Arouca","Portuguese Premier League","PAL","No","6/23/2021","6/30/2025","$2.1M - $4.4M","Left","Very Strong","Reasonable","6'1""","180 lbs","61","28",126,130,11,11,13,15,11,7,12,11,4,5,12,12,6,12,13,13,14,14,12,12,14,11,7,15,12,16,12,17,13,11,12,9,14,14,13,13,11,10,15,8,8,7,6,14,7,6,14,11,16,2,2,2,3,3,2,3,3,2,1,4
"3010",67279664,"Yaser Hamed","12/9/1997 (25 years old)","D (C)","Qadsia","Kuwaiti Premier League","PAL","Yes","1/26/2023","6/30/2023","$0 - $100K","Right","Reasonable","Very Strong","6'2""","178 lbs","76","5",105,130,4,3,4,4,8,2,13,3,6,14,6,3,14,8,9,12,10,9,11,13,6,5,7,8,9,8,4,9,14,13,9,9,11,13,10,14,15,12,9,11,11,8,13,8,12,4,12,11,13,1,2,1,1,3,1,3,2,2,3,2
"3011",2000161643,"Khaled Al-Nabris","3/27/2003 (20 years old)","AM (LC), ST (C)","Ismaily","Egyptian Premier League","PAL","No","1/29/2022","7/31/2026","$45K - $475K","Right Only","Weak","Very Strong","5'11""","154 lbs","13","1",83,127,5,8,12,13,13,6,11,12,13,6,11,15,4,11,6,7,13,9,4,12,16,11,11,10,7,7,8,12,11,13,6,13,8,13,9,3,12,11,11,10,11,11,8,1,6,2,10,10,14,3,3,1,2,2,3,1,2,3,1,3
"3012",2000069048,"Badr Mousa","4/11/1999 (24 years old)","M (L), AM (RL), ST (C)","Military Production","Egyptian Second Division - Group 2","PAL","No","12/2/2020","7/31/2023","$0 - $60K","Right","Reasonable","Very Strong","6'2""","167 lbs","10","-",91,122,6,8,12,12,10,5,9,9,5,3,12,7,4,12,10,9,7,7,7,8,18,12,8,13,7,8,6,12,13,13,13,8,11,13,13,4,12,18,10,14,12,11,5,12,7,5,20,11,19,1,2,3,4,1,1,2,2,3,1,1
"3013",59132031,"Erjan Tokotaev","6/17/2000 (22 years old)","GK","Kaspii Aqtaý","Kazakhstan Premier League","KGZ","No","1/26/2023","12/31/2026","$26K - $275K","Right Only","Weak","Very Strong","6'2""","178 lbs","52","-",100,120,5,2,1,3,6,6,3,3,1,2,10,1,1,7,6,10,15,9,7,11,18,1,9,3,11,7,9,9,12,8,11,12,14,11,5,8,11,11,10,12,10,10,6,7,13,2,15,8,16,12,10,14,12,11,13,14,5,12,10,12
"3014",13207368,"Mahmoud Wadi","12/19/1994 (28 years old)","ST (C)","Al-Gaish","Egyptian Premier League","PAL","No","11/3/2020","7/31/2024","$110K - $1.1M","Right","Reasonable","Very Strong","6'2""","187 lbs","84","20",107,120,8,9,14,10,12,8,14,9,7,8,9,4,6,13,8,7,7,10,9,10,5,12,8,14,6,13,9,13,14,12,10,9,14,12,14,13,11,11,11,9,11,10,12,11,15,8,16,14,8,2,4,3,2,2,2,3,3,2,1,1
"3015",75005564,"Yashir Pinto","2/6/1991 (32 years old)","ST (C)","U. de Concepción","Chilean First Division B","PAL","No","2/3/2023","12/31/2023","$0","Right","Weak","Very Strong","6'0""","169 lbs","245","58",94,115,6,10,10,12,11,5,11,8,4,3,10,11,4,11,10,12,10,13,12,12,12,10,10,12,4,10,10,10,10,11,13,13,12,11,13,12,7,15,14,14,10,13,7,10,6,6,8,8,17,2,2,3,3,3,1,3,1,1,1,1
"3016",42039088,"Ataa Jaber","10/3/1994 (28 years old)","DM, M/AM (C)","Neftçi","Azeri Premier League","PAL","No","6/22/2022","6/30/2024","$60K - $600K","Right","Reasonable","Very Strong","5'11""","160 lbs","212","15",92,115,9,10,9,7,13,6,11,12,11,11,11,8,10,12,12,12,12,10,10,10,5,5,9,11,11,9,11,10,12,10,12,13,12,8,11,12,14,4,5,4,2,1,15,9,11,12,11,3,20,2,1,2,2,3,3,2,3,1,2,2
"3017",93051805,"Amr Kaddoura","7/1/1994 (28 years old)","GK","Landskrona BoIS","Swedish First Division Elite","PAL","Yes","1/7/2022","12/31/2025","$230K - $700K","Right","Strong","Very Strong","6'1""","194 lbs","152","1",102,115,6,1,3,2,12,7,7,3,3,1,14,3,2,10,15,11,12,11,7,9,10,1,14,2,11,12,9,10,10,13,11,13,11,9,8,11,12,10,9,11,12,16,8,2,7,10,12,9,12,11,12,15,16,12,14,8,15,14,11,10
"3018",93146291,"Samir Maarouf","1/2/2001 (22 years old)","AM (RLC)","AFC Eskilstuna","Swedish First Division Elite","PAL","Yes","7/15/2022","12/31/2025","$14K - $150K","Right","Weak","Very Strong","5'7""","136 lbs","26","1",90,115,10,11,12,7,12,12,5,10,5,5,10,9,6,12,11,11,9,10,9,9,11,12,6,12,8,9,10,11,13,13,10,8,11,12,10,8,12,10,10,10,12,10,7,8,9,6,11,10,12,1,3,2,3,3,3,1,1,3,3,3
"3019",23176274,"Abdallatif Al-Bahdari","2/20/1984 (39 years old)","D (C)","Shabab Al-Khalil","Palestinian West Bank Premier League","PAL","No","7/19/2022","6/30/2024","$0 - $6K","Right","Reasonable","Very Strong","6'5""","205 lbs","82","12",82,114,4,4,1,7,8,1,12,3,6,10,8,7,14,7,13,9,9,8,11,14,11,5,13,6,14,7,7,8,6,6,6,16,12,6,6,7,12,11,11,12,12,12,5,13,6,4,13,9,14,1,1,1,2,4,1,3,2,2,3,4
"3020",47090809,"Mohammed Saleh","7/18/1993 (29 years old)","D (C)","Al-Ittihad","Egyptian Premier League","PAL","No","9/6/2022","7/31/2025","$170K - $500K","Right","Reasonable","Very Strong","6'1""","176 lbs","37","10",100,112,4,1,2,4,6,2,9,6,3,13,8,12,13,5,15,8,10,8,11,13,12,7,12,5,13,7,6,8,13,13,8,11,13,13,10,13,11,20,10,10,12,11,5,9,8,2,11,11,20,2,1,3,3,3,3,1,3,1,3,1
"3021",2000111410,"Ahmad Rmieh","7/11/2003 (19 years old)","D/WB/M/AM (L)","TeBe Berlin","German Div. North East - North","PAL","Yes","1/31/2023","6/30/2025","$0","Left Only","Very Strong","Weak","5'9""","145 lbs","29","-",78,112,7,10,7,13,11,7,7,4,7,7,14,5,9,12,10,7,8,5,9,7,13,11,5,9,5,8,6,9,14,14,6,5,13,14,7,5,14,19,10,12,12,11,5,6,10,2,19,12,15,2,4,2,3,1,1,2,1,2,3,3
"3022",75014688,"Rodrigo Gattas","12/2/1991 (31 years old)","AM (R), ST (C)","San Antonio Unido","Chilean Second Division","PAL","No","7/8/2022","12/31/2023","$0","Left Only","Very Strong","Very Weak","5'8""","163 lbs","189","36",89,112,7,9,12,10,9,12,8,10,5,6,10,10,7,12,13,12,12,10,9,11,12,14,8,12,6,11,11,12,13,13,10,7,10,12,12,11,6,12,9,11,10,10,16,10,4,12,7,6,13,2,1,3,2,3,3,2,3,2,3,3
"3023",98044551,"Saleh Chihadeh","8/25/1994 (28 years old)","ST (C)","Naters Oberwallis","Swiss First League Classic Group 1","PAL","Yes","7/1/2022","6/30/2025","$0","Right","Strong","Very Strong","5'11""","171 lbs","287","114",93,111,7,10,11,11,11,8,9,9,4,6,11,12,5,11,11,12,10,11,10,10,10,10,8,11,6,11,8,12,11,10,11,10,11,12,10,10,10,11,11,13,9,12,11,3,9,6,18,10,9,3,3,2,1,1,3,1,1,2,4,3
"3024",2000039809,"Dastanbek Toktosunov","9/2/2002 (20 years old)","ST (C)","Neftchi Kochkor-Ata","Kyrgyzstani High League","KGZ","No","3/20/2023","12/31/2023","$10K - $30K","Right","Reasonable","Very Strong","6'0""","163 lbs","51","5",78,119,7,8,11,9,15,8,10,9,5,7,13,6,2,12,10,11,6,8,4,12,9,12,9,12,9,8,9,13,15,12,14,8,12,10,8,5,12,15,10,10,10,9,5,12,12,1,14,10,7,2,2,1,3,3,1,1,2,3,2,2
"3025",960174,"Daniel Mustafá","8/2/1984 (38 years old)","D (C)","Club Bell","Argentine Torneo Federal C","PAL","Yes","1/14/2020","12/31/2024","$0 - $20K","Right","Weak","Very Strong","6'3""","189 lbs","233","18",85,110,5,5,6,6,7,9,14,6,10,11,6,7,11,7,11,10,14,12,12,11,12,5,8,7,13,13,6,12,6,8,12,16,11,6,8,12,7,13,13,13,10,5,7,7,10,6,9,12,8,2,1,1,1,1,3,3,3,4,1,1
"3026",93033257,"Ahmed Awad","6/1/1992 (31 years old)","AM (RLC), ST (C)","Ariana FC","Swedish First Division South","PAL","Yes","2/26/2023","12/31/2023","$9K - $28K","Left Only","Very Strong","Weak","6'0""","163 lbs","271","66",82,110,11,11,12,9,11,10,5,11,6,6,11,10,6,12,7,10,7,10,9,9,10,16,5,10,7,8,11,8,12,12,10,10,11,10,10,8,5,11,11,11,11,9,6,9,7,6,10,9,14,1,3,2,1,1,3,1,2,3,2,1
"3027",93117353,"Tarek Alnator","10/30/1998 (24 years old)","AM (RLC), ST (C)","Eskilsminne IF","Swedish First Division South","PAL","Yes","2/11/2023","11/30/2024","$50K - $140K","Right Only","Weak","Very Strong","5'7""","158 lbs","119","44",86,110,9,8,11,11,11,8,6,11,5,6,9,11,7,11,10,8,8,9,8,9,11,14,7,12,7,7,8,7,13,13,8,5,10,12,11,7,7,11,11,12,12,12,15,12,8,6,12,10,15,2,1,2,3,2,1,2,1,2,2,2
"3028",91209981,"Daoud Iraqi","9/13/1999 (23 years old)","M (L), AM (RL), ST (C)","Babelsberg","German Regional Division Northeast","PAL","Yes","7/1/2022","6/30/2024","$55K - $160K","Right Only","Weak","Very Strong","5'9""","152 lbs","69","6",89,109,7,10,14,11,11,3,9,9,7,6,14,8,3,15,11,8,6,11,9,15,5,13,9,11,7,9,10,10,14,13,9,10,13,10,6,6,13,12,11,12,13,10,9,12,7,2,10,10,19,2,1,2,4,3,3,3,1,3,1,1
"3029",75049278,"Nicolás Zedan","6/7/2000 (23 years old)","ST (C)","Shabab Al-Khalil","Palestinian West Bank Premier League","PAL","No","11/25/2022","6/30/2026","$0","Right","Reasonable","Very Strong","6'0""","176 lbs","29","1",80,109,5,7,9,10,9,8,11,8,6,5,8,10,8,11,9,11,11,9,9,9,2,11,8,12,5,12,6,12,11,10,11,12,11,12,11,11,8,12,15,11,13,11,7,8,5,7,7,9,13,3,1,1,1,1,1,2,2,1,3,2
"3030",93020875,"Mahmoud Eid","6/26/1993 (29 years old)","M/AM (RL), ST (C)","Bangkok Utd","Thai League","PAL","Yes","6/6/2023","6/30/2025","$60K - $600K","Left","Very Strong","Weak","6'0""","171 lbs","206","57",106,109,10,12,13,9,12,11,7,11,6,6,11,10,9,13,16,11,12,10,10,12,9,13,7,11,7,10,12,12,12,11,10,10,13,12,12,11,8,6,7,8,9,7,7,7,15,6,13,9,14,2,1,3,2,4,2,3,2,2,3,3
"3031",2000304913,"Mahdi Assi","12/23/2004 (18 years old)","GK","Mosaset Al-Birah","Palestinian West Bank Premier League","PAL","No","6/30/2022","6/30/2024","$3K - $9K","Right","Fairly Strong","Very Strong","6'1""","163 lbs","-","-",75,109,2,2,2,3,4,4,1,3,3,3,5,3,1,4,10,5,9,4,9,12,19,1,9,2,7,7,6,7,12,14,7,7,15,9,4,4,8,15,11,9,9,10,7,12,13,3,11,11,18,6,7,13,9,9,7,13,5,9,12,9
"3032",2000306882,"Jehad Abou El Aynein","8/10/2003 (19 years old)","M (C)","Racing (LIB)","Lebanese Premier League","PAL","No","8/1/2022","6/30/2025","$0 - $12K","Left","Very Strong","Reasonable","5'11""","152 lbs","18","2",70,109,2,6,7,6,12,3,6,8,1,8,7,3,5,8,7,8,7,8,6,12,7,7,11,9,5,7,12,12,13,12,4,8,16,13,8,5,11,10,12,12,11,9,14,10,8,1,9,12,15,4,1,2,3,1,3,3,2,1,3,2
"3033",91209988,"Ali Abu-Alfa","8/28/1999 (23 years old)","M (L), AM (RL), ST (C)","Energie Cottbus","German Regional Division Northeast","PAL","Yes","7/12/2022","6/30/2025","$0","Right Only","Weak","Very Strong","5'9""","147 lbs","74","10",94,108,3,7,12,9,13,6,5,9,4,8,12,5,9,12,10,9,7,11,8,10,13,12,1,11,8,9,7,13,14,14,14,8,13,14,12,4,13,14,11,13,9,11,12,14,5,2,11,9,13,1,3,1,3,3,1,2,2,1,3,1
"3034",93081154,"Michel Termanini","5/8/1998 (25 years old)","D (C)","Kazma","Kuwaiti Premier League","PAL","Yes","5/15/2022","6/30/2025","$85K - $850K","Right","Reasonable","Very Strong","6'1""","169 lbs","84","2",98,107,6,9,7,4,9,7,12,7,7,13,10,6,14,10,12,11,7,8,10,11,14,5,5,10,13,10,10,11,11,8,11,11,14,12,11,12,6,18,11,12,11,10,11,8,5,1,8,7,17,1,4,3,3,1,3,1,1,3,3,2
"3035",2000271280,"Manas Kubanychbek Uulu","2/19/2006 (17 years old)","AM (RL)","Ilbirs Kant","Kyrgyzstani High League","KGZ","No","6/13/2022","12/31/2024","$0 - $5K","Right","Reasonable","Very Strong","5'6""","127 lbs","-","-",60,118,3,6,9,12,14,5,3,8,1,2,14,8,5,12,7,6,8,9,6,5,18,14,6,5,2,7,6,12,14,13,14,1,12,11,9,1,10,13,13,12,12,12,11,13,6,3,10,10,9,3,1,1,1,1,1,4,1,1,2,3
"3036",75047913,"Camilo Saldaña","7/13/1999 (23 years old)","D/WB/M (L)","San Felipe","Chilean First Division B","PAL","No","12/22/2022","12/31/2023","$55K - $170K","Left","Very Strong","Reasonable","5'7""","145 lbs","62","-",90,107,8,10,10,7,12,6,6,7,9,11,12,5,11,11,14,12,13,7,9,11,13,10,8,12,11,13,10,13,12,11,11,6,11,11,11,9,15,20,11,9,13,11,6,10,15,8,10,12,15,2,1,3,1,1,3,2,2,1,1,3
"3037",2000310029,"Khalid Abu El Haija","11/13/2005 (17 years old)","D (C)","Carl Zeiss Jena","German Regional Division Northeast","PAL","Yes","6/12/2023","6/30/2024","$12K - $40K","Right","Fairly Strong","Very Strong","6'5""","176 lbs","-","-",69,107,2,1,3,1,6,3,10,5,1,13,6,1,9,2,15,13,8,4,10,13,15,5,4,4,13,5,4,6,10,8,6,13,13,9,3,6,8,11,12,11,8,9,13,5,9,4,7,12,16,1,1,1,3,1,1,4,1,3,3,1
"3038",2000029122,"Mohammed Bassim Rashid","7/3/1995 (27 years old)","DM, M (C)","Jabal Mukabar","Palestinian West Bank Premier League","PAL","No","1/12/2023","6/30/2024","$0","Right","Reasonable","Very Strong","6'0""","178 lbs","28","6",99,105,8,6,4,7,11,5,8,7,3,9,11,5,11,11,8,13,9,10,10,9,8,5,10,9,10,9,12,13,14,13,9,6,16,14,14,7,15,18,13,12,9,12,9,9,7,8,14,11,10,3,2,1,2,3,2,3,4,3,2,3
"3039",42102958,"Mahmoud Youssef","7/30/1997 (25 years old)","AM (RC), ST (C)","Ahi Acre","Israeli B League North A Division","PAL","No","10/31/2021","5/31/2024","$0","Right","Weak","Very Strong","5'11""","145 lbs","122","38",50,105,4,6,9,7,8,4,6,6,1,4,5,2,6,8,8,6,10,11,4,7,13,8,11,8,4,7,7,6,11,10,5,9,5,11,6,3,11,18,11,12,10,11,14,11,14,8,10,8,16,2,1,3,2,3,3,3,1,3,3,1
"3040",42073151,"Mahmoud Iwisat","10/18/1998 (24 years old)","AM (RL), ST (C)","Al-Sawahreh","Palestinian West Bank Premier League","PAL","No","6/4/2023","6/30/2024","$500 - $3.5K","Right","Reasonable","Very Strong","5'11""","167 lbs","17","1",77,105,6,6,8,9,13,6,13,8,3,6,6,3,7,11,10,11,11,6,8,13,10,8,3,10,7,7,6,11,11,9,4,7,7,11,13,8,9,17,12,13,13,11,14,12,9,2,20,11,20,2,2,3,3,4,2,2,3,2,2,3
"3041",42078594,"Amid Mahajne","10/11/1996 (26 years old)","D (C), DM","Hapoel Umm el-Fahm","Israeli National League","PAL","No","6/4/2023","5/31/2024","$40K - $425K","Right","Reasonable","Very Strong","6'2""","176 lbs","179","9",82,105,3,2,1,2,8,5,13,6,1,11,8,2,13,6,12,12,9,7,8,13,5,5,10,4,13,6,6,8,13,13,7,10,18,13,6,10,12,16,12,9,11,11,10,9,7,1,16,12,14,2,1,2,3,1,3,2,3,1,2,3
"3042",54300206,"Ahmed Shehda Abunamous","10/5/1999 (23 years old)","AM (L), ST (C)","Baniyas","UAE Professional League","PAL","No","1/6/2022","5/31/2024","$300K - $3M","Right","Reasonable","Very Strong","5'10""","165 lbs","82","10",90,105,8,12,14,9,11,8,10,4,5,8,13,3,5,11,11,11,7,12,9,14,12,14,14,12,8,9,9,10,11,13,6,4,12,12,6,6,13,19,9,9,10,10,9,16,5,7,18,11,10,1,3,2,3,3,1,2,2,2,2,1
"3043",89067195,"Zeid Qunbar","9/4/2002 (20 years old)","ST (C)","Jabal Mukabar","Palestinian West Bank Premier League","PAL","No","6/5/2023","6/30/2025","$1K - $8K","Right","Reasonable","Very Strong","6'0""","160 lbs","-","-",75,105,7,5,14,9,11,7,12,7,4,7,9,1,7,8,11,6,6,7,3,11,10,15,7,10,7,8,7,12,14,13,11,11,12,13,7,9,12,11,11,7,11,12,5,1,10,3,11,12,11,2,2,2,1,1,2,2,3,1,3,3
"3044",965325,"Carlos Salom","4/15/1987 (36 years old)","AM (RL), ST (C)","Boca Unidos","Argentine Torneo Federal A","PAL","Yes","3/14/2023","12/31/2023","$0","Right","Reasonable","Very Strong","5'9""","163 lbs","388","117",70,104,6,8,12,10,10,6,10,11,6,3,10,12,5,11,15,12,11,9,13,9,4,13,10,13,7,12,6,13,9,9,11,9,14,9,9,10,9,15,12,12,12,12,8,11,10,6,12,13,11,3,2,3,1,3,3,2,1,3,3,2
"3045",2000037506,"Mohammed Hebous","7/25/2001 (21 years old)","M (C)","Al-Ansar","Lebanese Premier League","PAL","No","9/15/2020","6/30/2025","$0 - $22K","Right","Fairly Strong","Very Strong","5'8""","143 lbs","28","2",73,103,6,6,5,7,8,4,4,7,4,12,13,6,6,7,8,8,5,9,4,13,14,5,13,7,4,7,8,12,10,13,7,3,14,13,9,5,10,12,11,12,11,9,11,14,11,2,20,10,11,1,3,1,1,3,3,1,1,1,2,2
"3046",2000281192,"Sirozhiddin Astanakulov","1/26/2006 (17 years old)","AM (R)","Ankaragücü","Turkish Super League","KGZ","No","6/13/2022","6/30/2025","$50K - $500K","Left","Very Strong","Reasonable","5'10""","147 lbs","-","-",65,118,3,7,11,7,13,5,6,5,5,5,6,5,5,13,15,7,7,8,7,4,2,15,1,11,3,7,6,10,13,12,8,7,6,12,6,3,11,13,14,10,10,11,5,11,5,2,6,12,11,1,2,1,3,3,2,4,3,2,1,1
"3047",2000096540,"Hamza Hussein","5/2/2002 (21 years old)","ST (C)","Al-Ansar","Lebanese Premier League","PAL","No","5/22/2021","6/30/2024","$0 - $16K","Right","Fairly Strong","Very Strong","6'1""","167 lbs","11","1",65,100,4,2,13,13,8,5,8,6,1,5,6,8,4,8,12,7,7,8,6,12,2,8,9,13,6,5,6,6,9,11,6,12,12,9,6,4,12,19,13,9,11,12,5,15,7,3,18,11,10,1,3,1,2,2,1,3,3,2,2,2
"3048",2000239506,"Yazan Sharaha","2/20/2001 (22 years old)","D (RL)","Thagafi Tulkarem","Palestinian West Bank Premier League","PAL","No","7/1/2020","6/30/2024","$0 - $7K","Right","Reasonable","Very Strong","5'10""","149 lbs","-","-",78,100,5,10,10,1,9,1,7,3,1,11,12,5,10,7,8,13,8,12,6,11,3,5,3,12,14,8,6,11,10,13,7,4,14,11,13,5,13,16,10,13,11,13,10,9,10,5,11,10,17,2,1,3,1,3,3,3,2,1,1,3
"3049",2000299412,"Hamza Issa","11/8/1999 (23 years old)","ST (C)","Thagafi Tulkarem","Palestinian West Bank Premier League","PAL","No","7/19/2022","6/30/2024","$0 - $12K","Right","Reasonable","Very Strong","5'4""","136 lbs","-","-",80,100,5,8,10,11,10,6,9,10,1,6,9,4,1,10,5,11,4,13,12,14,12,15,7,12,7,7,7,11,13,14,13,5,6,12,13,7,9,14,12,10,11,12,8,18,6,8,11,13,16,3,1,3,1,1,1,1,3,1,2,3
"3050",2000304997,"Bashar Shobaki","4/15/2000 (23 years old)","D (C)","Mosaset Al-Birah","Palestinian West Bank Premier League","PAL","No","6/15/2020","6/30/2024","$8K - $24K","Right","Fairly Strong","Very Strong","6'0""","171 lbs","-","-",80,100,4,2,1,3,8,2,7,1,7,12,7,1,8,3,5,11,9,8,9,14,16,5,11,5,12,7,6,8,13,12,8,10,7,11,8,7,12,15,13,9,9,10,6,17,15,1,11,11,20,1,1,1,2,3,3,2,1,2,2,2
"3051",2000304954,"Wajdi Nabhan","7/26/2001 (21 years old)","D (L)","Mosaset Al-Birah","Palestinian West Bank Premier League","PAL","No","7/1/2021","6/30/2024","$0 - $18K","Left","Very Strong","Reasonable","6'1""","169 lbs","-","-",75,100,7,13,7,4,11,2,6,7,8,10,8,2,11,6,10,6,9,9,6,12,11,9,8,5,12,9,8,9,15,14,6,10,14,15,8,6,13,20,10,13,10,9,9,8,6,6,19,13,12,2,1,2,3,3,3,2,1,3,2,3
"3052",2000191379,"Ameed Sawafta","7/10/2000 (22 years old)","D (R), DM, M (C)","Markaz Balata","Palestinian West Bank Premier League","PAL","No","6/1/2023","6/30/2025","$1K - $10K","Right","Weak","Very Strong","6'0""","171 lbs","24","-",81,100,8,11,6,8,11,8,8,9,1,7,10,4,13,8,11,11,5,6,10,12,7,5,3,9,6,9,7,10,15,14,5,12,15,15,10,8,15,14,9,10,11,12,5,10,5,3,20,11,14,1,2,1,1,2,3,2,2,3,3,3
"3053",42050821,"Rami Hamadi","3/24/1994 (29 years old)","GK","Jabal Mukabar","Palestinian West Bank Premier League","PAL","No","6/22/2022","6/30/2025","$7K - $22K","Right","Reasonable","Very Strong","6'0""","163 lbs","6","-",80,100,3,3,3,1,1,5,1,3,2,1,8,1,3,2,8,7,14,6,10,13,5,3,9,3,8,8,7,7,9,11,3,9,14,8,3,5,8,14,11,9,12,11,12,8,10,3,13,10,15,12,10,11,10,12,14,13,6,9,10,11
"3054",2000029111,"Musab Al-Battat","11/12/1993 (29 years old)","D (RC), M (C)","Shabab Dhahrieh","Palestinian West Bank Premier League","PAL","No","6/12/2023","6/30/2024","$1.5K - $16K","Right","Reasonable","Very Strong","5'8""","165 lbs","52","1",96,100,4,10,12,7,8,6,9,8,6,11,10,8,9,8,6,9,10,14,13,15,17,5,15,8,10,12,8,9,11,13,10,2,7,10,7,9,14,15,8,10,12,9,9,2,5,5,12,13,17,1,1,1,3,1,1,3,1,1,3,2
"3055",2000115036,"Laith Hassoun","2/4/2000 (23 years old)","D/WB (R)","Al-Nawair","Syrian First Division Group D","PAL","No","6/15/2020","6/30/2024","$0 - $50K","Right","Fairly Strong","Very Strong","5'9""","152 lbs","-","-",57,99,5,11,7,4,9,3,6,5,5,7,4,1,10,8,9,8,8,8,8,12,12,5,6,6,7,8,6,8,7,12,8,6,11,12,10,5,11,15,10,13,11,10,6,8,9,3,14,11,19,2,3,2,2,2,2,1,3,1,3,1
"3056",2000028846,"Mohammed Khalil","4/5/1998 (25 years old)","D (L)","Hilal Al-Quds","Palestinian West Bank Premier League","PAL","No","7/8/2022","6/30/2023","$0","Left","Very Strong","Reasonable","6'0""","165 lbs","-","-",82,99,5,10,6,1,9,1,8,6,6,11,8,1,12,4,14,9,9,7,11,14,7,6,7,7,11,8,6,9,14,10,8,7,11,12,13,7,11,19,10,7,11,11,10,9,6,1,11,13,8,2,1,2,4,2,1,3,3,3,1,2
"3057",2000160050,"Erbol Atabaev","8/15/2001 (21 years old)","DM, M (C)","Dinamo Makhachkala","Russian First Division","KGZ","No","2/10/2022","7/12/2023","$0 - $30K","Left","Very Strong","Reasonable","5'9""","158 lbs","53","3",90,118,9,9,11,8,13,7,5,10,5,9,11,8,7,13,12,11,13,12,12,10,5,11,1,13,10,10,9,12,11,14,11,8,11,9,11,8,13,16,12,13,10,10,5,8,5,3,13,12,18,3,1,2,1,3,1,2,3,3,1,1
"3058",42017659,"Shadi Sha'aban","3/4/1992 (31 years old)","M (C), AM (LC)","Jabal Mukabar","Palestinian West Bank Premier League","PAL","No","7/15/2019","6/30/2024","$1K - $9K","Left Only","Very Strong","Very Weak","6'0""","154 lbs","31","2",87,99,14,10,12,13,12,13,11,13,11,11,11,15,11,12,12,10,15,11,10,14,11,15,9,8,5,10,9,11,12,11,9,13,8,11,10,11,8,13,9,10,8,11,6,7,4,8,6,13,17,3,1,2,3,2,2,2,2,4,2,2
"3059",23192118,"Ashraf Nu'man","7/29/1986 (36 years old)","M (L), AM (LC), ST (C)","Wadi Al-Nes","Palestinian West Bank Premier League","PAL","No","7/13/2021","6/30/2024","$0 - $10K","Left","Very Strong","Reasonable","6'1""","152 lbs","86","29",90,98,9,10,10,11,10,9,10,11,9,8,11,5,10,10,11,13,9,10,11,11,14,12,3,11,7,10,9,11,10,10,10,13,9,9,10,7,12,14,10,8,12,12,5,11,12,7,8,11,9,3,1,3,2,3,1,1,2,1,2,3
"3060",13211422,"Tamer Seyam","11/25/1992 (30 years old)","M/AM (C)","Shabab Al-Khalil","Palestinian West Bank Premier League","PAL","No","7/10/2021","6/30/2024","$0 - $50K","Left","Very Strong","Reasonable","6'1""","156 lbs","35","4",92,97,7,10,11,9,12,6,8,8,1,10,12,6,7,10,10,8,9,13,12,11,14,14,9,11,8,9,14,13,11,10,13,12,11,12,14,6,11,11,11,9,13,10,5,12,6,2,13,11,8,1,2,1,3,3,1,2,2,3,2,2
"3061",2000179034,"Samer Zubaida","4/26/2001 (22 years old)","M/AM (C), ST (C)","Hilal Al-Quds","Palestinian West Bank Premier League","PAL","No","7/1/2019","6/30/2025","$0 - $9K","Right","Fairly Strong","Very Strong","5'10""","154 lbs","-","-",73,97,6,6,10,8,13,6,8,8,2,6,9,2,4,8,10,12,8,8,5,6,2,13,5,9,6,7,7,8,13,13,7,8,10,13,10,4,11,13,12,11,11,9,8,12,6,2,13,11,17,1,3,3,1,3,2,2,2,1,1,3
"3062",2000069976,"Tariq-Emad Suleiman","6/13/2003 (19 years old)","DM, M (C)","Siegburg","German Div. Middle Rhine","PAL","Yes","1/31/2023","6/30/2025","$0","Right Only","Weak","Very Strong","6'0""","165 lbs","47","-",67,97,3,5,9,5,12,4,7,7,7,8,11,6,8,14,12,12,6,5,9,8,9,5,5,6,11,13,12,12,12,12,8,12,12,12,7,6,12,13,12,11,11,10,9,10,5,6,10,10,14,1,1,2,3,2,2,2,2,3,3,1
"3063",27134021,"Mohamed-Ali El-Ahmar","2/15/1997 (26 years old)","D (RLC)","CFC Hertha 06","German Div. North East - North","PAL","Yes","7/1/2020","6/30/2024","$24K - $70K","Right","Fairly Strong","Very Strong","6'2""","165 lbs","120","4",77,97,5,8,3,2,6,1,9,12,1,10,9,2,9,3,11,8,9,10,6,13,12,5,4,5,10,9,10,9,9,9,7,13,12,9,9,12,14,12,10,10,9,11,12,8,7,4,10,8,11,2,2,4,1,1,1,1,2,3,1,1
"3064",49031215,"Yoann Salmier","11/21/1992 (30 years old)","D (C)","Troyes","Ligue 2 BKT","GUF","Yes","7/1/2019","6/30/2025","$300K - $3M","Right","Weak","Very Strong","6'2""","187 lbs","224","4",124,130,4,9,9,7,12,6,14,8,9,13,11,8,13,11,14,13,13,11,13,12,13,8,10,9,13,13,10,13,11,12,14,14,15,12,14,17,10,11,11,12,12,14,7,12,10,9,12,12,10,1,1,3,2,1,3,2,3,2,1,3
"3065",2000278470,"Taigy Dugard","12/2/2006 (16 years old)","D (C)","TA Rennes","French National 3 - Group E","GUF","Yes","6/13/2022","6/30/2024","$0 - $55K","Right","Reasonable","Very Strong","5'10""","145 lbs","9","-",72,121,1,3,2,3,4,3,14,1,1,14,5,4,14,7,6,11,9,8,7,14,12,5,6,3,6,7,5,8,13,12,8,10,9,11,6,7,12,11,10,12,9,9,12,3,11,2,9,11,10,1,1,1,2,3,1,3,3,1,1,3
"3066",85049252,"Donovan Léon","11/3/1992 (30 years old)","GK","AJ Auxerre","Ligue 2 BKT","GUF","Yes","6/8/2022","6/30/2025","$240K - $2.4M","Right","Weak","Very Strong","6'2""","207 lbs","136","-",115,118,6,1,1,1,8,7,8,2,1,2,9,1,2,8,7,11,13,12,12,11,11,7,8,2,11,13,11,11,12,13,15,13,15,12,13,15,5,14,15,14,12,14,8,8,7,6,11,12,10,10,14,13,8,13,12,11,10,11,12,13
"3067",29022626,"Kévin Rimane","2/23/1991 (32 years old)","D (C), DM","SO Cholet","French National","GUF","Yes","7/1/2022","6/30/2024","$0 - $95K","Right","Weak","Very Strong","5'11""","163 lbs","141","2",90,104,12,9,10,6,10,7,11,5,6,12,10,6,11,9,15,11,15,11,10,10,14,8,8,7,11,11,10,11,11,11,12,11,14,11,12,11,14,14,13,10,12,12,9,11,14,6,11,12,11,2,2,3,2,2,1,4,1,2,2,1
"3068",47014925,"Azamat Baymatov","12/3/1989 (33 years old)","D (C)","Alga Bishkek","Kyrgyzstani High League","KGZ","No","2/10/2023","12/31/2023","$2K - $6K","Right","Reasonable","Very Strong","6'2""","180 lbs","85","5",90,115,6,5,9,2,10,3,15,6,4,11,8,3,15,7,11,10,14,11,10,8,16,5,10,8,9,8,5,10,10,9,10,14,14,10,6,14,16,19,11,11,11,8,8,6,5,4,10,11,17,4,2,3,1,2,1,2,2,1,1,2
"3069",916373,"Anthony Soubervie","4/24/1984 (39 years old)","D (RC), WB (R)","Bergerac Périgord FC","French National 2 - B","GUF","Yes","7/1/2022","6/30/2024","$12K - $35K","Right Only","Weak","Very Strong","6'0""","176 lbs","426","29",95,102,13,11,9,8,11,14,8,12,13,12,12,6,11,10,15,11,14,10,10,12,13,7,10,11,11,12,12,11,9,11,13,10,13,10,11,12,15,9,10,12,9,14,7,14,15,7,13,11,10,1,3,1,2,2,3,1,3,1,3,4
"3070",85027977,"Loïc Baal","1/28/1992 (31 years old)","M (C)","Le Puy Foot 43","French National 2 - A","GUF","Yes","7/1/2021","6/30/2025","$75K - $220K","Right Only","Weak","Very Strong","5'10""","158 lbs","226","18",93,98,6,6,9,6,11,6,9,10,5,12,11,6,10,11,12,12,13,11,12,11,12,6,7,9,12,13,11,13,12,13,12,8,14,12,13,12,11,10,12,11,11,12,6,10,12,6,12,12,9,1,2,2,1,3,1,3,2,3,2,1
"3071",49056393,"Thomas Nemouthé","1/16/2001 (22 years old)","D (R), DM, M (C)","US Créteil-Lusitanos","French National 2 - D","GUF","Yes","7/1/2021","6/30/2026","$5K - $16K","Right","Reasonable","Very Strong","5'10""","165 lbs","20","-",65,97,6,11,2,6,11,5,5,6,2,10,13,3,11,6,5,7,6,6,7,13,13,5,8,6,5,7,6,12,12,13,6,5,7,10,7,5,9,12,13,9,11,10,12,9,5,8,13,11,18,2,3,3,2,2,3,1,1,1,1,1
"3072",50039252,"Stéphane Privat","4/2/1997 (26 years old)","ST (C)","FC Marmande","French Regional Divisions","GUF","Yes","7/1/2019","-","$0","Right Only","Weak","Very Strong","6'1""","182 lbs","19","6",70,95,7,8,10,10,7,5,11,6,5,5,8,10,6,9,9,9,10,8,8,8,7,7,5,10,9,9,7,9,12,10,11,13,13,12,10,13,8,10,12,10,10,10,13,5,8,9,5,8,8,1,2,1,3,3,4,1,1,2,2,2
"3073",34005769,"Neki Adipi","5/15/1984 (39 years old)","ST (C)","Etoile Matoury","French Guianese Régional 1","GUF","Yes","6/14/2021","12/31/2024","Not for Sale","Right Only","Weak","Very Strong","5'8""","160 lbs","79","13",75,95,7,7,9,12,11,6,5,8,6,2,6,12,2,11,7,11,8,12,12,8,9,11,5,11,4,7,6,9,14,13,11,6,13,11,12,11,5,13,13,10,10,14,6,13,7,5,12,9,12,2,3,2,3,1,2,1,2,3,1,3
"3074",50051027,"Arnold Abelinti","9/9/1991 (31 years old)","AM (L), ST (C)","Olympique Alès Cévènnes","French National 2 - A","GUF","Yes","7/1/2022","6/30/2024","$4K - $40K","Left Only","Very Strong","Weak","6'0""","158 lbs","240","86",85,95,8,12,12,12,14,6,11,7,4,6,14,7,4,11,10,9,5,11,6,8,7,10,4,12,7,8,6,7,12,11,12,11,12,12,12,11,12,19,10,13,10,10,6,7,9,6,12,12,12,2,3,1,2,3,1,3,3,3,3,1
"3075",2000028575,"Raphaël Galas","10/24/1997 (25 years old)","M/AM (R)","St-Pryvé St-Hilaire FC","French National 2 - B","GUF","Yes","7/1/2020","6/30/2025","$6K - $60K","Right","Fairly Strong","Very Strong","5'11""","152 lbs","89","13",83,94,7,11,10,13,11,6,6,6,6,6,8,8,7,13,11,5,5,9,7,7,5,13,14,9,6,7,8,12,13,13,7,9,13,13,7,4,13,13,13,12,10,13,11,2,5,4,6,13,12,3,3,3,2,3,1,3,3,4,3,2
"3076",48042201,"Shaquille Dutard","9/21/1996 (26 years old)","ST (C)","Bourges Foot 18","French National 2 - B","GUF","Yes","7/1/2022","6/30/2023","$2.5K - $8K","Right Only","Weak","Very Strong","5'11""","194 lbs","73","12",84,93,6,4,14,14,14,4,12,8,1,7,7,7,2,13,6,8,3,7,8,10,10,12,11,14,5,7,7,8,12,13,12,11,12,11,11,12,11,11,9,11,11,10,12,11,5,5,19,12,9,2,1,3,3,3,3,2,1,2,3,2
"3077",2000098701,"Maurane Mathurin","7/3/2002 (20 years old)","M/AM (L)","Olympique Cayenne","French Guianese Régional 1","GUF","Yes","6/13/2022","-","$0","Left","Very Strong","Reasonable","5'7""","138 lbs","-","-",62,93,6,11,12,13,9,4,5,6,3,5,11,7,4,13,10,7,7,7,6,7,10,13,5,10,5,6,6,6,10,12,6,5,15,12,6,3,9,10,9,12,13,13,7,10,6,6,12,10,19,2,2,2,1,2,2,3,2,3,3,2
"3078",2000106857,"Dylan Adam","11/7/1998 (24 years old)","D (RC)","Etoile Matoury","French Guianese Régional 1","GUF","Yes","6/15/2020","12/31/2025","$2.5K - $8K","Right","Fairly Strong","Very Strong","6'4""","187 lbs","-","-",77,90,3,8,1,1,5,1,11,4,1,12,5,1,12,4,12,4,9,6,10,12,16,5,3,5,11,5,5,7,10,10,6,13,15,12,12,11,11,14,11,12,11,9,11,13,15,3,10,12,19,1,3,1,4,1,1,2,3,2,1,3
"3079",59069953,"Farkhat Musabekov","1/3/1994 (29 years old)","M/AM (C)","Abdysh-Ata","Kyrgyzstani High League","KGZ","No","3/2/2023","12/31/2023","$9K - $28K","Right","Strong","Very Strong","5'8""","149 lbs","75","8",98,115,6,8,13,9,12,8,9,11,3,8,12,9,9,13,7,12,8,11,9,12,13,13,6,11,8,11,13,12,12,12,11,8,11,12,11,9,15,15,15,14,8,9,6,15,6,8,14,8,16,2,4,2,2,2,2,3,2,2,1,1
"3080",2000230707,"Zedan Charlec","12/8/1999 (23 years old)","DM, M (C)","Etoile Matoury","French Guianese Régional 1","GUF","Yes","1/1/2020","12/31/2025","$0 - $2.5K","Right Only","Very Weak","Very Strong","5'8""","152 lbs","-","-",75,90,7,2,5,8,12,7,6,8,4,10,11,3,14,13,9,12,6,9,9,14,4,5,10,7,13,8,7,11,13,8,8,2,8,12,7,7,15,10,8,10,11,13,7,5,12,2,13,12,15,1,3,3,1,2,2,1,2,3,2,3
"3081",2000230710,"Joël Sarrucco","11/18/1990 (32 years old)","ST (C)","ASC Le Geldar","French Guianese Régional 1","GUF","Yes","6/14/2021","12/31/2024","Not for Sale","Right","Reasonable","Very Strong","5'10""","160 lbs","-","-",77,90,7,6,13,14,14,7,14,7,2,7,7,4,6,11,10,13,5,9,8,13,6,10,10,10,8,7,5,8,11,8,8,7,12,7,9,7,11,13,11,11,12,12,11,14,8,3,9,10,7,1,2,2,2,3,3,2,4,2,1,1
"3082",2000230554,"Mickaël Colino","12/17/1997 (25 years old)","D/WB (R)","ASU Grand Santi","French Guianese Régional 1","GUF","No","6/15/2020","12/31/2024","$0 - $12K","Right","Weak","Very Strong","5'11""","154 lbs","-","-",82,90,4,10,6,2,11,1,7,5,6,7,8,3,11,8,15,10,9,7,10,11,7,5,10,6,6,7,6,8,13,13,7,10,15,13,13,6,12,10,13,12,11,13,14,2,5,3,8,11,13,3,1,3,1,3,2,3,2,2,3,3
"3083",82077786,"Alex Éric","9/21/1990 (32 years old)","ST (C)","US Matoury","French Guianese Régional 1","GUF","Yes","6/14/2021","12/31/2024","Not for Sale","Right","Reasonable","Very Strong","6'1""","169 lbs","20","23",75,90,1,2,12,13,13,6,13,7,4,3,7,9,1,9,6,12,6,9,2,7,13,11,10,13,7,6,7,7,11,11,7,11,11,11,12,8,8,12,10,10,10,10,9,9,7,1,12,10,7,3,3,3,1,4,2,2,2,1,1,1
"3084",50038820,"Grégory Lescot","5/10/1989 (34 years old)","D (C), DM","St-Pryvé St-Hilaire FC","French National 2 - B","GUF","Yes","7/5/2022","6/30/2024","$0 - $30K","Left Only","Very Strong","Weak","5'11""","171 lbs","240","7",87,89,6,7,5,5,11,4,10,8,2,11,9,2,14,7,9,12,9,9,8,14,10,6,11,6,12,8,9,9,11,11,11,10,14,7,8,10,12,16,11,12,9,12,6,10,5,8,12,11,17,3,2,2,3,1,3,4,1,3,2,1
"3085",2000230721,"Warren Rino","8/9/1994 (28 years old)","M/AM (L)","ASC Le Geldar","French Guianese Régional 1","GUF","Yes","1/1/2021","12/31/2024","$3K - $10K","Left","Very Strong","Reasonable","5'11""","160 lbs","-","-",77,88,7,10,8,10,11,5,5,5,5,3,9,3,3,11,6,8,4,9,6,12,11,12,2,12,5,6,4,11,12,12,5,9,11,12,12,6,13,12,9,11,9,10,11,2,12,7,20,10,9,2,2,4,1,4,1,3,3,3,3,2
"3086",50041978,"Alain Mogès","7/22/1992 (30 years old)","D (C)","Olympique Alès Cévènnes","French National 2 - A","GUF","Yes","7/1/2022","6/30/2023","$0 - $5K","Right Only","Weak","Very Strong","6'3""","196 lbs","138","12",82,86,3,2,5,6,8,1,14,3,2,12,7,4,13,6,15,11,8,7,6,13,11,5,7,5,13,6,5,8,11,10,7,15,15,13,4,6,15,12,11,13,10,13,15,15,11,5,9,10,18,3,1,4,1,2,3,3,2,2,3,2
"3087",50070237,"Mehdi Espada","2/24/1997 (26 years old)","D (R)","US Castanet-Tolosan","French National 3 - Group B","GUF","Yes","7/1/2022","6/30/2024","$18K - $55K","Right Only","Weak","Very Strong","5'8""","136 lbs","46","-",68,86,4,10,6,1,11,1,7,2,1,8,7,3,11,7,7,9,8,7,5,14,14,5,9,6,11,7,7,8,14,14,7,6,13,12,13,5,11,20,11,12,11,14,7,4,6,2,8,9,9,2,2,1,1,3,3,3,3,2,2,1
"3088",82077718,"Rhudy Evens","2/13/1988 (35 years old)","M/AM (LC), ST (C)","ASC Le Geldar","French Guianese Régional 1","GUF","Yes","6/14/2021","12/31/2024","Not for Sale","Left","Very Strong","Reasonable","5'9""","149 lbs","-","-",70,85,7,10,6,9,13,6,7,8,6,6,13,2,5,13,8,6,4,8,7,10,11,13,11,12,7,7,7,8,9,8,7,4,13,9,9,5,10,19,13,12,12,9,11,3,11,5,12,9,13,1,2,3,3,3,2,2,4,2,2,2
"3089",34009549,"Jean-David Legrand","2/23/1991 (32 years old)","D/WB (L)","US Lège Cap-Ferret","French National 3 - Group B","GUF","Yes","7/1/2022","6/30/2024","$18K - $55K","Right","Fairly Strong","Very Strong","5'10""","174 lbs","203","4",77,82,6,9,9,5,8,10,7,7,7,6,10,5,9,11,7,10,10,7,7,12,14,7,5,11,7,10,9,12,12,11,12,9,14,10,11,12,16,15,15,16,13,14,6,12,8,5,11,13,8,3,3,3,3,3,1,3,1,2,3,1
"3090",2000282154,"Isa Begaliev","5/5/2007 (16 years old)","AM (RL)","CSKA Moscow","Russian Premier League","KGZ","No","7/1/2022","6/30/2026","$0 - $26K","Right","Reasonable","Very Strong","5'9""","123 lbs","-","-",50,115,9,12,8,12,8,6,3,3,6,5,9,1,7,9,5,9,7,5,3,7,8,9,5,7,2,8,6,13,9,11,7,6,12,9,12,4,11,13,13,13,11,13,5,11,5,7,7,10,14,1,1,3,1,1,3,1,3,3,1,2
"3091",2000055996,"Dany Florentine","2/12/2002 (21 years old)","DM, M (C)","Pistoiese","Italian Serie D Grp. D","GUF","Yes","8/25/2022","6/30/2024","$0 - $60K","Right Only","Weak","Very Strong","5'9""","149 lbs","32","3",70,81,7,8,9,7,11,7,11,7,10,8,12,9,11,8,10,9,6,8,10,10,8,5,6,9,11,12,10,9,11,10,11,9,11,11,11,9,10,13,14,12,11,11,8,1,12,8,6,10,11,2,3,1,3,2,2,2,3,1,2,2
"3092",82077826,"Inrick Baal","2/10/1992 (31 years old)","D (C)","CSC de Cayenne","French Guianese Régional 1","GUF","Yes","6/14/2021","12/31/2024","Not for Sale","Right","Reasonable","Very Strong","6'4""","182 lbs","-","-",79,81,1,4,1,1,8,5,14,5,1,8,7,3,14,7,10,13,9,8,9,14,8,5,14,5,14,3,2,8,7,8,8,16,15,8,5,9,11,20,12,12,11,12,12,4,13,2,19,11,19,2,4,2,2,2,4,4,2,2,2,1
"3093",82077879,"Miguel Haabo","9/1/1990 (32 years old)","M/AM (C)","Etoile Matoury","French Guianese Régional 1","GUF","Yes","6/14/2021","12/31/2024","Not for Sale","Right","Fairly Strong","Very Strong","5'10""","152 lbs","-","-",81,81,4,7,9,8,14,6,4,9,2,9,14,4,9,12,8,10,3,8,8,8,7,14,11,11,9,8,11,13,12,8,7,9,15,11,12,6,14,19,12,13,11,11,12,2,13,3,17,13,15,1,2,3,3,3,3,3,2,3,1,3
"3094",48043870,"Yohan Marmot","7/22/1999 (23 years old)","D/WB/M (L)","Angoulême Charente FC","French National 2 - B","GUF","Yes","9/9/2022","6/30/2023","$0 - $7K","Left Only","Very Strong","Weak","5'10""","154 lbs","56","-",74,81,9,13,10,7,10,9,8,6,7,10,11,3,10,9,9,10,10,10,11,10,19,5,15,10,10,10,8,11,10,9,10,11,9,11,10,9,13,11,11,13,11,11,14,8,5,3,11,14,14,3,3,2,2,3,3,1,3,2,1,3
"3095",2000230553,"Oliver Kwasiba","8/18/1994 (28 years old)","D/WB/M/AM (L)","ASC Le Geldar","French Guianese Régional 1","GUF","No","6/15/2020","12/31/2024","$2K - $7K","Left","Very Strong","Reasonable","6'3""","169 lbs","-","-",76,80,6,11,7,9,12,5,2,1,5,6,9,5,7,12,11,5,6,7,7,10,9,13,10,10,5,2,7,7,12,12,6,12,12,12,12,3,9,14,13,9,10,9,10,8,9,2,12,13,8,2,2,4,3,4,1,1,3,2,1,1
"3096",85051361,"Joffrey Torvic","11/13/1989 (33 years old)","ST (C)","FC Porto Portugais Amiens","French Regional 1 - Hauts de France - Group A","GUF","Yes","12/15/2022","-","$0","Right Only","Weak","Very Strong","5'9""","158 lbs","23","1",73,80,8,7,12,9,15,8,13,7,7,6,9,2,1,12,12,12,8,9,7,9,6,10,14,13,7,8,8,9,11,10,6,10,10,8,13,8,8,19,10,10,10,12,10,2,12,8,10,9,19,1,1,2,3,2,1,2,2,2,1,3
"3097",82077866,"Marc Edwige","9/26/1986 (36 years old)","D (C), DM, M (C)","CSC de Cayenne","French Guianese Régional 1","GUF","Yes","6/14/2021","12/31/2024","Not for Sale","Right","Weak","Very Strong","6'2""","185 lbs","-","-",70,80,3,7,4,6,11,4,9,5,1,10,14,1,11,9,5,11,8,9,6,14,13,5,13,8,10,8,10,13,9,8,8,9,15,7,9,9,10,18,11,13,10,8,11,12,6,1,12,10,16,2,2,2,3,1,1,2,2,2,2,3
"3098",82077929,"Jean-Beaunel Petit-Homme","8/10/1990 (32 years old)","GK","US Matoury","French Guianese Régional 1","GUF","Yes","6/14/2021","12/31/2024","Not for Sale","Right","Reasonable","Very Strong","5'10""","154 lbs","-","-",70,80,3,2,2,3,1,5,1,1,3,2,10,2,3,5,11,9,7,5,7,13,17,2,11,1,10,7,6,6,10,11,5,5,10,11,3,4,9,20,12,9,10,11,5,14,6,3,12,11,10,11,13,11,8,6,9,10,5,10,9,8
"3099",33048847,"Marvin Torvic","1/5/1988 (35 years old)","D (C), DM","Etoile Matoury","French Guianese Régional 1","GUF","Yes","6/14/2021","12/31/2024","$0","Right","Reasonable","Very Strong","6'4""","180 lbs","51","1",65,80,4,5,6,3,12,5,5,4,1,10,13,5,13,7,9,10,7,7,10,13,12,5,14,5,13,6,3,6,9,4,6,12,9,5,6,7,11,20,10,13,12,9,5,14,7,5,9,11,18,1,3,2,2,1,3,3,1,2,3,3
"3100",2000106821,"Serge Malbranche","11/11/2003 (19 years old)","GK","Olympique Cayenne","French Guianese Régional 1","GUF","Yes","6/13/2022","-","$0","Right","Reasonable","Very Strong","6'4""","182 lbs","-","-",53,80,2,2,3,2,1,5,1,3,2,1,5,1,2,1,5,4,11,1,8,13,8,3,2,2,9,6,4,2,6,16,6,14,11,5,1,7,9,19,11,9,11,12,5,5,5,6,10,11,20,9,6,13,11,8,13,6,7,4,9,11
"3101",70014436,"Anton Zemlyanukhin","12/11/1988 (34 years old)","M (RC), AM (RLC)","Alga Bishkek","Kyrgyzstani High League","KGZ","No","1/26/2023","12/31/2023","$0","Left","Very Strong","Weak","5'9""","149 lbs","274","60",95,115,11,11,13,10,12,11,8,10,15,7,11,11,8,14,13,9,15,9,10,9,13,16,6,11,6,6,11,10,10,15,8,5,12,11,7,7,16,8,9,8,9,15,14,10,13,10,11,13,15,3,3,1,3,1,3,1,2,1,1,1
"3102",2000230552,"Marius Kago","9/19/1997 (25 years old)","D (C)","ASU Grand Santi","French Guianese Régional 1","GUF","No","6/15/2020","12/31/2024","$0 - $7K","Right","Reasonable","Very Strong","5'11""","154 lbs","-","-",75,79,2,1,2,4,7,5,13,2,1,10,6,1,13,2,8,12,9,6,8,13,15,5,5,6,11,6,6,7,10,13,7,6,17,13,12,5,11,10,13,12,10,14,5,13,8,7,17,11,19,2,1,2,3,3,3,4,3,1,3,2
"3103",2000098429,"Bendy Lantiman","10/9/1996 (26 years old)","D (C)","Olympique Cayenne","French Guianese Régional 1","GUF","Yes","6/15/2020","-","$0","Right","Fairly Strong","Very Strong","6'0""","163 lbs","-","-",70,79,2,1,2,1,7,1,11,1,4,11,7,1,13,2,8,12,9,5,10,9,16,5,11,2,13,6,1,7,13,13,7,9,12,13,8,5,14,17,11,11,10,12,8,15,6,2,11,11,14,2,1,3,1,3,1,1,2,2,2,1
"3104",2000230714,"Isidor Mambré","6/3/1998 (25 years old)","ST (C)","Oyapock","French Guianese Régional 1","GUF","No","1/1/2020","12/31/2024","$0 - $8K","Right","Reasonable","Very Strong","6'2""","167 lbs","-","-",75,79,5,4,13,13,13,3,13,5,1,4,5,9,1,12,13,12,7,12,4,12,17,12,8,13,6,6,7,7,13,11,7,12,14,13,4,4,10,18,9,11,13,10,8,3,5,5,13,11,9,1,3,3,2,3,3,3,2,2,3,3
"3105",2000098747,"Julian Kago","7/22/2000 (22 years old)","M/AM (C), ST (C)","Olympique Cayenne","French Guianese Régional 1","GUF","Yes","6/15/2020","-","$0","Right","Fairly Strong","Very Strong","5'9""","145 lbs","-","-",66,79,4,4,10,12,12,4,5,3,3,5,6,7,6,11,5,9,2,11,5,11,5,12,1,6,6,5,9,6,12,12,5,7,14,12,5,3,12,17,11,8,10,10,15,4,14,4,11,11,7,3,1,2,3,2,3,3,2,2,3,2
"3106",2000230550,"Stéphane Roman","3/3/1988 (35 years old)","GK","CSC de Cayenne","French Guianese Régional 1","GUF","No","1/1/2021","12/31/2024","Not for Sale","Right Only","Weak","Very Strong","6'0""","163 lbs","-","-",79,79,3,1,2,2,3,6,1,1,1,3,7,3,2,1,7,10,9,8,6,10,6,2,12,1,11,8,7,7,10,13,8,10,14,10,7,5,10,17,13,10,12,11,12,4,10,4,10,11,8,9,7,10,14,10,13,10,5,10,10,14
"3107",2000230719,"Yann Tirilly","4/25/1994 (29 years old)","ST (C)","ASC Rémire","French Guianese Régional 1","GUF","Yes","6/15/2020","12/31/2024","$0 - $2.5K","Right Only","Very Weak","Very Strong","6'0""","165 lbs","-","-",74,78,5,4,9,13,9,6,13,7,5,6,6,9,1,12,14,12,2,10,7,10,13,12,5,12,6,6,5,7,13,13,7,7,15,13,12,9,11,14,12,10,10,13,10,3,7,3,9,11,10,3,2,1,2,2,3,4,1,2,3,3
"3108",2000098291,"Cyril Louis","11/9/1997 (25 years old)","D (C)","Olympique Cayenne","French Guianese Régional 1","GUF","Yes","6/15/2020","-","$0","Right","Strong","Very Strong","6'0""","171 lbs","-","-",65,78,2,1,1,1,3,1,12,4,1,6,5,1,12,1,15,7,7,1,6,11,7,5,12,2,12,4,1,5,12,12,5,8,16,12,10,12,12,12,10,11,12,10,15,7,5,6,9,8,17,2,1,4,1,1,2,2,2,3,1,1
"3109",82077994,"Raymond Jean-Jacques","2/15/1987 (36 years old)","D (C), DM, M (C)","CSC de Cayenne","French Guianese Régional 1","GUF","Yes","6/14/2021","12/31/2024","Not for Sale","Right","Reasonable","Very Strong","6'1""","171 lbs","-","-",72,78,5,4,6,2,10,3,9,6,3,11,10,4,14,9,6,12,8,9,8,12,12,6,12,8,9,8,8,13,9,8,8,12,15,6,8,7,12,13,12,10,12,10,13,10,12,5,18,9,16,2,2,3,3,2,2,1,1,3,1,3
"3110",2000288026,"Yvelin Nozile","3/19/1997 (26 years old)","AM (RL), ST (C)","ASU Grand Santi","French Guianese Régional 1","GUF","Yes","7/1/2019","12/31/2024","$0 - $6K","Right","Reasonable","Very Strong","5'11""","163 lbs","-","-",72,77,6,8,12,9,13,5,8,3,6,4,11,1,3,11,5,9,6,8,7,10,8,11,14,10,6,7,7,8,13,13,7,9,12,13,7,8,10,17,10,13,11,11,7,10,12,3,8,13,17,1,3,4,3,1,1,3,1,2,4,2
"3111",2000099072,"Alan Mondika","9/21/1998 (24 years old)","D (RC)","Olympique Cayenne","French Guianese Régional 1","GUF","Yes","6/15/2020","-","$0","Right","Weak","Very Strong","6'0""","160 lbs","-","-",65,77,5,10,5,1,6,5,8,5,3,12,4,4,7,5,9,12,8,6,6,13,9,5,11,3,12,5,4,6,13,13,6,6,14,13,6,6,12,13,12,12,12,12,12,9,11,5,7,12,11,2,1,1,2,2,1,2,3,1,3,1
"3112",82081445,"Dutherson Clerveaux","1/29/1999 (24 years old)","M/AM (C)","Cavaly","Haitian Championnat National D1","HAI","No","1/1/2019","12/31/2024","$45K - $130K","Right","Reasonable","Very Strong","6'0""","171 lbs","-","-",90,105,8,6,10,10,10,8,8,7,6,9,11,6,9,11,15,11,12,11,9,11,12,10,12,11,10,9,11,13,11,11,12,12,12,11,12,10,16,11,13,13,10,11,9,2,14,7,11,11,12,4,1,2,3,1,2,2,1,1,2,2
"3113",91204420,"Kai Merk","8/28/1998 (24 years old)","AM (R), ST (C)","Titus Pétange","Luxembourg National Division","KGZ","Yes","7/1/2021","6/30/2026","$0 - $75K","Right Only","Weak","Very Strong","5'10""","160 lbs","159","83",86,114,7,11,13,12,11,7,8,8,1,6,9,8,7,6,5,13,4,11,8,12,15,9,3,14,8,7,8,9,14,14,8,8,14,14,12,7,12,19,11,14,11,11,15,12,15,8,8,8,11,2,1,2,2,1,1,2,3,3,2,1
"3114",2000050985,"Roberto Adompai","7/24/1995 (27 years old)","AM (R), ST (C)","US Changé","French Regional 1 - Pays de la Loire - Group B","GUF","Yes","1/1/2023","-","$0","Right","Weak","Very Strong","5'10""","149 lbs","40","3",73,76,6,10,13,13,13,6,8,5,6,6,11,3,7,12,11,12,4,7,7,7,14,12,3,13,5,7,8,8,13,13,6,5,12,13,8,4,10,13,11,11,12,10,11,8,8,2,12,10,9,4,3,1,1,2,4,3,1,3,1,3
"3115",2000106893,"Calvin Soga","1/18/1995 (28 years old)","M/AM (L)","AJ Saint-Georges","French Guianese Régional 1","GUF","Yes","6/15/2020","-","$0","Left","Very Strong","Fairly Strong","5'10""","152 lbs","-","-",73,75,6,10,11,12,11,4,5,6,5,4,12,4,4,10,11,5,7,9,5,12,5,11,11,12,4,6,8,10,12,12,6,3,10,12,11,5,13,20,11,13,10,10,15,7,12,4,10,12,16,2,2,3,1,3,1,2,2,2,2,1
"3116",82077853,"Alan Clet","2/18/1986 (37 years old)","D (C), ST (C)","CSC de Cayenne","French Guianese Régional 1","GUF","Yes","6/14/2021","12/31/2024","$0","Right","Reasonable","Very Strong","5'11""","163 lbs","32","11",64,75,3,4,4,12,11,6,14,2,6,9,5,2,13,7,7,9,8,5,7,12,11,6,4,8,12,6,1,7,8,6,6,7,13,8,8,7,8,15,10,13,13,12,5,15,5,5,20,11,10,3,1,3,3,2,4,2,2,1,3,2
"3117",2000110825,"Teddy Adaoude","2/5/1997 (26 years old)","D/WB/M/AM (L)","Etoile Matoury","French Guianese Régional 1","GUF","Yes","6/15/2020","12/31/2024","$0","Left","Very Strong","Reasonable","5'7""","141 lbs","-","-",68,75,6,9,7,10,9,4,4,4,1,6,11,1,7,13,7,7,5,7,7,12,6,13,11,9,5,6,3,7,13,12,6,1,11,13,12,6,15,12,12,11,9,9,12,3,10,6,7,11,12,2,2,2,1,3,1,3,1,1,3,2
"3118",82064242,"Gary Pigrée","5/22/1988 (35 years old)","ST (C)","CSC de Cayenne","French Guianese Régional 1","GUF","Yes","6/14/2021","12/31/2024","Not for Sale","Right","Fairly Strong","Very Strong","5'11""","158 lbs","20","15",72,75,7,5,10,14,14,3,14,8,2,3,8,3,3,14,5,11,8,9,8,12,13,13,9,12,8,6,6,8,6,8,8,7,9,10,10,5,10,18,10,10,13,9,14,1,5,3,12,8,14,3,2,3,1,4,1,2,3,1,2,4
"3119",2000230716,"Delarno Belfi","7/5/1988 (34 years old)","ST (C)","ASU Grand Santi","French Guianese Régional 1","GUF","No","6/14/2021","12/31/2024","Not for Sale","Right","Reasonable","Very Strong","6'2""","171 lbs","-","-",75,75,7,3,11,14,10,7,13,4,2,7,7,8,4,12,8,10,8,10,6,14,18,11,4,11,6,7,8,8,11,11,8,9,15,11,7,7,11,11,11,11,12,12,13,6,9,3,9,10,13,2,3,2,3,2,2,2,3,1,3,3
"3120",2000225297,"Josh Laqeretabua","9/26/2005 (17 years old)","D (C)","Charlton","Sky Bet League One","FIJ","No","7/1/2022","6/30/2025","$300K - $850K","Right","Fairly Strong","Very Strong","6'3""","180 lbs","-","-",65,130,2,2,6,4,8,5,11,3,3,9,9,3,10,8,12,9,12,7,8,8,12,4,10,8,9,9,5,9,10,10,5,11,11,9,10,11,8,10,9,11,10,12,3,9,10,6,7,13,9,2,1,1,1,2,2,3,3,3,2,3
"3121",88000360,"Roy Krishna","8/20/1987 (35 years old)","AM (RL), ST (C)","Bengaluru","Indian National Division","FIJ","No","7/18/2022","6/30/2024","$0","Right","Fairly Strong","Very Strong","5'7""","154 lbs","283","149",110,116,6,10,13,14,12,6,6,9,3,7,8,13,8,12,7,12,12,11,10,12,15,12,4,14,7,12,9,10,14,13,10,5,13,16,13,7,5,9,15,16,13,15,6,11,7,6,13,15,18,1,1,1,3,2,3,3,2,1,1,1
"3122",88027972,"Tevita Waranaivalu","9/16/1995 (27 years old)","M/AM (RC)","Rewa","Fijian Premier League","FIJ","No","2/1/2019","12/31/2024","$0 - $4K","Right","Reasonable","Very Strong","5'9""","158 lbs","88","11",68,92,6,9,8,11,11,6,6,6,4,5,5,4,7,14,7,6,7,13,8,8,5,13,12,12,7,8,10,13,10,11,7,6,12,6,13,5,8,11,9,10,12,13,11,8,10,5,19,13,12,3,1,2,1,3,1,1,2,3,3,1
"3123",88001079,"Samuela Kautoga","5/21/1987 (36 years old)","D (RC)","Manukau United","New Zealand Northern League","FIJ","No","12/31/2022","-","$0","Right Only","Weak","Very Strong","5'11""","154 lbs","31","5",58,88,6,8,8,5,10,3,11,5,7,7,7,2,12,10,13,7,8,8,11,8,5,8,7,7,8,12,5,8,9,10,10,11,12,12,12,13,13,20,11,9,12,10,10,17,9,4,10,10,13,4,1,2,2,2,2,3,3,2,1,3
"3124",59145112,"Alimardon Shukurov","9/28/1999 (23 years old)","DM, M (C), AM (RLC)","Neman Grodno","Belarusian Highest League","KGZ","No","2/9/2021","12/31/2023","$18K - $180K","Right","Reasonable","Very Strong","5'6""","145 lbs","57","3",105,112,12,11,12,7,6,10,6,12,3,2,10,6,7,12,8,10,10,12,10,12,12,12,8,11,13,12,8,14,12,14,10,9,8,13,12,9,15,8,15,15,15,14,3,10,3,13,16,5,15,1,2,1,2,1,2,1,2,4,3,1
"3125",95031214,"Leroy Jennings","3/3/1998 (25 years old)","M (C)","Sydney United","National Premier Leagues - NSW","FIJ","No","6/1/2023","9/30/2023","$0 - $7K","Right","Reasonable","Very Strong","5'11""","160 lbs","63","14",79,87,6,6,2,7,11,6,6,13,5,11,10,2,7,12,9,9,1,7,7,13,7,9,10,6,9,7,12,12,13,13,7,9,16,13,12,9,12,10,10,11,11,10,8,12,13,6,16,10,20,3,2,1,2,2,3,1,2,1,3,2
"3126",88027983,"Sairusi Nalaubu","12/14/1996 (26 years old)","AM (R), ST (C)","Lautoka","Fijian Premier League","FIJ","No","1/1/2021","12/31/2024","$500 - $3.5K","Right Only","Very Weak","Very Strong","6'1""","169 lbs","92","59",80,87,9,5,8,11,8,6,14,11,4,3,7,12,6,9,9,7,3,6,7,6,3,11,9,10,3,8,8,11,15,9,8,14,14,19,11,11,10,12,12,12,10,10,14,14,5,8,8,12,11,1,2,2,2,1,1,1,2,3,2,3
"3127",2000012388,"Ryan Mudaliar","3/17/2002 (21 years old)","GK","Western United (NPL)","National Premier Leagues - Victoria 2","FIJ","No","1/1/2022","9/30/2023","$0 - $26K","Right","Reasonable","Very Strong","6'0""","171 lbs","35","-",67,86,4,1,2,2,4,5,1,2,2,2,6,1,1,2,5,9,10,5,8,13,6,3,6,3,9,6,5,5,9,14,6,5,12,4,1,4,11,19,12,11,10,10,12,7,7,2,8,9,20,8,9,13,7,7,10,13,5,6,7,7
"3128",2000094915,"Nabil Begg","3/17/2004 (19 years old)","AM (RLC), ST (C)","Ba","Fijian Premier League","FIJ","No","12/31/2022","12/31/2025","$0 - $1.5K","Right","Reasonable","Very Strong","5'11""","152 lbs","34","9",68,85,7,12,11,5,10,7,6,8,5,7,9,1,5,11,5,7,6,10,8,15,12,14,10,11,6,8,11,9,9,10,12,10,13,11,5,5,8,16,10,12,12,10,11,7,5,6,7,11,11,3,1,3,4,2,3,2,2,2,3,2
"3129",88031747,"Imraan Shah","12/6/1992 (30 years old)","WB/M/AM (R)","Papatoetoe","New Zealand NRF League One","FIJ","No","1/1/2020","-","$0","Right","Fairly Strong","Very Strong","5'10""","145 lbs","26","1",52,84,6,10,6,5,4,4,3,5,1,4,10,3,6,9,10,3,6,5,6,5,15,13,1,10,5,5,4,7,12,12,5,3,10,12,12,3,8,20,13,11,8,10,5,16,13,5,11,13,12,2,3,1,2,3,2,2,2,3,1,1
"3130",88027928,"Patrick Joseph","5/3/1998 (25 years old)","M/AM (C)","Rewa","Fijian Premier League","FIJ","No","1/1/2020","12/31/2024","$0","Right Only","Very Weak","Very Strong","5'11""","156 lbs","86","10",64,83,5,5,5,7,7,5,4,5,1,3,9,8,5,9,12,8,2,9,10,9,6,9,2,9,7,8,10,8,14,13,3,9,17,14,13,6,13,16,11,13,12,7,11,10,5,2,10,8,20,1,1,1,4,1,3,3,2,3,3,3
"3131",88027957,"Gabriele Matanisiga","6/14/1995 (27 years old)","D (C)","Rewa","Fijian Premier League","FIJ","No","6/15/2020","12/31/2024","$0","Left","Very Strong","Reasonable","6'2""","174 lbs","83","16",66,82,2,8,2,4,6,1,7,5,2,13,10,1,13,10,7,8,8,6,5,5,16,5,7,8,13,5,7,5,13,13,6,7,13,13,6,8,14,10,8,9,12,10,13,8,8,3,20,11,20,4,3,1,2,2,1,3,2,3,2,3
"3132",2000005846,"Divikesh Deo","6/15/1995 (27 years old)","GK","Manukau United","New Zealand Northern League","FIJ","No","6/7/2019","-","$0","Right","Reasonable","Very Strong","6'6""","187 lbs","23","-",50,82,3,3,3,3,3,8,1,3,2,3,5,2,2,1,12,8,12,5,3,11,4,2,3,3,10,5,4,4,12,4,5,13,15,10,1,6,10,14,10,9,12,10,13,9,14,7,8,11,7,4,9,12,12,8,8,12,5,8,6,12
"3133",88027888,"Ilaisa Vulimainavuso","5/16/1997 (26 years old)","M (C)","Labasa","Fijian Premier League","FIJ","No","6/15/2020","12/31/2024","$0","Right","Weak","Very Strong","6'4""","185 lbs","73","2",58,81,5,3,2,4,9,5,5,10,1,11,13,1,8,12,13,6,1,6,6,8,3,5,11,9,7,7,11,10,13,8,6,10,12,12,6,8,9,12,11,12,12,10,10,16,10,3,10,10,9,1,1,2,1,2,2,2,1,1,4,2
"3134",2000163556,"Malakai Love-Semira","10/19/2003 (19 years old)","ST (C)","Peninsula Power","National Premier Leagues - Queensland","FIJ","No","1/1/2021","6/30/2025","$0 - $26K","Right","Reasonable","Very Strong","6'0""","156 lbs","69","12",76,80,6,5,13,14,11,4,9,6,2,6,10,4,1,8,7,5,3,9,6,12,11,7,8,13,3,7,4,11,14,13,14,10,11,15,10,4,9,18,10,10,12,13,8,8,11,4,10,12,11,3,3,3,2,3,2,1,1,3,1,1
"3135",2000040154,"Sultan Chomoev","1/20/2003 (20 years old)","GK","Dordoy","Kyrgyzstani High League","KGZ","No","1/1/2020","12/31/2023","$0 - $30K","Right","Reasonable","Very Strong","6'2""","180 lbs","34","-",79,111,3,1,2,3,8,6,3,2,1,1,10,2,3,8,10,3,13,8,3,10,16,2,5,4,13,5,10,4,13,8,7,14,10,11,6,10,12,10,13,15,9,11,6,11,8,2,12,10,16,11,9,15,9,13,10,13,5,11,7,12
"3136",88025939,"Saula Waqa","10/12/1995 (27 years old)","ST (C)","Lautoka","Fijian Premier League","FIJ","No","7/17/2022","12/31/2024","$0","Left","Very Strong","Reasonable","6'6""","194 lbs","67","32",59,79,6,7,7,9,9,4,11,7,1,5,8,5,2,8,8,9,12,8,7,7,6,9,9,7,6,7,8,7,11,6,11,16,18,8,11,16,10,11,11,11,14,13,13,10,6,2,12,11,12,3,1,3,2,3,1,1,2,3,3,3
"3137",88027929,"Peni Tuigulagula","3/8/1999 (24 years old)","D (C), DM","Heatherton Utd","Victorian State League 2 South-East","FIJ","No","1/1/2022","-","$0","Left","Very Strong","Reasonable","6'1""","205 lbs","33","2",64,79,1,5,3,1,5,5,14,6,1,11,6,1,7,7,12,5,13,6,9,12,16,5,11,6,6,6,6,8,13,10,7,12,12,10,11,12,11,19,10,10,10,9,7,12,6,1,9,11,8,1,3,3,3,2,1,2,2,3,3,2
"3138",88027873,"Malakai Rakula","5/16/1992 (31 years old)","D/WB/M/AM (R)","Suva","Fijian Premier League","FIJ","No","1/1/2022","12/31/2024","$0","Right","Reasonable","Very Strong","5'9""","167 lbs","74","7",55,78,4,8,9,13,11,7,10,6,5,8,10,6,6,9,11,10,8,8,9,6,14,14,12,14,7,9,7,11,9,7,12,10,10,7,9,12,11,19,10,12,10,11,8,10,7,4,7,13,7,2,4,3,3,1,3,2,1,2,3,1
"3139",88027911,"Samuela Drudru","4/30/1989 (34 years old)","AM (R), ST (C)","Suva","Fijian Premier League","FIJ","No","1/1/2022","12/31/2024","Not for Sale","Right","Reasonable","Very Strong","6'0""","176 lbs","95","44",60,78,8,9,10,9,8,8,9,4,8,6,8,7,3,10,9,9,10,5,6,5,6,5,11,10,8,11,10,11,10,10,10,7,10,11,10,11,11,19,10,13,12,10,14,13,12,6,18,10,17,3,2,3,1,2,3,3,1,3,1,3
"3140",2000247215,"Asivorosi Rabo","10/29/2004 (18 years old)","M/AM (L)","Rewa","Fijian Premier League","FIJ","No","6/13/2022","12/31/2025","$0","Left","Very Strong","Reasonable","5'8""","143 lbs","15","2",57,78,7,11,8,7,13,5,3,6,2,5,8,3,4,10,7,4,5,6,5,3,13,13,5,5,2,6,7,11,13,13,6,1,6,13,6,3,9,20,11,10,9,10,13,4,5,2,16,9,18,4,1,3,3,2,2,2,2,3,4,2
"3141",88027922,"Christopher Kumar","7/28/1991 (31 years old)","M/AM (C)","Nadi","Fijian Premier League","FIJ","No","6/14/2021","12/31/2024","Not for Sale","Right","Reasonable","Very Strong","6'4""","171 lbs","72","5",56,77,3,5,3,7,13,5,2,7,3,8,8,1,7,12,12,11,6,7,8,9,6,9,1,10,7,7,12,12,7,10,6,14,18,11,7,5,10,15,10,10,13,10,6,7,15,3,12,11,10,3,4,2,3,1,2,3,2,3,2,4
"3142",88027958,"Inoke Turagalailai","2/4/2002 (21 years old)","D (C)","Suva","Fijian Premier League","FIJ","No","1/1/2022","12/31/2025","$0","Right","Reasonable","Very Strong","6'0""","165 lbs","57","-",65,77,6,3,5,3,7,3,9,7,1,10,7,3,10,7,10,10,10,9,9,9,4,5,9,8,9,8,3,10,15,12,9,11,13,13,6,7,12,18,12,9,13,12,10,18,7,7,12,11,18,1,1,1,3,2,3,2,2,1,2,3
"3143",88031233,"Al-Taaf Sahib","9/12/1995 (27 years old)","M (RC), AM (R)","Mt Albert-Ponsonby","New Zealand NRFL Championship","FIJ","No","12/31/2022","-","$0","Right","Reasonable","Very Strong","5'8""","138 lbs","24","4",50,76,2,6,5,6,6,4,4,5,3,4,7,1,4,11,11,7,5,2,5,12,4,12,13,10,5,5,6,9,12,12,5,1,12,12,11,2,13,20,12,9,9,12,9,2,8,2,12,8,20,1,1,2,3,2,2,3,2,2,2,1
"3144",88027872,"Kishan Sami","3/13/2000 (23 years old)","D/WB (RL)","Lautoka","Fijian Premier League","FIJ","No","12/31/2022","12/31/2025","$0","Right","Fairly Strong","Very Strong","6'0""","154 lbs","67","2",68,76,3,9,8,6,6,1,5,2,4,7,10,2,7,8,8,8,7,8,9,8,11,5,7,9,8,7,9,7,14,11,7,5,14,15,7,7,11,12,10,10,11,11,10,6,11,5,8,10,16,2,2,3,3,3,1,2,3,1,4,1
"3145",88027932,"Tito Vodowaqa","4/9/1999 (24 years old)","AM (C), ST (C)","Heatherton Utd","Victorian State League 2 South-East","FIJ","No","1/1/2022","-","$0","Left","Very Strong","Fairly Strong","5'10""","145 lbs","13","1",55,75,5,4,11,8,7,5,7,7,1,5,8,5,5,6,5,9,7,6,3,11,16,7,1,9,6,6,9,7,13,13,7,5,16,13,8,3,10,17,11,14,10,9,10,11,6,1,11,9,14,2,3,3,3,1,1,2,3,2,1,3
"3146",59059397,"Valery Kichin","10/12/1992 (30 years old)","D (LC)","Yenisey","Russian First Division","KGZ","No","6/23/2022","6/30/2024","$375K - $1.1M","Left","Very Strong","Weak","6'1""","180 lbs","259","23",106,110,8,8,10,8,9,7,14,9,12,11,10,12,13,10,13,12,13,11,9,10,15,8,10,8,12,14,9,14,13,11,13,12,14,12,15,12,11,12,13,12,14,11,6,12,6,10,15,12,8,1,2,3,4,2,1,1,1,1,3,1
"3147",2000120205,"Marcus Lal","10/23/2003 (19 years old)","ST (C)","Manly Utd","National Premier Leagues - NSW","FIJ","No","6/13/2022","9/30/2023","$0","Right","Fairly Strong","Very Strong","5'11""","158 lbs","-","-",60,75,1,1,9,12,10,4,12,5,1,2,3,2,1,10,6,8,4,4,5,9,6,11,3,12,2,4,2,5,12,12,5,8,11,12,6,5,7,17,10,12,12,14,9,17,7,3,7,11,9,2,4,2,2,2,1,1,3,3,2,2
"3148",88027878,"Rahul Naresh","7/15/2002 (20 years old)","D (C), DM","Ba","Fijian Premier League","FIJ","No","1/1/2022","12/31/2025","$0","Right","Reasonable","Very Strong","5'11""","156 lbs","42","1",62,74,4,5,1,5,8,2,7,7,4,7,9,1,12,3,15,6,7,7,5,13,6,5,7,4,13,6,4,10,13,12,4,6,10,13,9,4,12,16,10,10,13,13,13,9,5,4,8,12,18,1,2,2,1,2,2,3,3,1,2,1
"3149",2000039308,"Faazil Ali","5/8/2003 (20 years old)","ST (C)","Ba","Fijian Premier League","FIJ","No","1/1/2021","12/31/2024","$0","Right","Weak","Very Strong","6'1""","165 lbs","24","5",54,74,3,3,12,12,10,5,10,6,1,3,3,9,1,11,8,6,2,13,5,3,11,11,11,6,5,5,6,7,13,9,6,10,13,13,6,6,8,16,10,12,11,11,8,16,7,3,11,10,7,2,2,2,1,2,2,2,3,3,1,2
"3150",88027933,"Vuniuci Tikomaimereke","6/7/1990 (33 years old)","D (LC)","Nadi","Fijian Premier League","FIJ","No","7/1/2019","12/31/2024","Not for Sale","Right","Weak","Very Strong","6'4""","185 lbs","74","4",58,74,3,6,4,1,7,1,8,4,1,11,7,1,6,4,15,10,8,6,9,12,7,5,12,5,12,6,1,7,5,9,6,10,13,7,9,7,12,16,13,10,10,11,12,2,9,3,9,10,15,2,2,3,1,1,2,3,1,2,3,2
"3151",2000156921,"Edwin Sahayan","5/7/1990 (33 years old)","M (C)","Labasa","Fijian Premier League","FIJ","No","1/1/2021","12/31/2024","$0","Right","Fairly Strong","Very Strong","6'0""","165 lbs","47","4",55,73,5,6,7,4,14,1,2,8,1,11,9,3,6,12,12,6,6,6,6,11,9,5,6,8,8,8,8,12,7,9,7,9,10,8,11,5,9,17,12,11,11,15,8,10,12,5,12,12,9,2,2,2,4,2,3,3,3,4,2,3
"3152",88027967,"Kavaia Rawaqa","9/20/1990 (32 years old)","D/WB (L)","Suva","Fijian Premier League","FIJ","No","6/12/2023","12/31/2024","Not for Sale","Left","Very Strong","Reasonable","5'9""","158 lbs","99","6",66,73,9,10,7,8,8,10,7,5,9,8,10,4,9,10,12,10,12,9,9,8,16,5,11,10,9,10,10,10,11,12,9,7,8,12,9,9,7,19,10,10,11,11,5,2,6,4,10,9,8,2,2,1,2,1,3,3,3,3,1,3
"3153",2000027647,"Josua Raqamu","7/21/1994 (28 years old)","D (C)","Labasa","Fijian Premier League","FIJ","No","12/31/2022","12/31/2024","$0","Right","Reasonable","Very Strong","6'1""","171 lbs","27","-",52,73,1,1,1,1,3,3,8,1,3,11,6,1,13,1,12,7,8,6,8,13,3,5,10,4,10,5,1,6,8,12,6,8,7,12,6,6,11,11,10,14,13,9,12,8,6,6,11,9,17,2,2,3,3,2,1,3,1,3,1,3
"3154",88028022,"Vinal Prasad","9/4/1997 (25 years old)","D (C), DM","Navua","Fijian Premier League","FIJ","No","1/1/2020","12/31/2024","$0","Right","Reasonable","Very Strong","5'11""","154 lbs","66","2",55,73,2,5,5,3,7,4,7,6,1,7,8,2,12,6,13,12,7,6,6,10,9,5,9,7,8,6,6,7,13,13,6,7,9,13,10,4,11,15,7,9,9,12,11,7,8,6,9,10,12,2,3,3,1,3,3,1,1,1,2,2
"3155",2000067277,"Suliano Tawanakoro","7/27/1997 (25 years old)","D (L)","Ba","Fijian Premier League","FIJ","No","6/30/2022","12/31/2024","$0","Right","Weak","Very Strong","5'10""","156 lbs","39","3",55,73,2,6,5,1,5,1,5,1,5,7,6,3,11,4,8,7,8,6,8,13,12,5,12,3,8,6,4,7,13,12,6,4,17,9,12,9,13,11,11,12,10,12,5,11,11,6,16,14,9,1,3,1,2,1,3,3,2,2,1,1
"3156",433740,"Simione Nabenu","5/6/2000 (23 years old)","D (C)","Manurewa","New Zealand Northern League","FIJ","No","12/31/2022","-","$0","Right","Reasonable","Very Strong","6'1""","169 lbs","48","-",64,72,1,3,4,1,4,1,11,1,1,6,7,2,9,4,8,11,8,5,10,14,6,5,2,3,9,6,3,7,12,13,7,8,13,12,11,7,3,18,10,10,10,11,5,2,11,8,6,10,18,1,2,1,3,2,2,1,3,1,3,2
"3157",59069952,"Kayrat Jyrgalbek uulu","6/13/1993 (29 years old)","D/WB/M (R)","Aqsý","Kazakhstan Premier League","KGZ","No","1/1/2022","12/31/2026","$0","Right","Reasonable","Very Strong","5'10""","167 lbs","76","8",100,110,7,12,10,9,9,3,7,5,4,10,8,5,11,11,8,8,13,10,9,10,14,10,11,6,8,10,8,13,13,12,7,8,11,13,13,8,14,20,14,15,11,10,11,9,11,1,17,10,11,2,2,2,3,1,1,1,3,1,2,3
"3158",2000283718,"Prashant Kumar","3/3/2006 (17 years old)","AM (R)","Lautoka","Fijian Premier League","FIJ","No","6/13/2022","12/31/2024","$0","Right","Reasonable","Very Strong","5'11""","149 lbs","-","-",50,72,7,11,10,9,9,6,3,6,6,3,8,3,4,11,7,4,3,8,6,7,3,12,5,4,3,7,4,11,14,10,7,10,9,11,6,4,8,12,11,10,11,11,9,12,9,1,7,12,17,3,1,3,1,4,3,2,1,3,2,3
"3159",88001042,"Monit Chand","4/9/1990 (33 years old)","M/AM (LC)","Rewa","Fijian Premier League","FIJ","No","12/31/2022","12/31/2024","$0","Left","Very Strong","Weak","5'10""","154 lbs","36","4",55,72,10,10,7,5,10,10,6,8,3,5,9,1,6,10,14,6,7,10,8,9,10,13,11,10,4,8,11,13,7,11,7,7,13,10,8,4,11,20,13,10,11,13,5,16,5,3,18,10,7,1,3,3,3,1,4,2,1,1,3,1
"3160",88027965,"Josaia Sela","12/27/2002 (20 years old)","M/AM (C), ST (C)","Rewa","Fijian Premier League","FIJ","No","6/13/2022","12/31/2025","$0","Right","Reasonable","Very Strong","5'10""","156 lbs","44","5",61,71,8,9,8,8,8,8,7,8,4,9,8,7,8,9,15,10,4,9,4,10,11,7,9,12,5,8,10,8,8,10,9,7,9,12,10,5,10,20,10,11,10,12,15,4,10,3,10,10,8,3,2,3,2,3,2,2,1,2,3,2
"3161",88027797,"Sitiveni Cavuilagi","7/26/1994 (28 years old)","D (C), DM","Lautoka","Fijian Premier League","FIJ","No","1/1/2020","12/31/2024","$0","Right","Fairly Strong","Very Strong","6'2""","171 lbs","71","12",65,71,2,4,2,3,7,5,8,5,4,9,10,4,11,6,6,8,7,5,11,13,14,5,3,6,11,7,6,12,11,11,7,9,14,12,14,7,12,11,12,11,11,11,5,16,9,4,10,9,16,2,1,1,2,3,3,2,1,1,1,3
"3162",88001162,"Zibraaz Sahib","9/9/1989 (33 years old)","DM, M (C)","Lautoka","Fijian Premier League","FIJ","No","6/14/2021","12/31/2024","Not for Sale","Right","Reasonable","Very Strong","5'11""","167 lbs","108","24",62,71,8,10,6,7,8,7,8,10,7,9,10,15,10,10,6,6,8,7,10,16,17,5,10,8,10,5,10,10,9,9,8,8,6,9,8,6,8,14,12,9,8,9,8,14,9,6,9,11,12,1,1,1,3,2,1,1,1,1,2,3
"3163",425942,"Savenaca Baledrokadroka","5/20/1999 (24 years old)","D/M (R)","Frankston Pines","Victorian State League 2 South-East","FIJ","No","6/12/2023","-","$0","Right Only","Weak","Very Strong","5'10""","145 lbs","7","1",63,71,7,11,11,6,11,7,7,5,10,8,10,3,7,9,11,6,8,7,6,7,15,10,11,8,8,5,7,9,14,11,7,10,12,12,11,6,8,16,11,9,10,11,6,8,9,3,11,12,3,1,1,3,3,2,3,1,3,2,4,1
"3164",2000170483,"Vilitati Kautoga","9/20/1997 (25 years old)","M/AM (L)","Nadroga","Fijian Premier League","FIJ","No","1/1/2022","12/31/2024","$0","Left","Very Strong","Fairly Strong","5'4""","121 lbs","42","5",54,71,6,10,8,6,7,5,2,3,5,5,6,1,6,4,6,9,7,7,5,13,11,7,9,12,3,6,9,11,11,11,6,1,15,11,11,1,12,20,13,10,13,8,9,15,6,4,12,11,9,3,2,1,2,3,2,2,4,2,3,2
"3165",88024444,"James Hoyt","9/28/1990 (32 years old)","M (R), AM (RL)","Manurewa","New Zealand Northern League","FIJ","No","2/1/2023","-","$0","Right","Reasonable","Very Strong","5'9""","141 lbs","67","9",58,70,5,7,9,6,9,4,5,5,3,4,6,1,5,8,8,5,3,7,5,9,14,13,4,10,4,5,2,6,14,10,10,4,15,13,11,2,9,11,9,12,12,11,10,11,5,2,12,10,7,2,3,1,2,3,2,1,1,2,2,4
"3166",88031511,"Shuaib Khan","11/8/1995 (27 years old)","D (LC), WB (L)","Manurewa","New Zealand Northern League","FIJ","No","2/1/2023","-","$0","Left Only","Very Strong","Weak","5'9""","154 lbs","95","6",65,70,2,5,6,5,7,1,8,4,6,10,7,4,10,4,14,5,15,7,9,10,5,5,1,5,6,7,2,8,13,11,8,7,17,11,13,13,12,18,12,12,13,12,9,4,13,3,9,9,7,3,2,3,2,1,3,3,2,2,2,2
"3167",2000283719,"Simione Ragoneturaga","10/31/2002 (20 years old)","ST (C)","Labasa","Fijian Premier League","FIJ","No","6/13/2022","12/31/2025","$0","Right","Reasonable","Very Strong","5'9""","149 lbs","7","-",50,70,5,2,10,10,10,3,9,6,1,5,6,4,1,9,12,12,1,8,5,11,9,11,12,7,6,5,4,6,13,11,6,5,12,11,5,4,9,12,13,11,9,12,12,16,5,1,16,12,17,3,2,1,2,1,4,1,1,2,2,1
"3168",59123580,"Ayzar Akmatov","8/24/1998 (24 years old)","D (C)","Abdysh-Ata","Kyrgyzstani High League","KGZ","No","8/11/2022","12/31/2023","$0 - $18K","Either","Very Strong","Very Strong","6'0""","165 lbs","45","6",88,110,2,3,5,4,8,4,11,5,5,11,8,1,12,6,14,7,17,7,9,9,9,5,9,8,12,12,6,12,12,9,8,10,10,12,11,8,9,17,10,9,11,11,6,15,14,1,9,10,7,1,1,3,2,1,2,3,3,2,1,1
"3169",88027869,"Etonia Dogalau","2/24/2001 (22 years old)","M/AM (C), ST (C)","Ba","Fijian Premier League","FIJ","No","12/31/2020","12/31/2025","$0","Right","Reasonable","Very Strong","6'6""","200 lbs","45","13",63,70,2,3,6,7,10,1,9,6,3,6,7,2,2,9,14,9,5,5,6,13,7,9,9,9,5,6,7,7,10,10,6,16,14,9,6,13,11,16,11,10,11,11,8,9,10,5,13,11,16,1,2,1,1,2,1,2,2,1,3,2
"3170",2000019485,"William Valentine","10/11/1991 (31 years old)","M/AM (C)","Nadi","Fijian Premier League","FIJ","No","6/14/2021","12/31/2024","Not for Sale","Left","Very Strong","Weak","6'2""","171 lbs","74","5",57,70,5,5,7,9,10,5,1,6,9,5,10,9,5,11,13,5,2,8,6,13,7,12,9,10,7,7,11,11,10,10,6,9,12,7,13,5,8,13,12,11,10,12,7,1,9,6,9,10,15,2,4,2,2,3,1,4,1,3,1,2
"3171",88025934,"Iosefo Verevou","1/5/1996 (27 years old)","M (C), AM (RC), ST (C)","Rewa","Fijian Premier League","FIJ","No","1/1/2022","12/31/2024","$0","Left","Very Strong","Reasonable","6'2""","187 lbs","68","10",62,70,5,8,9,10,8,8,7,5,1,5,10,2,2,11,6,8,5,9,6,13,15,12,9,10,6,9,9,10,10,9,4,12,12,10,12,13,11,10,8,13,11,10,9,8,7,2,4,10,15,3,3,3,3,2,3,2,2,1,3,3
"3172",88028056,"Thomas Dunn","1/19/2003 (20 years old)","M/AM (C)","Navua","Fijian Premier League","FIJ","No","10/4/2022","12/31/2025","$0","Right Only","Weak","Very Strong","5'8""","141 lbs","54","7",60,69,8,8,9,7,11,9,5,7,3,6,12,9,6,12,6,10,7,6,12,12,13,9,1,10,10,8,12,9,10,10,8,6,8,11,8,10,10,12,11,10,9,2,13,11,7,14,11,4,7,1,3,4,3,2,2,3,1,1,3,3
"3173",2000054795,"Aydin Mustahib","5/28/2004 (19 years old)","GK","Auckland United","New Zealand Northern League","FIJ","No","1/1/2022","-","$0","Right","Reasonable","Very Strong","5'11""","160 lbs","-","-",51,69,3,1,1,2,1,5,1,3,2,3,9,1,1,3,7,6,9,7,8,12,5,3,6,3,5,7,6,6,7,8,7,9,7,10,6,4,7,11,10,11,10,12,14,1,10,4,14,10,19,8,6,12,12,8,5,11,5,8,8,12
"3174",88027884,"Akuila Mateisuva","1/15/1992 (31 years old)","GK","Suva","Fijian Premier League","FIJ","No","1/1/2022","12/31/2024","Not for Sale","Left","Very Strong","Reasonable","6'0""","165 lbs","86","-",60,69,3,1,1,3,2,5,2,3,3,1,5,2,3,4,8,9,9,8,10,9,4,2,8,3,10,8,7,6,13,10,7,12,14,8,1,7,11,11,10,12,12,11,13,8,9,8,13,10,16,9,10,11,10,7,11,10,6,10,9,10
"3175",29113893,"Mahlon Romeo","9/19/1995 (27 years old)","D/WB (R)","Cardiff","Sky Bet Championship","ATG","No","6/15/2022","6/30/2025","$190K - $550K","Right","Weak","Very Strong","5'9""","165 lbs","267","4",107,130,6,11,12,9,12,6,7,4,11,11,11,5,12,11,8,11,11,11,10,9,15,12,6,11,9,11,10,13,14,14,13,9,14,14,14,10,10,14,11,12,13,12,7,12,8,3,12,12,11,1,1,3,3,3,2,3,2,1,3,3
"3176",29085912,"Nick Townsend","11/1/1994 (28 years old)","GK","Newport Co","Sky Bet League Two","ATG","No","6/7/2023","6/30/2025","$18K - $180K","Right","Reasonable","Very Strong","5'11""","194 lbs","144","-",90,120,5,3,6,2,8,6,2,1,2,2,11,2,1,9,11,11,12,8,8,9,12,5,7,8,10,10,7,10,10,11,11,15,10,10,11,12,14,11,12,12,14,11,5,5,4,6,9,10,14,11,10,10,11,10,13,12,11,11,11,12
"3177",5115857,"Myles Weston","3/12/1988 (35 years old)","WB/M/AM (RL)","Dag & Red","Vanarama National League","ATG","No","5/15/2023","6/30/2024","$2.5K - $7K","Left","Very Strong","Reasonable","5'11""","165 lbs","542","48",75,115,10,11,10,9,11,6,9,9,5,7,9,7,6,10,7,7,5,7,10,7,10,14,8,10,10,12,10,11,10,11,9,9,13,10,12,8,12,12,10,10,10,7,12,12,3,5,8,9,5,2,4,3,3,2,1,1,1,2,1,2
"3178",29146039,"Luther James-Wildin","12/3/1997 (25 years old)","D/WB (R)","Stevenage","Sky Bet League One","ATG","No","6/15/2020","6/30/2024","$6K - $60K","Right","Reasonable","Very Strong","6'0""","167 lbs","247","9",97,115,5,11,11,6,8,7,11,9,14,11,9,5,12,8,10,12,10,9,11,10,13,9,8,9,11,10,8,13,13,13,12,11,13,13,13,12,10,19,13,13,11,10,12,11,4,8,12,13,10,2,1,4,1,2,3,3,1,1,3,2
"3179",2000040745,"Biymyrza Jengishbekov","9/4/2003 (19 years old)","M (L), AM (RL)","Abdysh-Ata","Kyrgyzstani High League","KGZ","No","3/1/2023","12/31/2023","$10K - $28K","Right","Fairly Strong","Very Strong","5'9""","143 lbs","47","1",72,109,5,10,12,8,10,4,6,5,2,3,8,9,2,11,6,9,4,9,7,9,14,13,7,8,5,11,9,13,13,11,7,5,6,11,10,4,9,11,12,9,12,10,8,3,8,4,10,12,9,4,1,2,1,2,3,1,2,1,2,3
"3180",28049315,"Zaine Francis-Angol","6/30/1993 (29 years old)","D (LC), WB (L)","Oldham","Vanarama National League","ATG","No","7/2/2022","6/30/2024","$1K - $10K","Left","Very Strong","Reasonable","5'8""","171 lbs","261","6",68,110,3,11,10,4,9,4,7,2,6,8,9,3,8,9,8,10,10,10,10,9,12,7,6,10,8,11,9,12,10,9,11,9,15,12,12,10,9,11,12,13,10,12,9,8,2,6,9,11,7,2,3,3,1,1,3,2,1,3,4,2
"3181",61026790,"Aaron Taylor-Sinclair","4/8/1991 (32 years old)","D (LC), WB (L)","Airdrieonians","cinch Championship","ATG","No","6/12/2023","5/31/2024","$0 - $18K","Left","Very Strong","Weak","6'2""","176 lbs","301","17",80,110,8,11,8,6,11,8,11,5,13,10,9,6,10,8,11,9,10,10,10,11,14,7,11,8,10,12,10,11,13,9,11,14,12,8,10,11,5,15,11,14,12,14,3,12,5,2,11,13,13,4,1,1,2,2,3,1,1,4,1,1
"3182",28030714,"Josh Parker","12/1/1990 (32 years old)","ST (C)","Oxford City","Vanarama National League","ATG","No","6/9/2023","5/31/2024","$0 - $40K","Right Only","Weak","Very Strong","5'11""","167 lbs","252","50",74,109,7,9,11,12,10,6,10,7,6,6,11,9,7,11,7,10,7,10,9,9,10,10,10,11,6,8,8,11,11,8,12,9,15,11,8,12,13,11,11,12,10,10,12,9,7,12,9,10,12,3,3,2,3,2,2,2,3,1,1,2
"3183",31034668,"Ashley Nathaniel-George","5/14/1995 (28 years old)","M/AM (RL)","Maidenhead","Vanarama National League","ATG","No","8/15/2022","6/30/2024","$0 - $100K","Right Only","Weak","Very Strong","5'9""","165 lbs","202","41",77,106,5,10,13,10,10,8,7,10,2,5,9,8,5,10,6,9,9,8,5,9,9,16,6,8,5,10,8,12,13,13,12,7,11,12,10,9,11,10,11,10,9,11,5,8,9,7,8,13,12,1,1,1,1,2,1,3,1,3,1,2
"3184",28107002,"DJ Buffonge","11/7/1998 (24 years old)","M (C), AM (RC)","Telstar","Keuken Kampioen Divisie","ATG","No","1/30/2023","6/30/2024","$14K - $130K","Left","Very Strong","Reasonable","5'8""","154 lbs","25","1",88,100,6,10,11,6,11,11,7,7,4,3,12,6,4,12,6,8,7,10,7,8,17,14,5,8,6,7,9,8,14,11,11,9,10,14,11,13,13,6,14,15,12,13,12,8,4,4,8,14,13,2,2,4,1,2,1,1,1,2,1,3
"3185",28080365,"Rhys Browne","11/16/1995 (27 years old)","AM (C), ST (C)","Woking","Vanarama National League","ATG","No","10/14/2022","6/30/2024","$55K - $170K","Right","Weak","Very Strong","5'8""","176 lbs","219","40",84,100,7,7,16,14,14,5,7,7,5,5,10,14,5,13,11,8,10,10,9,7,10,13,6,9,5,10,8,12,14,12,9,7,7,11,9,8,6,8,10,12,10,9,9,6,4,2,9,10,7,1,2,1,3,2,3,2,4,3,3,3
"3186",20016306,"Quinton Griffith","2/27/1992 (31 years old)","D (L)","Grenades","Antigua and Barbuda Premier Division","ATG","No","7/1/2022","6/30/2025","Not for Sale","Left Only","Very Strong","Weak","5'9""","171 lbs","159","7",78,91,6,13,3,4,11,1,6,5,3,9,9,4,9,6,8,10,9,8,10,11,10,8,14,7,9,8,8,8,14,10,12,9,10,13,14,11,16,20,10,13,11,11,6,8,6,2,15,13,14,2,2,3,1,1,2,2,1,3,1,1
"3187",2000287420,"Antyon Henry","4/23/2002 (21 years old)","DM, M (C)","Hoppers","Antigua and Barbuda Premier Division","ATG","No","4/23/2020","6/30/2025","$0 - $3.5K","Right","Reasonable","Very Strong","5'9""","143 lbs","-","-",69,91,5,4,2,7,9,6,6,13,1,7,14,1,10,13,8,8,6,8,8,14,17,5,13,7,10,7,8,12,9,12,7,7,18,14,7,4,10,12,8,12,11,12,9,6,8,5,11,11,10,1,3,3,1,2,1,3,1,3,1,2
"3188",82074174,"Rodney Lawrence","4/26/1999 (24 years old)","M (C)","Hoppers","Antigua and Barbuda Premier Division","ATG","No","7/1/2018","6/30/2025","$0 - $5K","Right","Strong","Very Strong","6'0""","160 lbs","13","-",70,90,5,6,2,7,9,6,2,6,1,11,13,2,7,13,5,6,6,9,7,13,6,5,12,8,8,7,9,11,13,8,4,9,13,11,10,5,11,20,12,12,11,11,13,7,6,7,8,11,19,3,2,1,2,2,3,2,3,3,3,2
"3189",2000090290,"Akeem Isaac","12/18/1999 (23 years old)","M/AM (C)","Bullets (ATG)","Antigua and Barbuda Premier Division","ATG","No","6/15/2020","6/30/2025","$0 - $4.5K","Right","Reasonable","Very Strong","6'1""","167 lbs","7","-",68,90,6,3,8,11,10,6,4,8,6,7,11,8,5,14,14,8,7,11,7,11,11,13,12,9,6,7,12,12,7,10,7,11,13,12,10,5,8,17,11,10,10,13,12,5,5,4,9,11,7,3,2,1,2,3,3,1,2,3,1,1
"3190",59096086,"Odiljon Abdurahmonov","3/18/1996 (27 years old)","DM, M (C)","Maqtaaral","Kazakhstan Premier League","KGZ","No","7/20/2022","12/31/2023","$24K - $250K","Right","Reasonable","Very Strong","6'1""","165 lbs","50","3",95,108,9,8,5,10,12,9,13,10,4,11,12,9,11,13,14,10,10,14,10,13,6,5,11,11,10,13,8,11,10,8,15,14,13,9,11,5,15,13,12,14,12,10,8,6,5,2,15,11,14,1,1,2,3,3,2,2,1,1,3,1
"3191",82072163,"Tevaughn Harriette","6/26/1995 (27 years old)","M (L), AM (RL), ST (C)","Parham FC","Antigua and Barbuda Premier Division","ATG","No","6/1/2019","6/30/2024","$500 - $3K","Right","Fairly Strong","Very Strong","5'9""","154 lbs","-","-",80,90,7,10,10,10,14,7,9,9,4,7,8,6,6,12,11,8,5,10,8,10,12,15,11,10,7,8,6,9,14,10,8,9,8,9,11,6,9,20,10,12,12,12,7,14,9,3,20,13,13,3,2,2,1,1,1,4,2,3,3,3
"3192",82003444,"Peter Byers","10/20/1984 (38 years old)","ST (C)","SAP FC","Antigua and Barbuda Premier Division","ATG","No","6/14/2021","6/30/2024","$0","Right Only","Weak","Very Strong","5'10""","180 lbs","109","40",78,88,3,5,9,14,7,9,11,6,9,5,8,8,6,8,10,8,12,8,7,8,12,9,6,11,6,9,8,10,13,10,16,9,14,14,8,12,5,10,10,11,10,10,10,8,11,7,10,14,12,2,1,1,1,1,1,3,3,3,1,3
"3193",2000090294,"D'Andre Bishop","10/2/2002 (20 years old)","ST (C)","Belišće","Croatian Third League","ATG","No","7/1/2022","6/30/2025","$0","Right","Fairly Strong","Very Strong","6'2""","176 lbs","20","4",75,87,5,3,10,11,12,7,12,8,2,7,6,4,2,9,13,8,5,11,8,11,15,10,9,5,8,7,6,8,12,13,11,10,9,13,11,8,12,15,11,8,13,10,10,14,10,3,12,13,20,4,2,1,2,3,2,1,1,1,2,2
"3194",82073400,"Javorn Stevens","5/9/1998 (25 years old)","AM (RL), ST (C)","Hoppers","Antigua and Barbuda Premier Division","ATG","No","6/15/2020","6/30/2025","$0 - $8K","Right Only","Weak","Very Strong","6'0""","171 lbs","11","-",78,85,6,6,13,13,13,6,9,5,4,6,12,5,3,11,8,12,7,8,5,6,13,12,9,9,5,6,6,8,12,7,9,11,16,12,8,10,9,12,10,9,11,10,6,2,9,4,17,11,16,1,2,2,1,3,2,1,3,1,4,2
"3195",20016305,"Stefan Smith","8/11/1989 (33 years old)","ST (C)","Grenades","Antigua and Barbuda Premier Division","ATG","No","2/1/2019","6/30/2024","$0","Right","Fairly Strong","Very Strong","5'9""","176 lbs","75","28",68,85,5,5,11,13,9,3,6,5,1,5,5,9,1,6,5,12,5,9,6,6,15,13,12,9,6,5,5,6,10,9,11,8,13,9,7,11,12,13,11,14,9,10,8,3,12,4,15,10,12,1,1,2,2,4,3,2,1,3,2,3
"3196",2000122611,"Kendukar Challenger","1/24/1998 (25 years old)","DM, M (C)","All Saints Utd","Antigua and Barbuda Premier Division","ATG","No","7/1/2019","6/30/2025","$0 - $1.5K","Right","Fairly Strong","Very Strong","5'8""","143 lbs","13","2",70,84,6,5,5,5,7,6,6,8,1,10,7,4,10,7,10,9,6,8,8,13,7,5,1,5,10,7,8,8,13,13,7,6,17,13,10,6,15,16,10,11,10,12,6,6,12,1,8,10,19,2,2,3,3,2,3,1,4,2,2,1
"3197",29134275,"Kyjuon Marsh-Brown","12/5/1998 (24 years old)","M/AM (RL)","Concord","English Isthmian League Premier Division","ATG","No","6/1/2023","-","$0","Right","Weak","Very Strong","5'8""","147 lbs","106","13",58,84,2,7,11,7,8,4,6,7,6,7,9,3,5,10,8,8,9,9,7,7,13,13,2,8,7,10,6,8,11,11,8,9,11,13,8,7,12,10,8,9,8,14,4,6,5,5,8,11,7,3,2,4,2,1,1,1,3,1,3,1
"3198",2000090291,"Ronaldo Flowers","3/9/2003 (20 years old)","AM (RL), ST (C)","PS Kemi","Finnish Third Division","ATG","No","1/1/2022","11/30/2024","$4.5K - $45K","Right","Fairly Strong","Very Strong","5'7""","145 lbs","7","-",70,82,3,6,12,9,7,6,6,7,1,5,7,2,4,11,13,8,7,10,7,4,15,13,6,11,6,7,11,12,11,12,10,5,5,11,7,7,12,13,9,9,11,13,5,6,14,2,11,13,14,3,2,2,1,2,2,1,4,2,1,3
"3199",2000205384,"Eugine Kirwan","1/1/1993 (30 years old)","M/AM (C)","Five Islands","Antigua and Barbuda First Division","ATG","No","7/1/2019","6/30/2024","$0 - $3.5K","Right","Reasonable","Very Strong","5'9""","145 lbs","23","-",70,80,5,5,7,8,12,5,5,12,1,6,6,1,6,7,12,9,6,8,4,12,5,8,11,10,6,6,12,11,12,12,6,3,16,12,12,4,13,15,11,12,12,12,15,4,9,1,10,13,13,1,3,1,2,2,1,1,2,2,1,3
"3200",20016310,"Molvin James","5/8/1989 (34 years old)","GK","Tryum","Antigua and Barbuda Premier Division","ATG","No","6/14/2021","6/30/2024","$0","Right","Reasonable","Very Strong","5'9""","149 lbs","39","-",65,80,2,2,3,2,1,3,1,1,1,3,7,3,3,2,14,8,12,6,10,13,4,2,4,3,8,3,5,4,6,11,6,8,16,6,3,5,8,10,13,11,12,11,6,8,5,7,9,9,13,3,9,10,9,6,10,12,5,7,9,11
"3201",2000039000,"Bektur Abdyvaliev","4/29/2003 (20 years old)","M (L), AM (LC)","Dordoy","Kyrgyzstani National League A","KGZ","No","12/31/2022","12/31/2023","$0 - $24K","Left","Very Strong","Fairly Strong","5'9""","143 lbs","44","2",70,108,4,7,12,8,11,6,6,8,6,3,10,4,7,7,12,8,6,6,5,8,17,14,9,8,5,7,5,12,13,12,13,5,13,11,7,3,11,13,10,12,12,10,7,14,11,4,11,12,13,2,2,2,1,3,4,3,2,1,2,2
"3202",2000287409,"Kemoi Williams","1/26/1998 (25 years old)","DM, M (C)","Old Road (ATG)","Antigua and Barbuda Premier Division","ATG","No","6/12/2023","6/30/2025","$1.5K - $4.5K","Right","Weak","Very Strong","5'11""","156 lbs","37","1",71,80,6,6,2,7,13,6,5,8,1,6,9,4,12,10,7,9,8,6,8,13,16,5,4,5,8,7,13,12,13,12,7,6,14,11,12,4,13,19,9,15,12,10,12,4,11,5,13,10,13,3,4,1,1,2,3,2,1,2,3,2
"3203",2000122949,"Leroy Graham","12/7/1999 (23 years old)","D (LC), DM","Five Islands","Antigua and Barbuda First Division","ATG","No","6/15/2020","6/30/2024","$1.5K - $4K","Left","Very Strong","Reasonable","5'9""","149 lbs","-","-",70,80,5,8,5,4,9,6,9,5,3,12,9,4,11,9,7,10,6,8,8,13,4,5,12,7,11,3,9,8,12,14,8,5,13,14,7,6,13,16,10,12,10,11,6,3,15,4,11,10,9,1,2,2,1,3,2,1,2,3,3,3
"3204",82081361,"Denie Henry","5/7/1998 (25 years old)","M/AM (R)","Parham FC","Antigua and Barbuda Premier Division","ATG","No","6/15/2020","6/30/2024","$1.5K - $4K","Right","Weak","Very Strong","5'10""","158 lbs","-","-",70,80,6,9,8,7,11,6,5,7,6,6,12,1,5,10,12,6,4,6,7,10,15,14,13,9,6,7,9,11,13,13,7,4,9,11,6,5,16,18,10,11,10,11,12,10,8,7,14,11,14,3,2,1,3,2,1,1,2,1,1,1
"3205",2000287418,"D'Jarie Sheppard","10/3/2000 (22 years old)","M/AM (C)","Willikies","Antigua and Barbuda Premier Division","ATG","No","1/1/2023","6/30/2024","$0 - $5K","Right","Reasonable","Very Strong","5'7""","136 lbs","-","-",70,80,4,6,8,8,12,1,6,8,1,7,10,4,3,10,12,7,5,11,7,13,8,12,12,10,8,7,13,12,13,13,7,4,10,13,9,1,11,12,12,9,12,10,11,5,14,7,13,11,9,2,2,3,1,3,1,2,1,2,2,4
"3206",2000191695,"Jalmaro Calvin","6/30/2003 (19 years old)","AM (RL), ST (C)","Otto's Rangers","Antigua and Barbuda Premier Division","ATG","No","11/1/2022","6/30/2025","$0","Right Only","Weak","Very Strong","5'10""","154 lbs","9","-",68,79,3,7,12,10,11,2,7,7,5,5,10,7,2,11,5,5,4,11,3,2,14,11,3,4,5,7,7,12,13,13,13,7,10,13,12,3,7,16,10,12,8,12,10,15,8,7,6,12,18,3,2,2,2,2,1,2,1,1,3,3
"3207",2000287412,"Shevorn Phillip","9/9/1996 (26 years old)","D (C), DM, M (C)","Liberta FC","Antigua and Barbuda First Division","ATG","No","1/31/2019","6/30/2024","$0 - $6K","Right","Fairly Strong","Very Strong","5'6""","132 lbs","-","-",73,77,1,5,2,6,10,5,7,7,1,10,7,4,13,8,12,13,8,8,7,13,16,5,13,6,11,7,7,12,13,13,7,1,12,13,9,3,11,12,11,10,12,10,11,5,9,4,9,10,7,3,2,1,3,3,1,3,2,3,2,3
"3208",2000287464,"Whitney Gonsalves","1/7/1999 (24 years old)","M (L), AM (RL)","Tulsa Athletic","NPSL Midwest Region","ATG","No","3/18/2022","-","$0","Left","Very Strong","Weak","5'8""","145 lbs","-","-",70,76,7,11,9,9,9,6,4,7,6,6,8,6,3,11,6,11,7,4,7,12,12,11,12,10,3,7,4,12,13,13,7,6,15,13,7,7,13,10,13,12,10,8,6,13,6,1,10,11,10,3,2,1,2,4,3,3,2,3,2,2
"3209",82073388,"Shavorn Phillip","9/9/1996 (26 years old)","D (C)","Liberta FC","Antigua and Barbuda First Division","ATG","No","6/15/2020","6/30/2024","$0 - $4.5K","Right","Reasonable","Very Strong","6'2""","171 lbs","-","-",72,76,2,1,2,3,2,1,8,4,1,12,4,2,11,5,12,12,8,4,9,12,15,5,4,5,12,5,3,6,12,11,6,12,11,11,6,6,15,12,11,11,11,10,11,14,10,8,20,14,11,1,2,2,3,1,1,2,3,4,1,2
"3210",20028820,"Eugene Kirwan","1/1/1993 (30 years old)","M (R), AM (RL)","Hoppers","Antigua and Barbuda Premier Division","ATG","No","10/1/2020","6/30/2025","$0 - $5K","Right","Reasonable","Very Strong","5'9""","147 lbs","23","-",74,75,8,11,12,12,11,5,6,7,6,6,8,7,3,11,10,7,8,8,5,8,13,12,14,11,4,7,8,12,13,13,7,8,11,13,9,4,12,14,11,9,9,13,11,6,6,5,10,11,8,2,2,1,2,1,1,1,3,1,4,1
"3211",20016308,"Tamarley Thomas","7/28/1983 (39 years old)","M/AM (C), ST (C)","Hoppers","Antigua and Barbuda Premier Division","ATG","No","6/14/2021","6/30/2024","$0","Right","Fairly Strong","Very Strong","6'0""","167 lbs","70","9",75,75,7,8,7,13,11,8,9,10,3,9,12,10,8,14,10,9,9,11,6,12,6,12,11,10,8,9,8,10,7,7,7,9,11,7,7,6,11,17,11,11,10,11,5,6,10,3,8,10,19,2,3,1,3,2,3,1,1,3,2,1
"3212",2000039333,"Mirlan Bekberdinov","8/14/2003 (19 years old)","M (C)","Ilbirs Kant","Kyrgyzstani High League","KGZ","No","3/11/2021","-","$0","Right","Reasonable","Very Strong","5'11""","160 lbs","62","12",68,108,10,5,2,4,12,8,4,12,4,6,12,10,8,11,7,7,6,4,5,12,3,5,4,6,6,6,12,9,12,12,5,9,12,12,8,3,12,18,10,12,12,9,5,8,13,3,8,11,7,2,3,4,2,2,2,3,2,3,1,2
"3213",20016303,"Karanja Mack","8/24/1987 (35 years old)","D/WB/M/AM (L)","Parham FC","Antigua and Barbuda Premier Division","ATG","No","6/14/2021","6/30/2024","$0","Left Only","Very Strong","Weak","6'2""","165 lbs","64","-",67,74,5,10,9,11,11,7,8,7,4,9,10,3,13,9,11,12,8,6,9,15,9,7,15,13,9,8,9,9,8,7,8,11,13,6,6,6,12,14,12,11,11,13,11,6,9,6,11,15,12,3,3,2,3,3,2,2,2,1,2,3
"3214",20016702,"Randolph Burton","1/14/1987 (36 years old)","M (RC), AM (R)","All Saints Utd","Antigua and Barbuda Premier Division","ATG","No","7/1/2020","6/30/2024","$0","Right","Reasonable","Very Strong","5'10""","156 lbs","54","4",72,74,9,13,10,8,12,8,7,7,4,8,11,7,7,13,11,11,3,9,8,14,12,11,10,13,7,8,8,12,9,8,8,5,11,7,7,5,12,16,12,8,13,9,6,8,9,4,19,10,10,1,3,2,3,2,3,4,3,3,2,4
"3215",82081290,"Vashami Allen","5/9/1997 (26 years old)","D (RC)","Grenades","Antigua and Barbuda Premier Division","ATG","No","8/15/2022","6/30/2025","$0 - $6K","Right","Reasonable","Very Strong","6'0""","160 lbs","1","-",74,74,5,10,5,3,6,1,12,1,1,13,6,1,12,6,15,6,9,5,8,13,12,6,10,6,11,6,3,7,13,11,7,6,12,13,9,4,12,11,13,7,9,11,11,12,15,5,13,9,20,3,1,3,2,2,1,2,2,2,3,3
"3216",82073991,"Omarie Joseph","9/6/1988 (34 years old)","GK","Hoppers","Antigua and Barbuda Premier Division","ATG","No","7/1/2019","6/30/2025","Not for Sale","Right","Reasonable","Very Strong","6'2""","174 lbs","-","-",74,74,3,1,1,2,4,7,1,3,2,1,8,1,2,7,8,11,9,4,12,14,5,2,12,3,10,8,7,7,10,6,4,14,11,10,7,6,12,20,10,11,13,13,7,7,9,8,12,14,13,8,6,11,14,6,11,14,5,9,9,14
"3217",82074762,"Novel Francis","3/10/1993 (30 years old)","M/AM (LC)","Empire F.C.","Antigua and Barbuda Premier Division","ATG","No","6/14/2021","6/30/2024","$0","Left","Very Strong","Reasonable","5'6""","132 lbs","-","-",63,73,1,5,5,9,13,4,3,3,5,6,11,4,6,8,11,5,1,7,6,10,11,10,13,8,6,7,6,11,13,13,6,1,13,13,11,1,14,17,13,9,11,13,5,9,11,6,9,12,20,3,3,1,3,1,1,3,3,2,1,4
"3218",2000122987,"Junior Benjamin","8/13/1992 (30 years old)","ST (C)","Otto's Rangers","Antigua and Barbuda Premier Division","ATG","No","6/14/2021","6/30/2024","$0","Right","Reasonable","Very Strong","6'0""","165 lbs","-","-",69,73,4,1,6,12,10,2,7,5,4,4,5,9,1,10,12,8,5,10,3,10,16,12,10,12,5,4,5,6,12,12,5,7,13,12,11,6,9,15,9,12,12,10,11,1,14,1,10,11,9,2,3,1,3,1,1,1,2,3,1,1
"3219",2000090298,"Jamol Stevens","1/11/1995 (28 years old)","D (C), DM","Hoppers","Antigua and Barbuda Premier Division","ATG","No","6/15/2020","6/30/2025","$0 - $5K","Right","Reasonable","Very Strong","5'10""","163 lbs","-","-",70,73,4,1,4,6,7,6,11,7,3,12,8,1,13,6,8,11,9,7,9,8,5,5,13,6,12,6,5,8,10,13,7,4,7,13,10,8,10,16,13,11,14,11,9,4,7,3,9,9,7,2,3,2,1,3,3,1,3,3,3,3
"3220",20016317,"Elvis Thomas","6/2/1994 (29 years old)","ST (C)","SAP FC","Antigua and Barbuda Premier Division","ATG","No","7/1/2019","6/30/2024","$1.5K - $4K","Right","Fairly Strong","Very Strong","5'9""","163 lbs","9","1",68,72,5,6,7,13,13,5,6,1,1,4,6,11,1,9,5,10,7,13,5,8,14,10,3,9,3,5,1,7,13,13,6,5,10,13,12,12,10,16,12,10,11,9,14,17,5,8,10,9,13,1,3,1,4,3,2,3,4,2,2,1
"3221",82074773,"Kieron Richards","6/29/1995 (27 years old)","M (C)","Grenades","Antigua and Barbuda Premier Division","ATG","No","7/1/2022","6/30/2025","$0","Right","Weak","Very Strong","6'1""","176 lbs","11","1",70,72,4,7,5,8,11,7,7,14,1,12,10,3,6,6,5,11,7,6,8,10,11,6,14,10,9,8,12,13,14,12,7,12,7,11,9,10,12,20,11,12,12,12,15,3,5,8,10,10,15,2,2,2,1,1,1,2,4,2,1,2
"3222",2000287462,"Karique Knight","4/3/2005 (18 years old)","M/AM (C)","Garden Stars","Antigua and Barbuda Premier Division","ATG","No","7/1/2022","-","$0","Right","Reasonable","Very Strong","5'11""","147 lbs","-","-",70,72,7,4,5,9,6,4,7,7,2,7,10,6,9,11,13,10,2,6,4,7,12,10,7,9,8,8,9,8,14,14,8,6,11,14,9,5,10,11,13,11,9,14,5,7,5,4,20,8,14,3,3,1,3,3,1,1,1,3,1,1
"3223",72026251,"Andrew Jean-Baptiste","7/16/1992 (30 years old)","D (C)","Valour FC","Canadian Premier League","HAI","No","11/3/2022","11/30/2023","$7K - $65K","Right Only","Weak","Very Strong","6'1""","202 lbs","144","12",94,105,4,6,5,6,8,7,13,8,11,12,9,8,12,8,15,11,15,12,11,11,13,5,15,7,11,14,8,11,11,6,14,16,12,10,11,14,5,7,9,7,10,8,12,7,13,15,13,10,12,1,4,1,2,2,1,2,1,2,2,3
"3224",2000039803,"Irrakhimbek Nurmat uulu","1/27/2003 (20 years old)","M (L), AM (LC)","Neftchi Kochkor-Ata","Kyrgyzstani High League","KGZ","No","3/20/2023","12/31/2023","$1K - $9K","Left","Very Strong","Reasonable","5'7""","134 lbs","53","2",68,107,5,7,8,7,9,5,3,13,5,4,10,2,3,11,12,7,7,10,1,7,7,13,7,9,5,7,6,12,13,13,5,5,13,13,7,1,11,17,13,12,10,11,5,12,6,2,9,12,20,2,1,2,2,3,2,2,3,2,2,1
"3225",29091603,"Reece Beckles-Richards","7/19/1995 (27 years old)","AM (RL), ST (C)","Cheshunt","English Isthmian League Premier Division","ATG","No","7/1/2020","6/30/2024","$0","Right","Weak","Very Strong","6'0""","180 lbs","241","47",55,70,4,5,8,8,12,11,8,4,2,5,10,1,5,7,9,5,3,3,6,6,14,8,12,8,5,4,4,7,12,13,6,9,7,13,12,13,10,19,10,10,10,10,5,6,11,4,10,11,18,2,3,3,3,3,2,3,1,1,3,1
"3226",82073405,"Mervyn Hazelwood","12/6/1991 (31 years old)","D/WB/M/AM (L)","Tryum","Antigua and Barbuda Premier Division","ATG","No","6/14/2021","6/30/2024","$0","Left","Very Strong","Reasonable","5'9""","149 lbs","19","-",66,70,6,10,8,12,9,6,6,8,6,7,9,4,8,9,8,9,7,7,8,11,18,8,12,12,8,6,6,8,14,11,7,8,12,11,7,4,14,20,10,10,12,11,13,7,5,1,10,10,8,1,4,1,3,1,1,1,1,1,3,1
"3227",82081356,"Juwan Roberts","5/22/1994 (29 years old)","DM, M (C)","Swetes FC","Antigua and Barbuda Premier Division","ATG","No","6/15/2020","6/30/2024","$0 - $4.5K","Left","Very Strong","Reasonable","6'1""","180 lbs","-","-",70,70,6,6,2,6,7,6,6,13,3,7,11,1,8,8,8,9,8,8,7,13,5,5,12,7,11,7,11,12,12,9,7,7,11,11,8,12,12,12,15,11,9,10,7,4,10,4,20,10,16,3,4,1,3,1,1,1,2,3,3,3
"3228",82074166,"Shakkimba Williams","10/10/1994 (28 years old)","D (C)","Empire F.C.","Antigua and Barbuda Premier Division","ATG","No","6/15/2020","6/30/2025","$0","Right","Reasonable","Very Strong","6'3""","182 lbs","14","3",52,69,1,1,1,4,3,1,10,2,1,8,6,2,12,5,7,7,8,6,6,8,4,5,10,5,12,5,4,6,13,9,6,11,10,13,11,10,15,15,12,10,11,10,10,4,7,1,9,11,9,3,2,2,3,1,3,2,3,2,1,2
"3229",29047101,"Okeem Challenger","8/22/1989 (33 years old)","ST (C)","SAP FC","Antigua and Barbuda Premier Division","ATG","No","7/1/2018","6/30/2024","$0","Right","Fairly Strong","Very Strong","5'10""","160 lbs","1","3",63,68,4,2,10,14,10,5,14,6,4,5,3,2,6,9,5,8,1,6,7,8,6,8,1,13,7,6,7,7,12,8,7,8,13,9,5,8,11,20,12,11,9,11,12,9,13,2,12,13,17,3,2,3,1,2,2,2,2,3,1,1
"3230",2000232201,"Jajuan Williams","1/24/2001 (22 years old)","WB (L)","Old Road (ATG)","Antigua and Barbuda Premier Division","ATG","No","6/15/2020","6/30/2025","$0","Left","Very Strong","Reasonable","5'9""","149 lbs","-","-",55,66,6,10,5,3,8,1,1,3,3,7,9,1,7,5,9,9,6,2,4,7,2,10,7,7,7,7,7,8,13,10,2,5,13,12,13,6,9,11,10,13,10,11,12,5,10,4,9,10,20,4,2,1,1,1,3,3,2,3,4,2
"3231",13102011,"Ally Samatta","12/23/1992 (30 years old)","ST (C)","Fenerbahçe","Turkish Super League","TAN","No","7/1/2021","6/30/2025","$0","Right Only","Weak","Very Strong","6'0""","169 lbs","384","145",115,130,10,12,12,12,14,9,15,11,6,5,12,15,6,11,18,12,15,8,12,12,12,14,6,14,5,12,11,14,13,14,13,13,14,14,13,12,12,8,10,10,8,9,8,11,10,7,12,16,10,3,3,2,3,1,1,3,2,1,3,4
"3232",2000063047,"Novatus Miroshi","9/2/2002 (20 years old)","D (C), DM, M (C)","Zulte Waregem","Belgian Challenger Pro League","TAN","No","7/1/2022","6/30/2025","$55K - $550K","Left","Very Strong","Reasonable","5'9""","152 lbs","55","1",103,130,10,12,6,5,7,11,8,7,3,10,11,7,12,10,11,12,14,10,11,10,11,11,11,9,12,14,10,14,12,13,11,10,14,13,13,13,14,7,11,11,11,11,14,12,14,6,9,13,14,2,1,2,2,1,2,1,3,3,2,2
"3233",2000078773,"Abdulrazack Hamza","3/23/2003 (20 years old)","DM, M (C)","Mbeya City","Tanzanian Championship","TAN","No","1/1/2023","6/30/2024","$0","Right","Reasonable","Very Strong","5'10""","147 lbs","11","-",75,125,3,6,5,7,9,3,5,8,1,8,11,5,13,13,14,9,8,8,6,13,11,5,4,7,4,7,8,12,13,13,7,6,14,13,13,4,12,10,11,11,10,12,13,6,6,5,12,11,19,2,1,1,3,3,3,1,3,3,4,3
"3234",2000114950,"Denis Nkane","9/30/2002 (20 years old)","M (R), AM (RL)","Young Africans","Tanzanian Mainland Premier Division","TAN","No","7/1/2021","6/30/2025","$100K - $1M","Right Only","Weak","Very Strong","5'8""","147 lbs","33","1",87,122,9,10,12,8,12,9,6,8,6,9,11,8,8,10,9,9,11,9,10,10,12,10,6,11,10,11,9,12,13,12,9,7,16,13,11,7,13,11,11,10,15,12,11,11,11,4,11,11,9,2,3,2,2,3,2,3,1,1,1,3
"3235",2000243075,"Nürtilek Sulaymanov","6/27/2004 (18 years old)","M/AM (C)","Abdysh-Ata","Kyrgyzstani High League","KGZ","No","1/1/2022","12/31/2025","$0","Right","Reasonable","Very Strong","6'0""","152 lbs","-","-",57,106,5,6,11,5,8,6,6,8,5,7,11,2,4,12,9,8,7,7,2,11,18,14,11,12,4,13,14,8,7,13,4,9,13,8,3,4,13,17,9,12,10,9,10,7,8,5,10,11,7,3,1,2,1,3,2,4,2,1,3,2
"3236",13193844,"Dickson Job","12/29/2000 (22 years old)","D (RLC)","Young Africans","Tanzanian Mainland Premier Division","TAN","No","1/11/2021","6/30/2025","$85K - $850K","Right","Weak","Very Strong","5'11""","160 lbs","94","2",101,120,7,8,10,8,10,7,11,8,6,13,12,9,13,12,11,10,10,12,11,12,14,7,10,6,11,12,11,13,12,12,11,10,13,12,12,11,13,15,11,10,10,11,9,11,9,4,11,11,18,3,3,4,1,3,2,3,2,3,3,3
"3237",13102100,"Himid Mao","11/15/1992 (30 years old)","DM, M (C)","Ghazl El-Mahalla","Egyptian Second Division - Group 2","TAN","No","9/30/2021","7/31/2024","$22K - $220K","Right","Reasonable","Very Strong","5'10""","160 lbs","105","4",111,120,9,5,6,7,12,10,10,15,7,11,13,6,12,11,15,14,16,11,10,10,7,5,13,9,12,12,10,14,12,15,11,8,12,15,11,11,13,12,16,11,10,9,9,13,7,6,14,12,10,3,2,3,4,2,2,1,2,1,1,1
"3238",13225025,"Kelvin John","6/10/2003 (20 years old)","ST (C)","Jong Genk","Belgian Challenger Pro League","TAN","No","7/1/2021","6/30/2024","$850K - $1.8M","Right","Weak","Very Strong","5'9""","160 lbs","21","1",95,119,10,9,11,12,10,10,10,11,4,5,10,12,8,11,14,11,12,9,9,9,14,13,7,13,10,9,10,12,14,12,9,10,13,14,10,9,12,20,13,14,12,10,6,12,5,2,13,15,12,1,1,1,3,1,1,3,3,2,3,3
"3239",29162878,"Aishi Manula","9/13/1995 (27 years old)","GK","Simba","Tanzanian Mainland Premier Division","TAN","No","7/20/2022","6/30/2025","$120K - $1.2M","Right","Weak","Very Strong","6'0""","163 lbs","221","-",112,119,4,3,1,3,9,6,3,3,2,1,10,1,2,9,8,13,12,11,11,12,13,2,14,1,10,12,11,11,10,12,11,12,16,9,10,11,12,15,11,10,13,11,11,3,9,7,13,12,11,11,13,15,13,13,11,13,12,12,13,11
"3240",2000120538,"Jimmyson Mwanuke","1/13/2003 (20 years old)","AM (RLC)","Simba","Tanzanian Mainland Premier Division","TAN","No","7/1/2021","6/30/2025","$55K - $550K","Right","Fairly Strong","Very Strong","5'8""","138 lbs","9","-",90,118,9,11,12,10,11,10,8,10,8,5,11,8,4,12,6,8,9,11,8,10,12,10,4,9,4,10,9,12,12,12,9,7,10,12,11,9,10,11,11,11,13,10,8,8,7,1,10,11,10,1,1,3,1,1,3,4,2,3,2,3
"3241",13197704,"Simon Msuva","10/2/1993 (29 years old)","ST (C)","Al-Qadsiah","Saudi First Division League","TAN","No","7/22/2022","6/30/2023","$16K - $160K","Right","Reasonable","Very Strong","5'5""","132 lbs","140","46",113,118,10,7,16,13,10,11,10,11,7,8,7,7,7,14,12,15,5,11,10,10,15,11,12,9,11,7,8,12,13,15,12,8,11,13,12,13,13,14,12,10,9,9,13,8,6,2,12,9,9,1,2,2,3,2,1,3,3,3,1,2
"3242",2000245883,"Omar Abbas Mvungi","8/9/2004 (18 years old)","AM (C), ST (C)","FC Nantes","Ligue 1 Uber Eats","TAN","No","12/11/2022","6/30/2025","$45K - $425K","Left Only","Very Strong","Weak","6'2""","171 lbs","-","-",80,118,7,8,13,14,12,5,10,9,1,6,9,8,5,12,15,9,5,7,8,10,16,11,1,11,8,7,5,9,14,13,4,9,13,14,12,7,9,18,9,12,13,11,11,7,15,7,9,10,12,2,2,2,1,4,1,2,2,3,1,2
"3243",13193851,"Ally Kibwana","11/21/2000 (22 years old)","D (RL), WB (R)","Young Africans","Tanzanian Mainland Premier Division","TAN","No","7/1/2020","6/30/2025","$24K - $250K","Right","Fairly Strong","Very Strong","5'8""","147 lbs","74","1",93,115,12,11,11,6,11,7,10,5,9,11,10,7,11,10,12,10,13,7,10,11,15,10,5,11,11,13,8,15,12,11,9,7,12,12,12,7,13,14,12,8,13,11,12,11,13,2,8,13,17,2,1,3,2,3,1,2,3,3,3,4
"3244",13221652,"Ally Salim Juma","4/19/2000 (23 years old)","GK","Simba","Tanzanian Mainland Premier Division","TAN","No","7/1/2019","6/30/2026","$0 - $45K","Right","Weak","Very Strong","5'11""","160 lbs","6","-",87,115,3,2,3,1,7,7,3,2,3,3,10,3,2,10,6,10,11,9,10,11,13,3,7,3,11,9,7,10,10,10,11,12,11,9,8,12,11,12,12,11,11,12,11,3,5,1,11,10,10,10,12,12,9,11,10,12,7,11,10,12
"3245",29039556,"Adi Yussuf","10/3/1992 (30 years old)","ST (C)","Brackley","Vanarama National League North","TAN","No","12/9/2022","6/30/2024","$0 - $28K","Left Only","Very Strong","Weak","6'1""","174 lbs","299","73",64,115,6,9,9,10,8,5,8,8,4,5,9,11,7,9,11,9,6,8,9,9,12,10,6,10,7,8,7,12,12,11,10,10,11,12,10,11,9,11,9,6,2,8,3,10,3,4,5,12,2,3,3,2,1,2,3,1,3,3,3,2
"3246",2000160244,"Said Datsiev","4/10/2003 (20 years old)","D (RL)","Dordoy","Kyrgyzstani National League A","KGZ","No","1/1/2020","12/31/2023","$0 - $26K","Left","Very Strong","Strong","5'10""","169 lbs","39","-",72,106,2,9,6,4,8,5,11,6,11,12,7,4,11,6,14,10,14,8,9,7,12,7,9,6,10,6,8,13,11,8,9,14,11,10,11,13,14,12,12,11,12,11,5,10,11,7,9,12,9,1,4,1,2,1,1,1,1,1,1,2
"3247",13193848,"Abdul Hamisi","2/26/2001 (22 years old)","AM (L), ST (C)","Azam FC","Tanzanian Mainland Premier Division","TAN","No","7/13/2022","6/30/2024","$45K - $425K","Right Only","Weak","Very Strong","5'10""","154 lbs","75","17",91,115,11,10,12,10,12,10,7,11,4,5,10,10,5,12,6,9,11,12,10,10,14,11,8,13,6,12,10,13,14,9,8,7,9,13,11,6,14,20,12,10,11,12,13,14,7,6,18,11,9,3,1,1,1,1,1,3,1,2,2,1
"3248",13225010,"Mohamed Husseini","1/11/1996 (27 years old)","D/WB/M (L)","Simba","Tanzanian Mainland Premier Division","TAN","No","4/28/2021","6/30/2024","$50K - $500K","Left","Very Strong","Weak","5'7""","147 lbs","205","4",103,115,13,12,11,7,12,5,6,9,9,12,12,9,10,11,11,12,11,12,11,12,16,7,10,10,12,13,12,14,11,13,10,7,12,13,12,11,13,17,12,10,15,12,13,12,10,7,11,9,12,3,2,1,1,2,3,2,1,3,1,2
"3249",13129208,"John Bocco","8/5/1989 (33 years old)","ST (C)","Simba","Tanzanian Mainland Premier Division","TAN","No","6/14/2021","6/30/2024","$26K - $250K","Right","Weak","Very Strong","6'3""","154 lbs","343","135",101,114,7,9,11,14,12,9,13,11,8,6,10,11,7,13,12,14,11,13,12,14,14,12,13,13,6,11,9,13,9,10,13,11,16,10,9,12,12,10,13,11,11,11,8,12,7,3,13,9,11,1,1,2,1,3,3,4,3,3,3,2
"3250",2000112833,"Kibu Denis","4/12/1998 (25 years old)","AM (RLC), ST (C)","Simba","Tanzanian Mainland Premier Division","TAN","No","7/1/2021","6/30/2024","$275K - $800K","Right","Reasonable","Very Strong","5'10""","158 lbs","101","34",105,113,6,8,12,12,11,9,9,10,6,5,10,11,6,11,10,11,8,9,8,12,12,10,7,13,6,12,10,13,13,13,9,9,15,14,12,9,12,18,9,11,11,12,10,9,9,3,11,10,19,4,2,3,1,3,1,1,1,1,3,1
"3251",2000116174,"Issa Abushehe","2/28/2003 (20 years old)","M (RL), AM (RLC)","Arab Contractors","Egyptian Premier League","TAN","No","9/19/2022","7/31/2026","$160K - $1.6M","Left","Very Strong","Reasonable","5'7""","149 lbs","53","4",90,113,9,9,14,8,12,8,5,7,4,5,10,10,4,14,7,8,11,9,10,9,13,15,6,10,5,7,10,10,13,14,7,6,12,13,9,6,10,15,10,13,12,12,5,8,15,2,12,11,17,3,1,2,1,1,1,2,2,3,2,2
"3252",2000098712,"Lusajo Mwaikenda","10/27/2000 (22 years old)","D (C)","Azam FC","Tanzanian Mainland Premier Division","TAN","No","7/1/2018","6/30/2024","$40K - $400K","Right Only","Weak","Very Strong","5'10""","163 lbs","46","-",91,113,4,1,1,3,9,1,12,5,2,11,9,5,14,7,7,10,10,9,8,14,11,5,9,8,14,8,4,9,13,14,9,7,15,14,9,9,14,13,11,12,10,11,5,9,10,5,14,10,15,1,1,3,2,2,2,4,3,2,3,1
"3253",2000239823,"Clement Mzize","1/7/2004 (19 years old)","ST (C)","Young Africans","Tanzanian Mainland Premier Division","TAN","No","7/1/2021","6/30/2025","$16K - $160K","Right","Weak","Very Strong","6'0""","169 lbs","19","5",89,112,7,8,10,12,11,7,11,9,3,5,7,8,5,11,10,12,10,8,9,10,13,11,7,12,8,13,8,14,13,11,12,12,10,12,10,13,7,16,12,12,10,12,11,3,12,5,9,13,20,2,1,1,1,3,3,1,1,3,2,1
"3254",13193855,"Israel Mwenda","3/10/2000 (23 years old)","D/WB (R)","Simba","Tanzanian Mainland Premier Division","TAN","No","7/1/2021","6/30/2026","$14K - $130K","Right","Weak","Very Strong","5'9""","149 lbs","58","3",95,111,13,11,10,8,10,12,8,11,7,10,11,10,11,12,9,10,12,10,9,12,14,9,9,8,11,10,10,12,13,12,10,7,11,12,12,10,12,12,10,11,15,11,12,11,10,4,11,10,12,2,2,3,1,3,3,2,2,4,3,1
"3255",2000098686,"Ashraf Bashiru","12/29/2004 (18 years old)","ST (C)","Azam FC","Tanzanian Mainland Premier Division","TAN","No","7/1/2020","6/30/2024","$0","Right","Reasonable","Very Strong","5'11""","149 lbs","-","-",65,111,5,3,13,13,9,3,7,5,4,4,8,8,2,13,8,12,5,10,6,7,4,13,9,13,4,6,7,11,11,9,4,6,12,10,7,2,11,14,10,11,13,14,6,4,10,7,10,11,10,3,1,1,3,1,2,2,3,1,3,2
"3256",2000130181,"Morice Abraham","8/10/2003 (19 years old)","M/AM (C)","Spartak","Serbian SuperLeague","TAN","No","9/10/2021","6/30/2025","$35K - $100K","Right","Reasonable","Very Strong","5'5""","132 lbs","20","-",80,111,5,5,8,10,12,6,7,10,1,6,10,6,4,12,13,10,8,10,10,12,13,11,4,11,8,8,10,13,12,9,7,8,14,12,12,9,12,11,12,12,12,9,13,9,7,8,9,12,15,1,3,3,2,3,1,1,3,3,2,2
"3257",2000039343,"Islam Mejitov","1/4/2000 (23 years old)","DM, M/AM (C)","Abdysh-Ata","Kyrgyzstani High League","KGZ","No","1/1/2021","12/31/2024","$500 - $7K","Right","Reasonable","Very Strong","5'9""","152 lbs","46","2",72,105,6,6,10,8,13,6,6,7,1,8,13,3,8,11,12,10,8,8,5,12,5,12,1,12,8,7,8,13,12,6,4,8,5,8,14,3,18,18,11,10,11,11,5,3,12,5,10,13,13,2,3,1,2,1,1,1,2,2,1,1
"3258",12022828,"Erasto Nyoni","5/7/1988 (35 years old)","D (C), DM","Simba","Tanzanian Mainland Premier Division","TAN","No","6/14/2021","6/30/2024","$0","Right Only","Weak","Very Strong","5'10""","149 lbs","273","8",95,110,6,8,7,7,11,8,12,6,5,12,10,12,14,9,14,12,14,11,13,14,12,3,14,5,11,12,10,11,9,8,12,11,16,8,9,11,12,5,14,15,14,16,7,16,5,4,15,13,12,3,3,2,2,3,1,2,3,1,2,1
"3259",2000078818,"Pascal Msindo","8/15/2003 (19 years old)","D/WB/M (L)","Azam FC","Tanzanian Mainland Premier Division","TAN","No","7/1/2019","6/30/2024","$26K - $250K","Left","Very Strong","Reasonable","5'9""","132 lbs","24","-",80,110,7,11,4,3,12,7,7,4,5,9,7,1,14,9,12,6,8,6,7,13,5,5,2,7,4,8,9,9,14,10,8,9,15,14,14,5,11,13,11,13,10,13,9,14,12,7,16,10,14,2,1,2,2,2,3,2,2,3,3,3
"3260",29222279,"Feisal Salum","2/2/1997 (26 years old)","M/AM (C)","Azam FC","Tanzanian Mainland Premier Division","TAN","No","1/1/2023","6/30/2026","$30K - $325K","Right","Reasonable","Very Strong","5'10""","149 lbs","139","22",105,110,8,9,12,10,13,11,5,11,3,11,14,10,8,12,7,12,10,13,12,14,16,12,12,8,9,11,12,10,12,11,9,8,15,11,12,9,10,10,12,14,10,15,5,12,6,7,14,8,10,1,1,2,2,1,2,2,1,3,2,1
"3261",13193842,"Nickson Kibabage","10/12/2000 (22 years old)","D/WB (L)","Fountain Gate FC","Tanzanian Mainland Premier Division","TAN","No","12/19/2022","6/30/2024","$24K - $250K","Left","Very Strong","Weak","5'9""","152 lbs","13","1",95,110,11,12,12,9,10,9,7,11,8,10,8,7,9,11,7,12,10,10,11,9,12,6,7,10,11,11,10,11,14,13,12,7,11,13,12,8,16,17,12,11,10,8,9,12,15,3,20,12,10,1,1,1,2,2,3,2,2,3,3,2
"3262",2000136082,"Jackson Kasanzu","1/24/2003 (20 years old)","D (RC), DM","San Diego","USSL Championship Western Conference","TAN","No","8/12/2022","11/30/2024","$120K - $1.2M","Right","Weak","Very Strong","6'2""","158 lbs","16","1",76,110,5,8,9,3,11,9,11,10,3,11,11,5,15,7,11,7,10,14,6,7,10,5,11,9,11,10,9,9,8,10,8,13,7,7,6,10,14,12,10,8,12,9,11,16,12,5,16,13,15,2,1,2,3,3,1,1,2,2,1,1
"3263",2000137285,"Ibrahim Bacca","11/12/1997 (25 years old)","D (RLC)","Young Africans","Tanzanian Mainland Premier Division","TAN","No","1/15/2022","6/30/2024","$160K - $475K","Right","Strong","Very Strong","5'10""","149 lbs","69","2",100,110,5,6,9,5,11,7,12,5,3,11,10,7,14,10,10,13,14,12,12,10,12,5,8,6,12,12,10,12,11,10,11,12,15,11,11,10,7,19,12,12,10,10,5,10,8,3,12,11,11,2,2,3,1,2,3,3,1,1,2,1
"3264",13101880,"Thomas Ulimwengu","6/14/1993 (29 years old)","AM (R), ST (C)","TP Mazembe","DR Congo Premier Division A","TAN","No","1/28/2020","6/30/2025","$0","Right Only","Weak","Very Strong","5'10""","167 lbs","139","35",98,110,7,11,12,14,11,8,9,10,5,8,11,5,9,12,10,8,9,14,8,14,13,12,9,14,8,9,8,10,12,12,9,9,18,12,12,11,9,16,11,10,12,11,5,12,7,6,9,11,10,1,2,3,3,2,2,1,3,3,1,1
"3265",13206241,"Jonas Mkude","12/3/1992 (30 years old)","M/AM (C)","Simba","Tanzanian Mainland Premier Division","TAN","No","6/14/2021","6/30/2023","$0","Left","Very Strong","Reasonable","5'9""","138 lbs","163","7",107,110,12,11,11,8,12,10,9,11,8,9,14,12,8,14,12,11,12,12,10,14,14,7,9,13,12,13,14,9,10,11,12,10,13,10,11,9,15,17,10,10,10,12,7,12,8,1,8,12,20,1,3,1,1,4,3,1,2,1,1,2
"3266",67252797,"Faridi Mussa","6/21/1996 (26 years old)","M (L), AM (RL)","Young Africans","Tanzanian Mainland Premier Division","TAN","No","9/1/2020","6/30/2025","$300K - $900K","Left","Very Strong","Reasonable","5'6""","143 lbs","134","15",104,110,9,10,11,10,13,8,7,10,9,8,13,8,9,11,5,11,9,12,11,13,15,14,11,11,8,12,12,13,12,12,11,8,15,12,12,10,15,12,12,10,14,11,8,10,9,5,11,11,18,1,2,1,1,1,1,3,3,3,1,1
"3267",13229098,"Metacha Mnata","11/25/1998 (24 years old)","GK","Young Africans","Tanzanian Mainland Premier Division","TAN","No","1/16/2023","6/30/2026","$0","Right","Reasonable","Very Strong","6'1""","169 lbs","14","-",93,110,3,1,2,1,4,6,1,2,3,2,7,1,1,6,7,11,11,8,10,13,10,1,11,2,6,8,7,7,12,13,8,13,11,10,7,6,13,16,11,9,11,9,12,10,6,2,12,11,19,8,10,13,10,9,7,13,5,9,9,13
"3268",2000060749,"Artem Pryadkin","9/18/2001 (21 years old)","GK","Dordoy","Kyrgyzstani National League A","KGZ","No","1/8/2023","12/31/2023","$9K - $26K","Right","Fairly Strong","Very Strong","6'2""","178 lbs","22","-",72,105,1,3,3,1,1,1,1,2,1,1,10,3,1,3,10,9,15,6,6,11,10,3,2,1,6,6,3,5,10,10,4,9,13,9,1,4,12,12,10,12,11,12,15,9,7,5,15,14,16,7,5,12,8,7,8,12,5,8,11,12
"3269",2000114138,"Shaban Msala","12/30/1998 (24 years old)","DM, M (C)","Ruvu Shooting","Tanzanian Championship","TAN","No","2/22/2021","6/30/2026","$0","Right Only","Weak","Very Strong","5'10""","158 lbs","-","-",72,110,7,8,5,5,12,7,7,10,4,9,14,5,13,10,15,8,8,9,8,14,19,5,8,14,11,13,4,13,13,10,12,9,10,11,12,6,10,13,11,13,12,9,13,18,7,2,11,12,12,1,3,1,3,2,3,3,1,1,3,1
"3270",13201226,"Shomari Kapombe","1/28/1992 (31 years old)","D/WB (R)","Simba","Tanzanian Mainland Premier Division","TAN","No","4/30/2021","6/30/2023","$0 - $22K","Right","Reasonable","Very Strong","5'11""","149 lbs","220","15",106,110,13,13,11,7,10,9,8,8,9,11,11,8,12,11,13,10,8,11,12,12,12,8,10,9,12,12,13,13,13,12,11,12,15,12,12,11,9,14,12,11,9,11,11,12,11,1,12,10,16,3,2,2,2,1,3,1,1,1,2,1
"3271",2000117512,"Erick Mwijage","11/15/2001 (21 years old)","M/AM (RL)","Kagera Sugar","Tanzanian Mainland Premier Division","TAN","No","8/1/2022","6/30/2024","$0","Right","Reasonable","Very Strong","5'9""","145 lbs","58","8",77,109,8,12,7,9,11,6,6,7,6,6,8,5,7,13,8,4,8,4,7,7,12,13,1,10,6,7,7,12,13,9,7,5,12,13,13,5,12,13,13,11,12,9,9,6,9,1,12,9,10,3,1,2,1,2,2,1,1,3,2,1
"3272",2000088391,"Alfred Laurent","1/20/2002 (21 years old)","D (C)","Azam FC","Tanzanian Mainland Premier Division","TAN","No","7/1/2019","6/30/2024","$0","Right","Reasonable","Very Strong","6'0""","158 lbs","-","-",73,107,1,1,3,3,8,1,9,6,2,14,8,1,14,5,10,7,9,8,7,14,14,5,13,4,11,7,4,8,14,10,8,8,10,13,5,7,12,15,10,11,11,12,8,1,9,5,13,11,16,3,3,2,1,3,2,2,1,3,2,2
"3273",2000123669,"Zuberi Masudi","2/13/2002 (21 years old)","GK","Azam FC","Tanzanian Mainland Premier Division","TAN","No","7/1/2020","6/30/2024","$0","Right","Reasonable","Very Strong","6'1""","165 lbs","4","-",80,107,2,1,2,1,3,6,1,3,3,2,13,1,1,5,5,12,11,7,10,14,7,3,14,2,11,8,7,7,12,8,8,13,12,14,3,6,10,10,14,11,11,10,6,10,6,3,14,12,10,7,9,10,14,9,14,13,12,9,9,7
"3274",2000115917,"Jamal Masenga","11/20/1999 (23 years old)","D (LC), DM","Prisons SC","Tanzanian Mainland Premier Division","TAN","No","1/1/2022","6/30/2025","$0","Left","Very Strong","Reasonable","6'0""","165 lbs","19","1",72,107,5,8,3,1,8,6,13,3,1,10,6,3,11,7,13,8,9,5,7,13,12,6,5,6,12,6,2,8,13,13,7,10,14,11,10,6,17,17,9,11,11,11,13,12,5,2,11,12,8,2,2,2,4,2,3,3,3,2,3,1
"3275",2000121217,"Martin Kiggi","9/10/2001 (21 years old)","DM, M (C)","JKT Tanzania","Tanzanian Mainland Premier Division","TAN","No","7/1/2021","6/30/2025","$0","Right","Reasonable","Very Strong","5'9""","143 lbs","35","1",70,106,7,6,4,7,10,7,7,10,7,8,14,7,13,11,5,8,8,9,9,14,12,5,9,9,12,9,5,13,7,10,9,9,8,10,8,7,15,20,11,11,11,13,6,8,6,4,10,14,18,2,1,2,3,2,4,1,2,3,2,2
"3276",29222277,"Yohana Mkomola","4/18/2000 (23 years old)","ST (C)","Tabora United","Tanzanian Mainland Premier Division","TAN","No","6/12/2023","6/30/2025","$0","Right","Reasonable","Very Strong","5'10""","156 lbs","19","2",85,105,8,8,11,12,13,9,4,11,9,7,11,3,6,12,10,10,5,6,7,3,15,10,8,12,8,6,10,7,15,14,8,7,15,13,10,7,10,16,13,11,14,10,12,12,13,6,12,9,11,3,2,2,3,3,2,1,2,2,2,2
"3277",2000026370,"Frank Magingi","10/14/1999 (23 years old)","D (C)","Namungo","Tanzanian Mainland Premier Division","TAN","No","7/1/2020","6/30/2023","$0","Right Only","Weak","Very Strong","6'1""","169 lbs","17","-",85,105,2,3,5,6,6,1,12,4,1,14,6,6,9,2,7,10,9,6,11,14,1,5,10,7,9,7,1,8,10,13,8,14,12,13,6,6,12,11,12,11,13,8,9,18,9,5,12,12,11,1,1,3,2,1,2,2,2,1,2,3
"3278",2000292222,"Edmund John","12/4/2002 (20 years old)","AM (RL)","Geita Gold","Tanzanian Mainland Premier Division","TAN","No","7/1/2022","6/30/2024","$0","Right","Reasonable","Very Strong","5'8""","143 lbs","-","-",77,105,8,11,10,10,13,6,4,7,7,6,11,4,8,13,6,4,4,6,2,9,8,13,11,13,6,7,4,10,13,13,8,7,15,13,5,5,11,13,11,11,13,13,5,3,11,5,18,11,9,1,1,2,3,2,2,1,3,2,2,2
"3279",2000007980,"Emir Shigaybaev","8/12/2001 (21 years old)","M (C)","Alga Bishkek","Kyrgyzstani High League","KGZ","No","3/30/2023","12/31/2023","$0 - $26K","Right","Reasonable","Very Strong","5'9""","147 lbs","33","-",73,105,7,5,5,7,14,7,7,8,1,9,9,5,6,12,9,10,3,9,8,12,9,5,9,9,9,8,9,13,14,14,8,9,12,14,8,5,10,12,13,10,12,12,8,18,11,3,8,11,19,2,2,3,1,1,2,3,3,3,3,2
"3280",13201241,"Ayoub Lyanga","3/23/1998 (25 years old)","AM (RC)","Azam FC","Tanzanian Mainland Premier Division","TAN","No","8/1/2020","6/30/2024","$0","Right","Reasonable","Very Strong","5'10""","149 lbs","50","10",92,105,7,8,13,10,10,5,4,7,3,4,10,8,8,10,9,10,4,11,8,11,14,10,4,10,4,8,11,8,13,13,8,7,15,13,13,9,18,20,12,9,12,8,12,11,9,3,13,9,17,1,1,2,3,2,3,3,2,1,3,2
"3281",29222289,"Abdallah Shaibu","10/21/1998 (24 years old)","D (C)","Young Africans","Tanzanian Mainland Premier Division","TAN","No","12/5/2019","6/30/2024","$0","Right","Weak","Very Strong","6'2""","171 lbs","2","-",90,105,3,5,9,6,11,6,11,7,8,12,10,8,12,10,14,11,12,10,10,9,15,5,12,7,10,9,11,12,12,11,9,13,13,12,12,11,11,13,11,10,10,11,5,7,5,1,18,13,7,1,3,2,1,2,2,1,4,3,3,1
"3282",2000115913,"Abuutwalib Mshery","2/2/2000 (23 years old)","GK","Young Africans","Tanzanian Mainland Premier Division","TAN","No","1/2/2022","6/30/2024","$20K - $60K","Right","Weak","Very Strong","6'1""","171 lbs","55","-",88,105,4,1,1,2,9,6,8,1,2,2,10,3,3,9,6,11,13,12,10,11,10,2,9,3,11,10,9,10,9,10,9,11,9,9,8,10,13,17,10,12,11,12,7,8,8,4,12,11,7,12,12,11,5,9,9,12,12,11,10,13
"3283",2000078789,"Lucas Kikoti","2/15/2001 (22 years old)","M/AM (C)","Namungo","Tanzanian Mainland Premier Division","TAN","No","7/1/2019","6/30/2024","$0","Right","Reasonable","Very Strong","5'9""","147 lbs","21","2",87,105,3,5,9,11,13,7,7,8,3,8,14,5,7,10,15,8,1,4,8,11,5,9,11,9,9,8,13,9,14,14,8,4,11,14,5,5,14,19,10,10,13,11,12,11,7,4,9,11,14,3,3,1,1,1,1,3,3,1,2,2
"3284",2000098705,"Yusuph Athuman","2/28/2000 (23 years old)","ST (C)","Coastal Union","Tanzanian Mainland Premier Division","TAN","No","7/1/2021","6/30/2025","$0","Right","Reasonable","Very Strong","6'4""","165 lbs","6","-",85,105,6,6,13,13,12,6,8,4,5,4,5,4,1,10,5,13,6,8,7,10,9,10,6,12,7,7,7,12,13,11,9,10,13,12,13,7,9,13,14,9,9,9,5,16,9,2,7,11,7,3,2,3,1,1,4,2,1,3,4,3
"3285",2000134985,"Ahmad Feruzi Teru","2/20/2002 (21 years old)","GK","Simba","Tanzanian Mainland Premier Division","TAN","No","7/1/2020","6/30/2025","$0","Right","Reasonable","Very Strong","6'3""","178 lbs","-","-",81,105,3,3,2,2,1,7,1,3,3,3,8,1,1,3,9,10,13,7,12,13,14,3,10,3,10,7,6,5,12,9,7,15,6,9,1,4,12,18,9,10,12,10,6,9,6,6,12,11,7,6,5,13,13,8,13,8,5,9,10,12
"3286",85096089,"Marco Ilaimaharitra","7/26/1995 (27 years old)","DM, M (C)","Charleroi","Jupiler Pro League","MAD","Yes","1/31/2022","6/30/2024","$600K - $1.7M","Right","Weak","Very Strong","5'10""","158 lbs","275","12",117,130,7,7,8,7,11,9,11,13,8,13,12,13,13,11,12,14,14,11,14,11,12,6,13,14,12,15,11,15,12,13,14,9,15,12,15,14,12,14,12,10,11,15,5,14,12,8,14,12,10,2,1,2,1,3,1,1,2,2,2,2
"3287",49054415,"Rémy Vita","4/1/2001 (22 years old)","D/WB/M (L)","Fortuna Sittard","Eredivisie","MAD","Yes","7/5/2022","6/30/2026","$300K - $3M","Left","Very Strong","Weak","5'7""","132 lbs","78","4",108,130,6,10,13,7,11,7,6,7,7,10,11,6,13,13,7,11,12,11,10,10,12,13,4,12,11,12,10,14,15,14,10,6,13,14,13,8,12,16,15,11,11,12,9,10,4,7,11,13,13,1,3,1,4,2,2,2,2,3,1,2
"3288",48040321,"Rayan Raveloson","1/16/1997 (26 years old)","D (C), DM, M (C)","AJ Auxerre","Ligue 2 BKT","MAD","Yes","8/5/2022","6/30/2025","$2.7M - $5.4M","Right","Weak","Very Strong","6'0""","160 lbs","216","18",118,128,10,11,11,10,14,10,11,12,12,11,14,10,12,13,11,13,12,11,12,12,11,11,10,11,12,12,11,13,12,13,11,11,14,11,13,12,11,9,11,10,9,12,7,10,11,10,11,13,12,3,3,3,1,1,1,3,2,3,2,1
"3289",48036390,"Loïc Lapoussin","3/27/1996 (27 years old)","WB/M/AM (L)","Union SG","Jupiler Pro League","MAD","Yes","6/14/2022","6/30/2025","$500K - $5.2M","Right","Reasonable","Very Strong","5'11""","154 lbs","167","14",126,126,11,13,13,11,15,11,8,11,7,12,14,12,14,14,14,12,13,13,14,13,14,16,12,13,11,12,15,14,12,12,12,10,12,11,14,10,13,7,11,11,10,10,6,12,7,4,14,12,11,1,1,2,4,3,3,3,2,1,1,1
"3290",59132026,"Alexander Mishchenko","7/30/1997 (25 years old)","D (RLC)","Dordoy","Kyrgyzstani High League","KGZ","Yes","6/15/2020","12/31/2023","$0 - $28K","Right","Fairly Strong","Very Strong","5'9""","152 lbs","61","-",95,105,6,11,10,5,11,6,11,8,10,13,11,7,12,10,11,9,12,8,10,12,13,6,13,8,13,15,12,15,13,10,9,8,12,13,11,8,14,19,12,14,12,11,8,14,5,5,10,11,14,1,3,1,2,2,3,3,3,1,1,2
"3291",12040288,"Andria","7/6/1989 (33 years old)","AM (R), ST (C)","Najran","Saudi Second Division Group A","MAD","No","8/31/2022","6/30/2023","$0 - $70K","Right","Weak","Very Strong","5'8""","145 lbs","279","95",110,125,9,10,14,12,14,10,6,12,3,4,11,11,4,15,9,13,10,13,11,12,13,13,6,13,4,11,11,13,14,14,7,8,9,14,10,8,7,15,15,12,10,12,10,11,6,7,13,14,14,2,3,2,1,3,3,1,4,2,1,1
"3292",85116741,"Kenji-Van Boto","3/7/1996 (27 years old)","D/WB (L)","AJ Auxerre","Ligue 2 BKT","MAD","Yes","6/15/2020","6/30/2025","$0","Left Only","Very Strong","Weak","6'1""","156 lbs","114","2",108,124,8,12,10,7,11,7,11,7,10,13,11,8,12,12,14,11,13,12,11,10,11,9,7,12,9,12,7,13,14,12,10,12,14,15,13,13,11,12,9,13,10,14,7,12,12,1,12,12,20,1,1,3,1,3,3,2,4,1,1,4
"3293",13101893,"John Baggio","12/19/1991 (31 years old)","AM (RLC)","Sukhothai","Thai League","MAD","No","12/19/2022","6/30/2025","Not for Sale","Right","Weak","Very Strong","5'1""","123 lbs","196","61",112,121,7,10,14,11,13,11,5,10,5,3,10,11,7,13,5,13,13,12,11,12,14,14,3,13,4,11,10,12,14,14,8,6,12,14,12,8,2,18,10,15,12,11,9,11,9,4,14,12,18,2,1,3,4,1,2,1,2,1,3,2
"3294",2000305698,"Mathis-Tahiry Andrianaivo Mahefa","7/23/2007 (15 years old)","D/WB (L)","OM","Ligue 1 Uber Eats","MAD","Yes","7/1/2021","6/30/2027","$250K - $2.6M","Left Only","Very Strong","Weak","5'9""","130 lbs","-","-",70,120,6,13,2,5,12,2,9,5,7,5,9,4,10,10,9,6,9,7,9,15,15,5,1,7,6,9,8,9,15,15,5,5,15,15,6,7,6,12,13,8,12,10,5,14,8,6,10,13,7,3,1,3,2,2,4,2,2,1,1,3
"3295",85006430,"Jérôme Mombris","11/27/1987 (35 years old)","D/WB (L)","Afa F.A","French Regional 1 - Corse","MAD","Yes","6/12/2023","-","$0","Left","Very Strong","Weak","5'10""","158 lbs","421","9",90,116,6,12,10,6,11,7,9,10,11,12,11,6,11,11,9,12,12,11,12,11,14,8,10,12,12,13,10,12,10,10,12,7,14,10,11,12,10,14,14,13,12,13,5,14,9,6,12,13,11,2,3,4,3,2,2,3,3,2,2,2
"3296",85005080,"Faneva Andriatsima","6/3/1984 (39 years old)","ST (C)","FC Riomois","French Regional 1 - Auvergne Rhône Alpes - Group A","MAD","Yes","7/1/2022","-","$0","Left Only","Very Strong","Weak","6'0""","163 lbs","361","90",90,116,5,9,11,10,11,8,13,12,6,5,10,13,3,10,9,12,12,11,10,9,11,12,8,12,6,13,10,11,11,11,13,13,12,10,12,13,8,12,10,14,8,10,8,13,9,8,11,12,13,2,4,1,2,1,2,3,2,1,2,1
"3297",2000035966,"Titouan Fortun","1/28/2004 (19 years old)","D/WB (L)","FC Nantes","French National 3 - Group D","MAD","No","5/30/2022","6/30/2024","$110K - $1.1M","Left Only","Very Strong","Weak","5'7""","147 lbs","-","-",84,116,6,12,9,6,10,4,10,7,6,11,11,9,12,11,10,6,10,8,7,11,4,5,2,9,9,10,7,10,15,13,10,7,12,13,8,8,10,17,10,12,12,11,5,10,13,6,12,11,11,1,1,3,2,2,3,2,2,2,1,2
"3298",85040607,"Thierry Ratsimbazafy","9/21/1986 (36 years old)","M/AM (R)","Nonthaburi Utd","Thai League Three Bangkok Perimeter Region","MAD","No","6/14/2021","6/30/2024","$1K - $12K","Right Only","Weak","Very Strong","5'7""","127 lbs","80","12",80,115,5,10,8,6,11,7,7,8,7,7,14,5,7,11,9,13,12,8,8,14,14,11,11,13,9,8,9,14,9,13,8,5,15,13,15,5,14,10,9,10,9,12,9,9,6,1,20,13,7,1,3,1,1,1,2,2,1,3,2,2
"3299",49060916,"Mathyas Randriamamy","4/23/2003 (20 years old)","GK","Paris SG","French Regional 1 - Paris Ile de France - Group A","MAD","Yes","8/16/2021","6/30/2024","$0","Right Only","Weak","Very Strong","6'1""","207 lbs","1","-",80,115,3,1,3,3,5,4,1,2,1,3,8,3,2,7,15,11,15,6,11,13,7,2,9,3,10,8,7,7,9,7,3,14,18,8,3,13,11,17,11,11,11,12,5,15,8,7,11,12,15,10,14,12,5,8,10,14,5,11,9,12
"3300",29114961,"Dorian Bertrand","5/21/1993 (30 years old)","AM (RL)","FC Argeş","Romanian Second League","MAD","Yes","6/15/2022","6/30/2024","$275K - $800K","Left","Very Strong","Weak","5'9""","143 lbs","199","26",91,115,9,10,13,7,12,6,6,10,3,4,10,8,4,14,3,10,7,8,7,8,10,10,7,10,9,9,13,8,13,13,10,8,9,13,12,9,10,12,11,9,10,13,2,9,3,11,8,9,9,3,2,1,1,1,3,3,3,3,1,2
"3301",2000039801,"Elaman Akylbekov","8/11/2003 (19 years old)","D (RC)","Alay","Kyrgyzstani High League","KGZ","No","3/27/2023","12/31/2023","$8K - $24K","Right","Reasonable","Very Strong","5'9""","145 lbs","39","2",65,105,4,9,3,1,7,2,6,4,6,11,8,1,13,7,11,10,9,7,12,9,11,5,9,5,14,7,7,8,8,13,8,8,15,13,7,5,10,14,12,11,9,10,6,5,10,3,8,13,8,2,2,4,1,2,1,3,3,1,2,2
"3302",85070599,"Fabien Boyer","4/12/1991 (32 years old)","D (C)","AS Excelsior","Réunion Regional 1","MAD","Yes","2/18/2021","12/31/2024","Not for Sale","Left Only","Very Strong","Weak","6'2""","176 lbs","109","3",90,110,4,7,7,6,10,6,12,10,6,12,9,6,11,10,11,12,12,11,10,10,14,6,7,6,12,12,10,10,9,11,15,13,14,12,12,13,10,12,14,14,13,9,9,10,11,7,10,12,7,2,2,1,2,1,3,1,3,3,1,1
"3303",2000024573,"Ehsan Kari","5/17/2002 (21 years old)","D (C), DM","Nîmes","French Regional 1 - Occitanie - Group A","MAD","Yes","8/26/2022","6/30/2024","$150K - $450K","Right Only","Weak","Very Strong","6'2""","176 lbs","-","-",73,105,4,7,3,7,12,3,9,6,1,14,9,5,12,9,15,12,8,7,12,14,15,5,13,7,7,13,8,13,8,9,8,8,12,7,9,5,16,15,8,10,11,9,11,11,14,7,10,10,18,2,3,3,3,3,2,3,3,2,2,2
"3304",18089548,"Melvin Adrien","8/30/1993 (29 years old)","GK","Thonon Evian Grand Geneve","French National 2 - A","MAD","Yes","7/1/2022","6/30/2024","$20K - $200K","Right Only","Weak","Very Strong","6'0""","185 lbs","141","-",91,105,3,3,3,2,9,4,7,2,2,1,7,3,2,9,12,12,13,7,10,13,13,1,7,2,11,8,7,7,10,16,10,11,5,9,11,10,11,10,12,11,13,12,11,12,12,3,12,9,20,8,9,10,14,10,9,11,5,10,9,9
"3305",2000287463,"El Hadary Raheriniaina","8/19/2006 (16 years old)","M (C)","St. Michel Utd","Seychellois First Division","MAD","No","1/1/2023","6/30/2026","$0","Right","Reasonable","Very Strong","5'10""","143 lbs","-","-",70,104,7,7,7,6,13,7,7,8,1,9,13,2,4,8,6,5,8,7,3,10,3,10,11,5,7,8,11,9,14,8,8,6,7,12,12,5,9,10,10,13,14,12,14,4,7,3,17,11,8,3,3,4,1,1,1,1,3,3,2,3
"3306",13234219,"Arnaud Randianantenaina","1/3/2001 (22 years old)","ST (C)","El Gouna","Egyptian Premier League","MAD","No","1/31/2022","6/30/2024","$8K - $80K","Right","Reasonable","Very Strong","5'10""","158 lbs","26","-",87,104,7,8,14,14,14,7,14,8,4,5,8,6,3,13,6,9,4,5,8,5,5,12,2,8,8,7,6,8,14,14,8,9,14,14,13,10,13,19,10,11,10,12,8,7,12,5,20,11,17,2,4,1,3,3,1,1,3,2,3,1
"3307",2000177616,"Iroy Eckenfelder","4/22/2002 (21 years old)","AM (RL)","FC Annecy","French Regional 1 - Auvergne Rhône Alpes - Group C","MAD","Yes","6/13/2022","6/30/2025","$20K - $190K","Left","Very Strong","Reasonable","5'9""","158 lbs","7","-",77,102,8,13,12,9,12,6,5,5,7,7,12,3,7,12,12,7,8,7,7,7,12,10,12,11,7,8,6,13,12,11,14,4,9,12,9,8,10,17,11,13,11,12,5,12,14,2,10,14,10,3,2,1,1,4,2,1,4,2,2,2
"3308",48044369,"Alexandre Ramalingom","3/17/1993 (30 years old)","ST (C)","CS Sedan Ardennes","French Regional Divisions","MAD","Yes","9/14/2020","6/30/2025","$140K - $425K","Right","Weak","Very Strong","5'10""","176 lbs","172","62",97,102,6,6,11,12,14,8,12,8,1,8,6,6,2,9,13,13,6,10,9,12,16,8,9,14,6,8,8,9,14,14,9,6,12,14,13,13,11,13,12,10,7,10,12,1,10,4,12,12,7,3,2,2,1,3,2,1,1,1,3,4
"3309",13160669,"Njiva Rakotoharimalala","8/6/1992 (30 years old)","M/AM (RL)","Al-Jandal","Saudi First Division League","MAD","No","8/12/2022","6/30/2024","$0","Right","Weak","Very Strong","5'10""","154 lbs","54","28",90,100,6,10,13,12,12,6,9,8,6,3,11,10,8,12,6,11,12,11,10,12,5,13,4,11,4,10,12,11,11,11,8,9,13,11,12,9,11,20,11,12,10,11,6,12,15,8,13,12,19,2,3,4,3,2,3,2,2,3,1,2
"3310",85093467,"Héry Randriantsara","1/22/1995 (28 years old)","M (L), AM (LC)","Tarbes Pyrénées Football","French Regional 1 - Occitanie - Group C","MAD","No","7/1/2020","-","$0","Left Only","Very Strong","Weak","5'3""","130 lbs","76","4",76,100,9,13,10,7,10,7,4,10,8,5,10,4,4,11,6,10,9,10,8,10,10,13,8,14,8,10,10,10,10,10,8,2,5,10,14,5,10,14,12,12,10,13,12,6,11,7,20,13,19,2,3,2,2,4,2,1,2,3,2,1
"3311",65042348,"Dax","4/21/1991 (32 years old)","M (C)","Fosa Juniors","Madagascar Orange Pro League - Conference Nord","MAD","No","7/1/2021","12/31/2023","$0 - $9K","Right","Reasonable","Very Strong","5'10""","160 lbs","37","3",85,100,8,6,9,6,11,8,7,11,4,10,12,2,9,11,7,7,11,10,10,12,2,7,11,8,10,12,6,11,13,10,12,8,11,12,14,8,13,13,15,11,8,11,6,7,9,6,10,12,19,3,1,1,2,2,3,1,1,2,2,1
"3312",59132032,"Atay Dzhumashev","9/15/1998 (24 years old)","AM (RL)","Abdysh-Ata","Kyrgyzstani High League","KGZ","No","3/27/2023","12/31/2024","$0 - $50K","Right Only","Weak","Very Strong","5'9""","167 lbs","84","30",95,105,8,12,12,13,11,8,8,9,5,7,12,9,6,14,9,10,8,12,10,12,14,13,4,14,9,9,10,10,14,14,9,9,13,14,7,6,14,17,13,14,11,11,8,5,6,3,11,12,10,3,2,3,1,1,3,2,2,1,2,1
"3313",2000187198,"Solonaina Avizara","2/28/2000 (23 years old)","D (L)","Fosa Juniors","Madagascar Orange Pro League - Conference Nord","MAD","No","6/15/2020","12/31/2023","$0","Left","Very Strong","Reasonable","6'6""","202 lbs","-","-",75,100,5,13,5,2,6,2,8,4,7,8,7,1,14,8,11,7,9,6,9,14,8,7,5,7,11,8,5,9,11,7,8,16,5,10,13,10,13,18,12,11,11,12,10,8,6,3,13,12,13,1,2,3,1,1,3,3,1,2,3,1
"3314",85145335,"Hakim Abdallah","1/9/1998 (25 years old)","ST (C)","RE Virton","Belgian First National Amateur Division","MAD","Yes","7/1/2022","6/30/2025","$0","Right","Weak","Very Strong","6'0""","169 lbs","106","38",98,100,6,10,11,13,11,8,11,12,4,5,11,12,7,12,9,11,9,11,10,10,8,12,5,10,7,8,11,8,13,13,13,13,8,13,9,12,5,13,13,13,7,10,7,10,8,6,8,8,6,2,2,2,2,3,1,2,2,1,3,2
"3315",23084653,"Guy Hubert","8/25/1979 (43 years old)","D (RC), DM, M (RC)","Nonthaburi Utd","Thai League Three Bangkok Perimeter Region","MAD","No","2/1/2019","6/30/2024","$10K - $35K","Right","Fairly Strong","Very Strong","5'9""","160 lbs","199","15",80,99,8,10,10,5,10,5,12,10,10,11,10,7,11,10,9,11,10,10,9,10,16,8,10,6,9,12,6,10,10,8,12,10,13,10,9,9,16,19,11,10,11,10,5,11,9,2,11,10,15,3,3,1,3,2,3,1,3,3,1,2
"3316",49040510,"Nomena Andriantiana","2/6/2000 (23 years old)","D (C)","Aubagne FC","French National 2 - A","MAD","Yes","7/1/2022","6/30/2024","$0 - $100K","Right","Reasonable","Very Strong","5'11""","149 lbs","32","1",81,97,2,6,1,4,8,1,10,6,1,13,8,2,14,3,12,8,9,8,7,14,5,5,6,6,13,7,3,8,13,11,10,10,12,13,10,7,13,13,12,10,12,13,11,3,10,8,20,12,13,1,2,3,1,4,3,2,2,2,1,1
"3317",49048513,"Thierno Millimono","8/16/2002 (20 years old)","D (LC), DM","Besançon Foot","French National 3 - Group J","MAD","Yes","9/30/2022","6/30/2024","$20K - $65K","Left","Very Strong","Reasonable","5'10""","156 lbs","15","-",70,96,4,7,5,4,6,6,13,6,1,13,5,1,11,6,12,8,9,7,9,13,12,5,9,6,11,6,5,8,11,9,7,5,15,10,5,6,12,14,9,9,13,12,7,1,12,3,17,10,15,3,1,3,3,2,2,1,1,4,3,1
"3318",13183268,"André Todisoa","3/7/2000 (23 years old)","M (C)","Fosa Juniors","Madagascar Orange Pro League - Conference Nord","MAD","No","7/1/2020","12/31/2023","$0","Right","Reasonable","Very Strong","5'7""","138 lbs","-","-",70,95,6,7,7,9,14,7,5,9,6,9,10,4,7,13,15,7,6,8,7,10,12,8,13,9,8,13,14,9,9,9,12,4,14,9,8,3,13,20,12,12,11,12,12,17,7,5,12,10,12,3,1,3,1,1,3,3,3,1,2,2
"3319",2000084693,"Lolody","1/22/1985 (38 years old)","D (LC)","Fosa Juniors","Madagascar Orange Pro League - Conference Nord","MAD","No","6/14/2021","12/31/2023","$0","Left","Very Strong","Weak","5'9""","158 lbs","-","-",80,95,3,10,3,8,10,1,15,5,8,14,8,8,15,9,9,9,9,9,10,15,17,5,5,8,9,9,8,9,8,8,8,8,12,8,8,8,10,17,12,11,11,11,5,2,9,7,11,12,14,1,1,3,2,2,2,1,3,2,1,3
"3320",2000187200,"Tsilavina Fanomenzantsoa","7/21/1999 (23 years old)","ST (C)","Fosa Juniors","Madagascar Orange Pro League - Conference Nord","MAD","No","6/15/2020","12/31/2023","$0","Right","Fairly Strong","Very Strong","6'0""","160 lbs","-","-",77,95,6,5,10,13,13,6,13,5,1,2,7,8,1,10,15,9,5,7,4,9,16,10,10,8,7,6,7,7,13,13,7,9,16,13,6,7,13,15,12,8,10,14,7,2,12,3,19,10,8,2,3,3,3,1,3,2,2,1,2,3
"3321",13177806,"Rojo Andriamanjato","8/11/1992 (30 years old)","ST (C)","Ajesaia","Madagascar Orange Pro League - Conference Nord","MAD","No","3/4/2022","12/31/2023","$0 - $9K","Right","Reasonable","Very Strong","6'0""","165 lbs","-","-",85,93,6,5,13,13,13,6,11,7,1,5,7,9,1,10,12,7,8,9,7,8,8,10,3,12,6,6,5,8,13,10,7,10,16,13,13,7,13,10,13,13,13,10,14,7,13,5,13,10,11,1,1,3,2,2,1,2,3,2,3,1
"3322",12076013,"Ando Rakotondrazaka","9/25/1987 (35 years old)","D (C), DM","ASSM","Madagascar Orange Pro League - Conference Sud","MAD","No","7/1/2021","12/31/2023","$0","Right","Reasonable","Very Strong","5'10""","163 lbs","-","-",70,90,2,5,3,1,9,5,14,6,2,14,9,1,9,8,15,14,8,6,11,11,17,5,4,7,14,7,6,9,9,9,8,5,12,8,9,9,12,15,12,11,12,14,12,8,5,7,13,9,11,1,3,2,1,1,1,2,2,2,1,3
"3323",2000039337,"Maksat Alygulov","12/21/2000 (22 years old)","ST (C)","Alga Bishkek","Kyrgyzstani High League","KGZ","No","1/30/2023","12/31/2023","$12K - $35K","Right","Reasonable","Very Strong","5'11""","165 lbs","61","29",85,105,6,5,10,13,10,6,14,4,1,5,7,11,3,11,11,7,11,9,5,11,15,10,6,12,7,6,7,7,10,12,12,11,14,14,9,13,12,11,14,14,10,7,10,15,6,3,20,8,17,3,1,1,3,3,2,3,1,3,4,1
"3324",85051590,"Sylvio Ouassiero","5/7/1994 (29 years old)","D (RL), WB (R)","Dudelange","Luxembourg National Division","MAD","Yes","7/1/2022","6/30/2023","$0","Right","Weak","Very Strong","5'9""","145 lbs","135","3",82,90,8,8,12,8,12,9,7,7,6,5,10,7,6,13,6,10,9,10,10,10,12,12,5,10,6,8,9,11,14,10,12,8,11,13,11,9,15,20,10,14,11,13,12,6,9,12,10,12,14,3,3,1,1,3,3,1,1,2,1,3
"3325",2000084692,"Théodin Ramanjary","8/16/1996 (26 years old)","D (C)","Fosa Juniors","Madagascar Orange Pro League - Conference Nord","MAD","No","6/15/2020","12/31/2023","$0 - $14K","Right","Reasonable","Very Strong","6'2""","167 lbs","-","-",80,90,1,4,1,1,7,1,10,1,1,13,5,1,11,3,11,8,4,7,8,13,11,5,5,5,13,6,2,7,13,13,7,13,18,13,11,6,13,10,11,10,13,12,6,3,10,4,9,12,13,3,3,1,3,1,3,1,3,1,3,3
"3326",85057772,"Dimitry Caloin","5/8/1990 (33 years old)","DM, M (C)","ESA Brive","French Regional 1 - Nouvelle Aquitaine - Group B","MAD","Yes","7/1/2022","-","$0","Right Only","Weak","Very Strong","6'4""","202 lbs","180","12",83,90,5,7,11,8,12,8,13,9,5,6,11,10,10,12,10,11,12,9,10,11,12,11,13,10,10,12,11,12,11,11,14,16,14,8,12,14,7,15,12,13,10,13,7,13,8,8,13,12,12,3,3,2,1,3,2,3,2,2,3,1
"3327",85100027,"Zout","4/22/1994 (29 years old)","M (R), AM (RL), ST (C)","FC Bălți","Moldovan Divizia Naţională","MAD","Yes","10/17/2021","12/31/2024","$14K - $140K","Right Only","Weak","Very Strong","5'10""","158 lbs","121","13",85,90,10,10,11,7,11,10,6,11,9,5,11,11,7,12,8,11,11,11,11,11,12,11,9,11,11,11,10,8,11,11,10,9,14,11,10,7,12,14,14,15,12,13,10,13,8,6,13,12,16,3,3,1,1,3,1,2,2,4,1,1
"3328",2000124930,"Lalaïna Manampisoa","4/5/1996 (27 years old)","D (RL)","CS-DFC","Madagascar Orange Pro League","MAD","No","7/1/2020","12/31/2023","$0","Left","Very Strong","Reasonable","5'7""","141 lbs","-","-",75,90,4,11,3,5,12,2,9,1,8,10,8,7,14,10,15,12,9,7,13,10,15,7,12,6,10,9,7,9,13,9,9,8,7,13,11,4,16,18,10,12,12,11,11,9,14,7,17,12,7,1,2,3,2,3,3,1,2,1,3,2
"3329",2000242077,"Solomampionona Razafidranaivo","3/25/2000 (23 years old)","M (RLC), AM (RL)","CFF Andoharanofotsy","Madagascar Orange Pro League - Conference Sud","MAD","No","7/1/2021","12/31/2023","$0","Left","Very Strong","Reasonable","5'7""","141 lbs","-","-",70,90,5,9,6,10,11,6,5,8,4,4,13,7,4,13,13,6,11,8,7,13,9,14,5,7,4,7,9,8,12,10,6,4,14,12,4,5,13,13,13,9,13,12,12,9,12,7,18,10,20,1,2,3,1,3,1,3,3,4,1,1
"3330",50053206,"Enzo Bovis","4/23/1994 (29 years old)","D (R)","FC Fleury 91","French National 2 - D","MAD","Yes","7/1/2022","6/30/2024","$12K - $120K","Right Only","Weak","Very Strong","6'5""","189 lbs","121","1",85,89,6,13,6,6,10,4,10,2,8,9,9,4,9,9,15,13,10,9,9,11,6,5,5,7,9,9,7,9,15,11,9,18,12,11,10,10,11,16,11,12,7,10,6,9,9,1,10,9,7,3,3,1,2,4,2,2,3,3,1,1
"3331",2000144641,"Davidson Guéguen","9/24/2004 (18 years old)","D (C)","Laval MFC","Ligue 2 BKT","MAD","Yes","7/1/2021","6/30/2024","$30K - $95K","Right Only","Weak","Very Strong","6'3""","165 lbs","-","-",65,89,1,6,1,1,5,3,10,4,2,12,6,1,15,7,12,7,9,6,10,15,15,5,2,5,7,7,6,8,9,7,8,14,10,9,6,8,10,16,10,13,10,10,12,13,10,3,8,11,10,1,2,3,4,1,1,1,1,3,1,1
"3332",13160931,"Dina Razanakoto","6/12/1992 (30 years old)","M (C)","SS Jeanne d'Arc","Réunion Regional 1","MAD","No","7/1/2018","12/31/2023","$0","Right","Fairly Strong","Very Strong","5'10""","149 lbs","36","8",78,88,7,6,3,6,13,7,7,9,1,12,14,1,10,11,9,8,6,8,6,14,4,5,7,8,9,8,9,12,6,11,6,8,15,9,8,10,13,14,12,8,9,12,12,6,5,1,17,12,10,2,1,1,3,2,2,3,2,1,1,1
"3333",8445898,"Juvet Tsiarovana","10/25/1987 (35 years old)","D/WB (L)","AS Saint-Louisienne","Réunion D2 Regionale","MAD","Yes","1/3/2020","12/31/2023","$0","Left Only","Very Strong","Weak","5'10""","145 lbs","116","2",65,88,9,9,9,5,9,6,6,6,10,5,7,9,6,10,8,8,10,9,7,6,13,11,6,9,6,10,8,11,13,11,10,8,13,11,10,6,10,15,15,8,12,8,8,13,8,6,12,9,12,4,2,4,4,2,1,3,1,3,2,4
"3334",48034660,"Bryan Alceus","2/1/1996 (27 years old)","DM, M/AM (C)","FC Argeş","Romanian Second League","HAI","Yes","7/1/2022","6/30/2024","$60K - $600K","Right Only","Weak","Very Strong","5'9""","165 lbs","108","-",99,105,9,8,12,5,12,8,7,8,8,11,12,6,12,11,13,11,14,10,11,10,12,12,12,12,12,14,11,14,12,13,13,8,12,12,13,11,10,12,13,12,10,10,7,9,9,1,9,12,13,1,3,3,2,1,3,1,3,1,3,2
"3335",2000139143,"Umar Madaminov","4/12/2005 (18 years old)","ST (C)","Ilbirs Kant","Kyrgyzstani High League","KGZ","No","1/1/2021","12/31/2023","$0 - $2K","Right","Reasonable","Very Strong","5'10""","154 lbs","26","1",60,104,2,4,6,13,11,3,11,4,2,3,6,9,2,7,10,6,7,11,5,7,3,7,9,13,5,5,6,6,13,13,6,8,7,13,5,5,10,14,11,11,11,10,11,3,11,7,9,11,18,2,1,2,2,3,1,1,1,2,2,4
"3336",2000089079,"Razakanirina Rakotoasimbola","10/14/1999 (23 years old)","GK","ASSM","Madagascar Orange Pro League - Conference Sud","MAD","No","1/1/2022","12/31/2023","$0","Right","Reasonable","Very Strong","6'4""","182 lbs","-","-",73,88,4,2,2,2,4,5,1,1,2,2,9,4,1,5,6,11,9,7,6,13,10,2,12,2,9,7,6,6,10,7,7,13,14,5,3,6,8,18,11,11,12,11,15,3,7,3,9,11,9,8,13,12,12,8,9,13,9,10,7,13
"3337",48049930,"Yvan Aly","4/10/2003 (20 years old)","ST (C)","SO Cholet","French Regional 1 - Pays de la Loire - Group A","MAD","Yes","7/1/2021","6/30/2024","$0 - $55K","Right","Reasonable","Very Strong","5'11""","163 lbs","-","-",68,88,1,3,13,14,14,4,13,3,2,5,7,7,1,13,11,7,5,9,5,7,5,12,12,14,6,6,7,7,10,9,7,11,15,9,8,7,10,15,11,11,8,9,11,17,5,4,19,11,20,3,2,1,4,4,3,2,2,1,3,2
"3338",2000311874,"Zaid Seha","1/25/2007 (16 years old)","M (C)","AJ Auxerre","Ligue 2 BKT","MAD","Yes","6/12/2023","6/30/2026","$45K - $450K","Either","Very Strong","Very Strong","5'10""","136 lbs","-","-",63,87,5,4,4,4,11,1,2,7,2,8,10,5,8,13,15,5,6,7,6,11,6,8,9,3,3,7,9,11,13,11,6,10,13,10,6,3,10,14,9,10,12,12,5,12,12,3,9,11,13,3,2,1,3,2,4,2,1,3,2,1
"3339",13183267,"Andry","1/6/2000 (23 years old)","D (C)","Fosa Juniors","Madagascar Orange Pro League - Conference Nord","MAD","No","7/1/2018","12/31/2023","$0","Right","Reasonable","Very Strong","6'1""","160 lbs","-","-",75,87,1,5,3,1,7,1,12,1,1,12,7,1,8,6,8,13,9,5,8,13,3,5,7,6,13,6,1,7,12,12,7,10,16,10,4,4,14,12,13,11,12,10,8,1,11,1,12,8,14,2,1,1,2,3,4,1,4,2,1,1
"3340",85138711,"Ferdinand Ramanamahefa","11/22/1991 (31 years old)","AM (C)","Voltigeurs Châteaubriant","French National 2 - C","MAD","No","7/1/2022","6/30/2024","$2K - $22K","Right Only","Weak","Very Strong","5'7""","160 lbs","126","29",78,86,3,7,6,10,11,6,9,10,3,8,12,3,3,12,6,11,8,8,10,12,18,12,7,11,5,9,15,10,13,11,11,6,12,12,8,8,13,14,14,13,11,13,5,6,5,6,16,15,12,3,2,2,2,1,3,3,2,3,1,2
"3341",2000242080,"Lalaina Rafanomezantsoa","3/10/1998 (25 years old)","M/AM (C)","CFF Andoharanofotsy","Madagascar Orange Pro League - Conference Sud","MAD","No","7/1/2019","12/31/2023","$0","Right Only","Weak","Very Strong","5'7""","134 lbs","-","-",77,85,6,3,8,8,13,6,6,10,1,8,13,2,7,11,11,7,8,7,8,11,9,11,4,8,10,7,10,12,13,13,7,3,13,13,11,1,14,17,10,10,10,11,6,4,5,8,7,11,16,1,2,3,2,3,2,2,3,3,4,2
"3342",27014234,"Jóan Símun Edmundsson","7/26/1991 (31 years old)","M (R), AM (RC), ST (C)","SK Beveren","Belgian Challenger Pro League","FRO","Yes","7/1/2021","6/30/2024","$100K - $1M","Left","Very Strong","Fairly Strong","6'1""","182 lbs","244","53",114,130,9,11,15,11,14,13,12,11,6,5,13,12,5,14,8,11,9,13,7,8,11,15,5,11,6,11,14,8,11,13,13,12,13,12,12,12,14,14,12,11,5,7,8,10,5,4,7,10,12,2,1,1,2,3,3,2,3,3,1,2
"3343",2000281399,"Bartal Klein","12/15/2006 (16 years old)","ST (C)","B36","Faroese Premier League","FRO","Yes","1/1/2022","12/31/2025","$1K - $12K","Left","Very Strong","Weak","5'6""","123 lbs","6","1",74,129,8,6,14,8,11,9,8,7,7,4,10,7,2,12,13,11,5,7,4,7,11,15,2,10,4,4,8,10,13,14,11,7,8,13,12,7,9,5,6,7,8,6,10,11,8,8,6,17,10,2,1,1,2,2,2,3,1,2,3,1
"3344",2000184336,"Virgar Jónsson","6/13/2006 (16 years old)","D/M/AM (L)","EB/Streymur","Faroese Premier League","FRO","Yes","6/24/2022","12/31/2025","$0 - $26K","Left Only","Very Strong","Weak","5'11""","141 lbs","6","1",75,126,9,8,10,5,11,9,8,4,11,4,7,2,5,9,14,9,13,6,7,5,13,9,10,7,6,8,8,12,13,11,9,10,11,14,11,8,10,18,11,12,9,14,6,14,7,8,10,14,12,2,2,2,3,2,1,1,4,2,2,2
"3345",2000008400,"Martin Agnarsson","12/7/2003 (19 years old)","D/WB (L), M/AM (R)","Viborg FF","3F Superliga","FRO","Yes","8/31/2022","6/30/2025","$140K - $1.4M","Left","Very Strong","Reasonable","5'6""","141 lbs","75","8",78,126,7,9,12,8,8,6,5,8,3,9,8,4,6,10,14,10,11,6,9,8,19,11,12,12,10,10,8,10,14,12,8,8,10,12,10,5,13,17,10,9,12,10,5,18,5,6,3,13,13,1,3,4,1,1,3,1,3,3,1,1
"3346",2000040583,"Atay Eshenkulov","2/19/2005 (18 years old)","D (C)","Ilbirs Kant","Kyrgyzstani High League","KGZ","No","6/13/2022","12/31/2023","$500 - $3.5K","Left","Very Strong","Fairly Strong","5'10""","149 lbs","-","-",65,104,3,2,1,3,8,1,11,5,1,12,5,1,11,4,14,8,8,6,10,14,4,5,15,4,14,12,5,7,9,11,7,6,14,10,8,4,13,16,10,10,10,11,9,1,5,5,8,10,12,2,2,1,2,2,1,1,1,2,3,1
"3347",27091487,"Brandur Hendriksson","12/19/1995 (27 years old)","M (C)","Fredrikstad","Norwegian First Division","FRO","Yes","1/24/2023","12/31/2024","$55K - $550K","Right","Fairly Strong","Very Strong","5'11""","165 lbs","123","22",110,120,13,13,11,12,12,13,7,14,10,7,12,15,6,12,15,11,12,13,13,12,14,11,12,11,9,12,12,12,12,13,12,9,14,12,13,9,12,8,14,10,13,14,14,14,12,4,13,14,15,3,1,3,1,1,2,1,2,1,3,2
"3348",32034444,"Samuel Chukwudi","6/25/2003 (19 years old)","D (C)","HB","Faroese Premier League","FRO","Yes","6/30/2022","12/31/2024","$0 - $26K","Right","Reasonable","Very Strong","6'5""","209 lbs","46","-",80,120,6,6,5,3,8,4,14,9,4,12,9,3,10,6,5,9,7,12,8,9,16,2,8,3,13,13,6,5,8,6,11,15,10,7,8,14,9,15,11,17,12,9,2,14,4,5,15,16,11,1,2,3,1,2,1,3,2,3,1,3
"3349",61014169,"Gilli Rólantsson","8/11/1992 (30 years old)","D (RL), WB (R)","TB","Faroese Premier League","FRO","Yes","3/15/2023","12/31/2024","$75K - $230K","Right","Fairly Strong","Very Strong","6'2""","180 lbs","256","36",106,119,9,11,10,8,9,8,8,11,17,11,11,8,11,9,13,9,12,8,8,11,13,10,9,11,9,13,10,13,12,12,11,12,13,13,13,11,18,8,11,14,9,10,8,8,12,3,11,12,13,1,2,1,3,4,3,2,3,1,3,3
"3350",27129072,"Mads Mikkelsen","12/11/1999 (23 years old)","M/AM (RL), ST (C)","KÍ","Faroese Premier League","FRO","Yes","7/18/2022","11/30/2023","$0 - $40K","Right","Fairly Strong","Very Strong","5'11""","167 lbs","49","7",106,118,11,9,14,7,12,6,9,8,10,6,9,6,7,11,8,8,9,8,6,8,13,12,10,9,7,11,8,12,14,12,11,9,7,13,9,8,16,14,14,12,8,8,9,11,6,4,8,13,15,2,3,2,3,1,1,1,3,2,2,3
"3351",32024306,"Petur Knudsen","4/21/1998 (25 years old)","AM (L), ST (C)","Lyngby","3F Superliga","FRO","Yes","7/1/2021","6/30/2024","$45K - $450K","Right","Reasonable","Very Strong","5'11""","165 lbs","197","85",98,115,11,11,14,14,10,15,12,13,8,8,11,6,6,12,15,9,5,12,8,11,11,13,5,13,8,9,6,12,14,14,10,6,9,14,7,10,11,11,9,10,12,11,10,7,5,1,8,12,8,1,1,3,1,3,2,1,3,1,1,2
"3352",32021159,"Meinhard Olsen","4/10/1997 (26 years old)","M (L), AM (RL), ST (C)","Mjøndalen","Norwegian First Division","FRO","Yes","1/1/2022","12/31/2024","$4.5K - $45K","Right","Reasonable","Very Strong","6'0""","176 lbs","226","70",94,115,7,11,12,11,11,8,7,9,5,4,7,8,3,12,10,8,9,11,11,9,10,13,4,12,7,11,8,10,12,13,9,9,8,12,11,7,10,10,10,10,10,10,4,11,7,3,12,13,12,2,2,2,3,1,3,3,2,3,1,2
"3353",32024322,"Adrian Justinussen","7/21/1998 (24 years old)","M/AM (L), ST (C)","HB","Faroese Premier League","FRO","Yes","3/3/2021","11/30/2023","$0 - $40K","Either","Very Strong","Very Strong","5'11""","152 lbs","221","92",99,115,12,14,9,12,11,18,7,15,4,4,14,13,6,13,6,11,7,12,12,11,13,13,6,11,5,10,12,6,8,12,12,10,13,10,11,7,12,8,15,11,13,12,11,18,7,2,16,16,10,3,2,1,1,1,3,2,2,2,2,2
"3354",2000065495,"Pætur Sørensen","9/14/2003 (19 years old)","M (C)","Víkingur G.","Faroese First Division","FRO","Yes","12/31/2022","12/31/2025","$0 - $2K","Right","Reasonable","Very Strong","5'7""","141 lbs","29","6",72,114,8,7,9,6,10,2,4,8,1,10,11,4,9,11,12,11,14,14,11,10,9,12,5,10,10,14,10,14,10,11,12,5,15,9,9,7,11,11,12,12,12,15,4,15,6,6,12,4,4,1,3,2,1,2,3,2,1,3,1,3
"3355",61014165,"Hallur Hansson","7/8/1992 (30 years old)","M (RLC), AM (C)","KÍ","Faroese Premier League","FRO","Yes","3/31/2023","11/30/2025","$80K - $240K","Right","Reasonable","Very Strong","6'0""","169 lbs","277","39",110,114,10,11,12,8,12,9,7,10,5,11,12,7,12,12,17,10,15,11,10,11,18,12,14,11,11,13,12,17,11,12,13,11,15,11,16,8,16,4,3,17,10,14,8,10,15,5,11,12,14,2,1,2,2,3,2,2,2,3,4,3
"3356",32027024,"Andrass Johansen","11/16/2001 (21 years old)","M (C), AM (R), ST (C)","B36","Faroese Premier League","FRO","Yes","11/6/2022","11/30/2024","$0 - $55K","Right","Reasonable","Very Strong","6'1""","165 lbs","94","28",89,113,6,5,12,8,11,8,11,7,11,4,9,8,9,11,12,9,13,11,10,9,13,14,8,11,7,11,7,11,13,11,9,12,10,12,10,11,16,15,17,12,9,11,9,11,7,1,12,11,11,2,2,2,2,1,1,3,2,2,3,1
"3357",59132028,"Temirbolot Tapaev","8/1/1999 (23 years old)","M/AM (RL)","Dordoy","Kyrgyzstani High League","KGZ","No","1/1/2023","10/1/2023","$0 - $14K","Right","Reasonable","Very Strong","5'10""","147 lbs","65","14",82,104,6,10,10,4,13,6,2,7,6,6,10,1,6,12,6,8,4,5,6,12,3,12,4,8,5,7,8,8,15,13,7,3,14,15,6,3,14,19,11,12,11,13,14,4,7,6,11,11,14,3,3,3,1,4,2,1,4,2,3,2
"3358",32024349,"Jóannes Bjartalíð","7/10/1996 (26 years old)","M/AM (RL)","Fredrikstad","Norwegian First Division","FRO","Yes","1/1/2023","12/31/2025","$45K - $140K","Left","Very Strong","Fairly Strong","5'10""","163 lbs","274","115",111,112,11,14,10,11,12,12,12,11,10,10,15,18,6,12,9,14,7,13,12,10,9,14,8,9,6,11,15,16,11,10,12,8,13,10,11,11,14,6,16,8,12,17,12,9,6,6,11,8,10,2,3,1,3,1,2,2,1,1,2,3
"3359",32034418,"Áki Samuelsen","4/17/2004 (19 years old)","M (L), AM (RL)","HB","Faroese Premier League","FRO","Yes","6/26/2022","11/30/2024","$0 - $75K","Right","Fairly Strong","Very Strong","5'9""","154 lbs","77","24",89,112,8,14,12,10,10,5,8,7,5,5,15,12,5,11,11,8,6,7,6,7,12,14,2,10,5,9,6,11,14,12,11,7,9,12,7,3,6,19,9,12,11,11,15,3,6,4,8,10,9,1,2,3,2,3,3,1,3,2,1,2
"3360",32026814,"Jens Erik Lünell Bruhn","5/12/2002 (21 years old)","D (R), DM, M (C)","TB","Faroese Premier League","FRO","Yes","10/31/2018","11/30/2023","$0 - $20K","Left","Very Strong","Fairly Strong","6'3""","174 lbs","100","4",78,110,4,7,8,8,7,9,8,5,7,9,7,5,9,7,13,9,13,9,10,12,12,11,5,7,7,12,6,14,10,8,11,15,11,13,11,11,12,18,11,10,12,12,6,11,8,1,12,11,8,3,2,2,1,3,1,2,3,3,1,1
"3361",32006919,"Klæmint Andrasson Olsen","7/17/1990 (32 years old)","AM (C), ST (C)","Breiðablik","Icelandic Premier Division","FRO","Yes","12/13/2022","11/30/2024","$2K - $22K","Right","Reasonable","Very Strong","6'0""","178 lbs","424","251",107,110,5,6,11,15,13,7,13,11,2,5,12,14,6,10,5,14,11,8,8,12,13,5,15,13,13,12,10,13,11,10,15,11,10,9,13,12,8,13,16,15,15,20,4,8,3,3,11,14,12,1,1,1,1,1,1,1,1,1,1,1
"3362",32034474,"Martin Klein","12/26/1999 (23 years old)","ST (C)","Víkingur G.","Faroese Premier League","FRO","Yes","12/9/2021","11/30/2023","$0 - $24K","Left","Very Strong","Fairly Strong","5'9""","147 lbs","140","80",84,109,9,5,11,11,9,9,12,7,9,5,6,6,5,7,12,9,10,11,9,6,5,6,10,11,6,8,6,12,14,11,10,11,10,13,9,7,6,19,13,10,14,12,12,13,4,5,6,12,15,3,3,2,1,3,3,2,1,1,3,1
"3363",2000154680,"Hans Pauli á Bø","10/29/2005 (17 years old)","M (L), AM (C)","EB/Streymur","Faroese Premier League","FRO","Yes","12/19/2021","12/31/2024","$0 - $7K","Left","Very Strong","Reasonable","5'6""","132 lbs","10","1",65,109,8,6,11,7,10,8,7,6,8,4,9,4,3,11,13,8,11,6,6,6,5,11,4,9,4,6,7,12,13,14,7,7,8,12,7,6,9,20,11,10,11,11,7,8,6,8,10,12,12,3,3,1,4,1,1,1,1,2,2,1
"3364",32027018,"Eyðbjørn Østergaard","9/30/2003 (19 years old)","GK","B36","Faroese First Division","FRO","Yes","1/1/2020","12/31/2025","$0","Right","Reasonable","Very Strong","5'11""","160 lbs","11","-",52,109,3,3,3,3,9,5,1,3,1,1,6,4,1,5,6,4,9,6,8,12,9,3,4,2,7,6,5,5,9,10,8,7,10,8,5,6,9,16,11,9,12,11,12,10,8,5,8,11,11,7,11,13,8,9,5,9,5,8,11,8
"3365",32006495,"Bárður Hansen","3/13/1992 (31 years old)","D/WB (R)","NSÍ","Faroese First Division","FRO","Yes","6/9/2023","-","$0","Right Only","Very Weak","Very Strong","5'6""","149 lbs","356","39",108,108,11,15,12,10,13,7,5,12,14,12,12,5,15,12,13,9,11,8,12,12,15,6,3,9,14,13,7,16,15,8,12,5,15,15,13,8,8,11,13,14,12,14,3,8,5,4,11,12,9,3,2,1,2,3,1,3,2,1,1,1
"3366",2000012714,"Óla Kristian Jacobsen","7/7/1997 (25 years old)","D (RC)","Víkingur G.","Faroese Premier League","FRO","Yes","6/15/2020","12/31/2024","$0","Right","Weak","Very Strong","5'9""","156 lbs","192","20",57,107,8,6,1,4,6,6,9,4,5,10,10,8,6,5,5,7,8,6,10,12,14,5,8,3,9,6,8,6,10,9,10,9,10,8,7,7,11,15,8,12,11,10,7,12,8,3,12,10,11,3,2,3,1,1,3,2,2,1,1,3
"3367",32027044,"Mikkjal Hellisá","2/18/2002 (21 years old)","D (RC)","EB/Streymur","Faroese Premier League","FRO","Yes","10/24/2022","11/30/2023","$0 - $12K","Right","Fairly Strong","Very Strong","6'2""","194 lbs","106","5",71,107,3,6,5,3,7,1,8,4,8,11,9,3,12,4,11,11,12,7,10,8,7,6,8,3,10,7,4,12,7,9,11,14,13,8,10,11,8,17,13,11,8,10,5,14,5,3,13,11,10,2,2,2,1,3,2,1,3,1,1,1
"3368",59059330,"Raul' Dzhalilov","7/20/1994 (28 years old)","M (L), AM (RL)","Alga Bishkek","Kyrgyzstani High League","KGZ","No","3/20/2022","12/31/2025","$0","Left","Very Strong","Fairly Strong","5'11""","169 lbs","235","30",87,103,6,11,13,11,13,6,6,5,2,6,7,1,7,8,10,7,5,6,7,12,14,8,6,12,3,7,4,12,13,13,7,7,7,13,13,4,14,10,12,12,13,12,7,4,6,1,20,13,9,2,1,3,3,1,3,2,3,1,2,3
"3369",32026982,"Ingi Jonhardson","9/11/2001 (21 years old)","D (L)","Víkingur G.","Faroese Premier League","FRO","Yes","11/10/2022","11/30/2023","$0 - $14K","Left","Very Strong","Fairly Strong","5'10""","152 lbs","88","19",82,107,11,12,10,7,8,7,10,4,7,8,9,2,5,7,10,11,12,5,8,8,14,11,12,9,7,9,10,15,13,12,10,10,11,13,10,11,12,19,10,12,9,12,5,1,8,1,10,7,12,2,4,2,1,2,2,3,1,2,3,1
"3370",32006947,"Árni Frederiksberg","6/13/1992 (30 years old)","M (RL), AM (R)","KÍ","Faroese Premier League","FRO","Yes","9/21/2021","11/30/2024","$7K - $70K","Left","Very Strong","Reasonable","5'10""","169 lbs","372","129",107,107,14,11,11,10,11,13,7,12,13,3,14,12,6,13,13,9,13,9,6,7,18,16,7,12,3,10,9,17,14,13,14,8,13,13,15,5,12,5,7,12,12,11,1,13,5,6,9,14,7,1,1,2,3,4,3,2,1,3,3,2
"3371",2000012813,"Jørgen Nielsen","11/30/2003 (19 years old)","AM (L), ST (C)","B68","Faroese Premier League","FRO","Yes","1/1/2023","11/30/2024","$22K - $70K","Right","Strong","Very Strong","6'2""","165 lbs","70","37",83,107,8,8,11,11,9,7,9,4,2,3,13,4,5,11,10,7,11,9,4,6,8,9,8,8,7,8,7,9,12,9,10,14,12,13,9,12,10,18,13,10,12,11,11,7,9,8,20,6,2,3,1,3,2,1,3,3,2,2,1,1
"3372",32033270,"Noah Mneney","12/6/2002 (20 years old)","D (C), DM, M (C)","Bryne","Norwegian Fourth Division Rogaland 1","FRO","Yes","1/30/2023","12/31/2025","$16K - $160K","Right","Reasonable","Very Strong","6'0""","156 lbs","102","6",84,106,7,11,7,7,11,9,11,6,3,9,9,6,8,15,13,9,12,12,10,10,13,9,13,7,12,10,6,11,12,12,10,10,14,12,12,9,12,15,11,14,8,8,10,10,9,6,12,16,19,3,1,1,2,2,2,1,3,2,3,1
"3373",32024268,"Gunnar Vatnhamar","3/29/1995 (28 years old)","D (C), DM, M (C)","Víkingur R.","Icelandic Premier Division","FRO","Yes","4/6/2023","10/31/2024","$24K - $240K","Right","Reasonable","Very Strong","6'3""","198 lbs","296","39",98,106,4,5,6,6,11,9,14,12,4,11,9,8,11,6,8,9,9,13,14,12,7,12,9,8,13,12,10,8,8,8,10,16,17,7,13,15,12,18,11,11,11,11,5,15,7,4,15,12,8,3,2,1,1,2,1,2,2,1,3,3
"3374",2000201585,"Mattias Hellisdal","1/21/2006 (17 years old)","M (C)","B36","Faroese Premier League","FRO","Yes","8/21/2022","12/31/2024","$16K - $45K","Right","Reasonable","Very Strong","5'11""","149 lbs","25","5",73,106,8,9,11,7,12,9,7,8,3,14,9,5,8,11,6,11,7,9,10,11,12,9,6,11,2,10,10,11,11,12,9,7,8,10,7,7,12,18,11,10,14,9,6,7,8,1,10,11,15,4,2,3,1,1,3,2,1,2,1,1
"3375",2000066089,"Dávid Andreasen","6/27/2004 (18 years old)","DM, M (C)","KÍ","Faroese Premier League","FRO","Yes","2/16/2023","11/30/2024","$10K - $30K","Right","Weak","Very Strong","6'0""","171 lbs","46","12",58,106,8,7,8,5,11,8,8,7,2,5,9,4,5,9,13,6,9,7,10,8,6,7,11,6,4,9,8,12,12,13,12,11,11,10,8,10,11,13,12,14,12,11,6,1,6,6,10,12,10,3,3,1,4,1,2,2,2,1,1,4
"3376",32024299,"Michał Przybylski","12/29/1997 (25 years old)","M/AM (C), ST (C)","B36","Faroese Premier League","FRO","Yes","12/31/2022","12/31/2023","$500 - $7K","Right","Fairly Strong","Very Strong","6'0""","169 lbs","221","54",78,105,3,5,8,11,6,4,10,11,5,7,6,7,6,7,8,14,6,13,11,10,13,9,8,12,7,10,7,6,11,7,6,11,12,13,12,11,11,17,12,10,11,10,7,12,8,8,13,10,14,1,1,1,1,1,1,1,1,1,1,1
"3377",32024357,"Jákup B. Andreasen","5/31/1998 (25 years old)","DM, M (C)","KÍ","Faroese Premier League","FRO","Yes","7/24/2022","11/30/2024","$45K - $140K","Left","Very Strong","Fairly Strong","6'2""","187 lbs","202","18",99,105,8,9,6,7,11,9,14,12,5,9,13,7,8,7,7,15,8,12,14,16,13,6,15,11,9,14,13,13,7,8,11,16,12,8,12,13,9,11,14,16,14,17,4,16,11,3,16,10,7,3,2,3,3,2,3,2,2,2,1,1
"3378",32024962,"Jann Benjaminsen","3/2/1997 (26 years old)","D/WB/M/AM (RL)","B36","Faroese Premier League","FRO","Yes","2/16/2023","11/30/2023","$0 - $45K","Right Only","Weak","Very Strong","5'9""","145 lbs","231","43",99,104,11,11,10,8,10,10,6,10,7,11,11,8,11,11,12,9,10,7,10,8,14,13,8,10,9,11,9,13,14,11,5,6,14,14,12,6,12,9,10,13,12,13,7,12,11,7,14,14,16,3,3,1,2,3,2,4,3,1,2,2
"3379",59145037,"Ryskeldi Artykbaev","4/9/2001 (22 years old)","AM (RL), ST (C)","Alay","Kyrgyzstani High League","KGZ","No","2/9/2023","12/31/2023","$9K - $26K","Right","Fairly Strong","Very Strong","5'11""","158 lbs","42","14",80,103,6,7,11,11,10,5,6,7,6,5,13,5,4,8,10,8,8,5,4,4,16,8,11,7,6,6,5,11,14,13,9,10,13,14,7,3,12,11,15,15,10,14,5,11,12,4,12,10,12,1,3,1,1,1,1,1,4,3,3,4
"3380",772899,"Rógvi Baldvinsson","12/6/1989 (33 years old)","D (C)","Bryne","Norwegian First Division","FRO","Yes","9/21/2022","12/31/2023","$500 - $3.5K","Right","Reasonable","Very Strong","6'2""","187 lbs","358","34",98,104,3,6,7,7,12,6,12,8,7,13,11,5,13,11,8,10,8,13,7,12,15,6,14,6,12,9,13,11,10,8,13,14,10,10,9,14,8,8,12,15,15,11,1,9,11,7,15,15,13,2,2,4,1,2,3,1,3,2,3,2
"3381",27091942,"Sonni Nattestad","8/5/1994 (28 years old)","D (C)","B36","Faroese Premier League","FRO","Yes","1/28/2023","11/30/2023","$0 - $65K","Left Only","Very Strong","Weak","6'6""","207 lbs","156","12",103,104,4,9,7,5,11,8,13,8,12,12,12,4,12,11,17,12,12,12,8,11,9,9,6,7,12,11,9,11,10,10,12,18,15,13,13,13,10,10,8,6,8,3,4,15,16,15,8,11,11,1,2,3,2,1,1,2,2,2,2,1
"3382",32026939,"Børge Petersen","4/24/2002 (21 years old)","D (RC)","KÍ","Faroese First Division","FRO","Yes","11/26/2021","11/30/2023","$500 - $6K","Right Only","Weak","Very Strong","6'0""","174 lbs","99","7",78,103,6,9,4,3,11,4,12,7,6,10,11,4,9,7,6,12,7,8,12,11,8,6,10,5,8,10,8,7,12,11,11,11,14,11,10,11,9,10,13,10,10,12,14,7,7,5,9,9,10,1,1,1,2,1,3,2,2,3,1,1
"3383",32006489,"Sølvi Vatnhamar","5/5/1986 (37 years old)","M (C), AM (RC)","Víkingur G.","Faroese Premier League","FRO","Yes","7/23/2021","11/30/2023","$0","Right Only","Weak","Very Strong","5'9""","154 lbs","433","142",103,103,6,9,8,11,14,8,6,10,1,5,14,17,9,12,9,13,13,13,11,15,13,10,14,12,6,13,16,13,10,8,11,8,15,11,14,9,6,9,10,12,15,15,8,13,5,4,8,10,12,1,1,1,1,1,1,1,1,1,1,1
"3384",27092799,"John Frederiksen","1/10/1996 (27 years old)","ST (C)","Arendal","Norwegian Second Division Group 1","FRO","Yes","4/11/2023","12/31/2023","$0","Left","Very Strong","Fairly Strong","6'8""","202 lbs","162","41",75,103,7,7,8,8,11,9,12,11,17,3,8,6,4,8,11,12,14,11,11,12,15,5,10,10,5,12,10,8,5,5,13,20,13,8,8,13,10,10,10,13,11,12,10,9,9,3,8,12,13,3,1,2,1,2,1,2,2,3,1,3
"3385",27155423,"Hanus Sørensen","2/19/2001 (22 years old)","D (R)","HB","Faroese Premier League","FRO","Yes","7/1/2022","11/30/2024","$2.5K - $24K","Left","Very Strong","Fairly Strong","6'0""","165 lbs","32","1",87,102,5,8,12,7,13,7,7,9,6,11,8,7,10,11,6,11,8,10,11,9,2,13,7,12,9,8,8,12,15,12,10,9,9,13,9,8,8,10,12,10,11,9,7,8,5,5,8,12,9,2,2,3,3,3,1,2,2,1,3,1
"3386",32006243,"Heini Vatnsdal","10/18/1991 (31 years old)","D (C), DM, M (C)","KÍ","Faroese Premier League","FRO","Yes","5/25/2022","11/30/2024","$1K - $12K","Right","Reasonable","Very Strong","5'11""","176 lbs","327","25",80,102,3,5,5,4,7,4,12,7,6,8,8,7,13,8,15,8,15,7,12,12,11,5,8,7,10,14,9,13,9,8,8,13,9,10,12,14,8,9,13,13,12,12,5,11,4,4,12,14,12,1,1,2,3,4,2,2,2,2,1,2
"3387",32022064,"Høgni Nielsen","4/29/1997 (26 years old)","DM, M (C)","07 Vestur","Faroese Premier League","FRO","Yes","7/6/2022","11/30/2023","$0 - $6K","Right Only","Weak","Very Strong","5'11""","165 lbs","200","22",63,102,5,5,6,3,10,4,7,5,7,9,10,6,10,9,5,12,6,7,8,12,9,4,12,4,11,10,5,8,10,7,8,10,14,11,13,6,6,14,16,14,13,15,3,5,3,2,6,13,7,1,2,2,3,3,1,2,2,1,3,3
"3388",32000810,"Odmar Færø","11/1/1989 (33 years old)","D (C), DM","KÍ","Faroese Premier League","FRO","Yes","5/3/2022","11/30/2025","Not for Sale","Right","Reasonable","Very Strong","6'1""","196 lbs","320","24",93,102,5,7,7,6,9,6,13,7,5,10,10,6,13,8,13,11,15,12,11,11,9,8,12,8,13,12,10,14,9,8,10,12,8,9,11,13,7,14,10,10,12,8,15,10,7,5,12,10,9,1,3,2,1,3,1,1,1,2,3,2
"3389",32024254,"Pætur Petersen","3/29/1998 (25 years old)","AM (RLC), ST (C)","KA","Icelandic Premier Division","FRO","Yes","2/4/2023","11/16/2025","$18K - $170K","Right","Reasonable","Very Strong","5'11""","167 lbs","215","58",95,102,9,8,11,11,9,10,5,11,2,4,7,10,6,12,16,11,11,8,5,7,15,12,4,11,6,9,6,16,13,12,10,10,12,14,10,6,8,12,11,14,10,8,5,12,7,6,8,15,10,3,3,1,1,1,2,2,1,1,2,3
"3390",2000039334,"Arslan Bekberdinov","8/14/2003 (19 years old)","D (C)","Abdysh-Ata","Kyrgyzstani High League","KGZ","No","1/1/2023","12/31/2023","$0 - $26K","Right Only","Weak","Very Strong","5'11""","160 lbs","50","-",68,103,4,2,2,5,5,6,11,8,7,11,9,7,12,9,11,9,10,8,8,8,12,5,9,8,13,9,4,10,11,8,8,11,12,10,10,6,14,10,10,12,11,9,9,3,13,8,8,11,18,3,1,2,1,2,2,3,1,1,3,2
"3391",32026780,"Stefan Radosavljević","9/8/2000 (22 years old)","M (C), AM (RLC), ST (C)","Sligo Rovers","Irish Premier Division","FRO","Yes","2/10/2023","11/30/2024","$85K - $850K","Right","Fairly Strong","Very Strong","5'11""","169 lbs","155","49",90,102,8,9,9,11,11,9,9,8,4,3,11,15,5,10,10,9,11,12,10,12,14,11,4,11,4,11,10,10,12,10,12,10,12,11,11,10,13,12,15,16,13,6,3,11,9,2,13,12,13,3,1,3,2,4,2,1,3,1,3,1
"3392",2000159770,"Thomas Bjørn Miezan","4/15/2006 (17 years old)","M (RL), AM (C), ST (C)","FC København","3F Superliga","FRO","Yes","7/1/2022","6/30/2025","$14K - $150K","Right","Reasonable","Very Strong","6'0""","176 lbs","4","1",70,101,5,6,12,9,10,4,5,5,7,3,6,7,4,9,7,6,7,7,4,5,11,9,4,5,7,6,6,9,13,11,9,13,9,15,11,11,8,16,11,10,13,12,7,5,5,8,5,11,12,1,1,1,2,2,3,1,1,2,2,3
"3393",32024817,"Erlendur Magnusson","7/2/1998 (24 years old)","DM, M/AM (C)","B36","Faroese Premier League","FRO","Yes","2/21/2023","11/30/2023","$7K - $22K","Right","Strong","Very Strong","6'0""","169 lbs","94","13",82,101,9,7,7,5,13,9,9,3,7,7,11,7,8,9,11,8,14,6,9,12,15,7,9,11,5,12,13,12,9,8,11,11,13,10,11,11,13,13,16,17,14,18,16,11,5,2,11,6,12,3,2,1,4,3,1,1,3,1,2,1
"3394",32000812,"Pól Jóhannus Justinussen","1/13/1989 (34 years old)","D (LC), DM","NSÍ","Faroese First Division","FRO","Yes","6/14/2021","-","$0","Left Only","Very Strong","Weak","6'3""","167 lbs","360","85",92,100,4,6,5,5,8,6,14,9,13,13,9,6,12,7,11,11,9,10,11,10,12,7,6,5,12,13,8,12,8,7,11,15,12,10,13,16,6,14,14,13,14,12,3,8,2,3,10,13,14,2,2,3,3,1,1,1,3,3,2,3
"3395",2000261617,"Hanus Højgaard","12/3/2005 (17 years old)","M/AM (L)","B68","Faroese Premier League","FRO","Yes","1/1/2022","12/31/2024","$10K - $28K","Right","Reasonable","Very Strong","5'7""","132 lbs","14","1",71,100,9,8,11,10,10,9,6,7,6,4,10,5,3,12,12,9,7,8,5,6,15,9,6,12,4,8,7,10,13,14,9,8,11,11,8,4,10,11,10,9,10,12,11,8,9,7,20,11,17,2,1,1,2,3,3,3,1,1,3,3
"3396",32006499,"Kaj Leo í Bartalsstovu","6/23/1991 (31 years old)","M/AM (RL)","Leiknir","Icelandic First Division","FRO","Yes","3/2/2023","10/31/2024","$0","Left Only","Very Strong","Weak","6'0""","152 lbs","295","44",90,100,13,13,13,8,13,14,7,14,6,5,9,9,5,14,6,12,3,10,8,11,10,13,4,14,6,12,12,14,11,12,10,7,15,12,10,6,8,12,13,13,11,10,4,6,2,6,5,12,14,3,3,3,1,3,3,1,3,2,3,2
"3397",43043994,"Marcel Büchel","3/18/1991 (32 years old)","DM, M (C)","Ascoli","Italian Serie B","LIE","Yes","9/16/2021","6/30/2024","$100K - $1M","Left Only","Very Strong","Weak","5'9""","156 lbs","259","11",113,129,10,12,12,9,12,10,10,13,10,10,14,10,13,14,12,12,14,12,13,13,14,12,13,12,12,13,14,12,11,10,12,9,14,12,11,12,13,11,12,12,15,10,7,11,15,8,11,13,10,1,3,3,2,4,1,3,1,2,3,2
"3398",2000266888,"Jonas Verling","6/24/2007 (15 years old)","D (L), ST (C)","Vaduz","Swiss Challenge League","LIE","Yes","4/13/2022","6/30/2027","$22K - $230K","Left","Very Strong","Fairly Strong","5'10""","138 lbs","-","-",57,117,6,9,9,12,12,4,11,1,3,1,3,5,5,10,8,7,6,11,6,11,7,11,6,3,1,4,3,5,7,10,2,4,10,11,9,5,6,13,14,9,11,13,7,9,7,6,5,10,17,2,3,3,1,1,3,2,1,3,3,3
"3399",2000133967,"Fabio Luque Notaro","8/31/2005 (17 years old)","M (RL), AM (R)","Vaduz","Swiss Challenge League","LIE","Yes","7/2/2021","6/30/2024","$7K - $70K","Right","Fairly Strong","Very Strong","5'11""","149 lbs","1","-",63,115,6,9,11,9,11,4,1,3,1,3,11,1,2,8,15,7,1,5,1,6,3,12,1,6,4,6,6,10,12,12,5,6,15,12,10,4,9,16,11,12,10,11,6,17,6,3,10,10,8,3,3,1,2,3,1,3,4,3,1,1
"3400",98047907,"Gabriel Foser","9/2/2002 (20 years old)","GK","Vaduz","Swiss Challenge League","LIE","Yes","4/21/2023","6/30/2024","$12K - $120K","Right","Reasonable","Very Strong","6'2""","171 lbs","34","-",78,114,5,1,2,3,6,8,1,2,3,1,10,3,3,5,13,5,12,6,9,13,11,1,7,1,8,7,6,6,11,13,7,11,14,10,3,6,11,10,11,12,11,10,14,11,14,1,11,13,16,8,5,13,11,7,13,8,5,7,13,13
"3401",23501141,"Kamolidin Tashiev","2/9/2000 (23 years old)","D (RC)","Abdysh-Ata","Kyrgyzstani High League","KGZ","No","2/2/2021","12/31/2024","$0","Right","Weak","Very Strong","5'9""","152 lbs","37","4",70,102,6,11,5,4,8,2,10,4,6,13,7,2,10,4,8,10,9,7,10,12,1,5,12,5,11,4,4,7,12,12,7,6,12,10,4,6,10,18,11,10,13,11,11,14,9,1,5,12,7,1,3,1,2,1,3,2,3,3,1,4
"3402",98009107,"Sandro Wieser","2/3/1993 (30 years old)","D (C), DM, M (C)","Vaduz","Swiss Challenge League","LIE","Yes","11/30/2020","6/30/2024","$6K - $60K","Left","Very Strong","Reasonable","6'1""","176 lbs","192","17",96,112,8,9,9,11,10,12,13,11,11,11,10,11,13,10,16,12,14,11,11,9,15,6,12,10,12,13,6,13,10,10,11,11,12,10,12,11,9,8,5,16,11,12,18,12,14,11,10,12,8,3,3,1,3,1,1,3,1,4,3,3
"3403",67211716,"Dennis Salanovic","2/26/1996 (27 years old)","M/AM (RL)","Talavera","Spanish Federation Second Group 5","LIE","Yes","3/9/2023","6/30/2024","$35K - $325K","Right","Weak","Very Strong","5'10""","163 lbs","174","28",98,110,9,10,13,10,12,8,7,9,5,6,13,6,7,14,13,10,9,11,9,11,18,12,7,12,7,11,11,13,14,13,8,10,11,14,10,7,14,12,11,10,11,9,11,8,7,1,13,13,12,3,3,1,2,3,3,3,2,2,3,1
"3404",84154012,"Lars Traber","6/12/2000 (22 years old)","D (C)","Vaduz","Swiss Challenge League","LIE","Yes","7/1/2022","6/30/2024","$20K - $200K","Left","Very Strong","Reasonable","6'1""","171 lbs","99","6",93,109,4,7,5,6,9,2,12,6,3,12,3,10,14,5,9,11,11,7,10,12,14,5,11,10,16,10,9,11,12,12,11,10,12,11,7,8,13,12,11,11,12,12,9,7,7,1,11,11,14,3,2,1,3,1,3,1,3,3,2,3
"3405",2000145530,"Philip Käppeli","4/16/2005 (18 years old)","M (RC)","Tägerwilen","Swiss Second League Interregio Gr 4","LIE","Yes","6/12/2023","-","$0","Right","Fairly Strong","Very Strong","5'9""","143 lbs","-","-",59,109,6,7,8,7,10,5,6,7,5,8,14,3,9,9,13,8,5,8,8,10,16,5,9,7,7,7,10,12,9,10,6,8,14,11,7,5,11,13,12,9,9,12,8,5,10,8,14,12,18,2,1,3,3,1,3,1,3,3,2,1
"3406",98042555,"Justin Ospelt","9/7/1999 (23 years old)","GK","Vaduz","Swiss Challenge League","LIE","Yes","6/15/2020","6/30/2025","$0","Right Only","Very Weak","Very Strong","6'2""","180 lbs","45","-",92,108,4,2,2,2,6,6,1,3,1,1,11,1,1,4,6,12,15,7,11,14,15,1,9,1,9,9,8,6,11,12,4,10,14,10,1,8,10,14,12,14,11,12,7,7,12,4,11,11,19,9,10,14,11,8,14,11,5,9,12,9
"3407",2000266876,"Eros Caroccia","7/10/2007 (15 years old)","DM, M (C)","Triesen","Swiss Lower Division","LIE","Yes","4/13/2022","6/30/2027","$0","Right","Fairly Strong","Very Strong","6'0""","136 lbs","-","-",53,108,4,1,1,5,12,4,4,5,1,4,12,1,10,10,7,4,6,3,4,12,13,5,10,3,4,6,8,10,12,12,5,12,14,12,5,2,8,20,8,11,12,8,8,11,15,8,8,9,11,1,2,2,3,1,3,3,2,3,2,3
"3408",29183176,"Aron Sele","9/2/1996 (26 years old)","DM, M (C)","Chur 97","Swiss Second League Interregio Gr 4","LIE","Yes","7/1/2020","6/30/2024","$0 - $55K","Right","Reasonable","Very Strong","5'6""","134 lbs","138","9",77,106,7,8,4,8,14,7,7,8,4,9,10,2,12,10,12,13,8,9,4,12,11,5,14,8,12,8,12,12,14,13,8,1,12,12,7,2,14,12,10,9,13,12,11,7,6,2,8,10,13,2,2,3,2,3,3,3,3,2,2,3
"3409",98040369,"Maximilian Göppel","8/31/1997 (25 years old)","D (LC), WB (L)","Eschen/Mauren","Swiss First League Classic Group 3","LIE","Yes","5/30/2023","6/30/2024","$14K - $45K","Left Only","Very Strong","Weak","5'10""","154 lbs","160","3",76,105,3,9,6,2,7,1,9,4,6,8,9,6,14,8,7,10,9,9,9,12,8,5,12,4,10,8,7,13,8,12,7,7,14,12,14,6,16,14,11,12,7,12,13,12,9,7,10,8,17,1,3,2,3,2,3,3,3,1,3,2
"3410",98001693,"Nicolas Hasler","5/4/1991 (32 years old)","DM, M (C)","Vaduz","Swiss Challenge League","LIE","Yes","7/1/2022","6/30/2025","Not for Sale","Right","Reasonable","Very Strong","5'11""","174 lbs","327","29",97,104,8,10,10,8,10,10,10,10,7,11,12,11,11,11,8,11,12,11,10,12,5,8,8,11,11,12,10,13,11,12,13,8,13,11,12,10,15,14,9,11,13,10,6,11,8,8,10,13,12,3,4,2,2,1,2,2,3,3,3,2
"3411",98048539,"Niklas Beck","3/25/2001 (22 years old)","D (C), M (LC)","Eschen/Mauren","Swiss First League Classic Group 3","LIE","Yes","5/30/2023","6/30/2024","$500 - $4.5K","Right","Strong","Very Strong","6'1""","165 lbs","46","9",66,103,5,7,6,1,8,5,7,5,5,10,12,1,12,7,9,10,7,7,2,13,11,5,10,6,5,6,6,7,13,12,6,10,12,13,3,4,13,16,12,10,11,12,8,8,6,2,12,11,10,1,3,1,3,3,1,4,3,1,3,3
"3412",59123590,"Aidar Mambetaliev","7/22/1998 (24 years old)","D (C)","Talant","Kyrgyzstani High League","KGZ","No","4/1/2023","12/31/2023","$0","Right","Reasonable","Very Strong","6'3""","178 lbs","71","8",72,102,3,1,1,6,8,1,8,6,1,10,7,1,13,5,15,7,9,4,10,13,6,5,9,4,13,6,1,7,11,8,7,13,9,9,9,5,13,13,9,12,13,12,10,7,7,4,10,13,15,3,4,1,3,1,2,1,1,3,3,4
"3413",2000266887,"Sascha Spellecchia","1/18/2007 (16 years old)","M/AM (C)","Vaduz","Swiss Challenge League","LIE","Yes","1/18/2023","6/30/2026","$3.5K - $35K","Right","Reasonable","Very Strong","6'0""","152 lbs","-","-",51,103,5,5,7,9,13,5,2,7,5,4,8,1,7,10,15,4,4,6,5,9,6,10,5,4,6,7,11,12,8,9,5,11,8,8,9,3,13,14,10,11,10,10,12,1,10,4,17,13,13,1,3,1,2,3,3,3,2,2,2,1
"3414",98001153,"Benjamin Büchel","7/4/1989 (33 years old)","GK","Vaduz","Swiss Challenge League","LIE","Yes","9/27/2021","6/30/2024","$40K - $120K","Left","Very Strong","Reasonable","6'2""","187 lbs","313","-",97,102,4,1,3,2,6,7,2,1,3,1,8,2,3,6,8,11,14,8,11,12,10,2,14,2,13,5,8,6,8,10,9,13,13,10,12,11,11,7,11,14,10,9,2,9,1,2,12,11,17,10,12,13,12,12,11,11,11,10,12,11
"3415",2000212008,"Lorin Beck","6/27/2006 (16 years old)","GK","Vaduz","Swiss Challenge League","LIE","Yes","7/1/2021","6/30/2025","$0 - $7K","Right","Reasonable","Very Strong","6'2""","154 lbs","-","-",52,102,1,1,2,2,1,6,1,3,1,1,6,1,2,1,7,3,8,5,6,12,7,2,9,1,7,5,4,3,5,12,5,8,13,6,1,2,9,17,11,11,12,11,5,6,5,8,15,9,17,4,7,12,8,6,7,12,5,7,12,6
"3416",98044085,"Ferhat Saglam","10/10/2001 (21 years old)","AM (R), ST (C)","Eschen/Mauren","Swiss First League Classic Group 3","LIE","Yes","8/31/2022","6/30/2025","$6K - $20K","Right","Reasonable","Very Strong","5'11""","165 lbs","57","23",69,101,5,7,13,9,13,3,7,8,5,5,6,2,4,11,8,7,6,6,6,7,10,11,12,12,4,7,7,12,13,10,7,6,14,10,8,2,10,16,11,9,11,10,5,12,9,6,11,9,19,3,3,2,1,2,3,2,1,2,1,3
"3417",29114924,"Guillaume Khous","8/18/1992 (30 years old)","M/AM (LC)","CS Sedan Ardennes","French Regional Divisions","LIE","Yes","7/1/2022","6/30/2024","$35K - $350K","Right","Weak","Very Strong","5'8""","143 lbs","307","47",99,100,7,10,12,9,12,7,7,10,7,5,11,10,6,12,11,10,12,11,11,10,4,12,9,11,9,12,11,13,13,13,11,7,15,12,13,8,11,11,11,13,12,12,7,11,11,8,12,12,18,2,1,2,3,1,3,3,3,3,3,1
"3418",2000266858,"Lukas Heeb","6/7/2007 (16 years old)","GK","Balzers","Swiss First League Classic Group 3","LIE","Yes","7/1/2022","6/30/2026","$0","Right","Reasonable","Very Strong","6'2""","154 lbs","-","-",51,100,5,2,3,3,1,6,1,3,3,1,7,3,1,1,7,3,14,5,2,12,15,1,10,2,3,5,4,4,10,13,5,11,12,12,4,3,9,19,10,11,10,10,7,9,11,8,12,11,15,6,13,12,9,4,3,8,8,7,9,9
"3419",2000043406,"Severin Schlegel","7/24/2004 (18 years old)","D/M (C)","Vaduz","Swiss Challenge League","LIE","Yes","3/1/2021","6/30/2024","$12K - $120K","Left","Very Strong","Reasonable","5'5""","134 lbs","13","-",63,99,2,7,5,3,10,7,12,8,7,11,5,2,9,11,11,8,14,9,5,15,6,5,13,8,10,14,7,9,7,9,9,6,15,7,8,5,11,11,9,11,11,10,11,4,6,5,13,11,18,2,1,2,2,3,3,3,3,4,2,1
"3420",98034172,"Yanik Frick","5/27/1998 (25 years old)","AM (RC), ST (C)","Montlingen","Swiss Lower Division","LIE","Yes","9/5/2022","-","$0","Right","Reasonable","Very Strong","6'2""","180 lbs","53","11",69,99,11,5,6,8,10,11,9,10,4,5,6,12,3,6,6,9,9,9,8,7,11,11,7,9,5,10,9,12,10,9,12,11,13,11,11,11,14,8,6,4,11,9,13,10,6,5,9,8,5,3,3,3,1,1,4,2,2,2,1,3
"3421",2000184186,"Julian Keller","7/23/2006 (16 years old)","D (RL)","Vaduz","Swiss Challenge League","LIE","Yes","7/1/2022","6/30/2026","$18K - $180K","Right","Reasonable","Very Strong","5'7""","123 lbs","-","-",61,99,5,10,6,1,8,3,8,6,6,9,8,1,7,8,9,8,8,4,8,14,5,7,10,5,5,7,8,8,14,14,7,4,9,14,6,1,12,12,10,11,12,12,9,8,9,2,7,12,11,1,3,2,3,1,2,3,3,2,1,3
"3422",98010695,"Philipp Ospelt","10/7/1992 (30 years old)","M/AM (LC), ST (C)","Ruggell","Swiss Lower Division","LIE","Yes","7/19/2021","-","$0","Left","Very Strong","Reasonable","6'0""","163 lbs","110","32",64,98,5,6,10,11,11,5,6,5,1,5,9,3,4,7,10,6,7,8,6,13,5,7,3,11,6,6,6,7,13,10,6,7,15,12,9,8,8,10,9,13,9,12,7,9,5,1,9,13,7,3,1,3,2,3,4,3,1,1,4,1
"3423",35006411,"Sergej Evljuskin","1/4/1988 (35 years old)","DM, M (C)","Schöningen","German Div. Lower Saxony","KGZ","Yes","1/27/2021","-","$0","Right","Reasonable","Very Strong","5'10""","165 lbs","414","30",80,100,7,6,9,6,13,9,13,9,5,9,14,7,10,10,14,11,13,11,10,7,12,8,13,9,12,11,13,7,7,11,10,12,14,8,10,10,6,14,12,13,14,13,4,13,8,8,15,12,10,3,3,2,2,4,2,2,2,1,3,2
"3424",98044082,"Andrin Netzer","1/11/2002 (21 years old)","D (L), DM, M (C)","Vaduz","Swiss Challenge League","LIE","Yes","6/13/2022","6/30/2026","$0 - $24K","Left Only","Very Strong","Weak","5'10""","158 lbs","52","3",66,98,8,9,9,4,14,8,8,8,2,10,11,2,10,9,14,11,8,7,10,16,11,5,3,9,13,9,7,5,9,9,9,7,17,9,7,7,11,17,11,12,9,12,5,9,6,1,12,11,17,2,3,1,2,2,2,2,3,4,1,1
"3425",2000184185,"Jonas Weissenhofer","7/25/2006 (16 years old)","D (C)","Vaduz","Swiss Challenge League","LIE","Yes","7/1/2022","6/30/2026","$65K - $200K","Right","Reasonable","Very Strong","6'2""","158 lbs","-","-",64,96,2,1,1,3,6,1,13,4,5,14,10,3,11,2,12,9,8,8,5,14,6,5,1,5,9,6,4,8,13,10,6,11,15,11,7,6,12,10,11,12,10,11,6,10,12,4,8,10,14,1,2,3,2,2,2,3,2,1,3,1
"3426",2000119536,"Alessio Hasler","7/7/2005 (17 years old)","M (LC), AM (L)","Vaduz","Swiss Challenge League","LIE","Yes","2/1/2022","6/30/2024","$0 - $130K","Left","Very Strong","Reasonable","5'8""","132 lbs","-","-",63,96,4,5,7,10,10,5,5,6,5,5,9,2,4,9,9,7,7,7,3,9,15,9,12,8,3,6,7,11,13,13,6,5,7,13,6,4,13,19,11,10,11,12,13,8,5,7,7,12,14,2,2,3,3,3,3,2,1,1,1,3
"3427",98043992,"Noah Frommelt","12/18/2000 (22 years old)","DM, M (C)","Kosova","Swiss First League Classic Group 3","LIE","Yes","7/1/2022","6/30/2023","$0","Right","Reasonable","Very Strong","6'2""","171 lbs","81","4",73,96,6,5,4,3,8,1,7,7,2,8,14,7,11,8,13,11,8,8,9,13,9,5,13,9,10,8,8,12,14,14,8,13,11,14,7,6,12,16,11,11,11,11,13,3,7,6,17,10,13,3,4,1,3,2,3,1,1,2,2,3
"3428",98044078,"Noah Frick","10/16/2001 (21 years old)","M/AM (C), ST (C)","Montlingen","Swiss Lower Division","LIE","Yes","7/1/2022","-","$0","Right","Weak","Very Strong","6'2""","180 lbs","62","4",70,95,8,8,10,6,10,7,11,11,5,6,11,4,6,11,7,9,12,9,8,8,18,10,8,9,6,11,11,11,10,9,11,13,11,11,11,12,10,20,12,13,13,13,13,15,7,6,7,8,17,2,2,2,2,3,3,1,1,3,1,3
"3429",98044083,"Fabian Unterrainer","6/5/2001 (22 years old)","D (C)","ASKÖ Donau Linz","Austrian County-League East (OÖ)","LIE","Yes","6/30/2021","6/30/2024","$0 - $1.5K","Right Only","Weak","Very Strong","5'10""","156 lbs","65","5",70,95,4,1,1,3,7,6,8,2,2,12,7,1,13,3,14,7,9,7,11,13,18,7,13,6,9,6,2,7,9,12,7,7,15,13,9,9,16,14,10,13,13,13,13,12,11,4,14,13,13,1,2,1,3,3,2,1,1,2,2,2
"3430",98042649,"Manuel Mikus","7/13/1999 (23 years old)","D (RL), WB/M (R)","Balzers","Swiss First League Classic Group 3","LIE","Yes","7/10/2020","6/30/2023","$0","Right","Fairly Strong","Very Strong","6'1""","163 lbs","45","4",62,94,7,10,7,6,8,6,4,4,5,8,6,3,8,8,11,8,8,8,6,12,4,5,8,5,8,7,8,3,14,14,6,7,15,14,5,5,11,11,11,12,11,13,13,7,5,5,15,11,17,2,2,1,2,3,3,2,2,2,1,1
"3431",2000185524,"Noah Marxer","8/28/2006 (16 years old)","M (C)","Eschen/Mauren","Swiss First League Classic Group 3","LIE","Yes","7/1/2022","6/30/2026","$0","Right","Reasonable","Very Strong","6'0""","152 lbs","-","-",53,93,5,3,2,7,12,6,5,8,1,8,7,3,8,7,8,4,3,7,5,14,5,9,7,5,5,7,8,12,13,9,3,7,13,13,10,7,10,13,12,14,11,9,7,15,5,4,8,10,11,3,3,3,1,1,1,1,3,2,2,2
"3432",2000266889,"Yonas Abidi","12/18/2006 (16 years old)","D (RL), M (R)","Vaduz","Swiss Challenge League","LIE","Yes","7/1/2021","6/30/2026","$22K - $65K","Right","Weak","Very Strong","6'0""","149 lbs","-","-",50,92,7,10,7,4,10,6,7,4,6,6,8,1,9,8,10,7,8,4,12,6,9,8,3,3,4,7,6,8,14,8,2,8,10,12,7,4,10,17,9,11,10,11,11,15,11,3,9,10,7,2,2,3,1,2,1,2,4,2,1,4
"3433",16282906,"Jakob Lorenz","9/11/2001 (21 years old)","DM, M (RC)","Vaduz","Swiss Challenge League","LIE","Yes","7/1/2022","6/30/2025","$0 - $85K","Right Only","Weak","Very Strong","6'1""","165 lbs","98","7",60,92,5,6,7,3,13,5,5,6,1,7,10,1,7,10,6,8,7,4,5,13,6,5,1,6,7,7,5,12,13,9,6,13,10,12,12,4,11,11,11,12,11,13,6,15,5,5,18,11,12,4,3,1,2,4,2,2,3,2,3,2
"3434",59123585,"Suyuntbek Mamyraliev","1/7/1998 (25 years old)","D (L)","Dordoy","Kyrgyzstani High League","KGZ","No","1/1/2022","12/31/2023","$2.5K - $8K","Left Only","Very Strong","Weak","5'8""","143 lbs","57","1",87,100,4,9,9,7,10,1,5,6,4,10,7,7,10,9,9,10,5,10,9,14,13,5,6,7,7,9,7,14,15,14,15,7,14,11,15,5,11,19,11,9,12,12,6,5,13,1,19,10,10,1,2,1,1,3,1,2,1,3,1,1
"3435",98042557,"Martin Marxer","10/4/1999 (23 years old)","D (C)","Muri-Gümligen","Swiss Second League Interregio Gr 2","LIE","Yes","7/5/2022","-","$0","Right","Reasonable","Very Strong","6'3""","176 lbs","28","1",60,90,2,1,4,5,7,1,11,6,4,11,6,4,12,2,8,10,9,7,6,8,2,5,5,6,12,6,5,8,9,10,8,16,11,11,4,7,14,14,13,9,13,9,6,13,9,5,10,11,15,3,3,3,2,1,3,2,2,1,4,3
"3436",70032849,"Cengiz Biçer","12/11/1987 (35 years old)","GK","Eschen/Mauren","Swiss First League Classic Group 3","LIE","Yes","6/12/2023","6/30/2024","$1.5K - $4K","Right","Weak","Very Strong","6'2""","171 lbs","103","-",68,90,3,1,1,1,1,7,1,1,2,1,6,1,2,4,6,7,13,7,10,10,5,3,9,2,11,8,7,7,11,17,7,13,6,10,6,6,10,15,11,12,11,11,13,4,11,3,8,8,18,9,9,8,11,6,9,7,5,9,7,7
"3437",98044080,"Simon Lüchinger","11/28/2002 (20 years old)","DM, M (C)","Vaduz","Swiss Challenge League","LIE","Yes","4/21/2023","6/30/2024","$0 - $100K","Right Only","Weak","Very Strong","5'10""","156 lbs","27","2",78,90,9,7,10,6,11,5,9,8,4,9,11,3,7,11,9,14,9,9,9,16,6,5,11,11,11,10,9,11,7,10,8,6,15,11,15,7,16,14,11,12,10,13,10,3,7,8,10,9,12,2,3,3,2,1,1,2,2,1,3,1
"3438",98044004,"Lukas Graber","5/3/2001 (22 years old)","D (R), DM, AM (R)","Eschen/Mauren","Swiss First League Classic Group 3","LIE","Yes","7/1/2020","6/30/2024","$0 - $9K","Right","Reasonable","Very Strong","5'10""","149 lbs","48","-",60,90,5,8,7,10,7,5,5,3,5,7,9,3,13,11,11,5,7,5,5,11,6,11,10,10,5,7,4,7,13,13,7,8,15,13,3,4,13,16,10,11,10,8,5,18,5,1,10,10,12,2,3,3,3,3,3,1,1,1,1,3
"3439",2000043394,"David Jäger","7/4/2004 (18 years old)","D (RL)","Vaduz","Swiss Challenge League","LIE","Yes","7/21/2020","6/30/2024","$0 - $60K","Right","Fairly Strong","Very Strong","6'0""","158 lbs","8","-",57,89,5,11,1,1,8,1,7,6,6,8,7,1,13,7,12,8,8,4,7,9,17,8,3,4,6,7,6,8,11,14,7,13,15,13,5,6,11,18,11,8,13,10,5,10,8,4,7,10,20,1,2,3,1,1,2,1,2,1,1,2
"3440",16067564,"Andreas Malin","1/31/1994 (29 years old)","D (C)","FC RW Rankweil","Austrian Regional League West","LIE","Yes","7/1/2021","6/30/2024","$22K - $210K","Left","Very Strong","Fairly Strong","6'1""","180 lbs","215","12",87,89,4,1,1,2,5,6,14,4,7,14,7,5,10,3,10,9,9,6,10,8,11,5,13,7,14,6,2,8,13,12,8,13,9,14,4,14,12,10,9,10,9,12,8,8,10,3,13,10,17,3,3,3,3,1,4,3,2,1,3,2
"3441",2000082696,"Emanuel Zünd","4/19/2004 (19 years old)","AM (LC)","Signal FC","Swiss Second League Interregio Gr 1","LIE","Yes","6/12/2023","6/30/2024","$0 - $6K","Left","Very Strong","Weak","6'2""","165 lbs","3","-",55,89,3,7,9,6,13,1,3,7,3,1,5,5,6,12,10,6,7,5,6,9,9,12,11,5,5,6,8,11,13,12,6,12,17,12,8,5,11,10,10,12,13,12,5,7,8,4,10,11,8,1,1,2,3,1,2,2,1,1,3,3
"3442",98042629,"Menderes Caglar","7/20/1999 (23 years old)","M (C)","Montlingen","Swiss Lower Division","LIE","Yes","8/4/2021","-","$0","Either","Very Strong","Very Strong","6'2""","167 lbs","29","-",62,88,3,5,4,5,7,5,4,7,1,6,9,3,5,12,6,7,5,7,7,13,10,5,3,7,6,6,4,11,12,10,6,7,14,13,12,5,13,11,10,13,13,8,9,15,12,1,18,11,16,1,1,2,3,1,2,1,1,3,2,1
"3443",98042432,"Claudio Majer","3/23/1996 (27 years old)","GK","Eschen/Mauren","Swiss First League Classic Group 3","LIE","Yes","1/1/2019","6/30/2024","$0 - $9K","Right","Strong","Very Strong","6'0""","163 lbs","54","-",60,88,5,2,1,1,2,7,1,2,2,1,7,2,2,5,5,6,6,7,9,14,6,1,14,1,9,7,6,6,11,6,7,7,12,13,3,6,12,17,11,11,7,10,12,9,5,6,12,11,18,5,9,14,11,9,8,8,5,10,7,9
"3444",2000185523,"Felix Gritsch","7/20/2006 (16 years old)","WB (L), ST (C)","Schaan","Swiss Lower Division","LIE","Yes","7/1/2021","-","$0","Left","Very Strong","Fairly Strong","6'0""","145 lbs","-","-",50,88,6,8,6,8,9,6,7,7,2,3,5,2,2,12,13,7,4,5,8,7,8,11,7,10,5,6,5,7,12,12,7,8,14,14,9,4,8,19,11,11,10,10,14,5,8,4,9,8,10,3,1,1,1,3,1,2,1,3,2,1
"3445",18051217,"Gary Ambroise","7/17/1985 (37 years old)","AM (RLC), ST (C)","US Vimy","French National 3 - Group G","HAI","Yes","7/1/2022","6/30/2023","$0","Right Only","Weak","Very Strong","5'11""","163 lbs","242","43",80,105,7,10,11,7,10,4,7,6,6,7,9,6,5,10,11,11,12,10,11,10,14,8,11,7,7,13,7,11,11,11,10,10,15,11,7,10,12,14,13,11,12,11,14,10,11,6,14,12,15,2,1,3,3,2,1,3,1,3,3,1
"3446",2000039007,"Nurlan Sarykbaev","9/29/1998 (24 years old)","DM, M/AM (C)","Alay","Kyrgyzstani High League","KGZ","No","2/9/2023","12/31/2023","$500 - $4.5K","Right","Reasonable","Very Strong","5'9""","156 lbs","40","2",83,100,7,3,9,9,11,7,7,14,3,9,11,7,9,12,12,8,8,11,9,11,4,14,11,9,13,13,11,9,9,9,14,7,14,7,8,7,10,17,12,10,10,13,9,15,9,8,10,14,19,1,1,2,3,3,3,3,3,2,3,3
"3447",2000185521,"Lukas Verling","9/16/2005 (17 years old)","GK","Vaduz","Swiss Challenge League","LIE","Yes","7/1/2021","6/30/2025","$16K - $45K","Right","Reasonable","Very Strong","6'3""","169 lbs","-","-",53,87,2,1,2,1,1,3,1,3,3,1,7,3,3,1,14,5,12,4,7,10,4,2,4,2,5,5,4,3,7,14,6,14,14,6,1,5,8,14,11,8,12,11,10,5,8,2,14,11,9,8,8,12,6,8,6,12,5,4,8,12
"3448",2000039396,"Eldar Moldozhunusov","9/15/1995 (27 years old)","AM (RLC), ST (C)","Neftchi Kochkor-Ata","Kyrgyzstani High League","KGZ","No","3/20/2023","12/31/2023","$0 - $26K","Right Only","Weak","Very Strong","5'11""","163 lbs","76","28",92,100,7,8,9,11,8,7,9,10,6,3,8,4,8,11,5,10,7,11,8,12,16,11,1,12,7,8,11,9,13,13,7,7,13,13,13,12,13,20,12,12,12,10,5,9,10,4,11,11,15,2,1,2,3,1,1,2,1,1,3,4
"3449",59096065,"Kadyrbek Shaarbekov","2/2/1998 (25 years old)","AM (RL)","Alga Bishkek","Kyrgyzstani High League","KGZ","No","1/1/2020","12/31/2024","$0","Right","Reasonable","Very Strong","5'11""","169 lbs","60","14",81,99,5,11,10,8,8,6,8,3,6,4,10,1,6,13,10,8,6,6,5,8,8,12,7,11,6,7,3,12,13,13,13,9,15,13,8,8,15,20,11,10,11,10,8,2,10,6,6,10,9,2,1,1,3,3,1,2,3,1,1,3
"3450",2000040461,"Amantur Shamurzaev","1/25/2000 (23 years old)","D (LC)","Alay","Kyrgyzstani High League","KGZ","No","2/9/2023","12/31/2023","$4.5K - $14K","Left","Very Strong","Weak","5'11""","158 lbs","51","3",75,99,5,11,9,7,11,3,6,8,7,11,10,11,16,9,9,10,8,9,11,11,7,5,13,9,10,9,9,10,8,11,10,9,12,10,11,6,8,14,12,11,11,11,11,10,13,4,20,11,13,3,3,3,3,3,1,3,1,2,1,3
"3451",59059196,"Marsel' Islamkulov","4/18/1994 (29 years old)","GK","Abdysh-Ata","Kyrgyzstani High League","KGZ","No","1/26/2023","12/31/2023","$0 - $20K","Right Only","Weak","Very Strong","6'2""","171 lbs","123","-",92,99,3,3,3,2,8,7,1,2,1,1,10,3,3,3,15,12,9,9,12,10,8,3,2,2,14,9,8,8,10,10,9,11,17,10,8,9,13,13,9,10,11,11,11,7,6,2,20,13,13,8,9,14,15,8,7,14,8,13,14,12
"3452",59006087,"Pavel Matyash","7/11/1987 (35 years old)","GK","Muras United","Kyrgyzstani High League","KGZ","No","3/30/2023","12/31/2023","$0","Right","Reasonable","Very Strong","6'6""","207 lbs","108","-",75,98,3,2,3,3,6,6,1,3,1,3,9,1,1,1,12,11,8,7,14,14,15,2,12,2,10,8,7,7,9,6,6,17,8,6,7,8,8,20,12,10,10,10,9,12,14,2,6,10,18,8,8,10,6,10,13,10,5,10,10,13
"3453",318119,"Aender","2/12/1983 (40 years old)","D (C), DM, M (C)","C & W District","Hong Kong First Division","HKG","No","12/15/2022","6/30/2024","$0 - $2K","Right","Reasonable","Very Strong","5'9""","182 lbs","219","29",67,130,10,7,5,6,6,10,6,10,2,10,9,3,11,8,11,11,12,9,11,10,11,8,9,6,10,11,10,12,9,7,11,6,14,9,12,11,11,12,12,10,7,12,15,8,6,5,7,8,8,2,2,3,1,1,2,2,2,1,2,3
"3454",19025808,"Hélio","1/31/1986 (37 years old)","D (C)","Kitchee","Hong Kong Premier League","HKG","No","8/1/2022","6/30/2024","$0 - $26K","Right","Reasonable","Very Strong","6'1""","174 lbs","214","12",80,129,8,7,8,3,9,6,12,2,7,12,7,1,12,7,8,12,10,9,11,11,16,5,6,6,13,9,8,9,8,8,12,14,12,6,9,11,12,13,12,12,11,11,13,2,15,2,14,13,14,1,1,1,3,3,3,3,3,2,3,4
"3455",316579,"Roberto","5/28/1983 (40 years old)","D (C), DM, M (C)","Kitchee","Hong Kong Premier League","HKG","Yes","6/12/2023","6/30/2024","$500 - $6K","Right","Reasonable","Very Strong","5'10""","167 lbs","247","15",77,118,9,6,7,7,11,9,7,9,4,10,12,3,10,10,12,11,12,10,10,11,14,11,10,9,10,8,11,13,8,9,8,7,12,8,12,8,13,6,12,10,7,8,5,12,5,1,11,10,9,2,3,1,1,2,2,1,1,3,2,3
"3456",23078403,"Mahama Awal","6/10/1991 (32 years old)","AM (R), ST (C)","Southern District","Hong Kong Premier League","HKG","No","7/29/2022","6/30/2025","Not for Sale","Right Only","Very Weak","Very Strong","5'9""","171 lbs","229","60",74,111,9,8,9,8,8,9,12,6,9,9,6,6,6,8,6,9,14,9,11,8,12,14,14,12,10,11,8,13,13,12,8,10,9,14,9,7,13,20,14,7,11,13,9,5,4,7,12,5,13,2,3,1,2,2,2,2,4,1,1,2
"3457",2000040739,"Christian Brauzmann","8/15/2003 (19 years old)","D (RC)","Abdysh-Ata","Kyrgyzstani High League","KGZ","No","6/13/2022","12/31/2023","$1.5K - $18K","Right","Reasonable","Very Strong","6'3""","176 lbs","41","1",88,131,4,6,9,4,7,2,13,4,15,12,12,3,14,10,8,12,9,14,8,9,15,6,12,6,10,12,13,11,12,11,6,13,10,13,12,12,13,13,15,16,12,13,4,10,5,4,15,11,14,1,2,1,3,1,4,1,1,2,3,2
"3458",2104373,"Paulinho Piracicaba","1/16/1983 (40 years old)","AM (RC), ST (C)","HKFC","Hong Kong Premier League","HKG","No","10/7/2022","-","$0","Right","Fairly Strong","Very Strong","5'10""","165 lbs","149","37",64,109,6,7,11,11,10,9,6,7,5,3,8,7,5,11,7,9,6,9,6,9,15,15,12,9,7,7,4,9,10,11,10,8,13,10,9,9,8,14,12,10,15,11,12,12,15,8,13,10,10,4,3,2,2,2,1,1,3,2,1,2
"3459",19016906,"Fernando","11/14/1986 (36 years old)","M (L), AM (LC)","Kitchee","Hong Kong Premier League","HKG","No","7/25/2022","6/30/2024","$0 - $28K","Left","Very Strong","Reasonable","5'11""","167 lbs","137","36",81,106,9,8,12,8,11,10,7,7,8,6,9,9,9,12,6,12,9,9,11,10,7,11,13,9,9,10,9,7,12,13,5,8,10,11,10,8,12,20,9,10,10,9,9,4,8,7,10,12,13,2,1,3,3,1,3,1,2,1,2,1
"3460",19056510,"Diego Eli","9/3/1986 (36 years old)","DM, M (C)","Lee Man","Hong Kong Premier League","HKG","No","7/1/2022","6/30/2024","$0 - $26K","Right","Reasonable","Very Strong","5'11""","189 lbs","141","15",82,104,6,7,8,10,9,9,11,10,6,9,10,5,11,9,14,7,11,11,11,10,12,5,10,9,12,10,12,11,9,9,12,13,13,7,13,10,14,19,10,10,11,10,12,10,16,2,13,11,13,1,3,2,3,3,2,2,2,1,3,2
"3461",67009468,"Recio","12/17/1982 (40 years old)","D (C), DM","Lee Man","Hong Kong Premier League","HKG","Yes","7/1/2022","6/30/2024","$0 - $20K","Right","Reasonable","Very Strong","6'2""","158 lbs","174","7",79,103,3,6,7,1,8,5,12,7,6,11,8,3,12,8,8,11,11,12,12,12,3,7,13,6,11,5,8,11,8,8,9,11,12,8,7,10,13,14,11,8,13,13,13,10,8,3,14,10,14,1,3,2,1,3,3,2,2,3,3,3
"3462",19075369,"Tomás","4/7/1985 (38 years old)","D (RC)","Southern District","Hong Kong Premier League","HKG","No","7/2/2020","6/30/2024","$0","Right","Reasonable","Very Strong","5'11""","189 lbs","124","12",82,103,4,7,3,5,8,1,10,8,1,12,10,4,12,9,13,11,11,8,12,15,7,5,14,8,12,8,6,10,7,7,8,12,10,7,8,12,11,17,11,10,9,10,10,1,10,3,16,12,16,3,4,1,1,3,2,4,1,3,2,1
"3463",2000197505,"Michael Udebuluzor","4/1/2004 (19 years old)","AM (R), ST (C)","FC Ingolstadt 04 II","German Div. Bavaria North","HKG","No","7/1/2020","6/30/2024","$80K - $240K","Right","Strong","Very Strong","6'1""","171 lbs","2","-",79,102,5,8,13,13,13,4,12,7,1,5,5,4,4,11,13,9,4,11,7,10,4,11,8,6,5,6,8,8,10,13,7,11,9,10,6,6,11,13,10,10,9,13,6,5,9,1,9,12,9,1,3,1,3,1,1,1,3,1,3,1
"3464",23348516,"Everton","5/25/1991 (32 years old)","AM (RL), ST (C)","Lee Man","Hong Kong Premier League","HKG","No","7/12/2022","5/31/2026","Not for Sale","Left","Very Strong","Fairly Strong","6'0""","178 lbs","103","54",91,96,9,8,12,12,11,10,8,12,5,3,6,9,4,12,12,10,11,10,8,9,12,6,10,12,3,5,7,10,14,11,11,10,12,13,12,13,6,13,10,11,12,12,12,11,11,7,11,13,8,3,2,2,3,2,2,1,1,1,1,4
"3465",1000438,"Huang Yang","10/19/1983 (39 years old)","DM, M (C)","Kitchee","Hong Kong Premier League","HKG","No","6/12/2023","6/30/2024","$0 - $14K","Right","Reasonable","Very Strong","5'10""","156 lbs","184","2",76,94,9,9,11,6,12,9,7,7,1,8,10,4,7,11,11,11,13,10,12,11,13,8,14,10,12,12,10,13,9,10,12,6,12,8,13,8,12,15,14,17,13,12,3,15,6,2,14,13,13,1,1,1,1,2,1,2,1,1,4,1
"3466",784196,"Yuto Nakamura","1/23/1987 (36 years old)","M/AM (C), ST (C)","Lee Man","Hong Kong Premier League","HKG","No","6/2/2020","6/30/2024","$0 - $4.5K","Right","Strong","Very Strong","5'9""","149 lbs","193","57",70,94,8,9,9,11,4,5,6,8,2,3,8,9,3,9,8,10,14,10,10,10,11,14,13,9,3,9,9,10,11,10,7,6,12,11,11,8,6,11,10,10,11,9,11,10,5,5,8,13,16,3,2,1,1,1,3,3,2,2,3,2
"3467",1010275,"Ju Yingzhi","7/24/1987 (35 years old)","M/AM (C)","Southern District","Hong Kong Premier League","HKG","No","8/1/2022","6/30/2024","$500 - $3.5K","Right Only","Weak","Very Strong","5'9""","171 lbs","190","33",76,93,11,9,11,7,10,12,6,7,3,7,13,5,6,12,7,11,7,10,10,12,7,12,10,10,8,10,13,7,8,10,9,6,13,7,10,9,12,19,14,11,11,13,9,8,14,3,13,12,13,3,2,2,1,1,1,2,2,2,2,3
"3468",89069477,"Guljigit Alykulov","11/25/2000 (22 years old)","AM (RL)","Qairat","Kazakhstan Premier League","KGZ","No","1/27/2020","12/31/2026","$600K - $1.8M","Right","Reasonable","Very Strong","5'7""","132 lbs","116","20",108,129,8,9,16,11,13,10,7,11,11,8,12,13,4,16,5,9,15,9,13,13,15,15,6,13,5,8,8,12,14,11,10,9,13,13,7,12,13,8,12,14,12,11,3,12,5,4,14,11,14,3,3,1,3,2,3,3,2,3,2,1
"3469",23004565,"Yapp Hung Fai","3/21/1990 (33 years old)","GK","Eastern","Hong Kong Premier League","HKG","No","6/9/2023","6/30/2025","Not for Sale","Right Only","Very Weak","Very Strong","5'10""","163 lbs","282","-",80,93,2,2,1,2,3,7,7,2,1,4,6,2,10,3,5,10,13,11,13,11,15,2,14,1,11,10,2,12,8,12,8,9,11,8,8,9,12,6,5,14,14,11,5,16,5,15,15,15,19,9,14,11,10,12,7,11,12,11,12,9
"3470",23010501,"Christian Annan","5/3/1978 (45 years old)","AM (RL), ST (C)","C & W District","Hong Kong First Division","HKG","No","10/8/2022","6/30/2024","$0","Right","Weak","Very Strong","5'5""","127 lbs","281","114",56,93,8,5,10,9,7,7,8,3,8,8,9,8,3,11,13,8,12,7,11,11,12,11,14,10,4,13,13,12,9,10,7,5,11,11,9,8,6,18,10,14,12,6,10,13,6,3,10,13,12,2,3,2,1,2,2,3,3,4,2,1
"3471",23348378,"Sun Ming Him","6/19/2000 (22 years old)","M/AM (L), ST (C)","Eastern","Hong Kong Premier League","HKG","No","8/26/2021","6/30/2026","$35K - $375K","Left","Very Strong","Reasonable","5'10""","163 lbs","77","17",78,90,6,10,10,10,10,4,8,7,4,6,11,5,6,8,12,4,6,9,7,10,11,11,1,11,7,10,7,8,12,12,7,5,14,13,11,10,11,16,11,12,11,11,8,11,12,2,12,12,15,2,1,3,2,1,2,4,2,3,2,3
"3472",2105434,"Paulo César","3/27/1986 (37 years old)","GK","Kitchee","Hong Kong Premier League","HKG","No","8/1/2022","6/30/2024","$0 - $6K","Right Only","Very Weak","Very Strong","6'4""","242 lbs","124","-",70,90,2,2,2,2,3,5,3,2,1,1,7,3,2,3,12,12,13,10,8,8,6,1,8,1,9,8,4,10,8,3,12,13,13,7,12,14,11,16,12,14,9,14,4,9,13,6,6,7,9,12,11,12,7,11,11,11,2,11,11,12
"3473",23164418,"Matt Orr Wing Kai","1/1/1997 (26 years old)","AM (L), ST (C)","GX PG Hawlaeh","Chinese National First Division","HKG","No","8/21/2022","12/31/2023","$0 - $65K","Left","Very Strong","Reasonable","6'2""","176 lbs","47","9",77,90,7,8,9,12,8,7,11,11,8,5,7,7,5,8,14,9,11,11,8,8,10,8,5,12,4,4,5,14,12,11,11,13,13,11,10,13,10,17,8,13,10,7,10,12,13,5,12,13,9,3,3,3,1,3,3,3,3,2,1,2
"3474",23308636,"Yue Tze Nam","5/12/1998 (25 years old)","D (R), DM, M/AM (C)","Meizhou","Chinese Super League","HKG","No","8/21/2022","12/31/2025","$10K","Right","Fairly Strong","Very Strong","5'7""","147 lbs","46","3",83,89,8,8,10,8,9,9,8,10,11,8,9,4,14,9,11,6,11,9,8,7,10,11,13,8,8,8,8,12,11,11,10,6,14,11,10,8,16,14,13,10,9,10,6,13,6,4,10,11,12,2,2,4,3,2,3,3,2,3,3,1
"3475",1027533,"Festus Baise","4/11/1980 (43 years old)","D (C), DM","North District","Hong Kong Premier League","HKG","No","9/1/2022","6/30/2024","$2K - $5K","Right","Weak","Very Strong","5'10""","154 lbs","278","43",65,88,2,4,7,5,7,5,10,10,2,10,7,8,11,8,5,10,13,11,9,9,10,8,14,3,11,8,6,12,7,8,9,9,12,6,8,11,7,19,11,12,11,9,8,12,13,8,14,13,19,2,1,3,1,2,2,1,3,3,3,1
"3476",41000903,"Jean-Jacques Kilama","10/13/1982 (40 years old)","D (C), DM","Rangers (HKG)","Hong Kong Premier League","HKG","No","6/1/2023","6/30/2024","$500 - $2.5K","Right","Reasonable","Very Strong","6'1""","182 lbs","192","13",66,88,5,8,5,8,8,4,13,7,6,12,7,4,10,6,13,6,15,7,9,9,13,2,10,7,7,12,8,12,10,8,12,12,14,8,11,14,6,6,7,15,11,13,10,8,15,5,6,11,11,3,2,1,1,2,1,1,2,3,2,2
"3477",23064403,"Paul Ngué","2/2/1988 (35 years old)","AM (R), ST (C)","HKFC","Hong Kong Premier League","HKG","No","8/1/2022","-","$0","Right","Fairly Strong","Very Strong","6'2""","194 lbs","187","101",57,87,4,6,6,7,5,6,12,11,6,2,7,10,6,6,13,8,3,6,7,5,12,12,9,8,5,8,7,12,11,8,11,13,16,11,9,12,12,17,11,9,10,10,13,3,12,2,10,10,7,3,1,1,1,2,3,3,2,1,1,3
"3478",23273698,"Tse Ka Wing","9/4/1999 (23 years old)","GK","Tai Po","Hong Kong Premier League","HKG","No","8/1/2022","6/30/2025","$16K - $160K","Right Only","Very Weak","Very Strong","6'1""","187 lbs","34","-",70,87,5,2,1,2,6,7,2,3,2,1,7,2,2,3,8,9,12,11,11,9,13,2,7,2,11,7,2,6,9,8,7,11,13,9,7,13,9,6,9,4,14,6,14,13,10,14,12,12,11,8,11,12,5,11,11,12,11,12,12,12
"3479",59145033,"Joel Kojo","8/21/1998 (24 years old)","ST (C)","Dinamo Samarqand","Uzbekistan Pro League","KGZ","No","2/15/2023","12/31/2023","$40K - $130K","Right","Reasonable","Very Strong","5'9""","138 lbs","49","21",100,125,4,5,12,15,12,11,11,6,2,4,7,11,2,12,7,11,7,13,9,13,19,12,4,7,8,7,9,11,16,13,11,10,9,16,11,6,11,16,12,15,11,10,7,9,11,6,17,15,17,3,4,1,4,2,1,2,1,2,1,4
"3480",23164513,"Tan Chun Lok","1/15/1996 (27 years old)","DM, M/AM (C)","Kitchee","Hong Kong Premier League","HKG","No","6/1/2023","5/31/2025","$75K - $230K","Right","Weak","Very Strong","5'9""","160 lbs","121","6",75,87,9,9,8,7,8,10,6,10,6,8,10,9,9,9,8,11,12,10,12,10,12,10,8,7,9,11,6,12,9,12,8,7,13,8,8,9,12,11,12,11,12,11,7,9,12,4,11,11,17,2,3,2,1,1,1,3,2,2,2,3
"3481",23348427,"Lam Hin Ting","12/9/1999 (23 years old)","D (R), DM, M (RC)","Rangers (HKG)","Hong Kong Premier League","HKG","No","6/9/2023","6/30/2025","$6K - $60K","Right","Reasonable","Very Strong","5'9""","165 lbs","68","6",67,86,8,10,5,4,6,5,7,6,5,9,7,4,12,4,13,11,14,11,11,11,13,10,12,7,11,11,6,12,10,9,9,6,7,10,8,10,19,4,4,6,11,11,11,13,18,14,12,7,18,1,1,1,1,2,1,1,2,3,2,2
"3482",23196642,"Law Tsz Chun","3/2/1997 (26 years old)","D (RL), WB/M/AM (R)","Kitchee","Hong Kong Premier League","HKG","No","6/15/2020","6/30/2024","$16K - $170K","Right","Reasonable","Very Strong","5'8""","147 lbs","58","2",75,86,8,7,10,9,4,8,4,6,5,10,8,2,9,7,15,12,8,5,6,8,15,7,9,11,10,12,7,10,14,12,7,4,16,12,11,11,12,18,12,13,12,12,6,15,13,5,12,11,8,1,2,2,2,1,1,1,1,1,1,1
"3483",19045585,"Chan Siu Kwan","8/1/1992 (30 years old)","M/AM (C)","Resources Capital","Hong Kong Premier League","HKG","No","1/24/2023","6/30/2024","$12K - $35K","Right Only","Weak","Very Strong","5'9""","138 lbs","173","27",74,85,9,9,10,5,10,9,9,4,8,10,8,8,11,6,10,8,11,12,9,9,13,8,7,4,9,10,9,13,13,13,11,6,11,12,12,9,12,10,11,13,13,14,7,12,6,2,14,13,9,3,1,1,2,3,2,2,2,2,2,3
"3484",23285139,"Tsui Wang Kit","1/5/1997 (26 years old)","D (RLC), WB (R)","Lee Man","Hong Kong Premier League","HKG","No","7/1/2022","6/30/2024","$2.5K - $26K","Right","Reasonable","Very Strong","5'11""","158 lbs","96","3",74,84,2,7,5,1,5,1,8,2,12,12,6,5,12,5,11,11,13,8,10,9,9,3,14,7,10,13,5,9,12,13,7,9,12,12,10,7,13,17,6,12,10,12,9,2,15,1,11,12,9,3,1,3,3,1,3,1,3,2,3,3
"3485",23497292,"Yu Joy Yin","10/8/2001 (21 years old)","M (C), AM (RLC)","Eastern","Hong Kong Premier League","HKG","No","6/10/2023","6/30/2025","$22K - $230K","Right","Reasonable","Very Strong","5'7""","130 lbs","21","5",68,84,5,9,11,12,8,6,6,8,1,6,10,2,8,10,10,4,6,6,6,8,13,9,7,7,7,7,10,12,13,11,9,7,5,13,10,9,14,20,11,12,8,4,6,3,8,13,12,13,11,3,3,2,1,2,1,4,1,2,3,3
"3486",23196648,"Wu Chun Ming","11/21/1997 (25 years old)","D (RC), DM","Eastern","Hong Kong Premier League","HKG","No","7/17/2019","6/30/2025","$22K - $210K","Right Only","Weak","Very Strong","5'10""","160 lbs","80","3",73,84,6,9,8,6,9,7,9,9,13,9,9,4,11,10,10,7,11,9,11,9,5,9,15,7,9,11,8,10,11,11,9,10,9,11,13,10,9,16,16,16,12,10,8,12,10,3,9,12,7,1,3,3,2,1,3,3,3,1,2,1
"3487",23034801,"Wong Wai","9/17/1992 (30 years old)","M/AM (C)","Lee Man","Hong Kong Premier League","HKG","No","7/8/2022","6/30/2024","$65K - $190K","Right Only","Weak","Very Strong","6'0""","165 lbs","205","52",77,84,8,7,11,10,12,11,9,8,3,6,9,7,8,12,7,9,9,10,10,11,17,10,11,11,11,13,11,7,11,9,6,7,8,11,11,6,12,18,11,11,10,10,15,12,9,4,19,13,9,2,3,3,3,1,2,3,3,3,3,3
"3488",23232166,"Cheng Chin Lung","1/8/1998 (25 years old)","AM (LC)","Kitchee","Hong Kong Premier League","HKG","No","6/15/2020","6/30/2024","$0 - $40K","Right","Strong","Very Strong","5'7""","158 lbs","50","7",69,83,3,8,9,10,14,2,10,12,1,6,14,3,6,12,5,10,11,9,8,8,12,10,9,9,7,7,7,7,10,9,8,7,8,8,8,6,9,18,19,12,12,11,14,2,1,2,14,13,13,2,2,3,2,3,3,1,1,3,4,1
"3489",23070662,"Leung Nok Hang","11/14/1994 (28 years old)","D (C)","Zhejiang","Chinese Super League","HKG","No","1/1/2021","12/31/2025","$18K - $180K","Right","Weak","Very Strong","6'1""","165 lbs","183","20",82,82,6,8,3,8,6,1,9,7,7,11,10,7,12,5,8,9,10,10,8,10,15,5,7,9,12,10,7,12,8,10,11,13,12,9,11,11,15,17,11,11,8,12,6,5,12,6,9,12,18,3,1,2,1,2,1,1,2,3,2,4
"3490",2000269776,"Avtandil Duishoev","10/27/2004 (18 years old)","AM (RL)","Al-Wahda (UAE)","UAE Professional League","KGZ","No","1/26/2023","6/30/2026","$400K - $4M","Right","Fairly Strong","Very Strong","5'10""","138 lbs","-","-",75,125,6,8,13,8,13,14,5,11,2,2,8,10,3,12,7,10,4,9,5,7,10,15,2,7,10,8,8,6,14,11,9,6,9,12,7,5,8,16,13,9,12,13,15,12,13,6,11,8,16,2,2,2,2,3,1,1,1,1,2,2
"3491",23251654,"Yu Wai Lim","9/21/1998 (24 years old)","D (RC), DM","Lee Man","Hong Kong Premier League","HKG","No","7/1/2022","6/30/2024","$0 - $85K","Right","Reasonable","Very Strong","5'9""","163 lbs","99","-",69,81,7,10,3,4,10,8,13,7,14,11,9,6,11,9,13,8,7,6,9,7,9,5,8,8,10,11,8,10,9,10,10,9,10,10,15,9,12,14,10,12,13,12,11,9,6,4,11,11,9,3,2,4,1,2,1,1,2,2,1,2
"3492",23411883,"Poon Pui Hin","10/3/2000 (22 years old)","D/WB (R), M/AM (RL)","Kitchee","Hong Kong Premier League","HKG","No","8/1/2022","6/30/2025","$5K - $50K","Right","Reasonable","Very Strong","5'11""","143 lbs","62","12",70,81,4,8,8,10,9,6,9,7,6,7,7,2,8,6,13,7,8,8,8,7,18,7,1,11,6,7,6,10,13,12,3,10,9,13,6,4,13,11,12,10,9,10,11,11,5,7,16,12,11,3,1,3,1,2,2,2,1,3,1,2
"3493",23308458,"Vas Nuñez","11/22/1995 (27 years old)","D (C)","DL Pro","Chinese Super League","HKG","No","8/21/2022","12/31/2023","$0 - $60K","Right Only","Weak","Very Strong","6'3""","176 lbs","90","4",77,80,6,2,4,8,6,4,11,3,5,12,6,3,16,6,9,10,5,10,12,9,10,4,8,6,10,10,7,12,9,9,11,16,14,10,10,12,12,10,11,10,11,10,12,11,7,3,12,11,14,1,3,3,1,2,2,1,3,1,1,2
"3494",23273691,"Lam Lok Kan","2/2/1999 (24 years old)","D/WB (L), M/AM (LC)","Resources Capital","Hong Kong Premier League","HKG","No","8/21/2021","6/30/2024","$0","Left Only","Very Strong","Weak","5'9""","167 lbs","60","4",53,80,6,9,8,10,10,6,4,11,4,7,10,1,8,10,7,10,7,8,8,10,9,7,10,11,8,7,8,8,9,7,7,9,14,9,4,7,11,19,12,11,11,11,10,12,6,6,19,11,14,1,1,2,1,3,1,2,2,2,2,1
"3495",133858,"Lo Kwan Yee","10/9/1984 (38 years old)","D/WB (R), DM, M/AM (R)","Rangers (HKG)","Hong Kong Premier League","HKG","No","5/30/2023","6/30/2024","$0 - $10K","Right","Reasonable","Very Strong","5'7""","141 lbs","382","41",63,80,11,11,9,7,9,9,3,7,12,6,9,6,5,9,10,8,13,8,10,9,7,10,14,8,8,9,11,10,8,9,6,5,14,8,9,4,14,10,12,11,13,15,8,8,16,1,9,12,10,1,2,1,1,3,3,3,1,1,2,1
"3496",23132369,"Wong Tsz Ho","3/7/1994 (29 years old)","D/WB/AM (L)","Eastern","Hong Kong Premier League","HKG","No","8/1/2022","6/30/2025","$60K - $180K","Left Only","Very Strong","Very Weak","5'8""","141 lbs","145","11",72,79,7,12,7,10,11,7,6,1,7,9,11,4,12,10,15,9,8,12,7,10,3,13,13,11,12,5,6,9,12,10,8,2,15,12,14,5,18,13,13,10,8,10,10,12,10,5,19,12,10,4,3,3,2,2,2,3,4,1,1,4
"3497",7401902,"Jack Sealy","5/4/1987 (36 years old)","D/WB/AM (R)","HKFC","Hong Kong Premier League","HKG","No","8/1/2022","-","$0","Right","Fairly Strong","Very Strong","5'8""","165 lbs","233","14",63,79,6,10,6,6,5,7,6,5,11,11,6,9,10,8,6,9,8,6,9,7,15,6,11,3,9,5,6,10,7,7,11,6,6,9,12,11,10,7,11,13,10,8,6,3,9,8,8,13,16,1,1,2,4,3,2,3,3,1,3,2
"3498",23469337,"Chang Hei Yin","4/6/2000 (23 years old)","M (L), AM (RLC)","Lee Man","Hong Kong Premier League","HKG","No","7/1/2022","6/30/2024","$30K - $90K","Right","Fairly Strong","Very Strong","5'8""","165 lbs","28","6",68,79,8,8,8,10,6,8,7,6,8,8,10,4,9,6,12,11,11,11,9,8,16,8,14,9,8,9,6,11,12,8,9,6,9,11,11,8,14,10,11,11,11,11,15,11,14,4,16,11,8,4,2,2,2,2,3,3,3,2,1,1
"3499",138265,"Lam Ka Wai","6/5/1985 (38 years old)","M/AM (C)","Rangers (HKG)","Hong Kong Premier League","HKG","No","5/30/2023","6/30/2024","$3.5K - $10K","Left Only","Very Strong","Very Weak","5'8""","158 lbs","315","40",66,79,10,11,12,9,12,11,9,12,6,8,12,8,6,12,15,12,10,10,8,10,10,12,11,11,10,8,12,8,8,11,11,6,10,9,6,5,10,11,12,13,12,12,10,10,6,3,12,11,13,2,2,2,3,3,3,3,2,3,1,2
"3500",7401886,"Andy Russell","11/21/1987 (35 years old)","D (C), DM","Kitchee","Hong Kong Premier League","HKG","No","2/8/2023","6/30/2024","$0 - $6K","Right","Strong","Very Strong","5'11""","158 lbs","325","25",70,79,3,3,4,4,2,7,14,9,4,8,3,8,13,6,16,12,14,9,10,6,4,6,11,7,9,6,7,9,7,7,12,14,13,7,9,15,8,10,8,11,12,13,9,9,10,7,6,10,8,3,1,2,3,2,2,1,3,2,3,3
"3501",2000185522,"Louis Linsmaier","11/18/2005 (17 years old)","M (R), ST (C)","Vaduz","Swiss Challenge League","LIE","Yes","7/1/2022","6/30/2025","$0 - $70K","Right","Fairly Strong","Very Strong","6'0""","160 lbs","-","-",60,87,6,8,13,14,14,6,9,7,2,6,6,6,6,11,7,6,2,8,2,9,3,10,6,9,3,6,5,8,13,9,7,8,10,8,4,6,10,14,10,12,10,10,9,3,5,6,7,9,11,2,2,1,1,3,1,2,3,1,2,4
"3502",2000093639,"Danie Asyraf Fadzli","1/4/2002 (21 years old)","AM (R)","Johor DT","Malaysian Super League","MAS","No","1/1/2023","11/30/2024","$10K - $100K","Right","Fairly Strong","Very Strong","5'6""","130 lbs","2","-",106,113,7,12,11,9,14,8,7,6,8,8,12,5,9,12,12,10,8,8,9,14,7,11,1,12,7,9,10,10,13,14,9,3,10,14,9,1,15,15,11,12,9,11,6,11,14,2,9,11,16,1,1,1,2,3,3,2,4,2,3,1
"3503",72021825,"Moisés Hernández","3/5/1992 (31 years old)","D/WB (L)","Miami FC","USSL Championship Eastern Conference","GUA","No","1/19/2023","11/30/2024","Not for Sale","Left","Very Strong","Reasonable","6'0""","160 lbs","217","5",102,108,6,11,9,7,12,6,7,6,12,9,11,6,11,11,13,9,11,9,10,8,13,6,5,8,9,12,12,10,14,13,13,13,12,13,14,13,10,15,13,12,9,14,9,9,5,4,12,9,14,2,1,3,1,3,1,2,3,3,1,2
"3504",87011626,"Bryan Ordóñez","11/5/1990 (32 years old)","M (L), AM (LC), ST (C)","Xinabajul","Liga Nacional de Guatemala","GUA","No","7/1/2021","6/30/2024","$85K - $850K","Left","Very Strong","Fairly Strong","5'5""","145 lbs","282","35",100,107,9,11,12,9,12,6,10,5,4,7,11,5,7,12,12,9,9,9,11,9,8,9,8,12,9,7,11,14,13,13,9,5,13,13,12,9,10,8,6,10,10,13,3,12,6,1,12,9,16,1,3,3,1,2,2,4,2,2,3,3
"3505",87016035,"Luis Lucero","9/8/1990 (32 years old)","GK","Sanarate","-","GUA","No","6/1/2022","6/30/2024","$9K - $90K","Right","Fairly Strong","Very Strong","5'10""","156 lbs","49","-",86,107,1,1,2,3,6,5,1,2,2,2,12,3,1,6,10,10,11,7,8,14,9,2,8,1,8,8,7,7,10,9,7,7,14,9,5,7,13,8,8,10,13,10,12,10,9,5,14,9,7,8,9,12,7,7,13,14,5,11,14,12
"3506",43203869,"Gerardo Gordillo","8/17/1994 (28 years old)","D (C)","JUV","Brazilian National Second Division","GUA","Yes","12/1/2022","12/31/2024","$0","Right Only","Weak","Very Strong","6'2""","185 lbs","184","6",107,107,4,5,8,7,8,6,16,6,7,13,10,8,12,10,13,14,10,11,10,10,18,9,10,11,12,11,7,12,10,12,14,15,14,10,13,14,11,6,12,14,14,10,12,12,12,1,11,11,13,1,4,2,3,2,3,1,2,1,2,1
"3507",87035959,"Víctor Armas","12/6/1995 (27 years old)","WB/M/AM (L)","Guastatoya","Liga Nacional de Guatemala","GUA","No","12/12/2022","6/30/2024","$14K - $140K","Left","Very Strong","Reasonable","5'9""","138 lbs","160","10",89,107,7,8,11,12,12,7,4,5,5,7,11,2,8,13,7,10,8,7,9,10,14,13,10,13,5,8,7,9,14,12,8,6,10,14,14,5,12,15,6,12,13,12,5,16,11,6,9,12,14,3,1,1,1,3,1,2,1,2,2,1
"3508",87036871,"Bryan Lemus","4/1/1994 (29 years old)","WB/M/AM (L)","Xelajú","Liga Nacional de Guatemala","GUA","No","12/31/2022","6/30/2024","$14K - $130K","Left","Very Strong","Reasonable","5'4""","156 lbs","229","19",89,107,8,11,6,10,11,9,7,7,5,6,12,4,9,13,8,9,6,7,7,14,10,13,12,12,8,6,9,9,14,13,8,2,12,12,14,5,14,1,1,11,10,11,12,9,11,8,10,12,20,2,3,3,2,1,1,1,1,2,2,2
"3509",2000032638,"Kieran Ngwenya","9/25/2002 (20 years old)","D/WB (L)","Aberdeen","cinch Premiership","MWI","No","7/19/2021","5/31/2024","$0 - $55K","Left Only","Very Strong","Weak","6'3""","180 lbs","57","-",80,128,5,6,10,4,12,1,7,5,9,10,12,4,11,14,10,7,12,11,13,6,19,5,6,9,6,12,11,12,12,13,12,13,15,14,13,11,15,19,13,11,10,11,7,8,4,8,12,10,17,2,2,4,2,3,2,3,1,3,1,3
"3510",13137118,"Gabadhino Mhango","9/27/1992 (30 years old)","ST (C)","AmaZulu","South African Premier Soccer League","MWI","No","6/30/2022","6/30/2024","$0","Right","Fairly Strong","Very Strong","5'4""","167 lbs","182","59",114,120,11,11,12,14,13,8,11,10,8,7,11,12,8,13,9,11,4,4,9,8,4,13,7,15,6,10,12,13,17,9,12,7,11,16,12,9,9,12,11,9,11,10,9,12,12,8,11,10,15,2,1,1,3,3,2,2,1,2,3,3
"3511",13221922,"Peter Banda","9/22/2000 (22 years old)","M (L), AM (RL)","Simba","Tanzanian Mainland Premier Division","MWI","No","7/31/2021","6/30/2024","$22K - $220K","Right","Weak","Very Strong","5'7""","138 lbs","37","9",95,115,8,9,12,10,12,10,5,11,9,5,12,8,4,13,7,10,9,8,11,9,14,12,5,10,4,10,9,12,14,15,10,5,14,14,9,5,12,17,11,10,11,11,13,8,12,7,10,10,8,2,2,2,3,3,2,3,2,1,3,2
"3512",2000253048,"Paul Kansungwi","3/13/2002 (21 years old)","M/AM (C)","Ferroviário de Nampula","Mozambican Premier Division","MWI","No","2/1/2023","12/31/2023","$0 - $75K","Right Only","Weak","Very Strong","5'6""","127 lbs","-","-",82,112,7,7,8,10,13,5,2,14,1,9,14,6,9,13,6,11,8,8,8,8,9,12,11,11,8,8,14,12,14,13,8,2,9,14,7,3,12,20,12,11,10,11,13,6,7,1,13,11,12,3,2,3,2,2,1,1,2,1,1,1
"3513",2000093645,"Muhd Shazriman Hasnul","3/5/2002 (21 years old)","D (C)","Johor DT","Malaysian Super League","MAS","No","1/1/2023","11/30/2024","$100K - $300K","Right","Weak","Very Strong","6'0""","165 lbs","-","-",109,112,5,1,3,4,10,6,13,3,6,15,9,6,14,9,15,14,11,5,10,15,2,6,1,9,15,9,6,10,15,15,10,12,9,13,7,7,12,15,10,13,10,11,12,11,9,2,14,12,14,4,3,3,1,2,3,3,3,3,2,2
"3514",13204324,"Chimwemwe Idana","9/7/1998 (24 years old)","M/AM (C)","Bullets FC","Malawian Premier Division","MWI","No","6/15/2020","12/31/2024","$0 - $35K","Right","Reasonable","Very Strong","6'0""","163 lbs","-","-",87,110,4,4,9,11,14,7,2,9,6,8,14,7,9,10,9,8,8,8,8,14,16,9,8,10,6,8,7,13,14,12,8,11,17,14,12,7,12,20,14,8,12,11,9,2,6,2,11,12,17,3,1,3,1,1,1,2,1,3,1,2
"3515",65032411,"Gerald Phiri Jr","6/8/1993 (30 years old)","AM (R)","Al-Hilal Omdurman","Sudanese Premier League","MWI","No","11/7/2021","6/30/2025","$0","Right","Fairly Strong","Very Strong","5'11""","156 lbs","86","9",101,105,8,13,13,13,8,8,4,9,8,8,13,3,4,12,12,9,7,10,7,11,11,12,8,12,8,8,10,12,14,14,9,8,14,13,14,6,13,19,11,11,11,13,12,13,5,4,11,14,16,2,2,2,2,1,3,1,2,3,3,1
"3516",13103530,"Atusaye Nyondo","7/25/1990 (32 years old)","ST (C)","Silver Strikers","Malawian Premier Division","MWI","No","5/25/2023","6/30/2024","$0","Right","Reasonable","Very Strong","5'11""","154 lbs","164","44",75,105,8,8,8,9,7,7,11,7,7,7,8,6,4,10,5,12,1,10,8,11,8,11,10,10,8,7,7,8,17,11,7,7,14,15,5,6,12,15,10,13,9,9,5,6,10,2,18,11,14,1,3,2,3,3,4,3,2,4,1,1
"3517",2000166451,"Stanley Billiat","10/10/2002 (20 years old)","M/AM (L)","Bullets FC","Malawian Premier Division","MWI","No","1/1/2019","12/31/2025","$0","Left","Very Strong","Fairly Strong","5'11""","154 lbs","-","-",62,103,6,9,12,10,9,5,1,3,2,2,11,1,5,13,5,7,3,5,6,7,5,14,1,12,5,6,6,7,13,13,5,8,9,13,7,3,10,10,12,9,15,9,11,13,5,8,11,12,11,1,2,3,2,3,3,1,2,1,2,3
"3518",13103547,"Peter Wadabwa","9/14/1988 (34 years old)","M/AM (R)","Mighty Wanderers","Malawian Premier Division","MWI","No","3/10/2020","12/31/2024","Not for Sale","Right Only","Weak","Very Strong","5'9""","156 lbs","5","2",80,101,7,12,8,13,14,5,8,8,2,7,11,8,5,15,10,11,6,12,9,13,4,13,13,14,6,9,11,10,12,12,9,5,11,12,7,7,10,13,10,10,12,13,13,8,14,1,16,10,10,2,3,2,1,1,3,3,2,2,2,1
"3519",13204323,"Precious Sambani","5/21/1998 (25 years old)","D/M (L)","Bullets FC","Malawian Premier Division","MWI","No","1/1/2019","12/31/2024","$500 - $5K","Left","Very Strong","Reasonable","5'9""","143 lbs","-","-",86,100,8,10,7,2,10,8,8,7,8,10,5,2,13,9,12,10,9,10,9,9,14,5,5,9,8,14,9,14,15,14,14,8,13,11,11,5,15,15,12,9,10,9,5,4,7,3,11,11,17,3,1,3,1,2,3,3,3,3,2,3
"3520",13185368,"Kuwali","6/27/1996 (26 years old)","AM (L), ST (C)","Blue Eagles FC","Malawian Premier Division","MWI","No","12/31/2021","12/31/2023","$0 - $9K","Left","Very Strong","Reasonable","5'6""","152 lbs","20","4",85,100,6,11,13,12,8,5,8,2,6,6,11,4,1,13,11,8,3,10,7,13,5,13,13,10,3,7,6,8,13,13,7,3,14,13,13,4,9,19,9,9,10,10,13,4,10,3,11,11,18,2,3,3,3,1,2,4,2,2,2,1
"3521",13227288,"Charles Petro","2/8/2001 (22 years old)","D/WB (R)","FC Botoşani","Romanian First League","MWI","No","1/7/2023","12/31/2024","$85K - $850K","Right","Weak","Very Strong","5'8""","149 lbs","52","2",87,100,9,9,9,7,9,8,10,8,11,10,10,8,11,10,11,10,12,10,8,10,9,8,7,9,9,12,9,12,13,12,10,11,12,12,12,9,13,17,9,9,12,10,6,8,9,5,10,11,8,2,1,2,1,2,1,3,3,3,3,2
"3522",13160226,"Frank Banda","1/12/1991 (32 years old)","M/AM (L)","Silver Strikers","Malawian Premier Division","MWI","No","12/16/2020","12/31/2024","Not for Sale","Left Only","Very Strong","Weak","5'7""","156 lbs","80","9",75,100,7,9,6,9,14,7,8,8,7,6,11,6,4,14,15,9,4,11,8,13,14,13,10,12,7,8,8,9,12,13,8,3,14,12,7,3,10,19,12,10,11,8,12,8,8,4,11,12,10,1,2,3,1,2,1,2,3,1,2,3
"3523",13103272,"Chiukepo Msowoya","9/23/1988 (34 years old)","ST (C)","Mighty Wanderers","Malawian Premier Division","MWI","No","1/1/2022","12/31/2024","Not for Sale","Right Only","Weak","Very Strong","6'1""","182 lbs","21","2",80,100,6,10,11,8,10,7,9,8,6,5,9,8,7,11,8,7,13,13,12,11,11,11,9,12,13,11,13,12,11,10,11,9,12,11,12,10,7,13,12,12,10,10,8,9,9,8,9,13,11,1,1,1,3,3,1,2,1,3,3,3
"3524",2000093377,"Muhd Riezman Irfan Mustafah","9/26/2001 (21 years old)","GK","Johor DT","Malaysian Super League","MAS","No","1/1/2022","11/30/2024","$95K - $275K","Right","Fairly Strong","Very Strong","6'2""","171 lbs","1","-",107,110,4,3,1,3,5,6,1,2,1,1,7,3,2,1,7,12,11,5,12,14,8,3,10,1,12,4,8,8,12,11,9,12,15,13,8,7,11,13,10,14,11,12,8,15,13,3,12,10,9,11,15,14,10,8,9,14,5,9,12,14
"3525",67141803,"Robin Ngalande","11/2/1992 (30 years old)","AM (C), ST (C)","Mighty Wanderers","Malawian Premier Division","MWI","No","9/21/2022","12/31/2024","$0 - $2K","Right","Fairly Strong","Very Strong","5'10""","158 lbs","78","8",79,98,6,8,7,13,9,6,8,7,3,6,8,5,3,10,11,8,7,9,5,13,12,10,5,13,7,7,3,12,13,13,11,4,12,13,11,8,9,11,11,8,10,13,13,10,5,3,8,10,9,2,2,3,1,3,4,1,3,3,1,3
"3526",2000157615,"Lawrence Chaziya","8/19/1998 (24 years old)","D (C)","Hussein","Jordanian Professional League","MWI","No","2/6/2022","6/30/2024","$4.5K - $45K","Right","Reasonable","Very Strong","6'1""","169 lbs","-","-",80,96,5,4,4,5,9,2,11,4,1,11,10,5,9,9,15,11,10,10,11,11,13,5,7,8,10,9,9,10,11,9,10,14,14,10,11,6,14,18,12,9,11,9,6,10,5,1,14,11,19,3,4,3,1,2,2,1,1,3,2,2
"3527",13167401,"Chawanangwa Kaonga","1/5/1995 (28 years old)","M (C), AM (RLC), ST (C)","Zanaco","Zambian Premier League","MWI","No","2/2/2023","12/31/2023","$40K - $120K","Left","Very Strong","Reasonable","5'7""","136 lbs","103","19",93,95,7,9,12,11,13,7,7,7,1,7,8,8,6,13,7,8,7,11,5,10,7,13,5,9,8,8,8,9,13,13,8,4,15,13,13,4,12,13,11,10,9,12,11,6,6,2,16,12,11,1,3,3,2,3,3,1,3,4,3,1
"3528",13176743,"Yamikani Fodya","12/12/1991 (31 years old)","D (LC)","Bullets FC","Malawian Premier Division","MWI","No","6/14/2021","12/31/2024","Not for Sale","Left","Very Strong","Reasonable","6'1""","169 lbs","-","-",80,95,6,9,3,4,10,2,10,6,8,13,12,2,13,5,9,11,10,8,10,12,20,5,8,8,11,9,9,14,5,7,10,12,12,8,11,6,14,19,13,12,14,9,13,9,10,3,19,11,19,3,3,3,2,2,2,2,2,1,2,4
"3529",13109163,"John Banda","4/20/1993 (30 years old)","M/AM (RLC)","UD Songo","Mozambican Premier Division","MWI","No","1/15/2022","12/31/2023","$1.5K - $14K","Right","Reasonable","Very Strong","5'3""","132 lbs","85","15",90,95,8,11,10,10,10,7,3,9,6,5,6,6,9,13,14,9,4,10,7,11,15,13,11,8,7,5,9,10,13,13,8,1,14,13,13,4,15,11,14,13,11,11,13,8,14,6,13,10,9,3,3,1,2,1,1,2,3,1,3,2
"3530",2000103487,"Maxwell Gasten","3/1/1999 (24 years old)","ST (C)","Silver Strikers","Malawian Premier Division","MWI","No","10/1/2019","12/31/2023","$0","Right","Reasonable","Very Strong","6'2""","167 lbs","-","-",76,95,6,3,13,13,8,5,8,3,1,6,8,2,2,7,13,7,6,7,7,11,6,7,1,13,6,7,3,11,13,12,13,13,11,13,12,4,10,12,12,12,10,10,7,6,8,5,9,11,8,2,1,2,4,1,2,2,1,2,2,2
"3531",65032420,"Micium Mhone","5/19/1995 (28 years old)","AM (RC)","Blue Eagles FC","Malawian Premier Division","MWI","No","6/15/2020","12/31/2023","$0 - $8K","Right","Reasonable","Very Strong","5'7""","125 lbs","14","1",85,95,8,11,13,9,8,6,7,8,5,7,13,7,7,12,8,9,4,9,6,9,15,12,13,11,7,8,9,13,14,14,14,2,13,14,9,2,11,11,12,9,13,9,6,8,9,8,10,10,15,3,3,2,2,3,3,4,1,2,3,3
"3532",2000043644,"Nickson Nyasulu","3/3/1998 (25 years old)","D (LC)","Bullets FC","Malawian Premier Division","MWI","No","1/1/2019","12/31/2024","$0 - $4K","Left","Very Strong","Reasonable","6'1""","178 lbs","-","-",82,95,6,10,6,4,11,2,11,8,4,11,7,3,14,9,10,11,10,12,11,11,15,5,11,9,10,9,9,10,11,11,10,14,12,11,8,11,14,14,13,11,12,9,11,2,7,3,11,9,18,3,1,1,2,2,3,1,3,4,2,2
"3533",2000043642,"Duncan Nyoni","5/18/1998 (25 years old)","M (L), AM (RL)","Silver Strikers","Malawian Premier Division","MWI","No","7/1/2022","12/31/2023","$0 - $12K","Left","Very Strong","Reasonable","5'9""","147 lbs","66","4",88,95,11,12,12,10,13,7,7,6,4,4,13,10,3,10,10,8,10,11,9,10,12,13,9,10,5,10,11,14,13,12,11,11,8,12,12,10,12,10,9,11,11,11,8,13,11,7,9,10,11,2,2,3,1,4,3,1,3,3,1,1
"3534",13192368,"Richard Mbulu","1/25/1994 (29 years old)","AM (R), ST (C)","Costa do Sol","Mozambican Premier Division","MWI","No","2/1/2023","12/31/2023","$0 - $50K","Right Only","Weak","Very Strong","6'1""","171 lbs","131","20",90,95,5,9,13,13,11,7,13,5,1,7,11,6,2,10,8,10,9,10,7,10,10,10,3,11,6,7,4,9,13,13,7,11,16,13,13,5,14,14,12,11,12,10,7,15,8,5,10,10,18,3,4,2,3,3,1,2,3,2,1,3
"3535",70088175,"Liridon Krasniqi","1/1/1992 (31 years old)","M/AM (C)","Terengganu","Malaysian Super League","MAS","No","12/20/2019","12/31/2023","$1.5K - $16K","Right","Weak","Very Strong","6'4""","198 lbs","161","23",85,109,6,10,14,7,14,8,10,9,6,5,13,8,8,16,10,12,10,14,8,12,14,12,6,12,12,11,12,10,6,12,14,11,12,8,10,11,12,10,10,12,11,9,9,13,5,5,8,10,11,1,2,1,3,3,2,2,3,1,1,2
"3536",13167409,"Brighton Munthali","12/11/1997 (25 years old)","GK","Bullets FC","Malawian Premier Division","MWI","No","9/13/2021","12/31/2024","$0","Right","Reasonable","Very Strong","6'3""","178 lbs","-","-",80,95,3,3,2,1,2,7,1,3,1,1,11,1,1,6,13,7,10,8,9,8,11,1,11,3,11,8,7,6,13,10,8,13,10,8,3,6,10,18,11,10,11,11,10,6,8,3,12,9,16,8,8,14,5,11,13,13,5,9,10,13
"3537",2000043647,"William Thole","10/2/1998 (24 years old)","GK","Mighty Wanderers","Malawian Premier Division","MWI","No","1/1/2019","12/31/2025","$0","Right","Reasonable","Very Strong","5'9""","154 lbs","-","-",75,95,4,1,3,3,3,8,1,1,2,3,8,1,3,7,8,13,8,5,10,14,6,2,9,3,11,8,7,7,9,14,8,5,12,9,7,4,11,14,14,10,12,11,13,6,6,7,19,12,10,6,5,8,6,9,13,11,10,11,10,8
"3538",13177285,"Zicco Mkanda","12/17/1990 (32 years old)","ST (C)","Bullets FC","Malawian Premier Division","MWI","No","3/19/2020","12/31/2024","Not for Sale","Right","Fairly Strong","Very Strong","5'9""","167 lbs","-","-",88,95,7,6,10,14,14,7,14,7,1,5,8,4,6,13,13,7,8,10,8,10,7,12,12,13,6,7,5,8,10,10,3,7,11,11,13,7,12,15,11,10,12,12,10,16,5,1,5,11,8,4,3,3,2,1,1,3,1,2,2,1
"3539",2000242025,"Lloyd Njaliwa","5/24/1998 (25 years old)","AM (C), ST (C)","Costa do Sol","Mozambican Premier Division","MWI","No","2/1/2023","12/31/2023","$5K - $16K","Right Only","Weak","Very Strong","5'10""","160 lbs","-","-",75,94,6,7,13,10,10,6,8,8,1,3,9,2,2,8,13,9,7,9,6,8,18,10,7,9,6,5,5,8,13,13,7,3,12,13,13,8,10,10,11,10,7,12,11,2,8,3,10,11,17,2,2,2,3,1,2,2,3,1,4,3
"3540",2000288956,"Chifundo Mphasi","4/17/2004 (19 years old)","AM (R)","Shamuel Academy","Zambian Lower Division","MWI","No","3/1/2021","7/1/2024","$0","Right","Reasonable","Very Strong","5'8""","138 lbs","-","-",72,94,4,8,12,10,11,6,7,13,1,2,12,2,7,11,13,8,6,7,7,5,15,11,13,8,6,7,5,11,13,13,13,5,15,13,6,3,9,19,12,10,11,14,7,14,10,4,8,11,15,3,2,3,3,1,3,2,2,1,3,3
"3541",13210736,"Gastin Simukonda","2/26/1993 (30 years old)","ST (C)","Moyale","Malawian Premier Division","MWI","No","6/14/2021","12/31/2023","$0 - $9K","Right","Reasonable","Very Strong","5'9""","160 lbs","-","-",86,94,3,4,13,11,9,6,14,4,6,5,6,2,1,12,10,11,8,10,8,10,10,11,5,13,7,7,2,7,13,13,7,4,13,14,6,13,12,15,11,9,10,12,9,18,8,6,20,13,18,1,1,1,2,2,1,3,1,4,1,2
"3542",2000166443,"Innocent Shema","12/5/2002 (20 years old)","D (RC)","Bullets FC","Malawian Premier Division","MWI","No","7/2/2019","12/31/2025","$0","Right","Fairly Strong","Very Strong","6'0""","163 lbs","-","-",65,93,3,9,6,6,8,1,8,6,6,10,5,1,14,6,10,7,8,7,9,11,9,6,7,6,7,7,5,8,14,14,8,9,15,14,7,7,14,18,10,13,14,13,5,12,12,3,12,9,17,2,3,2,2,2,2,2,3,2,1,3
"3543",2000166450,"Aubrey Maloya","3/3/2001 (22 years old)","AM (R), ST (C)","Ferroviário de Quelimane","Mozambican Premier Division","MWI","No","2/1/2023","12/31/2023","$0 - $30K","Right Only","Weak","Very Strong","5'3""","119 lbs","-","-",68,93,5,10,14,10,12,6,8,7,6,6,13,5,4,7,5,6,5,11,7,8,6,6,10,10,6,7,8,8,14,10,7,1,15,11,5,1,10,15,9,11,13,11,11,9,10,2,10,10,12,1,1,3,2,1,3,3,3,1,1,1
"3544",13204298,"Peter Cholopi","8/19/1996 (26 years old)","D (C)","Mighty Wanderers","Malawian Premier Division","MWI","No","6/15/2020","12/31/2024","$0 - $20K","Right","Fairly Strong","Very Strong","6'3""","154 lbs","-","-",87,92,4,4,4,5,3,3,10,5,4,10,4,7,14,6,9,9,8,8,10,10,18,5,10,6,12,7,8,9,9,10,9,17,8,10,5,10,14,16,9,9,12,11,9,13,5,1,12,11,13,3,1,3,2,2,2,1,4,1,3,3
"3545",13103532,"Sankhani Mkandawire","9/6/1990 (32 years old)","D (C)","Bullets FC","Malawian Premier Division","MWI","No","6/14/2021","12/31/2024","$0","Right","Reasonable","Very Strong","5'11""","165 lbs","-","-",75,92,4,3,1,5,8,7,12,7,3,14,8,4,13,3,11,14,9,5,7,11,13,5,10,4,9,7,4,8,9,8,8,7,10,9,10,6,13,18,12,9,10,11,12,6,8,4,9,12,20,1,4,2,3,1,1,3,1,3,3,2
"3546",2110416,"Guilherme","11/9/1986 (36 years old)","ST (C)","Melaka","Malaysian Division Three League","MAS","No","1/1/2022","11/30/2024","$0 - $18K","Right","Reasonable","Very Strong","6'0""","205 lbs","253","99",84,104,3,10,10,13,10,3,11,5,4,3,6,15,3,8,11,11,11,10,10,8,12,11,7,10,10,9,6,11,13,13,11,12,12,13,12,12,10,11,11,12,11,10,7,12,11,4,13,10,6,1,3,3,3,3,2,2,3,3,4,3
"3547",13167405,"John Lanjesi","3/3/1991 (32 years old)","D (C)","Bullets FC","Malawian Premier Division","MWI","No","6/14/2021","12/31/2024","Not for Sale","Right Only","Weak","Very Strong","6'0""","178 lbs","-","-",80,90,2,1,3,4,5,1,12,7,1,14,6,4,13,1,8,14,9,8,9,10,13,5,6,6,12,7,7,8,8,11,8,11,12,11,7,13,15,17,11,12,9,13,12,14,5,3,13,12,15,1,2,2,3,2,3,3,3,1,2,3
"3548",65001725,"Tawonga Chimodzi","6/26/1988 (34 years old)","DM, M (C)","Silver Strikers","Malawian Premier Division","MWI","No","9/1/2021","6/30/2023","$0","Right Only","Weak","Very Strong","5'11""","158 lbs","200","7",80,90,7,8,8,7,10,7,8,7,6,12,10,8,11,8,13,11,10,11,12,12,13,8,8,6,13,12,7,12,10,10,9,12,13,11,13,8,10,14,12,13,14,14,6,7,7,4,14,13,14,2,1,2,3,1,3,4,3,2,3,2
"3549",13176747,"Mike Mkwate","5/12/1998 (25 years old)","AM (C), ST (C)","Bullets FC","Malawian Premier Division","MWI","No","3/25/2023","12/31/2024","$0 - $1.5K","Right","Reasonable","Very Strong","5'11""","163 lbs","12","-",70,90,6,7,13,13,9,6,12,7,5,6,7,3,4,13,11,8,8,12,7,12,4,13,1,13,4,6,8,8,13,12,7,5,7,13,5,6,8,16,12,12,10,12,12,13,10,1,12,13,15,3,2,2,3,1,1,1,1,3,2,2
"3550",13204331,"Rafiq Namwera","10/30/1991 (31 years old)","M/AM (C)","Black Leopards","South African National First Division Championship","MWI","No","1/1/2022","6/30/2024","$1K - $9K","Right","Reasonable","Very Strong","5'7""","145 lbs","35","-",81,90,9,11,7,11,15,7,9,16,8,10,11,4,8,10,10,10,6,12,10,13,2,11,9,13,8,10,13,11,6,12,10,8,7,10,6,4,16,18,11,14,12,13,7,8,13,2,12,11,16,2,2,1,3,3,2,2,2,1,1,1
"3551",2000006196,"Vitumbiko Kumwenda","9/23/1998 (24 years old)","M/AM (C)","Blue Eagles FC","Malawian Premier Division","MWI","No","6/15/2020","12/31/2024","$0 - $8K","Right","Reasonable","Very Strong","5'7""","136 lbs","-","-",80,90,8,10,15,10,15,6,8,10,2,7,13,8,10,12,7,12,4,12,8,15,14,10,4,11,6,12,6,7,10,14,9,5,9,10,6,2,8,18,11,12,11,10,9,13,11,6,12,12,10,3,2,3,2,2,2,2,1,3,3,2
"3552",2000043632,"Vincent Nyangulu","7/4/1995 (27 years old)","ST (C)","Mighty Wanderers","Malawian Premier Division","MWI","No","1/1/2019","12/31/2024","$0 - $20K","Right","Reasonable","Very Strong","5'11""","154 lbs","-","-",86,90,6,4,11,10,9,6,13,7,4,4,7,6,2,11,5,13,5,12,5,11,16,11,11,13,7,6,7,7,13,13,7,6,15,13,9,6,12,15,10,12,12,12,7,12,9,8,20,9,16,2,4,3,2,1,4,1,2,1,2,2
"3553",2000157628,"Zebron Kalima","2/13/2002 (21 years old)","M (L)","Silver Strikers","Malawian Premier Division","MWI","No","1/1/2020","12/31/2023","$0","Left","Very Strong","Fairly Strong","5'7""","138 lbs","-","-",70,90,6,10,10,4,11,6,4,8,6,6,9,1,6,10,15,8,8,8,7,6,16,5,13,4,6,7,8,8,14,13,13,7,12,13,5,3,14,10,8,12,7,10,5,14,7,7,18,10,12,2,3,1,1,3,3,3,3,2,3,3
"3554",2000154227,"Mark Fodya","12/22/1997 (25 years old)","D (L)","Silver Strikers","Malawian Premier Division","MWI","No","6/15/2020","12/31/2023","$0","Left","Very Strong","Reasonable","6'0""","160 lbs","-","-",80,90,6,12,5,4,10,1,8,1,2,9,8,3,13,8,8,9,9,7,8,14,11,5,11,5,11,8,3,8,14,14,8,7,13,14,9,5,10,12,11,10,12,12,11,6,11,4,11,13,10,2,3,3,3,2,1,2,1,1,3,1
"3555",29162875,"Isaac Kaliati","4/8/1998 (25 years old)","AM (C), ST (C)","Mighty Wanderers","Malawian Premier Division","MWI","No","6/15/2020","12/31/2024","$0 - $1.5K","Right","Reasonable","Very Strong","5'6""","134 lbs","-","-",80,90,7,8,10,12,13,7,13,6,4,6,9,4,4,9,8,11,3,11,7,10,14,8,4,8,8,7,9,9,14,14,8,2,9,14,9,2,10,19,12,11,10,13,11,6,8,8,9,10,16,3,1,3,2,2,1,3,1,3,1,1
"3556",13167613,"Stanley Sanudi","2/2/1995 (28 years old)","D/WB (R)","Mighty Wanderers","Malawian Premier Division","MWI","No","6/15/2020","12/31/2024","$2K - $5K","Right","Reasonable","Very Strong","5'9""","152 lbs","-","-",82,90,6,10,9,5,9,1,10,6,4,10,14,4,15,7,9,12,9,10,10,15,20,5,12,8,11,9,7,13,11,11,7,10,7,12,8,5,12,13,14,10,13,12,11,11,7,6,11,10,15,2,3,3,4,4,3,2,3,1,1,3
"3557",23171842,"Mohamadou Sumareh","9/10/1994 (28 years old)","M (R), AM (RLC)","Johor DT","Malaysian Super League","MAS","No","1/1/2023","11/30/2023","$0 - $65K","Right","Reasonable","Very Strong","5'9""","154 lbs","128","24",90,103,6,9,13,11,11,8,10,7,6,5,9,13,11,12,10,10,12,11,12,11,16,14,8,2,4,11,11,10,13,12,9,10,13,11,12,10,13,15,12,12,11,10,9,14,6,2,12,9,13,1,2,4,1,3,3,1,1,1,3,3
"3558",13167408,"Yamikani Chester","12/20/1994 (28 years old)","AM (RL)","Costa do Sol","Mozambican Premier Division","MWI","No","2/1/2023","12/31/2023","$0 - $35K","Right","Weak","Very Strong","5'11""","160 lbs","31","9",85,90,7,10,13,8,13,6,6,6,6,3,12,1,6,8,8,7,5,5,4,6,9,12,12,13,5,7,5,12,13,13,9,9,11,13,12,9,13,17,10,11,7,11,9,6,7,8,10,8,17,3,1,1,3,1,2,2,1,3,1,3
"3559",13219865,"Francis Mkonda","10/22/1998 (24 years old)","M/AM (C)","Mighty Wanderers","Malawian Premier Division","MWI","No","2/4/2019","12/31/2024","$1.5K - $4K","Right","Fairly Strong","Very Strong","5'10""","149 lbs","-","-",77,90,4,1,5,9,12,6,5,5,1,7,12,8,3,13,10,10,8,12,7,9,10,13,10,7,7,6,11,12,12,12,7,7,13,13,9,4,11,15,10,13,11,12,8,13,9,7,12,10,9,1,2,2,3,2,2,3,2,1,1,1
"3560",13204287,"Charles Thomu","1/24/1999 (24 years old)","GK","Silver Strikers","Malawian Premier Division","MWI","No","1/1/2019","12/31/2023","$0","Right","Fairly Strong","Very Strong","5'11""","154 lbs","-","-",75,90,3,1,1,3,4,5,1,3,2,2,8,4,2,3,12,10,10,7,9,11,8,2,4,2,12,7,6,6,8,9,7,10,14,8,6,3,12,15,11,13,9,12,12,13,7,6,12,11,12,8,8,13,5,5,11,12,5,8,11,12
"3561",2000103500,"Misheck Seleman","11/2/1998 (24 years old)","DM, M (C)","Bullets FC","Malawian Premier Division","MWI","No","3/17/2020","12/31/2025","$0","Right","Reasonable","Very Strong","6'0""","169 lbs","-","-",74,90,8,7,5,9,10,5,8,10,4,10,10,4,10,10,8,9,9,9,10,15,6,5,11,9,10,9,7,10,10,10,8,10,13,10,6,9,14,14,11,9,10,11,11,9,10,6,10,14,15,2,3,1,1,1,1,3,1,1,4,1
"3562",2000166454,"Patrick Mwaungulu","5/18/2002 (21 years old)","M/AM (C)","Bullets FC","Malawian Premier Division","MWI","No","1/1/2020","12/31/2025","$0","Right","Reasonable","Very Strong","6'1""","171 lbs","-","-",70,89,7,6,9,9,13,7,7,7,5,8,11,4,7,11,14,9,5,4,8,9,16,10,13,9,9,8,10,9,13,11,8,13,11,10,6,6,12,13,13,9,13,10,5,5,5,1,12,11,11,3,1,3,1,3,1,2,1,1,1,3
"3563",13204303,"Denis Chembezi","1/15/1997 (26 years old)","D (C)","Black Leopards","South African National First Division Championship","MWI","No","7/1/2022","6/30/2024","$1K - $12K","Right","Fairly Strong","Very Strong","6'2""","174 lbs","44","1",80,89,1,2,5,4,6,1,13,5,1,13,7,1,7,5,15,10,9,3,6,13,2,5,10,3,7,6,5,8,13,13,7,7,12,13,13,8,14,16,13,14,12,10,8,9,11,7,11,9,7,1,1,1,1,1,3,1,3,2,3,2
"3564",13117428,"Casimir Ninga","5/17/1993 (30 years old)","M/AM (L), ST (C)","Anorthosi","Cypriot First Division","CHA","No","7/12/2022","6/30/2025","$120K - $1.2M","Right","Weak","Very Strong","6'1""","178 lbs","174","27",110,127,5,10,11,13,10,5,11,13,5,3,9,10,4,10,13,11,14,11,8,8,15,13,7,13,7,10,9,11,14,13,15,12,10,15,14,14,12,15,13,14,12,13,12,11,8,6,11,15,12,2,3,1,1,1,3,2,2,3,2,1
"3565",2000013648,"Gabin Allambatnan","2/19/2000 (23 years old)","GK","Cotonsport","Cameroonian MTN Elite One Group B","CHA","No","1/2/2021","6/30/2025","$0 - $110K","Right","Fairly Strong","Very Strong","6'8""","198 lbs","-","-",92,119,5,2,1,1,7,9,1,2,2,3,9,2,2,2,14,12,15,9,14,14,11,3,1,3,12,9,8,8,11,9,7,18,13,10,3,9,14,14,10,12,11,12,9,4,14,8,12,11,19,8,6,9,12,7,14,12,5,8,11,15
"3566",8442199,"Azrack Mahamat","3/24/1988 (35 years old)","DM, M (C)","US Lusitanos Saint-Maur","French National 3 - Group H","CHA","Yes","7/21/2022","6/30/2023","$0","Right Only","Weak","Very Strong","6'0""","158 lbs","205","3",84,110,8,11,8,7,12,8,11,8,8,11,9,8,11,11,14,12,13,12,12,12,14,8,10,9,12,12,11,12,11,12,10,11,12,11,12,12,12,20,10,12,11,13,6,2,10,7,14,13,12,3,1,2,1,1,3,4,3,1,3,1
"3567",2000108514,"Brahim Goudja","4/10/2003 (20 years old)","M/AM (L)","Elect Sport FC","Chadian Premier Division","CHA","No","1/1/2022","6/30/2024","$0","Left Only","Very Strong","Weak","5'9""","143 lbs","-","-",79,109,8,12,11,9,13,7,6,6,6,5,9,5,7,13,5,5,4,10,9,8,11,12,1,6,7,8,9,8,14,14,9,6,12,14,9,5,16,15,10,14,12,11,6,3,15,6,10,13,20,1,3,2,2,3,1,1,1,3,1,3
"3568",20015321,"La'Vere Corbin-Ong","4/22/1991 (32 years old)","D (LC), WB (L)","Johor DT","Malaysian Super League","MAS","No","1/1/2023","11/30/2023","$16K - $45K","Left","Very Strong","Reasonable","6'0""","165 lbs","263","10",96,100,6,8,9,5,11,2,9,5,9,15,7,4,14,11,14,13,8,10,12,14,14,5,11,8,10,10,4,10,12,10,7,12,12,9,8,9,17,13,15,15,15,13,8,16,9,5,16,13,8,2,1,1,1,3,1,3,1,3,2,1
"3569",83254092,"Marius Mouandilmadji","1/22/1998 (25 years old)","ST (C)","Seraing FC","Belgian Challenger Pro League","CHA","No","7/9/2021","6/30/2024","$140K - $1.4M","Right","Reasonable","Very Strong","6'3""","167 lbs","110","32",107,108,7,7,10,13,8,3,11,11,8,7,8,10,8,10,15,12,13,10,11,9,12,12,7,12,9,12,8,12,16,11,12,13,13,15,12,12,8,12,8,13,12,11,4,8,6,12,12,13,12,3,3,1,1,1,1,3,2,1,3,2
"3570",2000094141,"Yannick Masra","10/30/1997 (25 years old)","ST (C)","Gazelle","Chadian Premier Division","CHA","No","7/1/2020","6/30/2024","$6K - $18K","Right","Reasonable","Very Strong","6'0""","169 lbs","-","-",85,100,5,2,12,13,13,6,11,7,1,5,8,9,5,11,11,10,6,9,6,13,9,11,10,11,6,6,6,8,13,13,7,10,12,12,8,9,9,20,11,9,12,13,10,18,10,5,13,9,12,3,4,3,4,3,4,1,2,1,3,3
"3571",8631135,"Armand Djerabé","9/11/1980 (42 years old)","D (L), DM","ASCOT N'Djamena","Chadian Premier Division","CHA","No","6/1/2022","6/30/2024","$0","Left Only","Very Strong","Weak","5'11""","156 lbs","-","-",75,100,9,14,6,9,11,8,10,8,9,11,8,5,16,11,11,12,10,9,9,11,3,5,12,9,15,11,10,11,6,6,6,13,8,6,6,6,13,16,13,14,9,12,6,1,6,2,19,12,19,1,1,3,3,3,4,4,2,1,1,2
"3572",13107160,"Léger Djime","10/2/1987 (35 years old)","AM (LC), ST (C)","ASCOT N'Djamena","Chadian Premier Division","CHA","No","7/1/2020","6/30/2024","$0","Left","Very Strong","Reasonable","6'0""","167 lbs","43","6",79,100,7,9,10,13,14,7,9,7,4,7,7,7,6,9,5,11,8,11,8,13,7,8,8,12,8,7,6,9,10,7,8,11,13,8,8,5,10,18,14,8,11,10,5,5,11,5,13,11,15,3,3,1,2,1,1,1,3,2,1,2
"3573",2000120452,"Abanga Mahamat Youssouf","8/9/1996 (26 years old)","DM, M (C)","Foullah Edifice","Chadian Premier Division","CHA","No","2/1/2022","6/30/2024","$0","Right","Fairly Strong","Very Strong","5'8""","149 lbs","-","-",65,99,7,7,3,8,11,7,7,8,2,9,15,5,10,9,15,8,7,8,9,11,9,5,3,9,12,11,9,14,9,9,8,7,7,9,11,5,11,15,11,11,12,10,12,13,9,1,18,10,14,3,1,3,1,1,2,2,2,2,1,2
"3574",2000047011,"Eric Mbangossoum","5/26/2000 (23 years old)","DM","US Touarga","Botola Pro 1","CHA","No","9/1/2020","6/30/2025","$6K - $60K","Right","Reasonable","Very Strong","6'1""","169 lbs","-","-",89,99,6,4,4,7,13,6,1,8,3,9,11,4,13,9,9,10,8,7,8,13,17,5,8,5,11,7,6,12,13,13,7,10,14,13,7,9,12,19,12,11,11,12,5,3,7,1,9,9,14,3,2,2,3,3,2,3,4,1,2,2
"3575",18074493,"Morgan Betorangal","8/25/1988 (34 years old)","WB/M/AM (L)","CR Al Hoceima","Moroccan Lower Leagues","CHA","Yes","7/1/2020","6/30/2024","$4K - $12K","Left Only","Very Strong","Weak","5'7""","143 lbs","62","4",78,98,10,13,10,13,11,7,6,5,6,9,11,9,9,10,9,13,8,10,9,13,2,8,10,14,8,9,9,10,11,10,4,5,13,11,10,7,13,18,9,12,10,10,5,7,9,2,11,10,15,1,1,1,1,3,1,1,3,1,3,2
"3576",12061156,"Yaya Karim","8/10/1991 (31 years old)","AM (L), ST (C)","Foullah Edifice","Chadian Premier Division","CHA","No","10/6/2021","6/30/2024","$0 - $4.5K","Left Only","Very Strong","Very Weak","6'0""","152 lbs","24","5",80,95,3,6,10,8,10,6,10,10,5,3,8,5,3,10,8,11,9,7,7,7,7,11,14,12,3,10,9,7,13,12,12,12,12,12,11,13,11,20,12,8,11,7,6,10,13,7,9,12,8,2,3,3,3,3,1,1,1,1,2,1
"3577",13102729,"Esaie Djikoloum","10/3/1991 (31 years old)","M/AM (R)","ASCOT N'Djamena","Chadian Premier Division","CHA","No","6/14/2021","6/30/2024","$1.5K - $4K","Right","Reasonable","Very Strong","5'7""","149 lbs","-","-",80,95,9,14,8,11,11,8,8,7,6,8,11,7,8,8,7,11,2,13,8,15,2,9,12,14,8,9,10,10,9,12,9,5,14,12,10,2,12,16,10,10,10,14,14,3,9,4,11,9,9,3,1,3,1,2,3,3,3,2,2,3
"3578",50086063,"Charfadine Mahamat","3/16/1997 (26 years old)","M (C)","SO Châtellerault","French National 3 - Group C","CHA","Yes","12/2/2022","6/30/2024","$2K - $20K","Left","Very Strong","Reasonable","6'2""","176 lbs","43","4",72,95,6,6,3,6,10,6,6,13,2,7,13,6,7,10,6,6,8,8,8,9,12,7,3,8,7,8,8,12,13,13,8,12,15,13,13,10,12,15,11,10,12,7,11,8,11,4,12,8,7,2,1,3,2,3,1,2,1,2,2,1
"3579",15009865,"Brendan Gan","6/3/1988 (35 years old)","M (C), AM (RC)","Selangor","Malaysian Super League","MAS","No","1/1/2023","11/30/2024","$4.5K - $14K","Right","Weak","Very Strong","5'11""","158 lbs","196","31",79,100,7,8,11,8,9,8,9,10,5,5,9,9,6,9,8,9,7,8,9,8,12,9,8,11,7,8,9,9,12,13,12,9,12,12,10,7,11,9,9,9,13,9,4,9,7,9,8,12,6,3,1,3,2,3,3,2,3,3,3,2
"3580",2000171495,"Annour Mahamat","7/17/2002 (20 years old)","M (C)","Gulf FC","UAE First Division","CHA","No","6/1/2022","6/30/2025","$5K - $50K","Either","Very Strong","Very Strong","5'7""","132 lbs","26","1",65,92,3,5,5,2,9,5,2,10,1,11,13,1,7,13,7,4,7,5,5,11,4,5,2,6,7,7,4,11,13,11,6,3,17,13,7,1,11,13,11,11,13,7,14,7,12,1,19,10,11,4,1,3,2,2,2,3,3,2,2,3
"3581",23328211,"Mahar Sharoumah","5/12/1996 (27 years old)","ST (C)","Al-Entesar Club","Saudi Second Division Group A","CHA","No","8/11/2022","6/30/2023","$500 - $6K","Right","Reasonable","Very Strong","6'0""","163 lbs","23","9",80,90,6,4,13,11,12,6,13,5,1,5,7,3,5,10,7,11,2,10,6,10,5,10,10,13,7,6,5,7,13,13,7,10,13,13,12,8,10,11,13,11,9,11,5,5,6,8,9,10,7,3,3,1,2,3,2,3,3,4,2,3
"3582",2000018867,"Amine Hiver","4/11/1998 (25 years old)","ST (C)","Colombe Sportive","Cameroonian MTN Elite One Group A","CHA","No","7/1/2022","6/30/2024","$0","Right","Reasonable","Very Strong","5'9""","171 lbs","-","-",80,90,6,4,12,13,13,4,11,7,1,6,7,5,3,9,9,10,1,13,7,10,4,9,9,10,6,6,7,7,13,13,4,5,18,13,12,6,12,18,9,10,12,12,5,16,6,7,10,10,16,3,3,3,1,3,3,1,1,3,3,1
"3583",13108263,"Constant Matoingue","9/23/1987 (35 years old)","D (RC)","Foullah Edifice","Chadian Premier Division","CHA","No","1/18/2022","6/30/2024","$0","Right","Reasonable","Very Strong","5'11""","163 lbs","-","-",80,90,4,9,1,2,9,1,11,5,7,12,7,3,14,7,7,12,7,8,9,14,6,5,11,6,13,7,6,8,8,9,8,7,14,8,6,8,10,16,12,12,14,11,6,5,10,1,10,11,11,4,1,2,3,3,1,1,3,3,1,2
"3584",13232429,"Serge Diguel","6/26/1989 (33 years old)","GK","Fovu Club","Cameroonian MTN Elite One Group B","CHA","No","7/1/2022","6/30/2025","Not for Sale","Right","Reasonable","Very Strong","6'4""","185 lbs","-","-",78,90,3,1,3,3,4,7,1,1,3,1,7,2,1,5,11,12,13,5,11,13,13,2,12,2,8,7,6,6,11,5,7,14,12,11,3,5,8,20,10,11,10,12,8,9,6,8,11,12,15,7,7,11,11,6,11,13,5,9,13,13
"3585",13108283,"Mondesir Alladjim","2/10/1986 (37 years old)","D (C)","Renaissance FC","Chadian Premier Division","CHA","No","6/14/2021","6/30/2024","$0","Right","Reasonable","Very Strong","6'2""","178 lbs","-","-",62,90,2,6,4,4,4,2,11,2,1,14,7,3,14,1,13,10,8,7,8,12,5,5,7,4,13,6,3,7,8,8,7,8,12,6,7,7,12,13,10,15,10,10,5,10,15,6,8,11,11,3,2,2,2,1,1,1,3,3,1,3
"3586",2000176120,"Mahamat Abakar","5/9/1985 (38 years old)","DM, M (C)","Foullah Edifice","Chadian Premier Division","CHA","No","6/14/2021","6/30/2024","$0","Right","Reasonable","Very Strong","5'7""","145 lbs","-","-",70,90,7,7,3,7,14,7,4,13,1,10,11,1,12,9,14,10,6,8,9,12,15,5,12,8,10,8,10,12,7,7,3,4,16,7,7,6,13,19,10,12,10,11,9,9,8,2,13,11,20,3,1,3,2,3,2,3,1,3,1,3
"3587",50086069,"Brahim Mahamat","11/13/1995 (27 years old)","M/AM (C)","Olympique Alès Cévènnes","French National 2 - A","CHA","Yes","7/1/2022","6/30/2024","$20K - $65K","Right Only","Weak","Very Strong","6'0""","160 lbs","70","35",72,90,5,6,5,10,10,6,6,7,1,5,12,1,6,5,7,8,4,6,4,13,15,11,12,8,8,7,13,8,13,13,7,11,12,13,13,4,11,17,12,12,9,12,6,3,9,4,5,12,14,2,3,2,1,1,2,1,4,3,3,1
"3588",13195244,"Hassane Brahim","11/13/1989 (33 years old)","AM (R), ST (C)","FC Nouadhibou","Mauritanian D1","CHA","No","8/27/2022","6/30/2024","$0","Right","Strong","Very Strong","6'4""","180 lbs","-","-",82,90,6,9,11,13,13,6,11,7,6,5,11,8,5,8,7,10,6,8,6,11,6,8,9,12,6,7,4,8,9,7,7,12,12,8,5,7,12,13,13,11,12,12,6,6,5,3,13,9,17,3,1,1,2,1,2,1,4,1,4,2
"3589",13108255,"Appolinaire Djingabeye","2/9/1993 (30 years old)","M (RL)","Renaissance FC","Chadian Premier Division","CHA","No","6/14/2021","6/30/2024","$0","Right","Reasonable","Very Strong","5'10""","154 lbs","-","-",72,90,4,9,9,7,13,6,6,7,3,6,10,4,6,8,10,9,5,5,5,6,8,9,9,7,6,7,10,12,13,13,6,7,9,13,9,6,12,13,13,11,13,9,11,13,13,5,20,11,20,4,2,1,2,2,2,1,3,3,2,1
"3590",14057911,"Ezequiel Agüero","4/7/1994 (29 years old)","AM (C), ST (C)","Pahang","Malaysian Super League","MAS","No","1/1/2023","11/30/2024","$5K - $50K","Right Only","Weak","Very Strong","5'9""","160 lbs","60","15",80,100,7,9,14,10,13,11,3,8,2,1,12,10,2,15,7,10,8,7,7,12,7,13,10,10,7,7,11,8,9,12,7,3,12,11,9,7,6,10,12,10,10,12,5,1,6,5,15,11,20,1,1,2,1,3,3,3,2,1,2,1
"3591",2000059877,"Othman Hassan","7/1/1997 (25 years old)","M (C)","Jeddah","Saudi First Division League","CHA","No","7/25/2022","6/30/2023","$3.5K - $12K","Right","Reasonable","Very Strong","6'0""","167 lbs","33","2",70,90,4,5,6,7,11,6,5,9,4,10,10,2,5,10,10,6,3,10,7,13,4,5,9,7,7,7,12,11,13,11,7,9,9,11,13,6,13,13,12,11,10,10,9,6,7,2,11,8,18,4,1,4,2,3,1,3,3,2,2,3
"3592",13108246,"Samuel Ramses","10/10/1986 (36 years old)","D (C)","ASCOT N'Djamena","Chadian Premier Division","CHA","No","6/14/2021","6/30/2024","$0","Right","Weak","Very Strong","6'2""","174 lbs","-","-",60,90,4,3,1,6,6,1,10,1,2,11,8,2,9,5,12,14,8,7,10,14,14,5,11,6,14,6,2,8,6,5,7,11,15,5,9,7,13,10,12,8,12,11,15,5,8,6,9,9,15,1,2,1,2,4,3,3,3,3,2,1
"3593",2000160370,"Youssouf Khalifa","1/1/2003 (20 years old)","ST (C)","Fujairah","UAE First Division","CHA","No","6/1/2021","6/30/2024","$24K - $240K","Right","Reasonable","Very Strong","6'0""","163 lbs","7","1",55,90,3,4,11,12,12,4,12,4,1,4,4,2,2,7,14,8,1,5,5,9,4,10,11,12,3,4,4,6,12,11,5,7,11,9,11,4,10,11,14,11,10,8,14,9,15,6,9,13,7,3,1,2,4,1,1,1,2,3,2,1
"3594",49033279,"Samuel Betina","6/21/1995 (27 years old)","M/AM (R)","Genêts Anglet","French National 3 - Group B","CHA","Yes","10/1/2022","6/30/2024","$6K - $60K","Right Only","Weak","Very Strong","5'10""","165 lbs","87","15",84,89,8,11,9,11,14,7,9,8,5,6,10,1,7,12,9,11,5,11,8,10,12,11,12,10,7,8,7,8,12,14,7,9,12,13,10,11,13,16,10,11,10,12,9,7,10,8,16,10,19,2,1,1,1,1,3,1,4,3,2,2
"3595",2000012703,"Othman Al-Rengi","1/7/1994 (29 years old)","AM (R), ST (C)","Sitra","Bahrain Premier League","CHA","No","9/4/2022","6/30/2023","$0","Right","Strong","Very Strong","6'0""","165 lbs","19","2",85,88,8,5,9,10,3,8,11,9,1,7,5,6,3,7,7,12,9,9,6,9,10,10,7,14,9,8,10,10,15,10,9,8,13,13,10,7,11,15,11,10,11,12,14,13,5,3,10,11,13,4,2,1,3,2,3,1,1,1,1,3
"3596",2000101762,"David Junior Dayang","12/20/2000 (22 years old)","D/WB (L)","Gazelle FC","Cameroonian MTN Elite One Group A","CHA","No","7/1/2022","6/30/2025","$0 - $45K","Left","Very Strong","Reasonable","6'1""","171 lbs","-","-",71,88,6,9,8,3,10,1,10,8,3,7,9,3,13,10,5,13,9,6,13,14,6,5,12,7,6,9,7,10,13,9,4,15,14,10,8,8,14,11,8,11,11,11,12,10,5,7,12,11,15,3,2,3,3,2,1,2,2,2,1,1
"3597",13108257,"Ferdinand Gassina","11/13/1992 (30 years old)","DM, M (C)","ASCOT N'Djamena","Chadian Premier Division","CHA","No","6/14/2021","6/30/2024","$1.5K - $4K","Right","Reasonable","Very Strong","5'9""","152 lbs","-","-",75,85,6,7,5,6,13,6,6,7,6,8,10,5,8,11,11,9,8,8,8,7,4,5,8,8,12,8,6,11,13,13,8,8,7,13,13,5,14,12,11,12,9,12,11,7,11,1,13,9,10,1,3,3,1,2,3,1,2,1,1,1
"3598",2000176117,"Bicto Tyonga","9/11/2001 (21 years old)","D (C), DM, M (C)","Foullah Edifice","Chadian Premier Division","CHA","No","7/1/2021","6/30/2024","$0","Right","Fairly Strong","Very Strong","6'0""","167 lbs","-","-",65,85,1,4,2,2,13,6,8,7,1,10,9,1,12,8,6,9,7,8,7,12,6,5,14,6,9,7,10,11,9,10,7,6,8,10,6,6,10,14,13,12,10,12,13,14,5,1,12,10,17,2,1,3,3,1,1,1,3,1,3,1
"3599",2000047015,"Alboury Aboubakar","10/27/1997 (25 years old)","DM, M (C)","Tourbillon (CHA)","Chadian Premier Division","CHA","No","7/1/2020","6/30/2024","$0 - $1.5K","Right","Reasonable","Very Strong","5'10""","156 lbs","-","-",75,85,6,6,5,6,10,6,1,8,4,8,12,2,13,7,5,8,8,8,6,10,8,5,9,8,8,7,7,12,13,13,7,5,12,13,13,7,12,14,9,12,11,10,7,9,9,1,5,11,17,3,4,1,1,3,3,3,1,1,1,1
"3600",50038623,"Rodrigue N'Doram","11/25/1987 (35 years old)","DM, M (C)","Foullah Edifice","Chadian Premier Division","CHA","No","6/14/2021","6/30/2024","$0","Right Only","Weak","Very Strong","6'1""","169 lbs","37","1",67,85,3,6,5,6,14,6,6,8,2,8,14,2,10,9,11,8,6,8,7,14,9,5,5,8,8,7,12,11,5,8,7,12,11,8,7,6,11,18,12,10,10,11,15,10,7,3,10,11,10,3,3,1,2,4,1,4,3,3,1,3
"3601",15023671,"Matthew Davies","2/7/1995 (28 years old)","D (R)","Johor DT","Malaysian Super League","MAS","No","1/1/2023","11/30/2023","$500 - $4.5K","Right","Reasonable","Very Strong","5'10""","160 lbs","146","5",79,99,4,7,3,4,8,1,5,5,6,8,6,3,12,7,9,8,9,7,6,13,9,6,6,4,7,7,7,8,13,13,7,8,15,13,13,10,16,20,9,11,10,8,11,2,6,3,12,13,14,2,3,3,4,1,1,1,3,2,2,3
"3602",13195247,"Beadoum Mondé","1/15/1995 (28 years old)","D (L), M (RL)","Gazelle","Chadian Premier Division","CHA","No","1/2/2020","-","$0","Left","Very Strong","Reasonable","5'11""","163 lbs","20","28",82,85,7,10,8,5,11,6,6,5,6,7,8,6,8,11,10,8,8,6,7,9,5,5,12,7,7,5,8,8,13,13,8,9,12,13,9,10,13,10,11,10,11,11,5,15,7,1,11,11,9,3,2,3,1,1,1,3,3,1,3,3
"3603",2000088870,"Ali Mayde","8/20/2000 (22 years old)","DM, M/AM (C)","Renaissance FC","Chadian Premier Division","CHA","No","6/15/2020","6/30/2024","$0","Right","Fairly Strong","Very Strong","6'0""","160 lbs","-","-",62,84,5,5,7,11,9,5,5,10,2,7,7,6,10,12,12,8,7,6,2,13,15,12,9,6,11,7,5,11,13,9,6,5,12,12,6,4,20,13,13,10,12,11,7,4,10,3,13,12,18,1,1,3,2,3,3,1,1,1,2,1
"3604",2000083930,"Yaya Kerim","8/10/1991 (31 years old)","M (RL), AM (L)","Foullah Edifice","Chadian Premier Division","CHA","No","7/1/2019","6/30/2024","$0 - $22K","Left","Very Strong","Fairly Strong","6'0""","160 lbs","45","8",75,83,8,11,9,8,12,8,9,4,8,8,10,5,10,14,13,8,5,11,10,13,12,12,4,11,7,9,8,10,10,12,9,10,16,11,7,6,15,12,13,11,10,11,5,12,11,5,8,12,14,3,2,2,2,1,2,2,2,1,1,2
"3605",2000083932,"Joël Djingar","10/24/2002 (20 years old)","DM, M (C)","Foullah Edifice","Chadian Premier Division","CHA","No","7/1/2018","6/30/2024","$0","Either","Very Strong","Very Strong","5'7""","143 lbs","-","-",63,82,6,5,5,7,7,6,6,6,4,10,10,5,14,8,12,5,7,8,8,9,8,5,12,7,5,8,8,11,13,10,7,2,8,13,6,4,9,10,11,11,10,11,5,6,8,2,10,11,7,3,3,1,2,2,1,4,1,3,1,1
"3606",2000161959,"Abdelaziz Youssouf","7/14/2005 (17 years old)","ST (C)","Al-Ain","UAE Professional League","CHA","No","6/13/2022","6/30/2025","$4.5K - $45K","Right","Reasonable","Very Strong","5'9""","141 lbs","-","-",50,82,4,1,12,12,10,4,12,5,1,3,4,8,2,5,7,3,5,10,3,5,17,6,9,10,4,4,4,5,12,7,5,7,12,11,6,6,8,18,13,12,10,11,14,11,5,7,9,10,13,1,1,1,1,2,2,1,2,1,3,3
"3607",13117427,"César Abaya","10/12/1984 (38 years old)","D (RC)","AS SONIDEP","Nigerien Lower Divisions","CHA","No","7/1/2019","6/30/2024","$0","Right","Reasonable","Very Strong","5'11""","165 lbs","-","-",72,80,4,9,1,7,9,4,13,1,3,9,6,5,14,8,15,6,9,9,11,14,5,6,4,7,14,8,5,9,7,7,7,6,9,7,7,7,12,19,10,14,11,11,8,9,6,5,4,9,17,1,2,3,4,2,3,2,1,3,2,1
"3608",2000167621,"Mbaiossoum Samba Diallo","4/12/2002 (21 years old)","GK","AS Kaloum","Guinean Premier Division","CHA","No","1/31/2022","6/30/2024","$7K - $20K","Right","Reasonable","Very Strong","6'1""","169 lbs","-","-",65,80,3,2,3,1,2,5,1,3,2,2,6,1,3,1,10,3,9,6,11,13,14,3,11,1,10,6,3,5,9,13,4,10,6,8,5,4,11,13,12,9,12,10,9,5,6,5,15,10,10,9,10,13,9,4,13,8,5,11,8,12
"3609",13195248,"Adoum Defallah","1/31/1990 (33 years old)","GK","Elect Sport FC","Chadian Premier Division","CHA","No","7/1/2019","-","$0","Right","Weak","Very Strong","6'3""","187 lbs","-","-",78,80,5,2,1,3,7,7,1,1,2,3,10,2,1,6,7,9,12,5,14,6,8,3,13,1,8,8,7,7,11,12,8,16,13,10,5,7,8,16,11,8,13,11,9,10,11,2,10,13,9,11,6,12,7,11,9,14,5,10,7,14
"3610",2000013655,"Abdelaziz Issa","1/2/1995 (28 years old)","D (LC)","Foullah Edifice","Chadian Premier Division","CHA","No","1/1/2022","6/30/2024","$0","Left Only","Very Strong","Weak","5'7""","134 lbs","-","-",72,80,4,10,5,2,9,2,12,5,5,12,8,1,14,4,15,9,9,8,13,14,14,7,14,7,8,8,7,8,14,14,8,2,12,14,11,1,15,12,10,12,10,12,6,1,9,2,9,11,10,4,4,3,3,3,2,3,3,2,2,3
"3611",2000013654,"Bechir Djimet","1/10/1994 (29 years old)","D (C)","Foullah Edifice","Chadian Premier Division","CHA","No","2/1/2022","6/30/2024","$0 - $6K","Right","Fairly Strong","Very Strong","6'2""","187 lbs","-","-",80,80,3,2,3,1,3,1,10,4,2,13,6,1,13,6,14,6,9,7,10,11,6,5,8,6,13,6,2,7,11,13,7,7,12,12,8,13,14,11,13,10,11,10,13,6,8,7,8,12,19,1,1,1,2,3,3,3,3,3,3,2
"3612",2000211971,"Silvan Schädler","2/6/2006 (17 years old)","GK","Vaduz","Swiss Challenge League","LIE","Yes","7/1/2021","6/30/2025","$500 - $3.5K","Right","Reasonable","Very Strong","6'1""","158 lbs","1","-",53,87,3,3,2,3,1,6,1,2,3,3,9,1,2,2,11,4,12,6,9,13,10,3,9,1,8,6,5,5,11,8,6,7,13,7,3,4,9,12,11,12,10,12,6,10,5,2,12,12,13,6,10,8,13,6,12,13,5,7,9,10
"3613",8155051,"Luqman Hakim","3/5/2002 (21 years old)","AM (C), ST (C)","Njarðvík","Icelandic First Division","MAS","No","8/8/2020","6/30/2025","$20K - $200K","Right Only","Weak","Very Strong","5'7""","136 lbs","5","2",80,98,8,10,11,7,13,10,4,8,4,10,10,7,4,14,13,7,12,12,8,8,9,14,4,4,4,7,9,10,15,14,5,5,11,15,6,4,7,14,12,11,11,9,5,12,15,1,15,13,14,3,3,3,3,1,3,1,1,1,3,1
"3614",13195245,"Hassane Boudina","1/23/1990 (33 years old)","AM (R), ST (C)","Gazelle","Chadian Premier Division","CHA","No","6/14/2021","-","$0","Right","Reasonable","Very Strong","6'0""","163 lbs","-","-",70,80,7,10,11,13,13,5,8,5,6,4,7,5,6,9,6,8,7,8,5,13,3,9,14,13,4,5,8,8,11,11,7,6,12,11,9,5,9,14,9,13,9,11,9,10,7,2,13,11,9,4,2,2,4,3,2,2,3,1,3,2
"3615",54200883,"Mohammed Yehya","8/27/1995 (27 years old)","M (C)","Al-Washm","Saudi Second Division Group A","CHA","No","8/12/2022","6/30/2025","$10K - $110K","Right","Reasonable","Very Strong","6'1""","165 lbs","-","-",75,80,6,3,4,6,13,6,6,5,1,10,13,2,7,13,10,10,7,8,7,12,10,5,3,9,9,7,11,10,13,12,7,7,10,13,13,5,9,15,13,12,9,12,5,7,6,3,13,12,13,1,3,1,3,3,2,2,3,2,1,2
"3616",2000013743,"Edgar Minga","4/8/1995 (28 years old)","AM (R), ST (C)","Canon Yaoundé","Cameroonian MTN Elite One Group A","CHA","No","3/6/2022","6/30/2024","$1K - $12K","Right","Reasonable","Very Strong","5'8""","147 lbs","-","-",75,80,7,10,10,9,10,4,7,7,2,5,12,6,2,11,6,7,6,11,4,10,18,12,3,10,5,6,6,7,12,12,6,5,14,12,12,6,11,10,11,14,11,12,5,9,12,8,12,10,18,3,3,1,2,1,1,1,1,1,1,1
"3617",2000017777,"Marvin Assane","7/30/1993 (29 years old)","D (LC)","Zürich City","Swiss Lower Division","CHA","Yes","1/30/2023","-","$0","Right","Reasonable","Very Strong","6'0""","176 lbs","79","3",63,80,2,8,4,1,7,1,9,3,1,11,6,4,13,4,15,9,7,4,9,9,4,5,13,5,8,5,5,6,13,13,6,5,14,13,11,7,10,15,12,12,12,11,11,9,6,1,10,8,9,2,1,2,2,1,3,1,2,2,2,1
"3618",2000176122,"Florent Warna","6/23/2002 (20 years old)","D (C)","Foullah Edifice","Chadian Premier Division","CHA","No","7/1/2021","6/30/2024","$0","Right","Reasonable","Very Strong","6'1""","171 lbs","-","-",60,79,4,1,2,5,7,2,11,6,5,8,4,2,11,3,12,12,8,5,8,14,12,5,6,5,14,6,2,7,7,8,7,14,14,6,5,7,10,19,14,10,11,11,5,9,9,2,11,10,11,1,1,3,3,3,1,1,2,2,2,3
"3619",2000083931,"Aubin Mbaïgolmem","10/22/1994 (28 years old)","D (C), DM","Foullah Edifice","Chadian Premier Division","CHA","No","7/1/2020","6/30/2024","$0","Right","Reasonable","Very Strong","6'0""","169 lbs","-","-",70,77,2,6,1,6,5,3,12,8,1,9,7,1,14,8,8,9,9,5,8,9,15,5,9,7,13,7,5,9,13,14,8,10,9,14,5,9,13,11,10,11,11,12,10,10,9,1,11,11,7,3,3,1,4,3,3,1,3,4,3,2
"3620",109160,"Paul Ifill","10/20/1979 (43 years old)","M (C), AM (RLC), ST (C)","Christchurch United","New Zealand Southern League","BRB","No","1/1/2022","12/31/2023","$0","Right","Reasonable","Very Strong","6'0""","178 lbs","523","128",76,127,10,15,12,12,13,11,10,12,2,7,13,13,6,14,9,15,10,12,8,14,14,15,14,13,13,8,14,5,5,6,9,8,8,7,4,9,13,15,16,16,13,16,15,10,4,2,12,13,15,2,1,3,2,1,1,1,1,1,1,4
"3621",2000032796,"Thierry Gale","5/1/2002 (21 years old)","AM (R), ST (C)","Dila","Georgian National League","BRB","No","6/30/2022","12/31/2024","$210K - $2.1M","Right","Weak","Very Strong","5'6""","143 lbs","76","15",101,126,7,11,16,12,16,10,6,12,1,4,14,5,4,13,11,9,8,8,10,8,2,10,12,16,5,10,11,12,13,14,11,6,8,13,8,5,11,10,12,10,10,12,10,2,11,1,15,11,20,4,3,1,1,2,2,2,2,1,1,4
"3622",29014167,"Krystian Pearce","1/5/1990 (33 years old)","D (C)","Kidderminster","Vanarama National League","BRB","No","6/22/2022","6/30/2024","$500 - $5K","Right Only","Weak","Very Strong","6'2""","182 lbs","485","30",66,122,3,3,4,3,6,3,13,3,8,12,6,2,11,8,12,10,12,7,10,9,10,4,13,4,10,11,6,11,8,6,6,14,10,8,7,13,5,13,12,13,9,13,8,13,5,8,14,12,11,3,1,3,2,3,1,3,3,1,2,2
"3623",82071029,"Hadan Holligan","9/11/1996 (26 years old)","M (C), AM (RLC), ST (C)","Weymouth Wales","BFA Digicel Premier League","BRB","No","7/3/2018","12/31/2024","$4K - $12K","Right","Reasonable","Very Strong","5'8""","143 lbs","48","27",82,100,6,11,7,11,9,6,6,5,6,6,8,3,4,8,7,6,8,5,4,13,15,12,6,8,6,7,8,8,13,13,7,3,12,13,13,5,9,12,9,12,10,11,7,9,14,2,12,15,17,3,3,3,3,2,4,3,2,3,3,1
"3624",23324659,"Mohd Faisal Abdul Halim","1/7/1998 (25 years old)","AM (RL)","Selangor","Malaysian Super League","MAS","No","12/1/2022","11/30/2024","$6K - $55K","Right","Strong","Very Strong","5'2""","119 lbs","117","17",85,98,8,9,11,9,12,8,6,8,8,6,7,10,3,12,12,9,13,10,11,8,13,6,11,11,3,5,5,10,14,13,12,4,13,13,8,4,6,16,10,8,13,13,7,12,6,1,12,12,20,4,1,3,1,2,1,1,1,3,2,2
"3625",82086175,"Kishmar Primus","4/9/1998 (25 years old)","GK","BDFSP","BFA Digicel Premier League","BRB","No","6/15/2020","12/31/2024","$0 - $2K","Right","Weak","Very Strong","6'2""","182 lbs","36","-",75,100,1,2,3,2,1,3,1,3,2,1,9,4,3,6,11,11,15,8,10,10,16,3,9,2,9,8,4,7,14,7,8,14,8,11,5,9,11,15,11,11,11,12,15,5,15,5,11,12,7,9,11,14,7,7,10,6,6,11,10,14
"3626",82086135,"Ackeel Applewhaite","7/17/1999 (23 years old)","D/WB/M (L)","Paradise (BRB)","BFA Digicel Premier League","BRB","No","6/15/2020","12/31/2024","$0 - $2K","Left","Very Strong","Reasonable","5'10""","156 lbs","44","9",75,98,8,11,8,6,11,8,8,2,8,9,8,5,10,6,6,13,8,10,10,11,17,5,4,9,9,9,7,10,14,11,9,7,15,12,9,6,16,15,12,12,13,9,12,7,10,1,7,13,7,2,2,2,2,3,3,3,1,1,3,4
"3627",37059675,"Dwayne Green","9/3/1996 (26 years old)","D (LC), WB (L)","Spakenburg","Dutch Tweede Divisie","BRB","Yes","6/30/2021","-","$0","Left Only","Very Strong","Weak","5'9""","189 lbs","92","3",81,94,7,11,10,5,7,12,10,10,8,10,12,6,9,10,13,9,9,9,9,9,13,9,9,8,11,14,9,12,11,11,13,13,12,10,11,11,13,10,10,10,11,10,7,8,10,8,11,13,16,2,3,3,4,2,4,1,3,1,3,1
"3628",82086295,"Omani Leacock","1/5/1998 (25 years old)","AM (L), ST (C)","BDFSP","BFA Digicel Premier League","BRB","No","6/15/2020","12/31/2025","$0","Right","Reasonable","Very Strong","5'8""","152 lbs","31","26",80,90,8,9,12,10,11,8,10,9,5,6,13,2,7,11,7,12,9,11,7,9,7,18,13,12,8,8,10,10,11,10,9,8,10,11,7,7,10,12,11,9,11,14,8,5,10,1,11,13,14,1,3,1,3,3,4,2,3,3,3,3
"3629",82086304,"Nicoli Brathwaite","12/24/2000 (22 years old)","D (RC), WB/AM (R)","Progresul Ezeriş","Romanian Fourth League Caraş-Severin","BRB","No","1/1/2023","-","$0","Right","Reasonable","Very Strong","5'10""","158 lbs","11","-",76,90,3,6,8,8,8,6,8,2,5,11,9,2,10,7,15,12,9,8,10,13,10,7,3,10,5,4,4,8,10,13,8,4,17,13,9,8,15,12,10,12,13,10,8,14,5,8,15,10,8,2,2,3,2,2,1,1,2,4,4,2
"3630",82071006,"Shane Codrington","12/10/1995 (27 years old)","D (C)","BDFSP","BFA Digicel Premier League","BRB","No","6/15/2020","12/31/2024","$0 - $6K","Right","Fairly Strong","Very Strong","6'0""","160 lbs","17","1",74,90,2,1,1,1,6,1,13,6,1,13,5,5,10,5,6,10,9,5,6,13,13,5,11,4,9,5,6,6,13,12,7,9,6,12,8,4,10,17,14,12,13,8,6,10,15,7,9,12,8,1,2,1,3,1,3,2,2,3,2,1
"3631",37071152,"Ryan Trotman","6/27/1999 (23 years old)","AM (L), ST (C)","Kauno Žalgiris","Lithuanian A League","BRB","Yes","1/25/2022","12/31/2024","$40K - $400K","Right Only","Weak","Very Strong","5'9""","152 lbs","48","6",85,90,6,9,12,10,12,9,9,7,6,5,10,8,5,12,13,10,11,8,8,8,8,11,7,10,5,10,8,10,13,12,11,9,5,12,10,10,12,20,12,12,11,8,12,8,12,5,20,11,12,2,2,3,3,3,3,2,3,2,1,1
"3632",2000205330,"Sheran Hoyte","2/21/2000 (23 years old)","M/AM (C)","Paradise (BRB)","BFA Digicel Premier League","BRB","No","1/1/2019","12/31/2024","$0 - $7K","Right","Reasonable","Very Strong","5'7""","136 lbs","-","-",75,90,4,7,7,10,14,2,6,9,1,9,9,1,5,12,8,10,6,7,7,14,7,11,1,9,9,8,12,13,14,10,8,6,11,12,9,2,13,12,8,12,11,10,5,7,7,3,9,9,20,2,2,4,2,3,2,2,2,1,1,3
"3633",2000164433,"Justin Griffith","2/18/2005 (18 years old)","GK","Pro Shottas","BFA Division Two","BRB","No","7/1/2020","12/31/2023","$0","Right","Reasonable","Very Strong","6'0""","160 lbs","-","-",60,90,2,3,2,2,3,2,1,2,2,1,10,2,2,2,14,5,13,6,8,13,4,1,1,2,3,6,5,5,9,6,5,11,13,10,5,5,10,15,11,12,11,10,9,4,6,6,8,11,8,3,15,13,7,4,7,8,5,10,10,13
"3634",20041524,"Zach Ellis-Hayden","3/1/1992 (31 years old)","D (RL)","Electric City","League1 Ontario","BRB","No","12/3/2021","12/31/2024","Not for Sale","Right","Reasonable","Very Strong","5'8""","145 lbs","160","4",77,89,6,7,10,8,8,6,9,6,14,11,9,4,10,9,13,7,9,8,10,7,13,6,8,6,9,11,7,11,12,12,10,9,16,13,11,6,13,8,11,13,7,9,17,12,8,5,10,11,9,3,3,2,3,1,2,2,1,2,2,1
"3635",19241899,"Paulo Josué","3/13/1989 (34 years old)","M (C), AM (LC)","Kuala Lumpur","Malaysian Super League","MAS","No","1/1/2023","11/30/2024","Not for Sale","Either","Very Strong","Very Strong","6'0""","163 lbs","116","35",90,98,10,9,6,10,9,15,7,11,7,5,11,14,8,11,14,10,9,10,13,11,15,8,9,11,9,9,13,13,10,9,9,10,15,10,8,6,17,10,11,9,9,12,5,13,10,3,6,10,20,4,4,2,2,2,4,2,3,2,1,4
"3636",2000116895,"Abdullah Javaid","12/19/2004 (18 years old)","M/AM (R)","Leicester","Sky Bet Championship","BRB","No","7/1/2021","6/30/2026","$500 - $4K","Right","Fairly Strong","Very Strong","5'10""","147 lbs","-","-",50,88,8,12,9,10,7,6,4,2,5,3,5,1,7,13,12,7,3,4,5,11,12,12,3,6,6,6,5,8,13,9,7,6,12,12,3,3,12,20,12,11,14,12,12,12,10,3,2,11,9,2,3,1,3,3,3,2,2,3,1,3
"3637",28053774,"Hallam Hope","3/17/1994 (29 years old)","AM (RL), ST (C)","Oldham","Vanarama National League","BRB","No","5/23/2022","6/30/2024","$26K - $250K","Right","Reasonable","Very Strong","5'10""","154 lbs","290","52",83,88,5,9,10,9,11,3,10,9,3,6,9,6,6,8,8,10,10,9,9,8,10,9,5,11,9,12,10,13,12,11,11,9,13,12,10,13,10,11,10,12,8,13,14,4,9,1,8,15,11,3,1,2,2,4,2,3,2,2,3,1
"3638",2000129972,"Andre Applewhaite","6/3/2002 (21 years old)","D (LC)","Weymouth Wales","BFA Digicel Premier League","BRB","No","1/1/2019","12/31/2025","$0 - $7K","Left","Very Strong","Reasonable","6'2""","174 lbs","23","-",72,88,3,7,1,1,4,1,9,3,6,12,4,2,13,3,13,6,9,7,7,13,2,5,4,6,9,7,7,7,13,13,7,11,5,11,7,5,14,12,9,13,10,11,7,15,12,1,11,9,8,2,1,1,4,3,3,3,2,1,2,2
"3639",82073985,"Antone Greaves","12/4/1999 (23 years old)","M/AM (L), ST (C)","Weymouth Wales","BFA Digicel Premier League","BRB","No","6/15/2020","12/31/2025","$1.5K - $5K","Left","Very Strong","Reasonable","5'8""","141 lbs","8","7",68,87,6,9,10,9,7,6,13,4,6,4,7,5,5,12,11,8,7,10,6,11,6,11,10,10,6,7,8,3,14,13,4,2,18,14,4,6,8,18,13,10,9,10,15,6,5,4,11,10,8,1,2,2,2,2,1,2,1,2,1,1
"3640",72044270,"Keasel Broome","6/18/1991 (31 years old)","GK","Ocean City","USSL D2 - Mid Atlantic Division","BRB","No","3/1/2023","-","$0","Right Only","Weak","Very Strong","6'0""","191 lbs","20","-",82,86,2,3,2,3,2,7,1,3,1,1,11,3,3,1,7,9,11,5,8,13,16,3,13,2,10,7,6,6,10,8,12,10,6,9,6,13,9,15,11,14,8,11,13,3,10,8,10,8,14,7,10,10,13,8,11,12,5,7,11,12
"3641",2000130408,"Niall Reid-Stephen","9/8/2001 (21 years old)","AM (RC), ST (C)","UWI Blackbirds","BFA Digicel Premier League","BRB","No","1/1/2019","12/31/2025","$0 - $5K","Right","Reasonable","Very Strong","5'8""","143 lbs","22","19",70,85,6,8,11,9,7,6,7,8,4,5,7,2,5,7,11,8,6,6,5,13,15,10,4,10,7,7,8,8,13,13,7,1,14,13,13,5,12,20,11,11,12,9,10,8,8,5,12,11,15,3,1,2,1,3,3,1,3,3,1,3
"3642",82071128,"Shaquille Stewart","10/6/1994 (28 years old)","M/AM (L), ST (C)","Porey Springs","BFA Division One","BRB","No","6/15/2020","12/31/2023","$0","Left","Very Strong","Reasonable","6'3""","198 lbs","14","5",70,85,6,11,6,9,6,6,5,4,6,5,9,1,4,11,8,8,7,8,8,13,14,11,12,9,7,7,8,8,13,10,7,11,14,11,10,5,11,19,10,10,13,12,6,9,5,8,11,9,15,3,2,2,2,1,2,3,1,2,1,3
"3643",2000130425,"Romario Drakes","12/31/2000 (22 years old)","M/AM (RC)","Whitehall Titans","BFA Division One","BRB","No","12/16/2019","-","$0","Right","Reasonable","Very Strong","5'9""","152 lbs","33","3",70,84,7,10,10,8,14,7,6,8,3,7,11,1,9,13,12,9,8,5,6,10,16,12,8,11,8,8,9,12,13,12,8,9,12,8,7,5,17,18,11,9,11,9,11,6,13,8,14,9,15,3,2,3,3,3,3,3,1,1,3,2
"3644",82070971,"Ranaldo Bailey","7/5/1996 (26 years old)","D (C), ST (C)","UWI Blackbirds","BFA Digicel Premier League","BRB","No","6/15/2020","12/31/2024","$0 - $2.5K","Right","Reasonable","Very Strong","6'2""","187 lbs","18","-",75,81,6,3,9,12,11,7,14,5,2,11,8,2,12,8,11,12,9,7,8,9,15,11,5,9,11,12,11,10,10,7,11,12,6,8,12,11,10,10,12,12,10,10,11,15,14,2,12,9,14,3,1,1,1,1,3,2,1,1,2,3
"3645",82086203,"Nashton Browne","4/12/2001 (22 years old)","GK","Paradise (BRB)","BFA Digicel Premier League","BRB","No","6/15/2020","12/31/2025","$0","Right Only","Weak","Very Strong","6'5""","187 lbs","-","-",64,80,2,1,2,2,4,5,1,3,3,2,9,1,1,1,5,10,13,5,6,12,13,1,2,1,10,6,5,5,8,12,6,14,10,4,3,6,13,13,11,8,11,13,6,18,6,5,11,12,13,4,16,10,12,8,9,7,5,9,13,13
"3646",23270148,"Muhd Safawi Rasid","3/5/1997 (26 years old)","AM (RL), ST (C)","Johor DT","Malaysian Super League","MAS","No","6/15/2020","11/30/2023","$0 - $60K","Left","Very Strong","Reasonable","5'8""","156 lbs","138","31",84,97,8,7,12,12,13,12,8,4,6,6,6,4,1,8,6,7,4,7,5,12,13,8,1,11,6,7,8,8,13,13,7,2,15,13,13,5,9,16,11,10,10,11,10,15,5,2,5,10,8,3,3,1,3,2,1,3,1,4,4,1
"3647",2000130413,"Roshon Gittens","2/5/2002 (21 years old)","M/AM (R)","Ellerton","BFA Digicel Premier League","BRB","No","6/13/2022","12/31/2023","$0","Right","Weak","Very Strong","5'7""","134 lbs","8","-",70,80,7,11,10,13,13,5,6,2,4,5,9,3,6,13,9,7,3,9,5,12,13,13,14,13,6,7,6,12,13,12,7,3,10,12,9,1,15,11,9,10,9,11,9,15,10,7,12,9,9,2,3,3,3,1,2,1,3,4,3,2
"3648",82071066,"Akeem Hill","4/18/1997 (26 years old)","D/WB (L), DM, M (LC)","Notre Dame","BFA Digicel Premier League","BRB","No","12/31/2020","12/31/2023","$0","Left","Very Strong","Reasonable","5'10""","156 lbs","-","-",75,80,3,6,6,1,12,5,5,7,5,5,9,1,11,8,13,4,7,7,7,11,13,5,10,6,10,6,5,7,12,12,6,5,13,12,12,9,10,19,14,11,11,14,13,11,5,5,18,11,13,1,1,2,3,1,1,3,2,4,1,2
"3649",88025887,"Shakille Belle","10/21/1996 (26 years old)","M/AM (R), ST (C)","Ellerton","BFA Digicel Premier League","BRB","No","6/15/2020","12/31/2023","$0","Right","Reasonable","Very Strong","6'1""","163 lbs","17","7",55,80,3,6,8,8,11,4,5,3,4,3,8,1,1,7,5,8,2,5,4,12,4,8,4,8,2,5,5,6,11,10,4,8,15,11,10,5,9,20,11,11,13,12,9,8,10,4,19,10,16,2,2,3,2,4,2,1,1,2,1,3
"3650",82073977,"Elijah Downey","3/17/1999 (24 years old)","M (RL), AM (RLC), ST (C)","Wotton","BFA Digicel Premier League","BRB","No","1/1/2023","12/31/2023","$0","Left","Very Strong","Strong","5'7""","141 lbs","19","4",70,80,5,8,9,13,8,5,7,6,6,6,6,5,5,10,15,7,8,13,5,9,5,15,13,8,6,7,9,14,11,12,7,4,5,11,8,6,13,15,9,12,10,11,11,8,11,3,13,11,9,1,3,1,1,3,2,1,3,1,1,2
"3651",2000272410,"Nadre Butcher","3/6/2004 (19 years old)","AM (RC)","Weymouth Wales","BFA Digicel Premier League","BRB","No","1/1/2023","12/31/2025","$0","Right Only","Weak","Very Strong","5'7""","134 lbs","-","-",57,80,5,8,14,10,10,6,3,6,6,4,10,2,3,10,13,7,4,5,6,12,11,12,7,9,4,7,4,12,12,12,5,7,6,10,9,3,11,18,9,11,13,14,8,14,14,6,10,9,16,1,2,3,2,1,1,3,1,4,3,1
"3652",90051143,"Armando Lashley","11/8/1991 (31 years old)","ST (C)","Paradise (BRB)","BFA Digicel Premier League","BRB","No","6/14/2021","12/31/2023","$0","Right","Reasonable","Very Strong","5'10""","152 lbs","47","119",78,80,6,7,5,10,12,1,8,8,5,7,6,5,2,11,5,13,8,12,8,11,13,10,9,14,8,7,6,8,13,10,8,9,10,13,7,5,9,13,9,11,8,12,5,14,8,5,9,12,8,2,1,1,1,2,4,2,3,3,1,1
"3653",82071034,"Jomo Harris","2/15/1995 (28 years old)","DM, M (C)","Paradise (BRB)","BFA Digicel Premier League","BRB","No","12/31/2020","12/31/2024","$0 - $9K","Right","Reasonable","Very Strong","5'8""","154 lbs","34","8",76,80,6,5,5,5,13,6,6,5,1,8,13,4,7,11,11,9,8,7,8,9,14,5,12,6,7,7,9,14,13,10,7,6,13,9,11,10,13,8,9,13,10,9,8,8,13,3,11,10,10,2,2,3,3,2,2,3,3,3,3,1
"3654",2000164438,"Lemar Catlyn","12/6/2002 (20 years old)","D (RC)","Ellerton","BFA Digicel Premier League","BRB","No","1/1/2019","12/31/2023","$0","Right","Reasonable","Very Strong","5'11""","145 lbs","-","-",68,78,3,9,7,1,7,1,7,7,4,8,7,5,8,8,5,10,8,8,12,15,16,5,6,6,7,7,6,7,15,14,8,10,13,13,6,5,11,19,11,10,13,11,9,7,15,8,11,12,17,1,2,1,3,3,3,1,3,2,1,1
"3655",82065325,"Teriq Highland","9/9/1989 (33 years old)","D (LC), WB (L)","Caledonia Utd","TT Premier Football League Tier 1","BRB","No","6/14/2021","6/30/2024","$0","Left","Very Strong","Reasonable","6'4""","191 lbs","-","-",78,78,7,10,6,4,9,5,6,7,7,8,7,4,8,6,11,10,7,9,9,11,8,5,7,5,11,5,6,9,12,8,12,16,13,12,12,12,10,6,11,6,11,10,9,3,9,8,13,10,9,2,3,2,3,3,1,1,3,3,1,1
"3656",82086162,"Ramar Miller","3/14/1996 (27 years old)","D (C)","Weymouth Wales","BFA Digicel Premier League","BRB","No","6/15/2020","12/31/2024","$0 - $3.5K","Right","Weak","Very Strong","6'1""","160 lbs","25","2",68,78,1,3,1,1,5,3,13,4,1,13,6,5,13,1,10,10,8,6,9,8,14,5,3,5,12,5,5,7,13,13,6,9,11,13,12,3,14,15,11,10,12,8,9,2,11,8,20,10,13,2,2,2,3,1,2,1,2,1,2,3
"3657",15072130,"Declan Lambert","9/21/1998 (24 years old)","D (RLC), DM","Kuala Lumpur","Malaysian Super League","MAS","No","1/1/2023","11/30/2025","$0 - $90K","Right","Reasonable","Very Strong","5'11""","167 lbs","101","-",72,94,3,7,9,2,11,6,8,2,2,7,7,1,9,10,11,11,9,7,6,13,11,7,5,6,13,7,8,6,12,10,7,5,14,11,11,10,10,19,11,14,13,10,6,17,14,5,10,13,7,3,1,3,3,3,4,2,4,3,2,1
"3658",2000129899,"Liam Brathwaite","11/6/2000 (22 years old)","GK","Weymouth Wales","BFA Digicel Premier League","BRB","No","6/30/2021","12/31/2025","$0 - $1.5K","Right","Reasonable","Very Strong","6'2""","167 lbs","9","-",70,77,1,1,3,2,1,5,1,3,1,1,8,3,2,3,10,7,12,6,7,11,16,1,10,1,13,7,6,6,13,5,4,7,13,10,1,4,14,12,12,12,9,10,13,4,11,7,20,12,10,6,12,13,8,8,13,9,5,6,12,10
"3659",82064542,"Elsid Miggins","3/29/1992 (31 years old)","M/AM (C)","Brittons Hill","BFA Digicel Premier League","BRB","No","6/14/2021","12/31/2024","Not for Sale","Right","Fairly Strong","Very Strong","5'11""","152 lbs","-","-",52,77,7,7,8,6,10,7,5,9,1,7,14,1,7,15,5,7,5,7,8,10,3,13,5,10,9,8,9,11,5,8,8,11,11,5,8,5,10,15,12,13,12,9,13,17,10,7,9,11,13,2,1,2,2,2,3,2,3,2,1,1
"3660",2000287746,"Ramón Griffith","10/17/1993 (29 years old)","M/AM (C)","UWI Blackbirds","BFA Digicel Premier League","BRB","No","9/1/2022","6/30/2025","$0 - $4K","Right","Reasonable","Very Strong","6'5""","194 lbs","-","-",68,75,5,5,8,9,13,6,8,14,5,7,11,10,8,14,15,8,4,7,8,11,13,13,11,8,8,7,8,8,8,6,7,15,7,8,13,9,11,19,9,14,15,10,6,3,8,7,9,13,8,4,2,2,3,1,3,3,3,1,4,1
"3661",2000130200,"Carl Hinkson","4/14/1997 (26 years old)","D/WB/M/AM (R)","BSA (BRB)","BFA Division One","BRB","No","1/1/2020","12/31/2023","$0","Right","Reasonable","Very Strong","5'10""","152 lbs","8","-",68,75,4,8,7,6,9,5,1,5,4,6,5,1,7,4,7,5,7,6,6,11,12,6,6,8,6,6,6,8,13,13,6,7,11,13,13,4,14,10,9,8,11,11,7,11,9,11,10,9,13,2,2,2,2,3,3,2,4,3,4,3
"3662",2000129905,"Rashad Smith","7/31/1996 (26 years old)","D/WB (L), DM, M/AM (LC)","BDFSP","BFA Digicel Premier League","BRB","No","6/15/2020","12/31/2024","$1.5K - $4K","Left","Very Strong","Reasonable","6'0""","156 lbs","35","11",70,75,4,7,7,10,10,4,5,2,5,7,10,4,10,5,12,9,7,7,6,9,12,15,2,10,7,6,6,7,12,8,6,7,15,11,12,4,20,17,10,12,11,13,9,8,7,7,15,12,9,1,1,1,1,3,4,2,1,3,3,2
"3663",90051142,"Carl Joseph","9/20/1988 (34 years old)","D/WB/M (L)","Brittons Hill","BFA Digicel Premier League","BRB","No","6/14/2021","12/31/2024","$0","Left","Very Strong","Reasonable","6'2""","202 lbs","-","-",60,75,7,11,8,3,12,7,5,6,7,9,8,2,9,7,7,11,8,9,9,11,3,5,14,8,10,8,9,9,9,8,9,15,15,6,10,6,12,15,9,10,9,13,14,8,5,1,3,11,8,3,3,4,2,2,1,2,1,3,1,2
"3664",2000205092,"Darico King","5/29/1997 (26 years old)","M (C)","St. Andrew","BFA Digicel Premier League","BRB","No","1/1/2019","12/31/2023","$0","Right","Fairly Strong","Very Strong","5'10""","156 lbs","38","7",74,75,7,4,4,7,12,7,7,5,4,9,9,3,9,9,8,9,8,6,8,14,11,8,10,9,6,8,10,9,14,14,8,4,13,11,7,9,11,12,12,13,10,13,8,4,5,4,20,11,12,2,3,1,1,2,3,3,3,3,2,3
"3665",82070982,"Ramon Manning","1/11/1993 (30 years old)","D/WB/M/AM (R)","Paradise (BRB)","BFA Digicel Premier League","BRB","No","6/14/2021","12/31/2024","$0 - $3.5K","Right","Fairly Strong","Very Strong","6'4""","180 lbs","9","-",71,74,6,8,8,10,12,5,3,1,6,7,8,5,7,8,5,6,8,8,5,8,4,10,6,12,8,7,6,8,13,11,7,10,13,11,13,7,15,15,11,13,9,11,9,18,9,7,13,12,16,2,2,2,2,1,1,2,2,3,1,2
"3666",82071047,"Rashad Jules","6/24/1992 (30 years old)","M (L), AM (RLC)","BDFSP","BFA Digicel Premier League","BRB","No","6/14/2021","12/31/2024","$0 - $2K","Left","Very Strong","Strong","5'10""","160 lbs","37","29",74,74,5,11,10,9,10,7,7,8,7,7,9,2,9,11,9,10,4,10,9,14,15,14,13,11,7,9,8,13,7,10,11,6,15,8,9,11,13,13,11,10,11,12,12,16,5,4,11,10,15,3,2,3,2,1,2,3,2,2,1,1
"3667",90051168,"Raheim Sargeant","6/9/1992 (31 years old)","D/WB (R), DM, M (RC), AM (R)","BDFSP","BFA Digicel Premier League","BRB","No","6/14/2021","12/31/2024","Not for Sale","Right","Reasonable","Very Strong","5'6""","134 lbs","22","3",69,73,7,8,8,9,11,7,7,8,7,8,10,7,9,9,10,11,8,8,8,12,10,10,10,14,9,8,6,9,12,9,8,5,12,9,8,2,11,12,9,9,13,11,7,17,5,4,17,12,7,3,2,2,2,1,3,1,3,1,4,2
"3668",1043424,"Mohd Safiq Rahim","7/5/1987 (35 years old)","M/AM (C)","Johor DT","Malaysian Super League","MAS","No","1/1/2023","11/30/2023","$0","Right","Reasonable","Very Strong","5'6""","141 lbs","279","48",70,94,10,7,4,9,14,15,5,8,2,7,11,7,4,12,15,9,7,9,8,13,17,13,15,8,9,8,14,9,10,7,8,1,14,8,5,2,15,16,12,9,9,10,13,2,5,8,12,10,12,2,2,4,2,1,3,1,1,1,2,1
"3669",82071132,"Shaquille Boyce","6/13/1996 (26 years old)","M/AM (C), ST (C)","Weymouth Wales","BFA Digicel Premier League","BRB","No","7/1/2018","12/31/2024","$0","Right","Fairly Strong","Very Strong","6'1""","165 lbs","-","-",56,72,2,4,3,13,6,4,7,4,1,4,11,6,3,7,10,10,7,6,6,11,18,7,4,11,5,6,10,7,13,13,5,8,12,13,3,4,9,18,10,10,13,9,10,4,10,6,7,10,11,3,1,3,2,1,1,1,1,3,3,2
"3670",72001616,"Romelle Burgess","3/14/1982 (41 years old)","DM, M (C)","Paradise (BRB)","BFA Digicel Premier League","BRB","No","6/14/2021","12/31/2024","$0","Left","Very Strong","Reasonable","5'8""","156 lbs","49","2",55,71,2,5,4,6,13,4,7,7,5,12,9,4,15,15,10,10,8,9,9,12,7,5,7,9,8,8,12,11,5,5,5,5,13,5,7,5,7,11,10,10,12,7,10,6,11,7,12,9,13,1,3,2,3,1,3,1,2,3,1,1
"3671",2000130420,"Keon Atkins","5/19/1995 (28 years old)","AM (C), ST (C)","Deacons","BFA Digicel Premier League","BRB","No","6/15/2020","12/31/2023","$0","Right","Reasonable","Very Strong","6'2""","169 lbs","-","-",68,70,5,6,10,13,10,4,8,6,1,3,5,1,3,10,6,5,1,4,6,13,7,12,5,8,4,5,11,7,13,12,6,11,13,13,7,6,10,16,13,12,10,10,14,6,7,8,20,11,18,2,2,1,2,2,1,1,4,2,1,1
"3672",90051112,"Jason Boxhill","5/21/1983 (40 years old)","GK","Paradise (BRB)","BFA Digicel Premier League","BRB","No","6/14/2021","12/31/2024","$0","Right","Reasonable","Very Strong","6'0""","169 lbs","14","-",68,70,2,3,3,3,7,4,3,2,3,1,9,3,1,6,6,11,10,7,12,7,13,1,5,3,14,9,8,7,7,12,4,8,12,7,3,7,10,14,9,13,11,18,6,7,11,8,10,12,8,12,14,7,8,10,9,11,10,9,13,12
"3673",2000205326,"Azarel Croney","6/16/1996 (26 years old)","M/AM (R)","Notre Dame","BFA Digicel Premier League","BRB","No","1/1/2019","12/31/2024","$0 - $4K","Right","Reasonable","Very Strong","5'8""","141 lbs","-","-",67,70,6,8,10,8,12,4,2,6,5,1,10,1,4,7,7,9,1,6,4,8,4,7,3,13,5,6,3,11,13,13,6,2,12,13,11,3,13,14,12,11,10,11,9,7,15,2,10,12,15,1,3,3,3,2,1,3,1,3,2,1
"3674",90051109,"Kadeem Atkins","1/1/1992 (31 years old)","D/WB/M/AM (R)","Deacons","BFA Digicel Premier League","BRB","No","6/14/2021","12/31/2023","$0","Right","Reasonable","Very Strong","5'9""","152 lbs","-","-",62,70,6,10,8,5,10,6,5,5,6,7,12,6,8,8,9,9,7,8,8,11,13,13,14,10,8,7,8,8,12,7,7,7,6,10,13,4,13,12,11,9,12,10,8,11,6,5,17,9,8,3,1,1,2,3,3,2,2,3,3,2
"3675",5101569,"Lyle Taylor","3/29/1990 (33 years old)","AM (R), ST (C)","Nottm Forest","English Premier Division","MSR","No","8/15/2020","6/30/2025","$375K - $1.1M","Right","Weak","Very Strong","6'2""","176 lbs","472","167",116,127,5,11,12,13,13,9,12,10,6,4,10,17,5,13,10,12,10,13,9,10,15,14,12,13,5,13,8,14,14,14,13,12,11,14,12,13,2,12,7,9,13,14,5,14,6,10,11,17,14,1,2,3,2,3,3,3,2,1,1,1
"3676",29217179,"Nico Gordon","4/28/2002 (21 years old)","D (RC)","Birmingham","Sky Bet Championship","MSR","No","6/26/2020","6/30/2024","$3.5K - $35K","Right","Reasonable","Very Strong","6'1""","180 lbs","14","1",80,125,7,8,8,5,9,7,10,5,5,10,8,5,10,10,9,9,12,10,8,9,10,5,10,8,12,10,8,10,10,10,9,13,12,12,10,13,10,12,14,12,10,10,8,9,5,1,8,9,10,2,3,3,1,1,1,2,3,1,1,3
"3677",28042865,"Rohan Ince","11/8/1992 (30 years old)","DM, M (C)","Woking","Vanarama National League","MSR","No","5/19/2023","6/30/2025","$200K - $600K","Right","Reasonable","Very Strong","6'4""","209 lbs","230","12",100,122,3,6,12,8,12,3,12,10,5,10,12,8,14,9,12,13,11,11,11,10,12,10,7,9,12,14,9,13,10,10,13,15,12,11,11,14,10,13,13,8,8,8,12,10,9,5,9,5,9,3,2,3,1,4,2,3,2,2,3,2
"3678",28067967,"Donervon Daniels","11/24/1993 (29 years old)","D (RC)","Walsall","Sky Bet League Two","MSR","No","1/24/2022","6/30/2024","$10K - $110K","Right Only","Weak","Very Strong","6'2""","202 lbs","214","10",97,120,4,9,9,6,9,5,12,6,14,11,11,7,11,10,14,11,13,12,11,10,14,7,15,11,11,12,9,13,11,10,12,13,14,11,14,13,6,11,14,16,14,14,12,12,8,6,14,10,15,2,4,3,1,3,4,3,3,1,2,3
"3679",1043432,"Mohd Aidil Zafuan","8/3/1987 (35 years old)","D (C)","Johor DT","Malaysian Super League","MAS","No","1/1/2023","11/30/2023","$0","Right","Reasonable","Very Strong","5'9""","171 lbs","140","6",71,93,9,2,1,2,8,13,12,2,3,10,8,2,11,7,12,12,8,7,6,14,19,5,15,7,13,7,5,8,10,8,8,8,15,8,10,9,12,12,12,12,11,11,8,4,6,2,15,11,12,2,1,2,3,3,1,3,1,1,3,2
"3680",29194203,"Jeriel Dorsett","5/4/2002 (21 years old)","D (C)","Reading","Sky Bet League One","MSR","No","6/21/2022","6/30/2025","$50K - $500K","Left Only","Very Strong","Weak","6'1""","180 lbs","48","1",85,120,2,8,6,3,6,1,12,5,5,11,7,7,13,10,10,11,12,10,8,9,10,6,6,9,11,10,7,12,12,11,11,13,11,12,12,13,12,10,10,12,11,11,10,5,5,6,10,10,9,1,2,2,2,2,1,3,2,3,4,2
"3681",29009489,"Alex Dyer","6/11/1990 (33 years old)","DM, M (C)","Wealdstone","Vanarama National League","MSR","Yes","5/31/2023","5/31/2024","$3.5K - $12K","Right","Reasonable","Very Strong","5'10""","163 lbs","381","55",66,116,8,9,9,8,11,8,9,9,5,8,12,8,8,10,8,8,10,11,10,10,11,7,12,9,9,11,12,12,6,8,12,7,11,6,10,9,16,10,13,13,11,9,8,11,7,8,7,11,15,2,2,3,1,3,1,2,3,1,1,1
"3682",28094198,"Brandon Comley","11/18/1995 (27 years old)","D (C), DM, M (C)","Walsall","Sky Bet League Two","MSR","No","7/1/2022","6/30/2024","$0 - $140K","Right","Reasonable","Very Strong","5'11""","165 lbs","189","3",84,115,8,8,9,6,9,7,10,4,2,10,10,5,11,10,12,11,11,9,9,9,15,4,6,10,11,12,9,14,11,9,10,9,15,12,15,14,8,15,14,14,12,9,4,9,12,1,9,12,12,3,2,3,3,2,3,3,4,2,2,1
"3683",5107421,"Dean Morgan","10/3/1983 (39 years old)","M/AM (RL), ST (C)","Beaconsfield","English Southern League Premier South","MSR","No","7/1/2019","6/30/2024","$0","Right","Fairly Strong","Very Strong","6'0""","169 lbs","451","66",51,110,12,10,10,8,9,9,8,11,5,6,9,13,4,12,7,5,5,9,6,5,7,16,2,9,4,5,7,4,8,9,8,10,11,7,9,6,5,4,7,4,4,3,10,5,10,17,5,14,8,1,3,3,2,2,3,3,3,2,1,1
"3684",29236677,"Lewis Duberry","3/7/2003 (20 years old)","DM, M (RC)","New Salamis","English Isthmian League North Division","MSR","No","7/1/2022","-","$0","Right Only","Weak","Very Strong","5'10""","163 lbs","11","-",60,95,8,9,8,8,11,8,9,9,4,9,10,9,11,7,11,9,12,11,7,10,12,7,4,8,8,5,9,9,10,10,10,9,9,10,11,10,10,18,11,12,12,12,4,5,5,3,8,12,10,2,3,3,3,3,3,3,2,3,3,3
"3685",28019852,"James Comley","7/11/1991 (31 years old)","DM, M (C)","Hampton & Richmond","Vanarama National League South","MSR","No","6/12/2023","5/31/2024","$0 - $12K","Right Only","Very Weak","Very Strong","5'10""","174 lbs","352","15",58,80,8,8,6,2,10,8,10,7,13,9,7,4,11,11,16,10,13,11,9,9,14,8,13,7,11,11,10,12,9,7,11,7,11,9,9,12,12,2,2,13,11,11,14,12,9,7,8,13,9,2,2,3,1,3,1,2,3,2,2,2
"3686",28103233,"Brandon Barzey","7/27/1999 (23 years old)","WB (R), M (RC), AM (R)","Dartford","Vanarama National League South","MSR","No","6/12/2023","5/31/2024","$7K - $22K","Right Only","Very Weak","Very Strong","5'7""","143 lbs","66","12",63,78,7,9,11,10,9,5,6,4,7,7,8,5,7,10,10,6,8,8,7,8,15,13,4,7,6,12,5,12,13,12,12,7,12,11,8,8,8,13,12,11,12,10,11,13,15,7,6,13,19,2,3,2,1,2,3,2,4,1,1,3
"3687",89004337,"Craig Braham-Barrett","6/28/1988 (34 years old)","D/WB (L)","Tonbridge","Vanarama National League South","MSR","No","6/18/2021","6/30/2024","$0","Left","Very Strong","Reasonable","5'9""","156 lbs","460","6",61,70,5,8,6,4,7,6,7,5,12,8,8,8,9,9,12,8,7,6,7,7,9,11,5,6,9,8,5,8,12,12,7,8,14,13,11,8,7,10,8,4,6,6,6,8,6,13,7,14,9,2,1,1,1,3,4,4,3,2,1,1
"3688",29091122,"Tyrell Miller-Rodney","4/23/1994 (29 years old)","M (RC)","Dartford","Vanarama National League South","MSR","No","6/12/2023","5/31/2024","$0 - $16K","Right Only","Very Weak","Very Strong","5'8""","152 lbs","276","14",62,68,6,7,7,6,8,5,7,7,7,9,10,8,11,10,7,10,11,9,9,8,11,8,12,9,10,12,9,14,10,10,10,10,11,10,14,11,8,11,10,9,12,14,4,4,7,6,6,12,9,2,3,2,2,3,2,1,3,3,2,3
"3689",52071091,"Kaleem Simon","7/8/1996 (26 years old)","M/AM (LC), ST (C)","Fleetwood Utd","UAE Second Division","MSR","Yes","9/8/2022","-","$0","Left","Very Strong","Weak","5'9""","165 lbs","115","7",55,65,4,8,8,9,9,3,5,3,4,4,8,2,2,6,8,6,3,9,5,10,10,10,7,10,5,5,8,6,12,11,5,2,11,11,11,3,10,15,9,12,11,11,13,11,9,6,4,11,15,2,2,3,3,2,2,2,3,1,1,2
"3690",141465,"Indra Putra Mahayuddin","9/2/1981 (41 years old)","AM (RL), ST (C)","Kelantan Utd","Malaysian Super League","MAS","No","1/3/2023","11/30/2024","$1.5K - $5K","Right","Strong","Very Strong","5'9""","138 lbs","402","124",54,93,7,11,9,13,12,13,6,7,4,5,8,4,3,9,6,9,5,9,6,10,13,13,6,11,5,6,7,7,8,8,3,7,13,10,5,3,14,14,9,10,10,5,12,8,8,5,8,10,15,3,1,2,2,1,2,4,3,1,2,3
"3691",2000207276,"Dominic Richmond","2/8/2006 (17 years old)","ST (C)","Fleetwood","Sky Bet League One","MSR","No","7/1/2022","6/30/2024","$0 - $35K","Right","Weak","Very Strong","6'0""","160 lbs","-","-",51,60,1,4,5,9,10,1,11,5,3,3,4,3,3,8,5,8,7,8,7,10,3,10,12,6,9,10,12,10,11,7,8,12,10,9,10,11,8,11,12,12,9,11,3,5,8,6,10,12,17,3,1,3,1,2,1,2,3,3,3,3
"3692",83191081,"Dylan Collard","4/16/2000 (23 years old)","D (C), DM","MRT","Portuguese Second League","MRI","Yes","10/14/2020","6/30/2024","$275K - $800K","Right Only","Weak","Very Strong","6'7""","213 lbs","77","9",98,127,10,8,5,6,9,6,14,7,12,10,10,8,13,12,9,10,9,8,11,11,12,10,6,9,12,11,11,9,10,10,13,15,10,10,10,17,4,10,13,12,13,10,10,8,6,6,8,12,17,3,3,3,2,4,2,1,2,3,1,2
"3693",85045879,"Lindsay Rose","2/8/1992 (31 years old)","D (RC)","Legia","PKO Bank Polski Ekstraklasa","MRI","Yes","7/1/2021","6/30/2024","$18K - $190K","Right","Weak","Very Strong","6'1""","191 lbs","279","17",107,125,4,10,8,6,10,6,13,9,12,14,10,6,12,9,14,10,12,8,9,12,10,8,8,8,12,13,6,13,11,12,14,13,13,12,13,14,16,14,13,14,8,12,12,13,13,8,12,13,14,2,1,3,1,1,3,1,2,2,3,2
"3694",8440899,"Kévin Bru","12/12/1988 (34 years old)","M/AM (C)","C' Chartres Football","French Regional 1 - Centre Val de Loire","MRI","Yes","7/1/2022","-","$0","Right","Reasonable","Very Strong","6'1""","156 lbs","292","19",100,123,12,12,13,8,14,13,8,12,3,7,13,11,8,14,9,11,9,11,10,10,7,14,3,12,8,10,15,10,11,12,13,12,11,11,9,11,15,11,10,10,10,10,13,9,13,12,12,12,9,3,2,4,1,2,1,1,3,1,1,3
"3695",18115778,"Noah Vandevoorde","10/22/2001 (21 years old)","D (C)","SK Roeselare","Belgian Third Amateur Division VV A","MRI","Yes","7/1/2022","6/30/2023","$0","Left Only","Very Strong","Weak","5'11""","163 lbs","-","-",68,104,3,2,1,3,6,1,10,5,1,11,6,1,12,2,7,10,8,6,11,13,13,5,9,4,13,5,2,7,13,9,6,5,13,9,12,8,14,19,10,13,11,11,13,6,12,6,17,12,14,3,3,3,2,3,4,1,2,1,2,3
"3696",49030853,"Michaël Bosqui","2/2/1990 (33 years old)","D (C)","ES Fos-sur-Mer","French National 3 - Group A","MRI","Yes","6/14/2021","6/30/2024","$22K - $65K","Right Only","Weak","Very Strong","5'10""","145 lbs","68","2",85,98,6,7,7,3,9,6,11,8,7,11,9,5,11,8,13,11,13,12,10,11,13,7,8,7,11,11,6,11,11,11,12,10,11,11,11,11,10,13,13,13,12,11,12,5,10,6,11,11,20,1,1,4,3,2,1,2,2,3,2,1
"3697",13225903,"Jean-Fabrice Augustin","2/28/1995 (28 years old)","M (C)","La Cure Sylvester SC","Mauritian Lower Divisions","MRI","No","7/1/2020","-","$0","Right","Fairly Strong","Very Strong","5'9""","154 lbs","-","-",79,88,3,4,2,7,10,5,5,7,1,12,10,1,10,9,10,7,8,7,7,13,10,8,8,9,5,7,12,12,13,13,5,8,7,13,7,6,15,10,10,11,13,13,6,9,10,1,11,11,20,3,1,2,2,3,2,3,1,3,3,2
"3698",85097017,"Jérémy Villeneuve","4/25/1994 (29 years old)","AM (C), ST (C)","US Créteil-Lusitanos","French National 2 - D","MRI","Yes","7/1/2022","6/30/2024","$40K - $130K","Right","Weak","Very Strong","5'5""","134 lbs","158","25",82,88,10,10,11,9,11,10,5,10,6,4,10,6,5,12,6,11,8,11,11,11,15,12,8,11,6,9,10,10,11,11,10,5,12,12,12,9,12,16,12,9,9,8,9,10,6,5,10,10,14,3,2,4,1,1,2,3,2,2,3,1
"3699",13226571,"Ashley Nazira","11/11/1995 (27 years old)","ST (C)","Saint-Pauloise FC","Réunion Regional 1","MRI","No","9/1/2021","12/31/2023","$0","Right Only","Weak","Very Strong","6'1""","174 lbs","2","-",73,85,6,5,10,13,13,6,8,6,1,2,9,5,3,10,9,10,4,8,5,12,10,13,4,11,7,6,7,11,12,9,8,11,10,12,13,11,9,14,10,10,12,10,13,6,8,5,9,10,15,1,3,4,2,2,3,2,2,1,3,1
"3700",15087723,"Cooper Legrand","12/30/1998 (24 years old)","ST (C)","Dandenong City","National Premier Leagues - Victoria 2","MRI","No","1/31/2022","9/30/2023","$0","Right","Fairly Strong","Very Strong","5'9""","149 lbs","37","11",65,85,4,1,9,13,9,5,13,4,1,5,3,8,4,13,7,7,4,9,6,7,7,14,4,11,5,5,6,6,13,13,6,6,13,13,11,6,12,19,11,13,13,8,10,17,7,2,9,10,7,2,2,1,2,3,2,3,1,3,2,1
"3701",23258253,"Muhd Shahrel Fikri Mohd Fauzi","10/17/1994 (28 years old)","AM (RL), ST (C)","N. Sembilan","Malaysian Super League","MAS","No","1/8/2023","11/30/2024","$35K - $110K","Right","Reasonable","Very Strong","5'11""","160 lbs","124","44",72,93,6,9,9,12,9,5,6,3,5,4,8,3,2,10,15,7,5,8,5,8,15,11,10,12,5,6,5,7,12,12,6,9,9,12,12,4,10,14,11,11,9,11,8,7,6,3,16,11,7,2,2,1,2,3,1,1,3,1,2,3
"3702",29162881,"Emmanuel Vincent","8/27/1997 (25 years old)","D (R)","ASPL 2000","Mauritian Premier Division","MRI","No","6/15/2020","6/30/2024","$0","Right","Weak","Very Strong","6'3""","176 lbs","-","-",65,85,3,10,6,2,5,1,6,1,6,9,7,4,14,7,6,5,8,7,8,12,6,5,5,6,9,7,7,8,13,11,7,16,13,12,13,6,14,20,13,11,8,13,11,9,8,6,6,9,17,3,1,3,3,3,2,1,1,2,1,2
"3703",15069936,"Marcus Dimanche","5/20/1998 (25 years old)","AM (RL)","Preston Lions","National Premier Leagues - Victoria 2","MRI","No","11/30/2022","9/30/2023","$0","Right","Reasonable","Very Strong","5'11""","158 lbs","73","4",63,83,4,9,11,8,10,6,2,7,6,6,7,2,7,11,4,7,5,7,7,11,15,11,8,9,5,7,7,10,12,14,7,9,13,12,7,5,15,13,10,13,10,10,9,17,5,8,8,10,12,1,1,4,3,3,3,3,1,1,1,2
"3704",13225895,"Christopher Caserne","2/22/1993 (30 years old)","GK","Bolton City YC","Mauritian Lower Divisions","MRI","No","6/14/2021","-","$0","Right","Reasonable","Very Strong","5'11""","158 lbs","-","-",60,80,1,2,2,2,1,6,1,1,2,2,2,1,2,1,14,7,11,3,8,12,11,1,3,3,9,1,4,4,10,7,5,4,13,12,1,7,10,15,9,12,12,11,10,11,12,5,8,10,16,7,13,12,9,7,11,12,12,11,11,6
"3705",85019444,"Jonathan Justin","2/27/1991 (32 years old)","ST (C)","Avenir Fonsorbais","French Regional Divisions","MRI","Yes","7/1/2021","-","$0","Right Only","Weak","Very Strong","6'4""","202 lbs","83","42",66,80,2,4,6,8,6,6,12,7,4,2,5,11,2,8,12,7,9,12,6,11,14,11,6,10,5,6,5,8,8,5,12,15,12,7,13,16,7,19,10,10,9,10,9,9,7,2,7,11,9,2,2,4,2,1,2,2,1,4,1,4
"3706",2000087681,"Andy Patate","6/18/1989 (33 years old)","AM (C), ST (C)","Petite Rivière Noire","Mauritian Premier Division","MRI","No","7/1/2020","6/30/2024","$0","Right","Reasonable","Very Strong","5'9""","156 lbs","-","-",55,80,5,4,10,13,13,5,10,6,1,3,7,3,4,8,11,9,3,8,6,8,14,8,13,7,6,5,4,7,11,8,1,7,8,8,9,6,9,19,9,10,11,13,8,11,13,6,11,13,15,3,1,2,1,1,2,2,2,3,1,1
"3707",13209370,"Jordan François","5/8/2002 (21 years old)","D (C), DM, M (C)","Cercle de Joachim","Mauritian Premier Division","MRI","No","6/30/2022","-","$0","Right Only","Weak","Very Strong","5'11""","158 lbs","21","-",58,78,6,6,11,7,10,6,9,7,6,9,8,7,11,11,12,9,12,8,8,7,13,7,6,8,10,10,9,12,11,11,8,11,12,9,11,10,12,10,9,11,10,12,5,8,6,3,9,10,18,2,3,1,2,3,3,3,3,2,2,3
"3708",2000087659,"Walter St. Martin","7/7/1984 (38 years old)","D (C), DM","Pamplemousses","Mauritian Premier Division","MRI","No","7/1/2020","6/30/2024","$0","Right","Reasonable","Very Strong","5'10""","163 lbs","-","-",60,75,3,5,2,6,10,5,14,5,5,11,6,2,13,8,8,9,7,6,7,10,2,5,4,6,14,6,8,8,5,7,7,6,12,6,4,7,13,16,11,11,8,12,5,12,7,3,9,12,17,2,3,1,3,1,2,2,2,4,3,1
"3709",13101631,"Christopher Bazerque","3/31/1987 (36 years old)","D (C)","ASPL 2000","Mauritian Premier Division","MRI","No","6/14/2021","6/30/2024","$0","Right","Reasonable","Very Strong","6'2""","171 lbs","-","-",60,75,3,4,1,7,7,6,14,5,1,9,8,1,7,5,14,10,9,8,9,15,14,6,5,6,10,7,1,8,9,8,8,9,14,9,10,6,12,12,12,11,12,12,11,11,11,2,10,8,8,3,1,3,3,3,4,3,3,3,3,1
"3710",13101703,"Marco Dorza","10/8/1988 (34 years old)","D (C)","Cercle de Joachim","Mauritian Premier Division","MRI","No","7/1/2018","-","$0","Right","Weak","Very Strong","6'3""","178 lbs","-","-",55,75,1,1,1,1,4,1,11,4,3,13,6,4,13,5,11,7,8,6,4,12,3,5,13,3,13,3,3,6,7,6,6,10,13,5,10,6,13,19,11,12,11,11,10,9,5,7,11,11,16,2,3,2,2,3,1,2,2,2,3,1
"3711",13231216,"Jonathan Spéville","1/26/1991 (32 years old)","D (C)","Bolton City YC","Mauritian Lower Divisions","MRI","No","7/1/2020","-","$0","Right","Weak","Very Strong","6'2""","178 lbs","-","-",55,75,1,1,4,1,5,5,10,1,1,13,5,1,12,1,7,6,8,4,7,12,8,5,6,3,10,5,3,6,9,7,6,11,10,6,4,8,15,10,12,12,10,9,5,10,6,8,4,12,15,2,2,1,2,1,3,1,2,3,2,2
"3712",15086556,"Quentin Cheng","11/20/1999 (23 years old)","D (RC), WB (R)","Selangor","Malaysian Super League","MAS","No","1/1/2023","11/30/2025","$16K - $150K","Right","Fairly Strong","Very Strong","6'2""","169 lbs","119","3",75,92,5,8,6,1,7,4,8,2,4,9,8,1,9,8,7,6,9,7,8,13,7,5,2,6,7,7,7,7,13,13,7,13,9,13,8,5,14,10,10,13,11,12,5,5,4,1,12,12,10,3,3,1,3,3,2,2,2,1,2,1
"3713",2000086640,"Bernard Jubeau","5/13/1992 (31 years old)","D (C), DM","ASPL 2000","Mauritian Premier Division","MRI","No","7/1/2020","6/30/2024","$0","Right","Reasonable","Very Strong","6'1""","167 lbs","-","-",60,75,2,2,1,1,8,3,10,5,1,11,8,3,14,5,12,13,8,7,8,9,16,5,12,6,14,6,5,8,8,11,7,9,14,9,13,5,12,12,15,10,11,9,13,2,10,4,9,11,19,2,2,1,3,1,2,1,2,3,1,1
"3714",2000087551,"Rodney Castel","8/24/1990 (32 years old)","D (C)","GRSE Wanderers","Mauritian Premier Division","MRI","No","7/1/2020","6/30/2024","$0","Right","Reasonable","Very Strong","5'11""","165 lbs","-","-",65,75,3,6,1,1,7,1,14,5,6,10,7,5,14,5,14,8,8,3,8,12,7,5,14,3,14,6,5,7,9,7,7,9,14,9,6,9,9,16,9,13,11,11,9,10,9,6,9,12,10,2,1,1,2,1,1,3,1,1,3,3
"3715",13227712,"Jean-Jacques Patate","9/9/1998 (24 years old)","M/AM (C)","Petite Rivière Noire","Mauritian Premier Division","MRI","No","7/1/2022","6/30/2024","$0","Right Only","Weak","Very Strong","5'11""","156 lbs","-","-",65,75,6,6,7,5,10,6,6,9,1,8,10,1,5,12,11,8,3,10,5,12,3,11,12,6,8,7,13,10,14,14,7,9,12,14,5,5,11,12,12,12,11,11,14,1,9,8,11,12,16,3,3,1,2,1,3,2,2,2,1,1
"3716",2000012530,"David Aristide","2/1/2002 (21 years old)","M (C)","GRSE Wanderers","Mauritian Premier Division","MRI","No","7/1/2020","6/30/2024","$0","Right","Reasonable","Very Strong","6'2""","171 lbs","-","-",60,75,6,6,4,7,14,6,2,9,3,10,10,3,10,13,5,6,2,4,6,11,13,5,9,8,9,7,14,11,12,9,7,13,9,12,6,5,16,17,10,9,11,12,5,18,10,6,10,11,20,1,2,2,1,3,2,3,2,2,2,3
"3717",13177999,"Adel Langue","9/27/1997 (25 years old)","M (C)","CA Vitry","French National 3 - Group H","MRI","No","7/1/2022","6/30/2024","$1K - $10K","Right Only","Weak","Very Strong","5'7""","138 lbs","12","1",55,70,5,5,4,5,13,5,5,7,2,9,13,1,6,11,10,5,4,6,5,10,14,5,11,5,5,6,9,11,13,13,3,1,13,13,12,3,11,19,11,9,14,10,5,8,5,5,17,10,11,2,3,2,3,1,1,1,1,3,2,2
"3718",13105786,"Andy Sophie","6/26/1987 (35 years old)","ST (C)","GRSE Wanderers","Mauritian Premier Division","MRI","No","7/1/2020","6/30/2024","$0","Right Only","Weak","Very Strong","6'0""","167 lbs","137","46",65,70,6,4,10,14,14,6,11,7,1,4,7,6,4,14,12,12,1,9,7,8,8,13,6,12,7,6,2,7,9,8,7,11,13,9,6,8,10,15,10,13,13,8,6,12,12,3,7,14,9,3,1,3,1,2,2,3,2,2,4,3
"3719",2000303731,"Wilson Moutou","4/8/2002 (21 years old)","D (C)","CTN-FB","Mauritian Lower Divisions","MRI","No","7/1/2018","6/30/2024","$0","Right","Reasonable","Very Strong","5'11""","160 lbs","-","-",57,70,3,1,1,2,5,1,13,1,1,12,5,1,11,1,13,8,8,6,8,13,16,5,9,5,11,5,2,6,10,10,5,7,9,10,3,5,14,17,12,10,12,14,7,2,8,4,12,11,11,1,4,3,2,3,1,1,1,2,1,2
"3720",13225904,"Jason Selmour","12/21/1990 (32 years old)","M (C)","GRSE Wanderers","Mauritian Premier Division","MRI","No","7/1/2020","6/30/2024","$0","Left","Very Strong","Weak","5'10""","156 lbs","-","-",55,70,6,6,5,5,14,5,6,8,5,11,14,4,8,9,15,9,6,8,7,13,17,5,1,10,6,7,9,10,9,7,7,4,10,8,6,6,8,13,11,9,9,10,8,5,11,5,10,11,9,2,1,3,1,3,1,1,3,1,1,1
"3721",13105780,"Louis Chiffone","2/18/1988 (35 years old)","M (C)","Savanne SC","Mauritian Premier Division","MRI","No","6/14/2021","6/30/2024","$0","Right","Reasonable","Very Strong","5'11""","158 lbs","-","-",50,70,3,1,4,6,13,5,4,5,1,9,13,5,6,9,13,6,7,8,6,11,3,9,12,8,9,6,13,5,6,8,6,6,15,6,5,5,10,16,11,11,10,9,9,1,9,8,10,10,9,1,3,1,3,1,3,1,1,3,3,2
"3722",2000087656,"Nick Harel","1/11/1992 (31 years old)","D (R), M (C)","Pamplemousses","Mauritian Premier Division","MRI","No","7/1/2020","6/30/2024","$0","Right","Reasonable","Very Strong","5'7""","147 lbs","-","-",50,70,7,9,5,2,9,5,4,8,1,9,10,2,13,7,9,9,7,8,8,14,8,6,3,5,9,7,9,8,9,12,7,3,8,9,7,4,13,18,8,13,10,13,9,10,5,1,13,12,10,2,3,1,3,1,1,2,1,2,3,2
"3723",2000133973,"Silvan Schiess","7/11/2003 (19 years old)","D/WB/M/AM (R)","Rapperswil","Swiss Second League Interregio Gr 4","LIE","Yes","7/3/2020","6/30/2024","$1.5K - $4.5K","Right","Reasonable","Very Strong","6'2""","171 lbs","17","3",56,86,5,7,7,9,8,4,5,4,5,4,7,5,7,12,10,6,7,5,3,10,13,12,10,10,3,6,5,7,13,8,6,13,13,12,5,5,12,16,10,13,13,13,5,6,8,8,7,13,15,3,3,3,3,2,3,2,4,1,1,3
"3724",23227978,"Junior Eldstål","9/16/1991 (31 years old)","D (C), DM","Prachuap","Thai League","MAS","Yes","1/5/2023","6/30/2024","$0","Right","Reasonable","Very Strong","6'2""","180 lbs","129","8",82,91,3,4,4,6,10,3,13,7,8,13,8,5,11,5,12,12,11,9,11,11,10,5,5,4,11,9,5,14,11,10,7,11,12,10,14,9,14,13,12,12,12,11,10,6,7,4,11,11,10,3,3,2,1,3,2,2,2,1,3,3
"3725",2000089885,"Shale Moothen","2/11/2000 (23 years old)","ST (C)","Fremantle City FC","National Premier Leagues - Western Australia","MRI","No","1/1/2021","-","$0","Right","Strong","Very Strong","5'10""","147 lbs","15","-",52,68,4,5,9,10,8,4,12,4,1,1,5,3,1,11,8,6,1,6,4,6,11,12,3,10,5,4,3,5,12,12,5,3,18,12,4,7,10,20,10,12,12,12,7,1,6,7,10,14,14,3,1,1,2,2,3,3,2,2,1,1
"3726",2000132803,"Justin Tang","11/14/2001 (21 years old)","DM, M (C)","Cockburn City","Western Australia State League Division 1","MRI","No","6/13/2022","9/30/2023","$0","Right","Reasonable","Very Strong","5'11""","145 lbs","22","3",53,68,5,5,1,4,9,5,3,11,1,7,13,2,13,12,13,3,7,5,7,9,7,5,7,6,11,7,6,10,13,9,6,9,14,12,5,3,10,17,11,10,12,10,10,8,13,4,16,10,14,1,2,2,2,1,2,1,1,2,1,1
"3727",2000087566,"Adrien François","8/26/1999 (23 years old)","AM (RC)","GRSE Wanderers","Mauritian Premier Division","MRI","No","7/1/2020","6/30/2024","$0","Right","Reasonable","Very Strong","5'6""","132 lbs","-","-",60,68,5,8,6,9,8,5,1,5,5,3,9,5,3,9,9,9,7,6,6,8,15,9,11,5,6,7,9,12,12,12,3,3,14,13,10,1,11,14,11,9,12,12,13,13,12,7,9,12,16,2,3,4,2,2,3,2,1,1,2,3
"3728",2000303727,"Gordy Prosper","3/23/2004 (19 years old)","AM (C)","CTN-FB","Mauritian Lower Divisions","MRI","No","7/1/2021","6/30/2024","$0","Right","Reasonable","Very Strong","5'10""","149 lbs","-","-",53,67,5,5,8,8,13,6,6,8,1,4,11,2,5,10,10,6,1,3,5,11,6,9,5,8,5,7,5,8,14,11,7,6,17,14,6,4,9,18,11,11,11,12,14,1,12,2,10,12,10,1,1,2,1,1,1,3,1,2,3,3
"3729",15062803,"Domenic Dimanche","1/16/1993 (30 years old)","D (L)","Endeavour Hills Fire","-","MRI","No","6/14/2021","-","$0","Left Only","Very Strong","Weak","5'10""","167 lbs","41","1",59,67,6,8,11,4,8,1,7,5,7,9,9,1,11,7,12,8,9,9,8,11,3,6,10,6,8,8,8,9,10,11,8,5,12,10,8,11,14,12,11,12,10,10,15,9,10,1,10,10,15,1,2,3,3,2,3,4,2,3,1,2
"3730",2000012535,"Adrien Botlar","9/19/1996 (26 years old)","M (C)","Pamplemousses","Mauritian Premier Division","MRI","No","8/1/2019","6/30/2024","$0","Right","Reasonable","Very Strong","5'11""","154 lbs","-","-",60,65,5,4,5,6,10,2,5,8,1,7,8,3,7,5,10,9,3,5,3,13,14,7,3,4,7,6,11,11,13,13,6,5,13,13,13,4,12,14,11,11,12,12,15,4,10,1,9,14,15,1,1,1,2,1,3,1,2,3,2,1
"3731",2000303726,"Stéphane Gentil","2/16/2002 (21 years old)","D/WB (L)","Bolton City YC","Mauritian Lower Divisions","MRI","No","7/1/2018","-","$0","Left","Very Strong","Reasonable","5'7""","141 lbs","-","-",50,65,3,7,6,2,7,1,4,5,5,7,7,1,7,7,12,3,7,7,7,13,8,9,10,5,6,6,3,7,13,13,6,5,10,13,7,3,12,10,12,10,12,11,5,3,7,2,10,14,9,1,2,2,2,1,3,2,3,1,2,3
"3732",13107317,"Kerlson Agathe","3/8/1991 (32 years old)","D/WB/M (L)","Pamplemousses","Mauritian Premier Division","MRI","No","6/14/2021","6/30/2024","$0","Left","Very Strong","Weak","5'8""","147 lbs","-","-",55,65,8,12,8,4,9,7,7,3,3,7,7,2,10,9,10,7,7,8,13,12,3,10,13,8,9,8,7,9,13,9,8,7,8,11,6,5,9,19,10,9,14,13,8,7,9,1,14,10,8,2,2,3,3,4,3,1,2,3,1,1
"3733",13209366,"Jean Loic Michel","7/6/2002 (20 years old)","GK","GRSE Wanderers","Mauritian Premier Division","MRI","No","10/4/2021","6/30/2024","$0","Right","Reasonable","Very Strong","5'9""","147 lbs","-","-",50,65,5,1,3,3,2,6,1,1,2,1,7,1,1,4,8,7,10,3,9,12,16,2,12,2,8,6,5,5,10,11,2,3,11,8,4,3,8,16,12,11,13,12,7,7,11,4,8,9,7,8,12,11,8,8,9,10,5,9,8,5
"3734",15062076,"Laurent Coralie","3/11/1996 (27 years old)","D/AM (R)","Endeavour Hills Fire","-","MRI","No","7/2/2021","-","$0","Right","Reasonable","Very Strong","6'3""","171 lbs","13","1",52,64,5,9,7,7,8,5,5,1,1,6,5,1,8,8,12,5,5,7,7,6,6,13,5,10,5,6,4,7,12,6,4,11,13,11,12,4,10,14,9,12,12,9,12,1,5,6,10,8,19,2,1,3,1,2,1,3,3,1,1,2
"3735",23267418,"Dominic Tan","3/12/1997 (26 years old)","D (C)","Sabah","Malaysian Super League","MAS","No","1/1/2023","11/30/2024","$16K - $150K","Right Only","Weak","Very Strong","6'0""","167 lbs","88","3",79,91,4,1,1,3,4,1,10,6,1,13,7,1,13,6,5,8,6,5,7,13,10,5,13,6,12,6,1,3,13,13,7,11,15,13,4,10,15,17,13,12,11,12,8,5,3,3,11,10,8,2,1,2,1,2,1,1,2,2,2,2
"3736",2000087560,"Emmanuel Foolchand","9/20/2001 (21 years old)","M (C)","GRSE Wanderers","Mauritian Premier Division","MRI","No","7/1/2020","6/30/2024","$0","Right","Reasonable","Very Strong","6'1""","167 lbs","-","-",60,63,3,6,6,6,12,3,3,10,1,12,9,2,6,9,14,6,7,5,7,10,4,5,7,10,5,6,15,11,8,11,8,14,12,13,9,6,12,10,12,9,13,12,11,12,11,5,16,10,17,1,2,3,3,1,2,2,2,1,2,2
"3737",2000303728,"Nilesh Rasdarising","2/8/1994 (29 years old)","M (C)","Rivière du Rempart","Mauritian Lower Divisions","MRI","No","7/1/2020","6/30/2024","$0","Right","Reasonable","Very Strong","5'9""","147 lbs","-","-",55,62,1,2,1,5,10,1,2,6,1,6,6,1,6,10,11,5,7,5,6,12,15,5,10,6,5,5,10,8,12,12,5,7,15,12,11,4,14,17,12,11,9,10,5,13,13,7,11,11,19,1,2,1,2,3,3,1,3,3,2,3
"3738",13196777,"Yannick Aristide","3/15/2001 (22 years old)","AM (C)","Cercle de Joachim","Mauritian Premier Division","MRI","No","7/1/2020","-","$0","Right","Weak","Very Strong","6'2""","171 lbs","-","-",50,62,6,6,7,9,13,6,6,7,1,6,8,5,6,8,14,9,7,4,6,8,5,8,9,7,8,7,13,12,9,12,7,8,15,10,7,6,16,19,10,10,10,12,11,7,14,1,10,12,10,2,3,2,3,3,2,2,2,3,3,1
"3739",13177979,"Luther Rose","3/22/1989 (34 years old)","M (C)","ASPL 2000","Mauritian Premier Division","MRI","No","6/14/2021","6/30/2024","$0","Right","Reasonable","Very Strong","6'0""","163 lbs","-","-",55,60,6,6,2,6,10,6,6,6,1,9,8,1,9,8,9,10,7,9,7,14,10,5,6,9,6,8,8,11,9,7,7,8,17,7,6,6,10,20,10,12,11,11,13,11,12,3,12,13,8,1,1,3,1,3,2,1,1,2,3,3
"3740",13105164,"Kévin Jean-Louis","6/27/1989 (33 years old)","GK","Pamplemousses","Mauritian Premier Division","MRI","No","6/14/2021","6/30/2024","$0","Right","Weak","Very Strong","6'2""","167 lbs","-","-",57,60,4,3,1,3,1,5,1,1,2,1,6,1,3,2,11,10,12,6,8,8,14,2,6,2,7,6,5,5,11,9,3,12,13,11,5,4,11,14,13,12,11,11,15,2,9,8,12,12,19,8,10,9,10,7,8,13,5,10,13,12
"3741",2000087660,"Fabrice Brasse","7/15/1996 (26 years old)","M/AM (R)","Pamplemousses","Mauritian Premier Division","MRI","No","7/1/2020","6/30/2024","$0","Right","Fairly Strong","Very Strong","6'0""","169 lbs","-","-",53,60,4,7,10,7,9,1,1,1,1,3,4,1,4,8,13,7,6,2,3,11,5,13,11,6,3,5,3,10,11,11,4,7,13,11,11,9,9,17,12,11,12,12,10,8,5,7,9,10,12,3,3,3,1,1,2,3,1,1,3,3
"3742",13178024,"Pascal Balisson","10/28/1996 (26 years old)","D (L)","Cercle de Joachim","Mauritian Premier Division","MRI","No","6/15/2020","-","$0","Left","Very Strong","Weak","5'6""","132 lbs","-","-",50,60,6,11,3,5,6,1,6,2,1,7,2,1,9,6,7,7,7,5,9,9,12,5,10,4,6,6,4,7,13,13,6,1,11,13,12,1,12,12,8,11,13,10,14,4,14,4,9,9,20,2,2,2,2,3,2,4,2,2,3,2
"3743",13178026,"Francis Rasolofonirina","7/22/1986 (36 years old)","D (C)","AS Vacoas Phoenix","Mauritian Premier Division","MRI","No","7/1/2020","6/30/2024","$0","Right","Weak","Very Strong","5'10""","160 lbs","-","-",50,60,1,1,1,1,6,1,11,1,3,8,6,2,9,5,8,8,8,6,9,13,10,5,13,5,13,5,2,6,4,7,6,6,11,6,8,7,9,11,9,11,12,13,11,6,8,1,9,14,8,1,2,1,1,2,2,1,2,3,1,3
"3744",2000086630,"Kinsley St. Pierre","12/13/1995 (27 years old)","DM, M (C)","ASPL 2000","Mauritian Premier Division","MRI","No","7/1/2020","6/30/2024","$0","Right","Reasonable","Very Strong","5'11""","158 lbs","-","-",50,60,2,6,4,4,7,6,6,7,1,8,8,2,7,8,15,11,7,8,8,8,9,5,2,8,8,13,4,13,11,12,7,10,12,11,14,6,9,20,10,13,10,9,6,1,8,1,8,9,16,3,2,2,2,1,2,1,1,3,1,2
"3745",2000087663,"Kengy Saramandif","5/10/1997 (26 years old)","AM (RL), ST (C)","Pamplemousses","Mauritian Premier Division","MRI","No","7/1/2020","6/30/2024","$0","Right","Fairly Strong","Very Strong","5'9""","149 lbs","-","-",50,60,4,6,10,11,11,4,6,5,2,3,9,8,1,6,14,7,1,10,5,11,10,8,5,11,4,5,4,6,12,11,4,3,7,12,3,4,9,10,9,12,14,9,13,16,7,2,10,10,8,2,3,1,1,1,3,1,2,2,3,1
"3746",23268446,"Mohd Syamer Kutty Abba","10/1/1997 (25 years old)","M (RL)","Johor DT","Malaysian Super League","MAS","No","1/1/2023","11/30/2023","$0 - $12K","Right Only","Weak","Very Strong","6'0""","152 lbs","70","3",76,91,7,12,10,6,9,6,3,7,6,6,9,2,7,13,13,9,6,7,7,12,11,9,7,7,6,7,7,12,13,13,7,7,12,13,13,5,13,18,12,11,11,11,7,2,9,8,12,10,20,2,1,1,1,2,2,1,1,2,2,3
"3747",2000087658,"Guillaume Sockalingum","1/26/1986 (37 years old)","M/AM (C)","Pamplemousses","Mauritian Premier Division","MRI","No","7/1/2020","6/30/2024","$0","Right","Reasonable","Very Strong","6'2""","169 lbs","-","-",50,60,3,2,7,7,13,4,3,10,1,6,10,2,6,9,13,8,7,11,6,12,10,12,13,8,6,6,9,9,7,7,6,10,13,7,7,4,8,11,12,12,11,10,5,12,5,4,10,12,7,3,1,2,3,4,1,1,2,3,1,1
"3748",2000186589,"Emad Al-Godaimah","3/11/2003 (20 years old)","D (C)","May 22","Yemeni Lower Division","YEM","No","7/1/2020","7/31/2023","$0","Right","Reasonable","Very Strong","6'1""","160 lbs","-","-",68,126,1,1,1,1,6,3,13,1,1,11,6,5,13,3,5,13,8,6,5,12,9,7,11,3,13,5,4,6,8,10,6,13,15,9,6,3,12,20,13,9,12,11,9,11,6,2,11,10,12,3,3,3,3,4,3,4,1,2,3,1
"3749",2000164322,"Omar Ali","4/4/2003 (20 years old)","M/AM (RL), ST (C)","Al-Wasl","UAE Professional League","YEM","No","6/1/2021","6/30/2026","$240K - $2.4M","Right","Reasonable","Very Strong","5'6""","143 lbs","-","-",80,120,5,9,11,9,8,7,3,8,3,7,9,4,7,12,11,9,7,11,7,13,17,11,12,11,7,8,10,12,13,10,10,1,15,12,7,2,11,19,12,11,10,11,5,14,5,2,19,8,17,3,3,1,4,3,2,1,3,3,2,3
"3750",28115643,"Tareq Shihab","3/7/2001 (22 years old)","D/M (C)","Grótta","Icelandic First Division","YEM","Yes","2/4/2023","11/30/2024","$3K - $30K","Right","Weak","Very Strong","5'10""","156 lbs","5","-",76,109,7,7,2,3,10,7,8,5,5,10,9,2,13,9,12,8,8,9,5,14,10,5,8,8,9,8,7,9,14,14,8,4,12,14,6,7,12,18,8,12,12,12,12,7,15,5,11,8,14,3,3,2,2,3,3,1,1,3,1,3
"3751",2000288136,"Hamzah Al-Rimi","2/12/2002 (21 years old)","D/WB (L)","Al-Tahaddy","Libyan First Division","YEM","No","9/10/2022","6/30/2025","$0 - $95K","Left","Very Strong","Fairly Strong","5'10""","156 lbs","-","-",72,106,6,10,7,3,11,2,9,3,8,10,9,5,13,9,13,6,9,9,8,15,2,8,14,8,9,9,9,9,12,10,9,6,10,10,9,6,11,11,9,10,12,9,13,2,7,3,11,12,14,2,1,3,1,1,3,2,3,2,1,1
"3752",54203079,"Nasser Mohammedoh","5/24/1999 (24 years old)","DM, M (C)","Al-Shorta","Iraqi Premier League","YEM","No","2/4/2023","7/31/2023","$2.5K - $26K","Right","Weak","Very Strong","5'11""","165 lbs","13","1",90,105,11,5,6,3,13,7,7,10,1,9,7,3,13,11,12,11,9,9,7,13,6,5,13,8,10,8,8,12,13,13,8,8,14,13,7,10,15,18,10,11,10,12,9,8,13,1,16,11,14,2,3,1,4,2,1,3,1,3,3,1
"3753",2000153589,"Salem Al-Soumahi","3/2/2003 (20 years old)","ST (C)","Al-Wahda (UAE)","UAE Professional League","YEM","No","7/1/2021","6/30/2024","$350K - $1M","Right","Reasonable","Very Strong","5'9""","136 lbs","-","-",60,105,5,4,8,13,10,5,13,5,4,5,6,4,1,9,6,8,5,11,6,11,12,14,10,11,6,5,6,6,13,8,5,8,8,10,5,8,12,10,7,9,12,11,13,16,8,6,5,12,7,3,2,3,3,1,2,1,3,2,1,2
"3754",2000081077,"Ahmed Al-Wajih","2/5/2002 (21 years old)","D (L)","Al-Sha'ab Ibb","Yemeni First Division","YEM","No","1/1/2019","6/30/2025","$0","Left","Very Strong","Fairly Strong","6'0""","165 lbs","-","-",80,105,5,9,7,4,10,1,9,7,8,5,10,4,10,5,10,8,10,8,8,15,13,7,10,8,7,9,4,9,15,12,9,10,13,13,10,7,11,15,12,13,11,11,13,9,11,2,20,10,11,1,2,2,3,1,2,3,3,2,3,2
"3755",64049746,"Ahmed Maher","1/24/2002 (21 years old)","AM (L), ST (C)","El Baladeya","Egyptian Premier League","YEM","No","10/15/2022","7/31/2024","$20K - $210K","Left","Very Strong","Fairly Strong","5'9""","147 lbs","-","-",80,105,7,11,13,11,9,6,13,4,1,6,10,4,2,13,6,5,3,9,7,9,4,13,10,10,5,7,8,8,13,11,7,8,14,13,7,5,12,17,9,11,12,8,5,7,7,1,11,13,14,3,2,2,3,3,1,2,2,2,3,1
"3756",64049992,"Salem Al-Harsh","10/7/1998 (24 years old)","GK","Al-Wahda Aden","Yemeni First Division","YEM","No","6/15/2020","6/30/2024","$0 - $35K","Right","Reasonable","Very Strong","6'3""","171 lbs","-","-",75,103,2,2,3,1,6,5,1,2,3,2,8,2,1,4,15,8,15,7,9,11,15,3,5,1,9,7,6,5,11,5,7,15,15,13,1,7,13,12,9,15,9,13,10,15,5,5,17,14,14,8,12,13,7,9,9,13,5,11,12,13
"3757",2000093571,"Muhd Aliff Izwan Yuslan","10/2/2004 (18 years old)","M/AM (C)","Selangor","Malaysian Super League","MAS","No","1/3/2023","11/30/2025","$6K - $60K","Left","Very Strong","Reasonable","5'9""","154 lbs","28","2",67,91,13,10,11,6,9,8,5,10,4,4,12,2,6,12,13,5,12,6,6,7,8,11,11,12,8,7,11,12,13,12,7,8,12,11,7,9,11,10,11,8,10,11,15,5,7,1,7,11,10,1,3,1,2,2,2,1,4,1,1,1
"3758",2000260004,"Mabrook Saleh","6/4/2001 (22 years old)","M (C)","Gold Star FC","National Independent Soccer Association","YEM","No","3/10/2023","11/30/2023","$0 - $35K","Right","Reasonable","Very Strong","6'2""","171 lbs","-","-",71,103,6,6,4,7,13,6,5,12,1,8,11,1,5,13,15,8,4,4,7,13,10,5,12,8,9,7,12,12,12,10,7,10,11,10,7,5,11,10,11,12,11,13,5,14,5,7,11,10,16,2,2,4,3,2,3,3,2,2,1,1
"3759",54201846,"Omar Al-Dahi","12/15/1999 (23 years old)","M (RLC), AM (C)","Al-Zawra'a","Iraqi Premier League","YEM","No","2/4/2023","6/30/2025","$14K - $150K","Right","Reasonable","Very Strong","5'9""","141 lbs","10","-",85,100,7,7,12,9,14,7,7,7,3,7,12,7,9,11,9,10,6,9,8,10,5,15,11,12,8,8,11,12,13,9,14,4,9,10,8,4,15,13,13,12,10,13,13,4,11,2,13,9,13,3,3,2,3,2,2,1,3,2,2,2
"3760",54201848,"Mufeed Gamal","10/1/2000 (22 years old)","D (L), DM","Al-Saqr","Yemeni First Division","YEM","No","7/1/2021","6/30/2026","$0 - $35K","Left","Very Strong","Reasonable","5'9""","147 lbs","-","-",78,100,8,11,5,2,10,7,8,8,5,11,8,3,13,7,7,6,6,8,12,14,16,7,9,7,14,5,8,9,13,10,5,8,17,13,6,6,18,19,12,11,13,12,8,11,6,6,10,15,17,4,2,2,1,2,3,2,3,4,2,2
"3761",2000046108,"Adel Al-Chadli","4/13/2000 (23 years old)","AM (RL)","Shabab Al-Ahli","UAE Professional League","YEM","Yes","7/1/2018","6/30/2025","$90K - $900K","Left","Very Strong","Reasonable","5'8""","152 lbs","10","-",85,100,7,11,11,10,11,6,7,9,8,8,7,7,6,8,8,8,5,9,9,11,9,8,8,10,10,9,9,11,10,10,10,12,8,11,12,12,14,14,13,13,13,10,13,15,12,5,10,12,12,2,3,2,1,2,3,1,2,1,3,2
"3762",23243652,"Ala'a Al-Sasi","7/2/1987 (35 years old)","M/AM (C)","Al-Ahli Sana'a","Yemeni First Division","YEM","No","7/1/2020","6/30/2024","$0","Right","Fairly Strong","Very Strong","5'9""","154 lbs","7","3",80,100,8,10,9,12,12,8,8,7,2,9,11,5,8,11,14,10,9,10,7,9,15,14,14,10,10,9,10,14,8,11,9,8,12,9,9,6,13,19,10,11,13,10,6,6,7,4,18,11,13,3,1,2,3,2,3,2,2,1,3,3
"3763",19350876,"Ahmed Al-Sarori","8/9/1998 (24 years old)","ST (C)","SCC Mohammedia","Botola Pro 1","YEM","No","11/30/2020","6/30/2024","$0","Right","Fairly Strong","Very Strong","5'10""","149 lbs","15","3",77,98,6,4,11,13,13,6,8,6,2,6,13,9,5,11,11,11,8,10,7,11,11,14,11,11,7,12,7,7,12,13,11,8,13,9,3,3,10,13,12,11,11,11,5,3,6,3,13,10,11,1,1,4,3,1,2,2,1,1,2,1
"3764",2000164330,"Rashed Wadhah","5/23/2005 (18 years old)","M/AM (R)","Al-Wasl","UAE Professional League","YEM","No","7/1/2021","6/30/2024","$180K - $1.8M","Right Only","Weak","Very Strong","5'10""","174 lbs","-","-",75,95,4,8,9,11,11,7,9,9,7,4,8,6,7,10,8,10,6,12,4,7,16,8,9,10,7,9,6,14,15,13,15,8,16,12,12,5,12,15,11,10,13,9,14,2,8,1,19,11,9,2,2,2,2,2,2,3,1,2,1,2
"3765",2000189424,"Hamzah Al-Riymi","2/12/2002 (21 years old)","D (LC)","Al-Tahaddy","Libyan First Division","YEM","No","9/2/2022","6/30/2023","$0 - $35K","Left","Very Strong","Fairly Strong","6'2""","165 lbs","-","-",70,95,3,8,2,1,8,1,11,5,3,11,7,1,9,7,14,8,9,6,8,12,13,5,3,6,8,7,2,8,13,13,4,13,13,13,12,4,10,14,11,11,12,11,9,5,7,1,20,14,10,2,3,1,4,1,2,2,1,1,3,2
"3766",2000015153,"Hamada Al-Zubairi","1/6/1990 (33 years old)","D (C)","Al-Ahli Sana'a","Yemeni First Division","YEM","No","6/14/2021","6/30/2024","$4K - $12K","Right","Fairly Strong","Very Strong","6'4""","185 lbs","-","-",78,95,4,1,1,3,7,4,10,2,1,13,7,3,13,6,12,11,9,4,10,13,13,5,12,6,13,6,2,7,4,9,7,15,14,6,11,9,12,11,10,13,10,14,11,4,11,2,11,11,9,2,3,2,1,1,3,2,1,1,3,1
"3767",2000130001,"Mohammed Sohail","9/2/2004 (18 years old)","GK","Al-Ittihad Ibb","Yemeni First Division","YEM","No","1/1/2021","6/30/2025","$0","Right","Reasonable","Very Strong","6'0""","160 lbs","-","-",53,95,4,1,3,1,1,7,1,3,2,1,10,3,2,2,9,6,15,6,10,9,13,2,5,3,6,6,5,5,12,13,6,10,11,7,3,4,8,10,11,8,11,11,14,1,12,1,8,15,20,5,13,8,9,6,8,11,5,8,11,6
"3768",2000024964,"Sharul Nazeem Zulpakar","11/16/1999 (23 years old)","D (C)","Selangor","Malaysian Super League","MAS","No","7/2/2018","11/30/2025","$12K - $130K","Right","Reasonable","Very Strong","5'10""","158 lbs","59","1",77,90,1,2,2,6,7,2,11,1,6,13,5,4,11,5,15,10,9,7,9,9,15,5,7,6,12,6,1,7,9,13,7,9,15,13,4,10,9,19,11,12,12,10,12,11,19,6,10,10,7,3,3,1,2,3,2,3,1,2,3,1
"3769",2000015208,"Jalal Al-Jalal","1/3/1996 (27 years old)","M/AM (RLC)","Al-Saqr","Yemeni First Division","YEM","No","8/18/2022","6/30/2025","$0 - $22K","Right","Reasonable","Very Strong","5'9""","147 lbs","-","-",85,95,7,7,8,10,10,7,7,6,7,6,5,7,8,10,8,9,8,12,7,11,3,13,14,11,8,8,11,11,14,14,5,9,13,14,7,5,11,20,12,12,12,13,14,3,12,7,10,11,9,3,2,2,2,3,2,2,3,3,1,1
"3770",2000186590,"Abdul Majeed Sabarah","8/22/2000 (22 years old)","M/AM (L)","Al-Wahda Sana'a","Yemeni First Division","YEM","No","1/1/2020","6/30/2024","$0 - $22K","Left","Very Strong","Fairly Strong","6'1""","160 lbs","-","-",72,94,7,11,12,9,13,6,6,7,2,5,6,2,7,9,6,4,4,8,7,8,9,9,10,6,6,7,7,8,13,13,7,9,12,13,6,3,11,15,12,12,13,8,5,5,9,7,20,13,18,1,2,1,3,2,2,2,3,1,2,3
"3771",2000130015,"Suhail Al-Silwi","1/1/2001 (22 years old)","D (C)","Al-Wahda Sana'a","Yemeni First Division","YEM","No","1/1/2020","6/30/2024","$0","Right","Weak","Very Strong","5'11""","160 lbs","-","-",57,94,1,1,1,1,5,1,10,1,2,8,2,4,12,2,13,9,7,5,9,12,7,5,6,4,12,4,2,6,12,10,5,6,12,10,11,6,15,18,11,8,11,11,11,1,11,1,11,13,12,3,2,1,1,2,3,3,2,3,2,2
"3772",5636686,"Akram Al-Worafi","11/12/1986 (36 years old)","M (LC), AM (L)","Al-Sha'ab Ibb","Yemeni First Division","YEM","No","1/1/2020","6/30/2024","$0","Right","Reasonable","Very Strong","5'5""","127 lbs","-","-",69,94,7,10,10,12,15,7,1,9,7,5,12,5,9,12,15,9,3,5,7,12,13,10,12,14,7,8,7,9,10,10,8,2,10,10,10,1,12,14,12,10,10,11,13,17,6,7,14,11,13,1,1,3,1,3,2,1,1,3,1,1
"3773",64047362,"Abdulwasea Al-Matari","7/4/1994 (28 years old)","M (RLC)","Al-Nahda","Omani Professional League","YEM","No","1/1/2023","6/30/2024","$0 - $14K","Right","Reasonable","Very Strong","5'6""","132 lbs","59","8",86,92,6,10,8,6,10,6,6,8,2,6,12,3,8,12,8,10,7,6,7,9,5,5,7,8,5,7,9,12,13,13,5,4,12,13,13,6,13,14,10,10,10,13,5,5,5,2,15,12,17,2,1,2,2,3,1,1,1,3,3,3
"3774",2000180886,"Alaa Awsha","9/19/2004 (18 years old)","M (C)","Al-Sha'ab Sana'a","Yemeni Lower Division","YEM","No","6/13/2022","6/30/2024","$0","Left","Very Strong","Weak","6'1""","167 lbs","-","-",65,92,4,6,6,3,13,6,6,8,1,10,9,1,5,14,10,7,6,7,5,12,5,7,4,8,6,7,14,12,13,13,5,9,14,10,7,6,13,19,13,12,10,12,7,7,12,6,4,10,8,1,2,4,3,2,1,1,2,1,1,3
"3775",5636671,"Mohammed Ayash","3/6/1986 (37 years old)","GK","Al-Hilal Hudayda","Yemeni Lower Division","YEM","No","11/26/2018","6/30/2024","$0","Right","Reasonable","Very Strong","5'10""","143 lbs","-","-",70,91,4,1,1,2,4,6,1,3,3,2,9,1,3,6,10,10,12,8,7,14,8,2,13,1,10,8,4,7,8,6,8,5,15,8,5,6,12,20,14,11,8,14,13,9,12,2,11,11,7,10,7,8,5,12,8,14,5,13,12,9
"3776",2000130002,"Sadiq Al-Jalal","1/1/2001 (22 years old)","ST (C)","Al-Ittihad Ibb","Yemeni First Division","YEM","No","1/1/2021","6/30/2025","$0","Right","Reasonable","Very Strong","5'11""","158 lbs","-","-",55,90,4,4,12,12,9,2,12,5,2,4,5,7,1,8,7,9,1,5,4,3,7,9,9,9,5,4,2,5,12,10,5,6,13,12,4,7,11,11,10,11,11,11,8,13,10,7,14,11,20,1,2,2,1,3,4,2,3,2,2,2
"3777",54201847,"Mohammed Al-Madari","1/13/1997 (26 years old)","M (C)","Al-Wahda Aden","Yemeni First Division","YEM","No","3/1/2020","6/30/2024","$1.5K - $14K","Right","Reasonable","Very Strong","5'8""","149 lbs","-","-",76,90,6,6,4,3,12,6,6,6,3,10,12,3,8,8,14,7,4,4,7,13,5,9,9,9,6,7,6,12,13,13,7,5,12,13,11,8,13,18,12,9,10,11,8,13,5,1,13,10,15,3,3,1,4,1,3,3,1,2,3,3
"3778",23458620,"Ahmad Al-Haifi","11/10/1993 (29 years old)","DM, M (C)","Al-Yarmook Sana'a","Yemeni First Division","YEM","No","7/2/2019","6/30/2024","$0 - $16K","Right","Reasonable","Very Strong","6'0""","163 lbs","9","-",78,90,6,4,4,7,12,6,5,5,1,7,13,4,6,13,8,8,8,8,8,13,4,5,11,7,10,7,13,11,12,10,7,5,14,11,10,6,11,16,11,9,14,10,11,14,5,6,17,10,17,1,2,1,3,3,1,1,3,3,1,2
"3779",5107627,"Lee Tuck","6/30/1988 (34 years old)","AM (RC)","Kedah","Malaysian Super League","MAS","No","1/1/2023","11/30/2023","$0 - $1.5K","Right","Weak","Very Strong","5'10""","158 lbs","237","60",76,90,7,10,11,11,12,9,9,9,7,4,8,11,8,12,8,9,13,9,9,8,3,9,8,11,5,10,8,11,13,12,9,10,12,11,9,10,11,13,10,11,12,11,11,11,6,2,11,12,14,4,2,1,4,1,3,2,2,1,1,3
"3780",2000105211,"Mohammed Aman","7/27/1997 (25 years old)","D (RC)","Al-Ahqaf","Yemeni Lower Division","YEM","No","7/1/2019","6/30/2024","$1K - $8K","Right","Reasonable","Very Strong","5'10""","149 lbs","-","-",67,90,4,8,4,2,8,2,9,1,1,13,6,4,14,6,6,10,8,7,7,10,18,5,6,5,9,6,6,7,14,14,7,6,11,14,8,4,11,12,11,10,12,10,7,5,14,2,10,13,10,3,1,1,3,1,4,2,2,2,1,2
"3781",2000264326,"Nawaf Abdullah","12/31/1994 (28 years old)","DM, M (C)","Hidd","Bahrain Premier League","YEM","No","6/8/2023","6/30/2025","$0 - $14K","Right","Reasonable","Very Strong","5'7""","141 lbs","-","-",83,90,7,6,5,4,13,5,7,9,5,11,11,2,11,10,11,7,8,8,7,14,15,5,5,8,9,8,10,10,14,14,8,5,11,13,12,6,15,14,10,10,11,11,9,6,6,3,10,10,16,1,1,4,4,3,1,3,3,2,2,2
"3782",2000288134,"Ali Abbas Ahmed","12/27/2000 (22 years old)","GK","Al-Wahda Aden","Yemeni First Division","YEM","No","7/1/2020","6/30/2024","$0 - $10K","Right","Reasonable","Very Strong","6'2""","171 lbs","-","-",65,90,4,3,1,3,1,6,1,1,2,1,9,3,3,1,11,9,7,6,8,13,16,1,9,1,11,6,5,5,10,11,3,11,10,9,2,5,12,14,9,10,11,12,5,7,13,6,13,12,19,8,12,13,5,7,9,13,9,7,8,13
"3783",23458606,"Mohammed Fuad Omar","3/13/1989 (34 years old)","D (C)","Al-Sha'ab Ibb","Yemeni First Division","YEM","No","1/1/2021","6/30/2024","$0 - $3.5K","Right","Reasonable","Very Strong","6'0""","167 lbs","5","-",80,90,1,1,1,1,5,4,9,4,4,14,8,4,14,4,14,10,9,6,9,14,9,6,12,6,14,5,4,8,9,8,8,9,11,8,5,6,13,14,10,10,12,9,5,1,12,4,10,10,20,1,1,3,2,3,3,2,2,3,1,2
"3784",2000130000,"Ayman Al-Raawi","8/4/2004 (18 years old)","ST (C)","Al-Sha'ab Ibb","Yemeni First Division","YEM","No","1/1/2021","6/30/2025","$0","Right","Weak","Very Strong","5'9""","149 lbs","-","-",53,90,3,1,5,12,11,4,12,4,4,3,5,6,1,8,9,11,4,9,4,10,6,9,8,12,3,4,3,5,12,12,5,7,13,12,10,7,10,11,10,13,13,13,7,10,12,5,16,12,14,1,3,3,2,2,4,2,1,3,2,2
"3785",2000165076,"Abdulaziz Al-Asbahi","6/1/2005 (18 years old)","D (C)","Shabab Al-Ahli","UAE Professional League","YEM","No","6/1/2021","6/30/2024","$24K - $230K","Right","Reasonable","Very Strong","5'7""","138 lbs","-","-",60,90,3,1,1,5,5,4,12,3,4,12,6,1,7,1,8,12,8,6,9,13,15,5,10,4,13,5,3,6,13,12,6,3,12,11,11,5,13,10,13,11,12,11,11,7,6,4,8,12,14,3,2,3,1,2,3,1,2,3,3,3
"3786",2000059421,"Ali Yahya Salem","3/1/1999 (24 years old)","D/WB (R)","Al-Shaeib","Saudi Second Division Group B","YEM","No","9/1/2022","6/30/2024","$45K - $140K","Right","Reasonable","Very Strong","5'3""","121 lbs","-","-",70,90,6,12,7,6,6,1,8,7,7,9,9,2,10,9,8,11,9,6,9,14,10,5,8,7,8,8,8,8,14,14,8,1,15,14,9,2,13,18,13,11,13,11,8,3,10,1,8,13,13,3,1,4,3,2,2,2,2,1,2,3
"3787",2000186591,"Mohammed Al-Tairi","2/4/2000 (23 years old)","M/AM (C)","Al-Wahda Sana'a","Yemeni First Division","YEM","No","1/1/2020","6/30/2024","$500 - $5K","Right","Reasonable","Very Strong","6'4""","182 lbs","-","-",70,90,6,4,8,11,9,6,3,7,6,6,5,1,8,13,5,7,8,8,7,9,5,13,2,8,8,7,13,8,13,9,7,15,15,9,6,7,16,18,11,10,11,11,11,6,6,8,16,9,15,1,2,1,2,3,2,3,1,4,3,3
"3788",2000186573,"Ammar Al-Baidani","10/30/2001 (21 years old)","D (C)","Al-Wahda Sana'a","Yemeni First Division","YEM","No","1/1/2020","6/30/2024","$4.5K - $14K","Right","Reasonable","Very Strong","5'11""","160 lbs","-","-",70,90,5,1,1,1,7,2,13,1,2,12,7,2,11,5,5,8,8,7,8,13,12,5,13,6,13,6,2,7,8,8,7,9,13,11,7,6,9,10,10,13,12,9,11,8,13,4,6,11,11,3,1,1,2,1,3,2,3,3,3,1
"3789",2000156011,"Imad Al-Qadima","9/14/2000 (22 years old)","D (C)","May 22","Yemeni Lower Division","YEM","No","7/1/2020","6/30/2024","$0","Right","Reasonable","Very Strong","6'2""","169 lbs","-","-",63,90,3,1,1,3,5,3,10,4,1,9,4,1,13,5,14,8,8,6,5,13,7,5,13,5,12,5,1,6,9,13,6,10,12,11,6,5,14,14,10,13,12,10,14,2,11,7,20,11,19,2,2,3,4,2,3,3,3,1,3,2
"3790",23320020,"Muhd Akhyar Abdul Rashid","5/1/1999 (24 years old)","AM (L)","Johor DT","Malaysian Super League","MAS","No","1/1/2023","11/30/2023","$0 - $12K","Left","Very Strong","Reasonable","5'7""","132 lbs","62","10",76,90,6,9,10,9,10,6,5,2,6,6,8,4,5,12,13,9,8,8,5,10,11,12,9,12,5,7,9,12,13,13,5,4,13,13,7,1,11,17,10,9,10,10,7,10,15,1,9,12,9,1,3,2,2,2,3,2,2,3,2,1
"3791",2000186616,"Anes Al-Maari","1/9/2000 (23 years old)","ST (C)","Al-Sha'ab Hadhramaut","Yemeni First Division","YEM","No","6/15/2020","6/30/2024","$0","Right","Reasonable","Very Strong","6'0""","169 lbs","-","-",71,89,5,2,10,13,10,6,13,6,1,6,5,7,2,6,12,7,8,8,7,11,1,9,12,13,5,6,5,7,13,13,7,7,8,13,6,8,13,20,13,9,9,10,15,3,6,5,19,12,9,1,2,2,2,2,2,2,4,1,1,3
"3792",2000015224,"Zakaria Al-Tatouf","8/23/2001 (21 years old)","AM (C), ST (C)","Al-Ahli Sana'a","Yemeni First Division","YEM","No","1/1/2019","6/30/2025","$0 - $7K","Right","Reasonable","Very Strong","5'10""","154 lbs","-","-",63,88,4,6,5,12,13,5,6,3,3,4,7,6,2,8,8,4,3,9,6,8,6,8,10,9,6,5,8,7,13,13,6,5,8,13,7,3,11,12,8,10,11,12,13,1,15,7,12,9,14,4,1,2,3,4,1,1,1,1,1,3
"3793",23333499,"Fuad Al-Omaisi","10/4/1987 (35 years old)","WB/M/AM (L)","Al-Ittihad Ibb","Yemeni First Division","YEM","No","9/15/2021","6/30/2024","$0","Left","Very Strong","Fairly Strong","5'11""","163 lbs","-","-",74,88,7,10,9,7,12,7,7,3,3,8,10,2,9,14,5,10,5,9,9,10,11,13,13,14,8,8,6,9,10,7,8,10,14,10,7,8,15,19,10,11,11,13,8,3,6,1,16,13,16,2,3,4,2,2,3,3,1,3,3,3
"3794",2000186592,"Omar Shared","3/10/1997 (26 years old)","M (C)","Al-Wahda Aden","Yemeni First Division","YEM","No","1/1/2020","6/30/2024","$0 - $14K","Right","Reasonable","Very Strong","6'4""","180 lbs","-","-",67,88,3,4,5,3,12,1,2,3,1,8,8,2,6,12,12,7,4,5,6,10,9,7,9,9,7,7,13,12,13,10,6,12,14,13,12,8,14,10,13,11,9,14,8,15,8,8,9,9,9,1,1,3,1,1,1,3,1,3,1,1
"3795",23458613,"Mudir Abdurabu Al-Radaei","11/30/1989 (33 years old)","D (C)","Al-Ahli Sana'a","Yemeni First Division","YEM","No","7/1/2020","6/30/2024","$0","Left","Very Strong","Weak","6'4""","182 lbs","15","1",81,88,5,5,4,7,6,1,12,6,6,9,8,4,9,6,10,12,10,8,9,10,11,5,15,8,12,7,6,9,10,7,9,17,12,9,11,8,11,13,12,11,10,14,7,6,5,7,13,10,8,2,3,2,1,2,2,3,2,1,3,3
"3796",23333772,"Wahid Al-Khyat","1/1/1986 (37 years old)","M (C)","Al-Ahli Sana'a","Yemeni First Division","YEM","No","6/14/2021","6/30/2024","$0","Right","Reasonable","Very Strong","6'3""","178 lbs","-","-",80,87,8,8,4,8,15,7,6,9,6,11,14,6,7,12,6,9,9,9,9,9,14,5,12,9,9,9,12,14,9,9,6,13,15,9,9,8,13,11,10,9,11,13,6,8,15,7,10,10,15,3,3,2,3,2,1,3,1,2,1,2
"3797",2000179720,"Harwan Alzubaidi","3/19/2000 (23 years old)","M/AM (L)","Hartley","English Isthmian League South Central Division","YEM","No","12/31/2022","-","$0","Right","Fairly Strong","Very Strong","5'7""","138 lbs","31","2",70,86,7,11,11,13,14,7,6,8,3,5,9,10,6,14,9,10,8,11,8,11,12,13,3,12,7,8,7,13,11,12,8,4,12,8,10,3,18,14,13,12,11,12,7,1,15,1,12,9,12,3,2,1,1,1,2,1,4,3,1,2
"3798",2000130036,"Tamer Sinan","1/1/2001 (22 years old)","DM, M (C)","Al-Wahda Aden","Yemeni First Division","YEM","No","1/1/2019","6/30/2024","$0","Right","Reasonable","Very Strong","5'9""","152 lbs","-","-",57,86,3,1,5,6,10,5,5,6,3,9,11,2,10,10,15,10,7,6,7,12,12,5,12,6,9,6,10,11,13,10,6,7,7,10,7,5,13,13,11,8,11,13,12,13,7,7,12,9,9,1,2,1,1,3,3,3,2,2,1,1
"3799",2000186594,"Abdulaziz Khamis","4/22/2000 (23 years old)","D (C), DM, M (C)","Al-Wahda Sana'a","Yemeni First Division","YEM","No","1/1/2020","6/30/2024","$0 - $10K","Right","Reasonable","Very Strong","6'2""","171 lbs","-","-",66,85,6,5,3,2,7,6,8,3,1,10,9,1,11,8,10,8,5,8,4,14,11,5,10,6,8,7,8,4,14,14,7,11,13,14,9,7,13,14,13,14,10,12,11,11,9,8,11,11,10,2,1,2,3,1,2,2,2,1,1,3
"3800",64049993,"Ahmed Al-Khamri","12/28/1992 (30 years old)","D (C)","Al-Bahri","Iraqi First Division Group A","YEM","No","7/1/2021","6/30/2024","$70K - $200K","Left","Very Strong","Reasonable","6'4""","189 lbs","-","-",80,85,3,1,1,4,5,4,9,1,3,13,6,6,13,4,7,8,9,7,13,13,7,5,9,5,13,4,2,7,13,11,7,13,14,11,7,12,16,11,12,13,12,9,9,11,7,3,12,14,17,2,2,1,3,3,3,2,3,2,1,1
"3801",23136979,"Shahrul Mohd Saad","7/8/1993 (29 years old)","D (C), DM","Johor DT","Malaysian Super League","MAS","No","1/1/2023","11/30/2023","$500 - $5K","Right","Reasonable","Very Strong","5'10""","156 lbs","157","11",79,89,6,6,5,3,8,6,12,3,1,13,7,1,11,6,6,11,7,7,10,13,16,5,6,4,11,6,4,8,13,13,7,9,7,13,10,9,13,19,10,11,10,9,6,7,6,3,12,12,17,3,3,1,2,2,1,2,1,2,2,2
"3802",2000015211,"Saddam Al-Sharif","6/23/1996 (26 years old)","M (RC), AM (R)","Al-Ahli Sana'a","Yemeni First Division","YEM","No","6/15/2020","6/30/2025","$500 - $5K","Right","Weak","Very Strong","5'11""","156 lbs","-","-",73,85,6,6,10,10,10,6,7,8,2,4,12,7,6,12,9,7,8,8,7,12,17,11,12,12,7,8,9,8,13,10,7,7,10,12,7,4,13,15,9,10,12,12,6,14,5,1,13,11,11,3,3,3,3,3,2,2,1,1,2,3
"3803",2000116681,"Carlos Richards","8/30/2005 (17 years old)","M (R), AM (RL), ST (C)","Derby","Sky Bet League One","GIB","No","5/15/2023","6/30/2024","$300K - $900K","Right Only","Weak","Very Strong","5'8""","132 lbs","1","-",73,126,8,9,10,7,8,8,5,6,4,6,7,5,6,8,7,7,6,7,8,6,13,12,4,6,4,8,5,9,15,7,11,6,14,13,12,6,12,10,12,14,13,12,12,12,4,3,9,9,8,2,2,3,1,1,2,1,2,3,1,4
"3804",2000272185,"James Scanlon","9/28/2006 (16 years old)","M (C), AM (LC)","Man UFC","English Premier Division","GIB","No","6/13/2022","6/30/2024","$1.2M - $2.5M","Right","Fairly Strong","Very Strong","5'10""","145 lbs","-","-",66,123,13,5,10,9,8,11,4,6,3,2,9,11,3,10,8,10,6,8,8,7,8,9,4,12,3,10,8,9,10,9,8,8,15,11,9,7,11,20,11,13,12,11,10,2,8,5,9,12,9,2,3,1,4,1,2,1,2,2,4,3
"3805",67020680,"Liam Walker","4/13/1988 (35 years old)","M/AM (C)","Lincoln (GIB)","Gibraltar Football League","GIB","Yes","6/13/2021","6/30/2024","$0 - $4K","Left Only","Very Strong","Weak","5'8""","165 lbs","282","125",105,120,13,12,13,12,12,15,6,14,5,4,14,18,4,14,8,9,10,14,12,13,14,16,14,13,6,13,12,9,12,11,9,5,8,12,10,11,15,5,6,6,12,6,7,15,10,15,14,16,16,3,1,1,1,3,4,3,3,2,1,1
"3806",67034349,"Joseph Chipolina","12/14/1987 (35 years old)","D (LC), WB/M (L)","Magpies","Gibraltar Football League","GIB","Yes","6/1/2023","6/30/2024","$0","Left","Very Strong","Weak","5'10""","158 lbs","277","93",100,120,9,9,8,2,9,9,11,9,7,10,11,12,11,10,12,14,11,8,11,15,15,8,15,10,7,10,9,11,11,11,9,10,6,11,11,7,14,10,12,9,10,15,11,14,6,2,12,17,9,2,2,2,3,2,3,1,4,1,2,2
"3807",36510004,"Dayle Coleing","10/23/1996 (26 years old)","GK","Lincoln (GIB)","Gibraltar Football League","GIB","No","8/31/2022","6/30/2024","$0 - $9K","Left Only","Very Strong","Weak","6'4""","185 lbs","88","-",81,115,2,2,2,1,6,5,1,3,2,2,10,1,3,4,9,11,12,8,7,10,7,2,11,2,10,8,7,7,13,16,8,15,14,11,7,8,10,19,12,10,13,9,8,11,10,6,8,12,5,9,5,10,10,8,8,13,5,9,7,14
"3808",36516887,"Tjay De Barr","3/13/2000 (23 years old)","M/AM (R), ST (C)","Wycombe","Sky Bet League One","GIB","No","5/10/2023","6/30/2024","$12K - $120K","Right","Reasonable","Very Strong","5'9""","163 lbs","102","18",82,115,10,10,8,8,8,8,10,6,1,5,8,12,4,11,6,5,7,4,8,8,15,8,5,9,4,8,8,12,12,10,10,7,12,15,15,8,10,10,10,10,10,11,8,8,2,3,5,11,12,1,3,3,2,1,1,1,1,2,1,1
"3809",55038658,"Bernardo Lopes","7/30/1993 (29 years old)","D (C), DM","Lincoln (GIB)","Gibraltar Football League","GIB","Yes","6/15/2020","6/30/2024","$0 - $35K","Right Only","Weak","Very Strong","6'2""","178 lbs","237","32",89,112,6,9,6,4,13,8,11,10,4,11,14,4,13,8,15,11,10,11,11,11,14,14,7,9,11,9,9,11,11,11,10,14,12,11,11,11,8,20,10,10,11,11,5,19,8,8,3,10,7,2,1,1,2,1,4,1,3,1,1,2
"3810",36511831,"Jayce Olivero","7/2/1998 (24 years old)","D/WB/M/AM (L)","Europa FC","Gibraltar Football League","GIB","No","5/15/2019","6/30/2024","$1K - $10K","Left Only","Very Strong","Weak","6'0""","165 lbs","167","5",90,110,6,10,10,10,10,8,7,8,5,13,13,4,12,10,10,9,9,7,7,13,14,12,10,10,14,9,10,13,10,11,9,10,12,13,12,8,13,18,11,17,9,12,13,10,8,3,9,15,10,1,1,1,1,2,2,2,3,1,2,1
"3811",2000130978,"Nicholas Pozo","1/19/2005 (18 years old)","DM, M (C)","Cádiz C","Spanish Primera Andaluza Gr. Cádiz","GIB","No","7/1/2022","6/30/2025","$0 - $80K","Right","Reasonable","Very Strong","5'7""","141 lbs","-","-",66,109,6,6,8,10,11,9,9,11,5,6,10,5,10,14,12,11,8,9,11,17,12,5,5,11,11,10,11,11,6,9,10,8,11,7,7,4,11,13,9,10,12,12,8,19,5,1,7,9,18,1,3,1,4,1,3,1,1,1,3,2
"3812",23318919,"Muhd Syahmi Safari","2/5/1998 (25 years old)","D/M/AM (R)","Johor DT","Malaysian Super League","MAS","No","1/1/2023","11/30/2023","$500 - $4K","Right","Reasonable","Very Strong","5'8""","130 lbs","96","11",72,89,6,7,8,10,11,6,2,4,2,6,11,7,8,11,10,7,8,8,8,12,9,14,11,12,7,7,6,8,13,13,7,2,16,13,10,4,11,14,10,13,12,10,5,7,5,3,19,10,7,3,3,1,1,2,1,1,1,2,3,4
"3813",2000091996,"Jay Key","5/2/2005 (18 years old)","M/AM (C)","Man 62","Gibraltar Football League","GIB","No","7/1/2021","6/30/2023","$0","Right","Fairly Strong","Very Strong","5'10""","145 lbs","-","-",50,108,5,3,5,8,14,6,5,7,5,5,14,1,7,10,7,6,3,8,3,10,8,9,9,7,7,13,14,8,8,8,5,9,11,8,5,3,9,13,8,12,10,14,8,13,9,5,9,13,11,3,1,1,4,4,1,4,3,1,1,1
"3814",29085678,"Anthony Hernandez","2/3/1995 (28 years old)","M/AM (RC)","Magpies","Gibraltar Football League","GIB","No","6/1/2023","6/30/2024","$0 - $26K","Right","Weak","Very Strong","6'0""","165 lbs","126","37",85,105,7,8,8,7,14,7,3,5,5,7,11,7,1,12,10,8,8,9,10,10,13,11,5,14,10,13,6,13,14,14,14,10,13,14,8,4,11,15,10,13,12,11,15,5,12,3,14,11,10,1,3,3,2,3,1,3,2,2,2,3
"3815",89056007,"Louie Annesley","5/3/2000 (23 years old)","D (C), DM, M (C)","Dundalk","Irish Premier Division","GIB","No","1/10/2023","11/30/2024","$28K - $275K","Right","Strong","Very Strong","6'4""","165 lbs","36","-",88,104,4,6,6,6,9,4,12,8,3,10,11,4,9,9,7,8,11,12,9,8,12,5,11,4,9,11,11,11,11,10,12,16,12,10,12,11,13,14,12,12,14,8,5,14,4,4,10,12,10,1,3,3,2,1,3,1,4,3,1,2
"3816",36510353,"Jamie Coombes","5/27/1996 (27 years old)","M (RL), AM (RLC), ST (C)","Magpies","Gibraltar Football League","GIB","No","6/1/2023","6/30/2024","$4.5K - $14K","Right","Weak","Very Strong","5'7""","149 lbs","101","21",80,100,6,11,7,8,10,5,3,6,6,6,6,5,5,7,14,8,6,7,5,8,12,7,3,7,6,7,7,12,12,11,13,6,12,13,12,2,9,11,12,13,7,10,5,4,15,3,9,13,8,1,3,4,4,2,3,1,4,2,3,3
"3817",36511788,"Bradley Banda","1/20/1998 (25 years old)","GK","St Joseph's (GIB)","Gibraltar Football League","GIB","No","6/1/2023","6/30/2025","$0 - $10K","Right Only","Weak","Very Strong","6'0""","167 lbs","116","-",80,100,2,1,2,1,1,5,1,3,2,1,8,1,2,4,8,12,8,5,8,13,15,3,9,1,8,7,6,5,8,15,7,7,12,8,6,3,10,11,11,11,10,10,9,12,6,2,10,12,20,7,12,13,10,10,11,12,6,10,8,12
"3818",36514590,"Graeme Torrilla","9/3/1997 (25 years old)","D/WB (R), M (RC)","Lincoln (GIB)","Gibraltar Football League","GIB","No","1/28/2020","6/30/2024","$3K","Left","Very Strong","Reasonable","5'10""","169 lbs","137","11",80,100,5,8,8,9,6,3,7,8,6,8,11,3,10,11,15,11,8,9,9,9,7,5,9,10,7,12,9,8,14,10,8,5,8,13,13,6,15,15,14,11,10,10,12,4,13,5,7,10,8,2,3,3,1,2,1,1,3,3,1,2
"3819",36521699,"Jack Breed","6/18/1999 (23 years old)","M (C), AM (RLC)","Fareham","English Wessex League Premier Division","GIB","No","1/2/2022","6/30/2024","$0","Right","Strong","Very Strong","5'11""","149 lbs","163","21",55,99,3,5,6,8,10,3,1,5,3,3,8,1,4,5,10,6,2,5,4,8,12,9,11,10,3,5,6,10,11,11,4,8,12,11,11,2,15,13,12,11,13,12,13,15,8,5,7,10,17,3,2,1,3,3,2,2,3,2,2,1
"3820",36511543,"Jack Sergeant","2/27/1995 (28 years old)","D (RC), WB (R)","Lincoln (GIB)","Gibraltar Football League","GIB","No","3/23/2023","6/30/2024","$500 - $3.5K","Right","Weak","Very Strong","5'9""","165 lbs","132","4",78,98,7,11,7,4,11,8,15,7,9,12,3,6,15,9,15,11,13,6,8,8,16,5,16,9,11,15,11,11,8,11,10,10,7,9,11,9,12,11,12,11,15,12,7,7,7,6,9,12,10,2,3,2,1,2,3,3,1,1,3,1
"3821",36500284,"Lee Casciaro","9/29/1981 (41 years old)","AM (RLC), ST (C)","Lincoln (GIB)","Gibraltar Football League","GIB","No","4/15/2023","6/30/2024","$0","Right Only","Weak","Very Strong","5'10""","174 lbs","150","66",70,97,7,9,4,12,11,7,6,9,1,7,10,2,5,8,16,10,6,11,5,14,15,7,7,11,8,12,9,9,11,9,4,4,15,11,11,12,11,12,17,17,12,20,5,8,6,4,10,17,7,3,1,1,3,2,4,1,2,2,3,2
"3822",36510291,"Erin Barnett","9/2/1996 (26 years old)","D (RC)","St Joseph's (GIB)","Gibraltar Football League","GIB","No","7/1/2020","6/30/2023","$0","Right","Reasonable","Very Strong","5'11""","158 lbs","138","4",72,97,3,7,4,7,9,1,10,4,6,10,12,7,9,10,8,10,10,10,8,8,2,6,12,8,15,8,8,9,10,6,9,10,12,10,10,5,17,11,12,10,12,11,8,5,12,8,11,12,20,2,3,4,2,3,2,1,1,3,2,1
"3823",23495406,"Mohd Fayadh Mohd Zulkifli Amin","9/14/1998 (24 years old)","AM (RL)","Kedah","Malaysian Super League","MAS","No","1/1/2023","11/30/2025","$0 - $95K","Right","Reasonable","Very Strong","5'3""","119 lbs","76","13",72,89,5,11,8,10,11,3,2,5,6,4,8,7,7,9,14,8,8,10,7,9,6,9,14,9,6,7,9,12,13,12,7,2,16,13,11,1,14,19,9,13,11,12,7,13,7,4,9,13,13,3,1,1,3,3,3,2,1,2,2,3
"3824",36517652,"Kelvin Morgan","11/14/1997 (25 years old)","ST (C)","St Joseph's (GIB)","Gibraltar Football League","GIB","No","7/2/2021","6/30/2023","$0","Left Only","Very Strong","Weak","6'3""","202 lbs","89","23",76,96,8,6,10,10,12,8,12,9,6,8,9,7,6,10,15,12,16,10,8,10,15,12,13,10,9,8,9,9,10,8,15,13,10,10,7,13,12,13,8,9,10,13,11,6,7,5,13,11,7,2,2,3,2,2,2,2,1,4,3,3
"3825",2000084771,"Paddy McClafferty","9/19/2004 (18 years old)","M/AM (R)","Algeciras","Spanish Federation First Division B","GIB","No","7/1/2021","6/30/2023","$0","Right","Fairly Strong","Very Strong","5'9""","141 lbs","5","-",59,96,8,11,12,8,10,6,6,6,6,3,5,2,3,11,9,8,4,8,8,8,15,10,1,9,7,7,7,11,12,10,14,9,14,10,6,4,10,13,14,12,11,11,5,4,6,3,9,13,20,3,3,4,3,2,3,4,3,3,1,1
"3826",2000260410,"Lucas Pocock","1/1/2007 (16 years old)","ST (C)","San Roque","Spanish Primera Andaluza Gr. Cádiz","GIB","No","1/1/2022","-","$0","Right","Weak","Very Strong","5'11""","143 lbs","-","-",55,96,1,2,6,12,10,3,12,3,3,1,5,4,1,6,5,5,7,7,2,11,9,7,1,12,4,4,3,5,12,12,1,8,10,12,6,5,8,11,12,11,10,13,6,9,7,4,9,10,16,2,1,3,2,1,3,3,2,2,2,1
"3827",36531059,"Dylan Borge","10/15/2003 (19 years old)","ST (C)","St Joseph's (GIB)","Gibraltar Football League","GIB","No","6/1/2023","6/30/2024","$0","Right Only","Weak","Very Strong","5'11""","154 lbs","57","21",60,96,8,9,10,13,9,8,16,9,1,7,9,6,6,6,10,9,8,12,7,8,17,13,5,12,8,8,5,9,10,9,9,13,17,7,6,5,10,16,12,11,11,12,12,5,12,8,8,12,7,1,3,4,2,1,2,1,2,3,3,2
"3828",89054916,"Julian Valarino","6/23/2000 (22 years old)","D/M/AM (R), ST (C)","Lincoln (GIB)","Gibraltar Football League","GIB","No","3/22/2023","6/30/2024","$0 - $20K","Right Only","Weak","Very Strong","5'10""","156 lbs","44","3",70,95,6,9,7,11,9,5,7,7,4,6,9,8,8,10,13,12,7,11,8,8,14,15,3,13,7,7,7,8,13,9,7,5,9,13,7,5,12,18,11,11,11,9,6,4,11,6,13,10,13,2,2,3,4,3,2,1,2,2,3,4
"3829",89054413,"Ethan Britto","11/30/2000 (22 years old)","D (LC)","Lincoln (GIB)","Gibraltar Football League","GIB","No","3/21/2023","6/30/2024","$6K - $18K","Left Only","Very Strong","Weak","5'10""","156 lbs","107","11",75,95,6,11,10,6,10,3,6,9,9,12,11,4,12,10,15,11,8,11,10,15,16,5,12,8,7,10,9,15,11,12,10,7,10,12,10,6,20,19,11,11,14,9,7,10,12,3,18,11,19,2,2,3,2,1,2,2,1,2,2,1
"3830",89054912,"Jaylan Hankins","11/17/2000 (22 years old)","GK","Lincoln (GIB)","Gibraltar Football League","GIB","No","8/18/2022","6/30/2024","$0 - $8K","Left Only","Very Strong","Weak","6'1""","185 lbs","61","-",75,95,3,1,3,3,4,7,1,1,1,3,7,2,2,2,9,11,13,7,7,13,18,1,12,2,7,7,6,6,6,10,2,10,13,10,4,6,13,16,11,10,15,11,5,3,8,4,15,11,15,9,10,13,5,7,9,13,5,6,11,13
"3831",36519874,"Mohamed Badr","11/25/1989 (33 years old)","M/AM (R)","Europa FC","Gibraltar Football League","GIB","No","6/22/2020","6/30/2024","$0","Right","Reasonable","Very Strong","6'1""","163 lbs","151","22",70,95,9,11,8,11,10,9,9,8,9,8,10,5,7,13,12,10,8,12,11,10,12,10,9,11,9,15,11,13,6,7,10,12,11,7,11,6,11,17,13,11,11,12,8,3,5,7,10,9,11,3,1,1,1,3,3,1,3,2,3,3
"3832",36511581,"Ethan Jolley","3/29/1997 (26 years old)","D (RC)","St Joseph's (GIB)","Gibraltar Football League","GIB","No","6/1/2023","6/30/2024","$2.5K - $7K","Right Only","Weak","Very Strong","5'10""","163 lbs","172","-",75,95,2,7,6,1,8,1,11,2,5,11,8,3,11,8,12,10,9,8,8,14,11,5,12,3,12,5,8,8,14,14,8,6,5,14,13,6,16,10,10,12,11,20,13,5,5,3,8,11,20,1,1,2,1,4,3,4,2,2,2,3
"3833",36500415,"George Cabrera","12/14/1988 (34 years old)","AM (RLC), ST (C)","Mons Calpe","Gibraltar Football League","GIB","Yes","1/1/2023","6/30/2023","$0","Right","Reasonable","Very Strong","5'8""","158 lbs","207","96",70,95,7,7,7,13,11,7,9,6,5,7,9,4,3,10,8,9,4,12,10,10,12,9,9,11,8,8,7,12,11,8,8,7,10,10,7,4,12,20,11,10,11,11,13,11,8,3,10,10,12,2,3,2,3,2,2,3,2,2,3,2
"3834",98044003,"Noah Graber","5/3/2001 (22 years old)","D/WB (L), DM, M/AM (L)","Vaduz","Swiss Challenge League","LIE","Yes","7/1/2022","6/30/2025","$0","Right","Strong","Very Strong","5'10""","152 lbs","41","-",56,86,5,9,7,7,7,5,6,1,2,4,8,1,9,7,5,8,7,7,5,13,7,15,12,10,5,6,6,7,12,9,6,7,12,11,3,3,13,18,11,10,10,11,12,11,10,3,13,11,13,1,1,4,2,3,2,1,3,1,2,3
"3835",28100406,"Stuart Wilkin","3/12/1998 (25 years old)","AM (RL)","Sabah","Malaysian Super League","MAS","No","12/1/2022","11/30/2024","$12K - $130K","Right","Reasonable","Very Strong","5'11""","152 lbs","53","4",77,89,5,12,9,7,10,4,1,10,6,6,6,2,5,6,6,9,7,9,7,13,6,6,10,10,6,7,4,12,13,13,7,5,12,13,10,5,12,12,10,9,11,13,11,8,4,2,14,8,13,3,2,3,2,3,3,2,2,1,4,2
"3836",36525060,"Shay Jones","2/24/2002 (21 years old)","M/AM (L)","Magpies","Gibraltar Football League","GIB","No","6/12/2023","6/30/2024","$0","Right","Fairly Strong","Very Strong","5'11""","147 lbs","28","3",55,94,6,9,12,6,8,3,4,2,5,5,7,1,5,13,5,7,7,5,6,3,14,13,7,5,5,6,5,11,13,13,8,9,7,13,8,2,11,19,11,9,10,11,11,15,5,3,10,12,15,2,2,1,2,3,1,2,3,1,4,2
"3837",36500323,"Andrew Hernandez","1/10/1999 (24 years old)","DM, M/AM (C)","Europa FC","Gibraltar Football League","GIB","No","7/1/2022","6/30/2023","$0","Right Only","Weak","Very Strong","5'9""","156 lbs","104","2",73,93,6,4,9,7,9,7,7,8,7,11,9,1,8,9,15,9,13,9,9,9,8,8,9,9,9,13,9,13,9,14,8,8,11,14,14,5,13,12,10,11,12,8,12,17,6,3,8,9,20,3,3,2,3,3,3,3,2,1,3,1
"3838",36511723,"Alain Pons","5/16/1995 (28 years old)","D/WB/M/AM (L)","St Joseph's (GIB)","Gibraltar Football League","GIB","No","5/16/2023","6/30/2025","$500 - $2.5K","Left Only","Very Strong","Weak","5'10""","158 lbs","98","2",73,93,8,10,8,9,10,3,6,4,8,8,13,9,10,11,7,10,9,15,10,14,13,13,14,10,9,14,9,12,10,9,10,5,12,7,7,8,12,12,12,11,12,12,13,6,5,1,11,10,12,3,1,2,1,3,3,3,2,1,2,3
"3839",36500307,"Jeremy Lopez","7/9/1989 (33 years old)","M (R), AM (RLC), ST (C)","Europa FC","Gibraltar Football League","GIB","No","6/1/2023","6/30/2024","$0","Right","Fairly Strong","Very Strong","5'10""","167 lbs","135","15",65,92,8,10,8,8,9,8,6,8,5,6,7,5,8,8,10,7,3,11,9,10,2,13,8,15,8,9,11,10,7,9,6,8,14,9,8,10,10,13,8,11,11,9,7,3,15,2,11,9,10,1,3,2,1,1,1,1,2,2,1,2
"3840",2000130153,"Jesse Gomez","10/11/2005 (17 years old)","DM, M (C)","Algeciras","Spanish Federation First Division B","GIB","No","6/13/2022","6/30/2026","$24K - $75K","Right","Fairly Strong","Very Strong","6'0""","154 lbs","2","-",52,91,8,5,5,9,10,8,8,8,4,9,8,3,9,14,14,8,8,10,8,13,18,5,1,10,8,9,8,10,5,8,9,12,8,7,9,6,8,18,12,10,11,12,10,12,8,3,8,11,13,3,2,2,2,3,3,2,1,2,3,3
"3841",36523070,"Ethan Thorne-Llambias","11/23/2000 (22 years old)","D (RC), M (R)","Glacis Utd","Gibraltar Football League","GIB","No","7/1/2021","6/30/2024","$0","Right Only","Weak","Very Strong","6'4""","176 lbs","42","-",52,91,5,7,5,5,7,1,7,5,3,8,7,1,7,5,10,7,8,5,7,13,19,5,8,5,9,7,6,12,7,8,6,15,16,8,8,5,12,15,11,13,11,11,5,10,13,3,8,13,13,1,2,1,2,1,2,1,2,2,1,3
"3842",36526523,"Luke Bautista","11/9/2001 (21 years old)","M/AM (L)","Magpies","Gibraltar Football League","GIB","No","1/31/2023","6/30/2024","$0","Left Only","Very Strong","Weak","5'7""","149 lbs","44","2",55,91,4,5,11,7,12,2,6,7,6,6,10,5,5,14,10,4,6,8,8,7,17,13,1,9,5,8,8,12,12,8,14,3,18,7,13,5,8,16,8,10,11,11,6,14,7,3,20,13,9,2,3,2,2,2,1,1,3,1,2,1
"3843",36526037,"Julián Del Río","2/15/2002 (21 years old)","ST (C)","Magpies","Gibraltar Football League","GIB","No","7/1/2021","6/30/2024","$0","Right","Weak","Very Strong","5'7""","145 lbs","24","8",55,91,4,2,8,9,11,1,12,4,1,4,5,5,1,6,9,10,3,7,5,12,5,7,12,12,5,4,5,5,12,12,1,4,9,12,4,7,9,13,10,11,10,13,5,10,11,2,20,13,15,2,2,2,3,1,1,2,1,1,2,3
"3844",36510189,"Aymen Mouelhi","9/14/1986 (36 years old)","D (C), DM","St Joseph's (GIB)","Gibraltar Football League","GIB","Yes","8/17/2022","6/30/2023","$0","Right Only","Weak","Very Strong","6'2""","185 lbs","175","9",76,90,7,5,3,7,5,9,11,10,3,11,7,5,13,9,13,11,8,9,11,10,13,5,13,6,16,9,8,11,7,8,10,13,13,8,11,8,10,18,9,11,10,13,12,8,10,8,12,10,17,2,1,3,2,1,3,2,3,1,1,1
"3845",36500289,"Mikey Yome","8/29/1994 (28 years old)","AM (RLC), ST (C)","St Joseph's (GIB)","Gibraltar Football League","GIB","No","6/13/2022","6/30/2024","$1.5K - $5K","Right","Reasonable","Very Strong","5'11""","158 lbs","123","28",70,90,5,8,11,11,12,6,7,6,6,3,10,3,2,7,8,8,1,8,7,9,5,9,9,12,6,7,6,8,13,12,3,5,16,13,6,7,11,15,7,13,9,10,8,14,10,5,12,10,15,2,1,1,2,1,2,3,2,3,1,3
"3846",1043487,"Mohd Farizal Marlias","6/29/1986 (36 years old)","GK","Johor DT","Malaysian Super League","MAS","No","1/1/2023","11/30/2024","$0","Right","Fairly Strong","Very Strong","5'9""","158 lbs","182","-",73,88,3,2,3,2,3,5,1,1,3,1,9,2,2,7,12,7,12,8,7,13,14,2,12,2,9,8,7,7,9,7,3,4,11,9,2,9,12,16,11,10,10,11,10,13,5,3,13,11,14,9,6,9,10,9,10,13,5,9,9,11
"3847",36510241,"Ashley Rodriguez","11/13/1989 (33 years old)","DM, M (C)","Gib Reg","-","GIB","No","6/1/2022","-","$0","Right Only","Weak","Very Strong","6'3""","178 lbs","125","5",70,90,8,5,4,11,10,8,8,10,7,10,10,7,13,10,13,10,9,8,8,8,13,5,17,9,10,14,9,13,7,9,9,15,14,8,12,8,16,15,13,8,11,11,14,7,12,8,12,15,16,1,2,1,1,1,3,3,1,3,4,2
"3848",89054932,"Ayoub El Hmidi","9/30/2000 (22 years old)","M/AM (L)","St Joseph's (GIB)","Gibraltar Football League","GIB","No","8/13/2022","6/30/2024","$0","Right Only","Weak","Very Strong","6'0""","167 lbs","77","19",65,90,8,10,6,8,10,8,8,4,8,7,14,6,9,13,10,9,1,12,9,12,4,10,13,10,8,15,7,13,10,9,9,8,16,6,8,5,18,10,12,11,13,11,5,9,5,4,17,11,12,1,2,1,1,3,2,1,3,3,2,1
"3849",36500287,"Roy Chipolina","1/20/1983 (40 years old)","D (C)","Lincoln (GIB)","Gibraltar Football League","GIB","No","6/14/2021","6/30/2024","$0","Right Only","Weak","Very Strong","5'10""","165 lbs","137","22",65,90,4,6,3,4,12,1,12,3,6,8,13,5,12,10,13,10,9,12,9,10,17,5,18,8,9,8,10,10,6,5,7,10,9,5,7,14,15,13,17,17,9,20,10,6,8,7,10,17,19,1,2,1,3,3,1,1,3,1,3,2
"3850",2000091994,"Rafie Emrani","3/27/2005 (18 years old)","M/AM (C)","Linense B","Spanish Regional Division","GIB","No","12/1/2021","6/30/2025","$0","Right","Fairly Strong","Very Strong","5'8""","134 lbs","2","1",50,88,3,1,9,7,9,5,5,6,2,4,4,1,6,10,8,7,2,11,3,9,5,10,3,9,7,11,9,7,13,9,6,3,14,8,7,2,10,20,11,9,9,13,8,12,6,8,10,11,17,2,1,3,3,2,1,3,2,1,2,1
"3851",36510352,"Lee Coombes","6/20/1996 (26 years old)","D (LC)","Magpies","Gibraltar Football League","GIB","No","2/9/2021","6/30/2024","$0 - $6K","Left","Very Strong","Reasonable","6'1""","187 lbs","59","-",70,88,3,7,1,4,6,1,9,1,6,13,5,1,13,6,11,8,9,7,5,13,15,6,9,6,7,4,5,4,13,11,7,13,14,13,8,6,12,19,12,8,10,9,11,5,13,3,7,11,15,1,2,1,3,1,2,3,2,1,1,2
"3852",90004995,"Reece Styche","5/3/1989 (34 years old)","ST (C)","Matlock","English Northern Premier League Premier Division","GIB","No","5/12/2023","6/30/2024","$0","Right","Reasonable","Very Strong","6'1""","180 lbs","438","142",59,88,3,4,6,8,8,5,11,8,7,4,10,10,3,8,12,8,7,14,7,9,14,6,8,8,4,8,7,8,7,8,10,15,7,8,11,12,3,8,5,7,12,8,14,9,13,12,8,15,11,4,1,4,2,3,3,2,4,2,1,1
"3853",36532716,"Kye Livingstone","3/9/2003 (20 years old)","M/AM (R)","Larne","Sports Direct Premiership","GIB","No","5/26/2023","6/30/2025","$14K - $150K","Right Only","Weak","Very Strong","5'10""","145 lbs","12","-",50,87,6,10,8,7,10,4,4,1,4,5,7,1,4,12,13,6,5,5,6,7,13,12,9,8,5,6,6,11,13,11,9,6,14,11,12,2,9,12,11,10,10,12,15,9,8,3,9,11,13,3,2,1,3,2,1,1,3,1,2,3
"3854",36516897,"Kevagn Ronco","4/20/1998 (25 years old)","D/WB (R), DM, M (RC)","Magpies","Gibraltar Football League","GIB","No","8/31/2021","6/30/2024","$2.5K - $7K","Right Only","Weak","Very Strong","5'9""","156 lbs","64","1",72,87,5,9,6,3,10,8,8,8,1,10,9,4,10,10,14,11,9,12,10,15,18,5,5,9,10,9,8,10,10,10,9,7,13,10,8,7,12,19,11,9,12,11,8,15,6,3,20,9,7,1,2,2,2,3,2,3,1,2,3,3
"3855",36524409,"Dylan Peacock","8/24/2001 (21 years old)","ST (C)","Glacis Utd","Gibraltar Football League","GIB","No","1/31/2023","6/30/2024","$0","Right Only","Weak","Very Strong","5'6""","152 lbs","54","8",60,86,8,5,8,7,9,8,9,9,8,8,6,5,3,9,15,9,11,10,8,11,14,12,3,10,7,15,9,13,11,15,12,4,14,14,9,5,10,11,11,10,11,11,10,6,11,2,20,9,15,1,2,3,2,1,4,2,1,3,3,2
"3856",36511811,"Sykes Garro","2/26/1993 (30 years old)","M/AM (C)","Mons Calpe","Gibraltar Football League","GIB","No","1/17/2023","6/30/2023","$0","Right Only","Weak","Very Strong","5'11""","158 lbs","126","11",60,85,6,6,5,8,14,6,6,7,1,8,12,1,7,13,5,10,7,6,7,12,2,12,11,13,8,7,13,8,8,12,7,8,13,10,3,3,10,13,9,11,10,12,7,7,11,8,17,10,17,1,4,3,2,3,3,2,2,2,1,3
"3857",2000199088,"Muhd Haqimi Azim Rosli","1/6/2003 (20 years old)","AM (L), ST (C)","Kuala Lumpur","Malaysian Super League","MAS","No","1/1/2023","11/30/2025","$14K - $140K","Left","Very Strong","Fairly Strong","6'0""","160 lbs","26","9",73,88,6,7,8,13,12,6,13,6,1,6,8,7,1,7,5,5,6,8,7,7,4,7,1,8,7,6,6,8,13,11,3,11,17,13,8,6,12,18,11,13,10,12,8,18,8,4,11,7,12,3,1,2,1,2,3,3,3,1,3,1
"3858",36516885,"Leon Clinton","7/19/1998 (24 years old)","M/AM (C)","Glacis Utd","Gibraltar Football League","GIB","No","7/1/2021","6/30/2024","$0","Right Only","Weak","Very Strong","5'7""","147 lbs","80","13",65,85,6,7,11,8,12,3,6,8,2,7,7,8,5,9,6,10,3,14,7,14,6,8,6,13,6,13,9,8,9,12,7,3,12,10,5,7,13,15,11,13,10,13,10,11,7,2,8,10,9,1,3,1,1,2,3,1,1,2,2,2
"3859",13151014,"Ramadan El Agab","2/20/1986 (37 years old)","ST (C)","Al-Merreikh Omdurman","Sudanese Premier League","SUD","No","6/14/2021","6/30/2024","$0 - $16K","Right Only","Weak","Very Strong","5'11""","163 lbs","-","-",93,126,10,6,8,14,16,10,16,9,4,10,10,5,5,14,12,13,9,9,11,16,6,14,9,15,11,10,10,11,10,10,10,9,14,10,10,10,12,15,2,9,11,11,5,5,5,5,11,9,18,1,3,1,3,3,2,1,2,2,3,2
"3860",13202579,"Saif Terry","1/1/1994 (29 years old)","ST (C)","Pharco","Egyptian Premier League","SUD","No","8/10/2021","7/31/2024","$100K - $1M","Right","Reasonable","Very Strong","6'0""","163 lbs","3","-",110,125,9,8,14,13,14,8,11,10,2,9,9,6,5,12,15,14,8,11,10,14,3,11,3,14,9,9,7,9,14,12,14,7,11,14,12,5,12,14,8,10,10,12,13,14,14,7,13,10,14,3,3,1,3,3,3,2,1,4,1,2
"3861",28088523,"Mohamed Eisa","7/12/1994 (28 years old)","ST (C)","MK Dons","Sky Bet League Two","SUD","No","7/20/2021","6/30/2025","$16K - $150K","Right","Reasonable","Very Strong","6'0""","154 lbs","270","128",98,125,5,8,11,14,11,8,11,9,4,5,10,13,4,12,8,11,10,12,10,9,4,9,6,13,8,9,8,12,11,12,12,12,11,13,13,8,7,14,12,12,13,13,13,9,5,6,11,11,13,1,1,2,1,3,3,2,2,3,3,2
"3862",13151070,"Athar El Tahir","10/24/1996 (26 years old)","D/WB (R)","Al-Hilal Omdurman","Sudanese Premier League","SUD","No","7/4/2022","7/31/2025","$100K - $1M","Right Only","Weak","Very Strong","5'9""","136 lbs","25","2",108,120,7,11,10,8,10,3,10,4,8,9,11,6,15,10,5,11,11,10,13,13,6,5,9,6,9,13,10,14,15,15,14,8,17,12,14,6,16,11,6,10,11,9,13,19,6,1,13,10,17,2,3,3,2,2,1,2,2,1,3,1
"3863",2000307862,"Ali Abdalla","3/17/2003 (20 years old)","AM (RLC)","Hay Al-Wadi","Sudanese Premier League","SUD","No","7/1/2022","6/30/2025","$0","Right","Strong","Very Strong","5'6""","134 lbs","-","-",71,120,6,9,12,9,12,6,1,7,1,6,11,2,8,12,10,8,8,7,7,10,5,12,13,12,6,6,7,11,7,12,6,1,8,11,9,1,10,20,1,11,10,12,8,6,7,3,11,13,8,1,2,3,3,2,2,1,1,2,1,2
"3864",57150520,"Yasin Hamed","9/12/1999 (23 years old)","AM (RL), ST (C)","Nyíregyháza","Hungarian Division II","SUD","Yes","7/28/2020","6/30/2025","$0","Right","Reasonable","Very Strong","5'11""","145 lbs","178","32",92,118,10,11,11,8,10,10,7,11,5,6,10,10,5,13,8,11,12,10,9,9,12,11,3,12,5,9,11,9,12,13,7,9,12,12,10,11,14,12,9,11,10,12,4,5,12,7,8,11,15,1,3,2,1,1,2,2,1,2,1,2
"3865",2000185937,"Ali Hassan","5/8/2005 (18 years old)","D/WB/M (R)","OL","Ligue 1 Uber Eats","SUD","Yes","6/13/2022","6/30/2025","$400K - $1.2M","Right Only","Weak","Very Strong","5'9""","136 lbs","-","-",82,118,9,12,8,7,13,8,8,6,8,8,8,4,14,12,6,6,8,10,10,14,6,5,9,9,5,9,7,10,14,11,9,10,14,10,12,7,14,19,7,11,11,11,11,14,7,5,11,12,11,2,3,2,2,2,2,2,3,1,3,2
"3866",12011498,"Ala'a Eldin Yousif","1/3/1982 (41 years old)","DM, M (LC)","Al-Ahli Merowe","Sudanese Premier League","SUD","No","7/1/2020","6/30/2024","$0 - $40K","Right Only","Weak","Very Strong","5'10""","176 lbs","-","-",87,110,7,10,5,6,14,8,8,10,3,10,12,5,12,12,9,11,9,8,10,11,13,5,16,9,11,9,12,12,11,9,13,8,6,11,7,13,12,16,3,12,12,10,11,18,14,6,9,10,7,3,3,1,2,1,1,3,1,4,3,3
"3867",12000511,"Muhannad El Tahir","12/3/1984 (38 years old)","AM (LC), ST (C)","Al-Ahli Khartoum","Sudanese Premier League","SUD","No","7/1/2021","6/30/2024","$0","Right","Weak","Very Strong","6'2""","180 lbs","-","-",85,110,11,11,11,11,11,7,7,13,1,2,12,3,2,14,12,11,7,7,7,13,12,12,6,12,4,7,12,8,12,10,11,10,12,11,11,11,12,11,5,10,11,11,6,6,11,7,9,10,9,3,2,2,2,2,2,2,2,3,3,3
"3868",29038229,"Darren Lok","3/9/1991 (32 years old)","AM (RC), ST (C)","Sabah","Malaysian Super League","MAS","No","12/1/2022","11/30/2024","Not for Sale","Right Only","Weak","Very Strong","5'9""","163 lbs","217","50",80,88,6,10,11,13,8,7,5,10,7,5,7,9,8,10,2,5,7,10,5,5,5,11,7,14,7,11,10,14,12,11,11,6,10,12,12,7,3,17,11,11,11,14,7,10,10,4,10,9,8,1,2,1,1,1,1,1,3,1,4,2
"3869",13151016,"Ballah Gabir","9/12/1985 (37 years old)","D/WB (R)","Tuti","Sudanese Premier League","SUD","No","1/2/2021","6/30/2024","$0","Right","Fairly Strong","Very Strong","6'1""","174 lbs","-","-",85,110,5,12,8,6,14,3,8,5,8,10,8,3,15,10,15,10,9,9,11,12,15,5,6,8,13,9,8,9,9,9,9,9,13,8,8,8,14,12,10,9,11,9,6,18,9,8,11,12,7,1,2,1,2,2,2,3,2,3,2,3
"3870",13169776,"Sharaf Eldin Shiboub","6/7/1994 (29 years old)","M (C)","Al-Talaba","Iraqi Premier League","SUD","No","1/21/2023","6/30/2024","$26K - $275K","Right","Weak","Very Strong","5'11""","163 lbs","26","3",100,110,8,10,8,7,14,8,5,8,8,10,14,4,7,14,14,9,8,11,9,14,5,8,4,10,10,13,14,10,10,14,9,10,12,10,7,9,17,17,7,12,12,10,5,14,13,1,12,9,12,2,2,3,3,3,2,3,3,3,3,3
"3871",2000226052,"Mazin Mohamedein","5/2/2000 (23 years old)","D/WB (L)","Al-Merreikh Omdurman","Sudanese Premier League","SUD","No","7/1/2022","6/30/2026","$0 - $80K","Left","Very Strong","Reasonable","6'1""","169 lbs","-","-",90,110,5,9,6,7,9,1,8,7,5,10,9,2,13,10,10,12,9,10,9,14,12,6,9,6,10,9,10,13,11,11,9,11,11,12,14,6,18,20,5,13,12,11,7,12,13,6,12,12,16,3,3,1,1,2,1,2,1,3,3,3
"3872",13202578,"Walaa Eldin Musa","1/1/2000 (23 years old)","ST (C)","Al-Ahli Shendi","Sudanese Premier League","SUD","No","7/1/2020","6/30/2025","$0 - $90K","Right","Reasonable","Very Strong","6'2""","174 lbs","-","-",90,110,8,9,10,14,11,8,14,9,5,7,9,3,7,14,13,11,5,10,9,13,16,13,1,13,9,8,9,9,13,13,5,10,12,14,6,9,14,11,5,11,10,13,9,10,10,5,20,11,20,1,3,1,3,2,1,4,4,4,1,2
"3873",13151135,"Mohamed Abdel Rahman","7/10/1993 (29 years old)","ST (C)","Al-Hilal Omdurman","Sudanese Premier League","SUD","No","10/16/2020","6/30/2025","$45K - $425K","Right Only","Weak","Very Strong","6'1""","176 lbs","6","2",110,110,9,8,14,14,14,9,14,9,2,9,12,8,7,14,12,14,13,13,9,12,7,12,11,11,5,12,11,13,13,12,13,12,13,13,14,12,13,20,12,13,11,11,6,12,7,3,13,10,19,2,3,3,1,1,2,1,2,2,2,3
"3874",2000199224,"Ahmed Wadah","2/12/2000 (23 years old)","D (C)","Al-Hilal Omdurman","Sudanese Premier League","SUD","No","7/1/2020","6/30/2026","$0 - $95K","Right","Reasonable","Very Strong","6'2""","174 lbs","-","-",92,110,1,2,3,6,7,1,14,7,6,14,8,6,14,6,7,13,10,8,10,14,5,5,14,7,14,8,1,6,14,13,8,8,10,9,5,7,9,17,2,12,9,12,12,3,6,7,10,10,20,3,1,1,2,2,2,3,1,3,4,1
"3875",7642892,"Amir Kamal","7/24/1987 (35 years old)","D (C), DM","Al-Merreikh Omdurman","Sudanese Premier League","SUD","No","1/18/2023","6/30/2024","$0 - $5K","Right","Reasonable","Very Strong","5'9""","158 lbs","-","-",91,108,8,7,3,7,11,8,10,8,1,14,8,2,14,8,8,12,9,10,9,14,12,5,9,8,10,9,9,10,8,8,10,9,9,7,10,7,13,15,6,11,12,11,10,2,9,1,20,12,10,2,3,2,2,3,1,2,2,2,3,2
"3876",13151127,"Abdel Latif Boya","7/28/1989 (33 years old)","D/WB (L), DM","Al-Ahli Shendi","Sudanese Premier League","SUD","No","7/1/2022","6/30/2024","$0","Left","Very Strong","Weak","5'7""","141 lbs","-","-",88,107,9,12,10,6,12,9,9,8,6,11,11,9,16,12,8,12,9,11,10,11,16,7,5,10,10,11,12,11,8,12,9,9,8,12,10,4,15,13,3,12,11,11,9,2,11,4,8,12,13,2,3,2,2,2,3,2,1,3,3,1
"3877",13150975,"Faris Abdallah","2/19/1994 (29 years old)","D (RL), WB (L)","Al-Hilal Omdurman","Sudanese Premier League","SUD","No","6/15/2020","6/30/2025","$18K - $170K","Left","Very Strong","Reasonable","5'10""","167 lbs","-","-",100,107,6,13,9,3,12,3,9,7,8,10,9,7,9,10,14,10,10,8,9,13,4,6,7,6,10,9,8,10,14,14,9,6,11,12,9,11,13,11,7,12,12,10,8,3,6,4,11,13,8,3,1,3,1,4,2,2,4,3,1,2
"3878",2000299175,"John Mano","12/12/2001 (21 years old)","ST (C)","Al-Hilal Omdurman","Sudanese Premier League","SUD","No","8/9/2022","6/30/2025","$0","Right","Fairly Strong","Very Strong","6'1""","160 lbs","-","-",79,106,6,4,13,13,11,6,13,5,2,6,7,2,5,11,5,12,5,8,6,10,12,11,5,12,6,6,3,7,13,12,3,13,17,12,8,5,11,10,4,14,13,11,12,7,11,4,12,12,14,3,2,2,3,4,3,2,1,3,3,2
"3879",23494871,"Aliff Haiqal Lokman Hakim Lau","7/11/2000 (22 years old)","AM (RL)","Selangor","Malaysian Super League","MAS","No","11/1/2019","11/30/2025","$6K - $60K","Right","Reasonable","Very Strong","5'9""","145 lbs","57","2",73,88,7,12,9,11,10,6,6,5,6,6,9,2,6,11,8,9,1,6,7,11,8,11,9,5,6,7,6,10,13,13,7,8,16,13,5,4,14,14,12,13,10,12,6,8,12,7,12,11,17,1,4,3,2,2,1,3,3,2,1,3
"3880",2000298908,"Suliman Ezz Allah","2/10/2005 (18 years old)","D (LC)","Al-Hilal Omdurman","Sudanese Premier League","SUD","No","6/12/2023","6/30/2025","$0","Left","Very Strong","Reasonable","5'10""","158 lbs","-","-",70,106,6,8,7,4,9,1,8,7,5,6,7,3,10,8,6,7,9,9,9,12,4,5,1,5,11,8,8,9,14,11,8,9,6,11,10,5,14,20,9,8,9,12,8,6,12,6,11,11,15,3,3,1,3,2,2,1,2,2,1,4
"3881",2000299196,"Mohamed Elmonzer","10/13/2000 (22 years old)","DM, M (C)","Al-Hilal Omdurman","Sudanese Premier League","SUD","No","1/1/2023","6/30/2025","$0","Right","Reasonable","Very Strong","5'7""","138 lbs","-","-",84,105,7,6,5,7,14,7,7,9,6,8,9,1,14,14,12,7,8,9,9,14,12,5,1,7,9,7,11,11,13,9,9,3,12,9,13,3,14,19,9,11,11,10,14,11,11,4,12,10,19,1,3,1,2,3,3,1,1,1,1,3
"3882",13202612,"Mohamed Ahmed Adam","1/1/1994 (29 years old)","D (C)","Al-Merreikh Omdurman","Sudanese Premier League","SUD","No","6/15/2020","6/30/2025","$0","Right","Reasonable","Very Strong","6'2""","169 lbs","-","-",90,105,5,6,1,1,9,3,14,4,8,12,9,5,12,8,5,10,10,9,9,12,12,5,11,5,8,8,4,9,14,12,9,8,15,14,10,6,15,15,8,10,11,11,9,6,12,7,12,13,16,2,3,1,4,3,2,1,2,3,2,2
"3883",13151166,"Ragei Abdelati","4/10/1990 (33 years old)","M/AM (R)","Kober SC","Sudanese Premier League","SUD","No","7/1/2018","6/30/2024","$0","Right","Reasonable","Very Strong","5'8""","147 lbs","-","-",78,105,8,13,12,12,14,7,6,7,7,6,14,2,3,10,6,7,4,8,7,14,14,9,10,9,5,8,7,13,10,9,8,3,14,7,12,5,13,20,7,10,11,13,7,5,8,1,9,14,14,2,3,1,2,1,4,3,1,2,3,3
"3884",2000243056,"Musab Kurdman","4/4/2000 (23 years old)","DM, M (C)","Al-Merreikh Omdurman","Sudanese Premier League","SUD","No","7/1/2020","6/30/2026","$0","Right","Reasonable","Very Strong","6'2""","167 lbs","-","-",83,105,6,6,8,7,13,6,6,5,4,8,11,5,13,13,5,9,8,8,8,13,11,5,1,8,10,5,13,10,13,11,8,12,16,12,7,6,9,12,6,11,12,11,12,14,7,5,13,11,11,1,3,3,3,1,3,3,3,2,2,2
"3885",2000088904,"Walieldin Khidir","9/15/1995 (27 years old)","DM, M (C)","Al-Hilal Omdurman","Sudanese Premier League","SUD","No","10/30/2020","6/30/2025","$60K - $600K","Right","Reasonable","Very Strong","5'11""","160 lbs","-","-",101,105,8,9,7,11,14,7,10,11,6,10,11,9,12,10,15,11,10,11,9,16,3,5,5,11,12,15,10,11,12,12,16,10,10,10,7,6,13,13,4,9,9,12,6,12,7,1,15,10,11,1,1,3,1,1,1,4,3,1,1,2
"3886",2000080485,"Abdulaziz Noor","1/18/1999 (24 years old)","M/AM (RL)","Al-Wehda","Saudi Professional League","SUD","No","7/11/2022","6/30/2025","$2.4M - $5M","Left Only","Very Strong","Weak","5'9""","125 lbs","14","1",100,105,10,15,12,11,11,10,8,9,8,9,10,6,11,12,10,10,9,8,9,8,6,12,6,10,6,10,10,12,14,14,9,8,12,13,12,7,8,18,8,11,12,12,11,9,10,4,12,11,13,3,2,4,3,3,1,3,1,3,3,1
"3887",13169787,"Mohamed Mustafa","2/19/1996 (27 years old)","GK","Al-Merreikh Omdurman","Sudanese Premier League","SUD","No","1/5/2019","6/30/2024","$10K - $100K","Right","Fairly Strong","Very Strong","6'4""","178 lbs","-","-",97,105,3,3,3,1,7,7,1,3,1,2,12,3,3,7,6,8,11,6,14,10,13,2,9,3,14,9,8,8,10,9,6,11,14,11,8,7,11,10,10,13,10,11,12,7,13,6,20,11,11,8,12,14,15,11,12,13,5,12,10,8
"3888",64046252,"Jaser Hamed","6/26/1999 (23 years old)","ST (C)","Hidd","Bahrain Premier League","SUD","No","9/1/2019","6/30/2025","$0 - $26K","Right","Reasonable","Very Strong","6'2""","174 lbs","-","-",77,105,5,2,13,13,9,6,13,6,2,4,6,8,2,13,8,9,2,9,7,6,5,13,11,13,7,6,7,7,13,12,4,9,8,13,8,6,10,16,9,11,11,11,5,5,6,2,13,10,19,3,3,2,3,3,1,3,1,1,3,2
"3889",13151047,"Mohamed Abdelmoniem","7/1/1990 (32 years old)","AM (C), ST (C)","Al-Ahli Khartoum","Sudanese Premier League","SUD","No","7/1/2019","6/30/2024","$5K - $50K","Right","Fairly Strong","Very Strong","5'9""","152 lbs","-","-",92,105,5,8,9,14,8,7,13,8,3,8,10,4,7,13,11,10,4,11,8,14,6,12,6,13,9,9,7,10,13,11,9,7,11,11,10,6,12,10,6,11,10,11,6,6,13,8,13,9,16,1,2,2,2,1,4,3,3,3,1,2
"3890",23228086,"Muhd Syafiq Ahmad","6/28/1995 (27 years old)","AM (L), ST (C)","Johor DT","Malaysian Super League","MAS","No","1/1/2023","11/30/2023","$0 - $12K","Left","Very Strong","Reasonable","5'9""","147 lbs","96","22",74,88,6,10,11,10,12,5,8,3,1,5,7,2,1,9,12,6,3,8,6,9,6,10,13,8,6,5,10,7,12,12,6,4,12,12,11,10,11,10,11,10,10,13,11,5,8,7,17,14,19,3,1,1,1,3,3,2,2,3,3,3
"3891",13148143,"Bakri Al-Madina","11/30/1987 (35 years old)","AM (R), ST (C)","Al-Ahli Wad Medani","Sudanese Lower Division","SUD","No","1/26/2023","6/30/2024","$0","Right","Reasonable","Very Strong","6'1""","167 lbs","-","-",80,105,8,10,10,15,15,8,8,5,2,5,12,5,8,12,10,11,4,6,5,15,15,10,11,11,8,9,11,10,9,10,7,14,12,10,9,6,11,14,4,12,9,13,8,11,13,8,12,9,19,4,2,1,3,1,1,1,3,2,2,2
"3892",13169779,"Abuaagla Ahmed","3/11/1993 (30 years old)","DM, M (C)","Al-Hilal Omdurman","Sudanese Premier League","SUD","No","6/14/2021","6/30/2025","$20K - $190K","Left","Very Strong","Reasonable","5'10""","156 lbs","-","-",103,105,7,4,7,9,11,8,7,11,7,14,11,7,14,9,9,13,5,10,9,9,13,7,12,9,12,9,9,13,14,14,9,8,10,14,14,7,11,10,6,12,11,10,13,1,5,2,16,12,18,3,2,1,3,2,1,3,3,1,1,2
"3893",13150994,"Ali Maki Elrayah","11/25/1989 (33 years old)","D (C)","Al-Hilal Port Sudan","Sudanese Premier League","SUD","No","6/14/2021","6/30/2024","$0","Right","Reasonable","Very Strong","6'4""","185 lbs","-","-",80,105,4,3,2,1,8,1,11,5,1,12,7,1,14,7,6,11,9,8,6,14,6,5,10,7,9,7,6,8,10,6,8,15,8,8,11,6,13,19,8,9,11,10,11,13,11,3,11,13,17,4,2,1,1,2,4,1,2,2,3,1
"3894",13159139,"El-Tahir El-Haj Sadoumba","10/5/1989 (33 years old)","M (C)","Kober SC","Sudanese Premier League","SUD","No","7/1/2018","6/30/2024","$0","Right","Reasonable","Very Strong","6'0""","163 lbs","-","-",82,105,6,7,3,8,14,7,4,9,4,12,14,2,8,9,13,10,4,9,8,12,15,5,12,10,7,8,14,12,9,11,8,6,13,9,7,5,16,20,13,12,12,11,10,4,15,7,13,11,7,3,3,2,2,2,1,1,4,2,2,2
"3895",2000150747,"Osman Mukhtar","6/13/2000 (22 years old)","AM (LC)","Al-Hilal Omdurman","Sudanese Premier League","SUD","No","7/1/2021","6/30/2025","$0","Left","Very Strong","Weak","5'5""","127 lbs","-","-",83,105,5,10,14,10,12,7,7,4,7,7,11,5,9,14,12,7,3,9,8,11,5,13,6,6,7,8,8,13,13,12,8,3,15,13,10,3,14,17,4,11,10,13,11,13,11,1,12,11,10,3,4,2,2,3,4,4,2,3,1,1
"3896",2000166828,"Milyardo Asrat","11/1/2005 (17 years old)","AM (RL)","Hapoel Tel-Aviv","Israeli Premier League","SUD","No","6/13/2022","5/31/2025","$35K - $350K","Right","Weak","Very Strong","5'11""","149 lbs","-","-",57,104,7,10,14,11,12,6,6,2,6,3,12,4,5,12,14,8,4,4,7,11,7,11,2,12,5,7,8,8,11,13,4,10,13,9,8,4,13,16,2,11,10,11,12,4,5,8,7,12,14,2,1,3,2,3,2,3,1,2,1,3
"3897",2000199231,"Yasir Mozamil","1/1/1992 (31 years old)","AM (R), ST (C)","Al-Hilal Omdurman","Sudanese Premier League","SUD","No","7/1/2020","6/30/2025","Not for Sale","Right","Reasonable","Very Strong","5'9""","154 lbs","-","-",104,104,6,9,7,14,14,8,10,9,5,8,10,7,7,13,5,12,5,7,9,12,8,15,5,13,7,9,8,9,14,12,9,5,8,13,14,6,11,12,5,10,9,12,12,10,7,7,11,12,11,2,3,3,3,3,3,1,1,3,1,2
"3898",13151132,"Nizar Hamid","10/3/1988 (34 years old)","DM, M (C)","Al-Ahli Khartoum","Sudanese Premier League","SUD","No","7/1/2022","6/30/2024","$0","Right","Fairly Strong","Very Strong","5'10""","165 lbs","-","-",80,103,7,7,5,8,14,7,7,5,1,7,14,1,13,12,5,10,8,9,8,14,4,5,7,8,14,8,8,12,7,8,8,5,12,8,11,9,11,17,6,13,11,11,12,10,14,8,16,10,10,1,3,1,3,3,3,3,2,2,2,1
"3899",2000299200,"Musa Ali Hussein","1/1/2006 (17 years old)","AM (LC)","Al-Merreikh Omdurman","Sudanese Premier League","SUD","No","6/12/2023","6/30/2025","$0","Right","Reasonable","Very Strong","5'10""","145 lbs","-","-",65,103,6,10,11,9,13,5,5,7,5,5,11,2,7,13,10,4,6,3,6,11,14,13,7,7,4,6,6,10,13,12,6,3,12,9,5,3,11,13,1,13,12,13,7,17,10,1,11,12,14,1,2,2,3,4,2,2,1,1,3,3
"3900",13159158,"Samawal Merghani","10/22/1991 (31 years old)","D (RC)","Al-Ahli Khartoum","Sudanese Premier League","SUD","No","4/1/2022","6/30/2024","$28K - $275K","Right","Reasonable","Very Strong","5'11""","174 lbs","-","-",96,102,7,12,7,9,11,4,11,8,9,15,11,8,14,9,10,11,10,11,10,13,18,5,11,7,13,10,7,11,8,10,11,7,14,9,15,15,17,14,8,11,11,10,5,18,5,1,13,12,20,3,2,1,2,1,3,3,2,3,3,1
"3901",15048831,"David Rowley","2/6/1990 (33 years old)","M/AM (C)","Pahang","Malaysian Super League","MAS","No","1/1/2023","11/30/2024","$1K - $12K","Right","Reasonable","Very Strong","6'2""","163 lbs","173","18",75,88,7,7,9,9,11,7,7,7,1,9,8,7,5,10,15,8,8,10,8,11,11,9,11,8,9,8,11,13,9,12,8,11,7,12,12,5,11,18,10,9,11,9,5,13,9,7,12,12,19,3,1,1,1,1,2,3,2,2,3,1
"3902",12006811,"Akram El Hadi Salem","2/27/1987 (36 years old)","GK","Al-Nsour","Sudanese Lower Division","SUD","No","6/12/2023","6/30/2024","$0","Right","Weak","Very Strong","6'1""","169 lbs","-","-",76,102,4,2,1,3,5,7,1,2,3,2,11,3,1,6,15,10,10,8,10,14,8,3,4,3,9,8,7,7,9,14,6,9,13,9,6,6,9,16,8,11,11,11,7,8,13,3,9,10,18,6,7,9,6,7,10,14,5,11,11,9
"3903",2000164271,"Samer Danglo","8/21/2005 (17 years old)","D (C)","Al-Wahda (UAE)","UAE Professional League","SUD","No","6/13/2022","6/30/2025","$22K - $220K","Right","Reasonable","Very Strong","6'1""","158 lbs","-","-",55,101,5,7,4,7,10,2,8,5,5,11,10,3,12,5,12,10,9,10,10,7,1,5,6,7,8,6,7,10,10,8,10,13,12,9,9,7,10,12,5,11,12,12,5,9,12,8,19,11,16,1,1,1,1,2,2,2,2,2,4,1
"3904",13169786,"Hamza Dawood","6/28/1998 (24 years old)","D (RC)","Al-Merreikh Omdurman","Sudanese Premier League","SUD","No","6/28/2018","6/30/2025","$0","Right","Reasonable","Very Strong","6'1""","174 lbs","-","-",89,100,6,12,8,4,10,3,10,8,8,9,10,6,13,7,7,10,9,10,7,14,6,5,3,8,13,9,6,10,15,14,10,9,9,13,6,9,12,11,7,12,12,13,9,7,8,7,10,13,8,2,1,2,3,2,3,2,1,2,3,1
"3905",13169774,"Waleed Bakhit Hamed","11/11/1998 (24 years old)","ST (C)","Al-Hilal Omdurman","Sudanese Premier League","SUD","No","4/12/2022","6/30/2025","$0","Right Only","Weak","Very Strong","5'11""","165 lbs","-","-",87,100,7,5,14,14,10,7,14,5,1,6,8,10,4,11,5,9,5,13,6,12,16,12,10,14,5,7,8,8,14,14,8,7,7,14,12,7,12,20,7,12,13,10,12,11,6,1,11,9,18,1,3,1,2,1,1,2,3,1,1,2
"3906",89061783,"Abo Eisa","1/5/1996 (27 years old)","M/AM (L)","Bradford City","Sky Bet League Two","SUD","No","7/1/2021","6/30/2024","$2.5K - $24K","Right","Fairly Strong","Very Strong","5'11""","152 lbs","185","48",83,100,8,9,11,10,10,5,7,11,2,4,9,12,3,10,2,10,8,8,7,7,8,17,1,12,5,9,10,9,14,11,13,6,6,14,8,5,10,13,9,12,7,12,11,4,1,2,4,10,8,1,1,3,3,1,2,1,2,1,4,2
"3907",13159159,"Moaaz Abdelraheem","4/25/1989 (34 years old)","AM (R), ST (C)","Al-Amal","Sudanese Premier League","SUD","No","7/1/2022","6/30/2024","$0","Right","Fairly Strong","Very Strong","6'0""","167 lbs","-","-",90,100,8,9,8,14,12,8,11,8,1,6,14,8,3,10,9,8,6,8,9,14,2,9,5,11,8,8,7,10,11,11,9,9,12,10,9,7,13,11,10,11,9,9,8,12,5,8,11,10,11,1,2,4,3,1,3,3,2,1,1,3
"3908",2000265986,"Allaeldeen Fathy","8/7/2004 (18 years old)","D (R)","Al-Dahra","UAE Second Division","SUD","No","7/1/2022","-","$0","Right","Reasonable","Very Strong","5'8""","143 lbs","9","1",50,100,4,12,5,2,11,2,7,7,7,7,8,1,13,6,9,6,8,8,7,8,16,7,7,7,7,8,6,8,8,14,8,6,14,12,8,6,12,19,11,12,10,10,6,4,12,3,9,10,8,3,1,2,2,3,3,3,2,2,3,3
"3909",2000088905,"Dhiya Mahjoub","5/30/1995 (28 years old)","M/AM (C)","Al-Merreikh Omdurman","Sudanese Premier League","SUD","No","6/15/2020","6/30/2025","$0","Right","Reasonable","Very Strong","5'5""","127 lbs","-","-",89,100,6,3,7,9,14,7,7,8,6,8,12,2,12,11,6,9,6,9,6,14,17,10,7,9,11,8,14,13,13,10,8,2,12,12,11,2,12,11,7,11,10,8,9,12,10,4,12,8,7,3,2,3,1,3,3,1,2,3,2,2
"3910",13234071,"Mohamed Eldai","10/26/1998 (24 years old)","ST (C)","Al-Ahli Shendi","Sudanese Premier League","SUD","No","1/1/2023","6/30/2024","$0","Right","Strong","Very Strong","5'10""","156 lbs","-","-",85,100,6,7,6,11,13,6,13,7,2,4,7,6,4,11,8,10,3,8,6,12,1,11,6,13,5,6,5,8,13,12,6,7,13,13,12,6,9,13,10,13,10,10,5,4,7,6,10,10,19,2,1,3,2,2,3,1,1,2,1,2
"3911",2000112342,"Mohamed El-Rasheed","1/1/1994 (29 years old)","DM, M (C)","Al-Merreikh Omdurman","Sudanese Premier League","SUD","No","6/15/2020","6/30/2025","$45K - $425K","Right","Fairly Strong","Very Strong","6'1""","169 lbs","-","-",98,100,6,7,8,9,10,7,7,11,7,9,13,7,8,8,10,11,5,7,9,12,5,5,11,9,8,9,12,12,13,13,9,12,17,13,13,9,13,14,9,10,9,10,11,2,12,5,14,12,16,2,2,3,2,3,1,1,1,1,2,3
"3912",23136982,"Muhd Nazmi Faiz Mansor","8/16/1994 (28 years old)","DM, M (C)","Johor DT","Malaysian Super League","MAS","No","1/1/2023","11/30/2023","$0 - $9K","Right","Reasonable","Very Strong","5'5""","132 lbs","148","13",71,88,6,6,3,6,13,6,6,9,3,7,9,4,11,12,9,8,8,8,8,12,4,13,10,7,8,8,6,11,13,13,8,3,15,13,8,1,14,15,10,9,13,9,12,5,11,8,11,11,8,2,1,3,2,2,3,2,1,1,3,2
"3913",2000307851,"Moumen Esam","11/23/2000 (22 years old)","D (C), DM","Hay al-Arab","Sudanese Premier League","SUD","No","4/8/2022","6/30/2024","$0","Right","Fairly Strong","Very Strong","6'0""","165 lbs","-","-",76,100,3,4,4,7,6,6,9,9,5,11,8,1,14,8,8,10,8,9,8,12,4,5,8,7,14,8,7,12,12,12,7,9,11,10,11,6,13,19,9,12,11,12,8,9,8,1,11,12,14,1,3,3,1,3,3,3,1,1,3,3
"3914",2000115024,"Roman Angot","3/2/2001 (22 years old)","M (C), AM (RLC)","Bahlingen","German Regional Division Southwest","LAO","Yes","7/1/2020","6/30/2024","$0","Right","Reasonable","Very Strong","5'9""","147 lbs","31","-",74,94,7,9,7,11,8,6,7,6,2,7,10,5,8,13,6,5,6,9,4,13,12,12,1,6,8,8,10,12,14,14,8,4,10,14,7,5,14,12,11,10,10,13,6,14,6,3,10,8,8,3,1,2,3,1,3,2,2,3,3,3
"3915",23149455,"Soukaphone Vongchiengkham","3/9/1992 (31 years old)","M (R), AM (RLC)","Trat","Thai League","LAO","No","7/19/2022","6/30/2024","$0","Right","Reasonable","Very Strong","5'1""","119 lbs","100","6",74,81,5,7,13,11,10,8,7,9,5,3,10,7,4,11,14,9,10,8,8,9,4,13,5,14,3,9,10,8,13,12,5,6,11,12,9,4,8,19,9,12,8,11,6,11,7,6,10,10,10,1,1,1,1,1,3,2,2,1,1,2
"3916",64046097,"Bounphachan Bounkong","11/29/2000 (22 years old)","AM (C)","Young Elephant","Laotian Premier League","LAO","No","6/15/2020","12/31/2023","$0","Right","Reasonable","Very Strong","5'7""","136 lbs","43","32",51,70,3,1,6,7,7,2,4,5,3,4,7,3,2,9,8,2,6,7,4,12,10,10,4,9,6,5,12,10,12,12,5,1,14,12,5,1,11,10,11,11,11,12,11,11,5,6,12,10,12,3,2,1,1,2,2,1,1,4,3,1
"3917",23352537,"Phoutthasay Khochalern","12/29/1995 (27 years old)","M/AM (C)","Ezra FC","Laotian Premier League","LAO","No","5/16/2023","12/31/2023","$2K - $6K","Right","Reasonable","Very Strong","5'5""","132 lbs","88","4",64,67,6,6,7,7,8,6,5,6,1,7,6,3,4,9,15,5,3,5,7,7,14,8,2,8,7,7,12,8,14,14,7,5,13,14,13,5,13,20,11,13,11,10,5,5,8,1,9,11,10,2,3,1,2,1,1,3,1,2,1,2
"3918",13203783,"Djihad Bizimana","12/12/1996 (26 years old)","DM, M (C)","KMSK Deinze","Belgian Challenger Pro League","RWA","No","7/1/2021","6/30/2024","$26K - $275K","Right","Reasonable","Very Strong","5'11""","169 lbs","60","-",103,115,9,9,9,9,11,8,10,8,11,11,11,6,12,10,8,11,12,12,11,11,12,5,5,12,10,14,9,14,12,12,13,12,15,13,12,14,14,12,12,8,12,11,6,9,11,4,11,12,7,3,2,1,3,4,3,3,1,1,1,3
"3919",93065020,"York Rafael","3/17/1999 (24 years old)","D/WB/M/AM (L)","Gefle IF","Swedish First Division Elite","RWA","Yes","1/1/2023","12/31/2024","$28K - $275K","Left Only","Very Strong","Weak","5'10""","165 lbs","190","22",93,115,10,10,10,9,11,7,6,7,7,7,8,9,7,11,10,8,9,10,10,9,10,12,10,11,8,10,9,10,13,12,11,7,13,13,12,11,18,7,9,9,9,7,7,7,8,5,11,12,12,2,1,2,3,1,2,1,2,2,2,1
"3920",13176658,"Ange Mutsinzi","11/15/1997 (25 years old)","D (C), DM","Jerv","Norwegian First Division","RWA","No","2/8/2023","12/31/2024","$0 - $140K","Right Only","Weak","Very Strong","6'4""","171 lbs","48","-",93,115,4,7,9,8,10,7,13,7,5,12,8,7,12,7,14,13,12,10,11,9,3,10,7,9,12,11,7,11,13,12,11,13,15,12,11,12,10,14,10,11,9,11,10,12,10,6,8,13,8,1,2,1,3,2,3,3,3,2,2,2
"3921",13109472,"Emery Bayisenge","11/2/1994 (28 years old)","D (C)","Gor Mahia","Kenyan Premier Division","RWA","No","7/1/2022","6/30/2024","$16K - $160K","Right","Reasonable","Very Strong","6'0""","163 lbs","13","3",95,110,3,1,1,1,8,1,9,6,7,13,6,1,13,5,10,13,10,8,8,13,6,5,7,7,13,7,4,8,13,13,8,9,17,13,13,8,12,18,13,9,11,9,10,15,5,8,14,9,7,1,1,1,1,2,2,1,2,2,2,4
"3922",13167679,"Ernest Sugira","3/27/1991 (32 years old)","ST (C)","Al-Wahda (SYR)","Syrian Premier League","RWA","No","8/10/2022","6/30/2024","$35K - $350K","Right Only","Weak","Very Strong","6'3""","180 lbs","4","-",105,110,5,7,12,15,11,7,13,11,1,5,10,13,1,11,8,15,3,13,13,12,10,13,12,14,6,8,7,9,12,10,13,14,13,13,10,14,9,19,12,13,12,8,11,1,10,3,10,10,7,2,2,1,1,3,2,3,2,3,1,2
"3923",8650181,"Mohd Amri Yahyah","1/21/1981 (42 years old)","M (C), ST (C)","Sabah","Malaysian Super League","MAS","No","1/1/2023","11/30/2024","$0","Right","Reasonable","Very Strong","5'8""","154 lbs","217","44",58,87,5,6,3,12,13,5,10,6,1,6,4,5,1,11,5,10,5,10,6,10,14,12,15,12,4,6,12,5,10,6,3,6,13,10,12,8,11,14,11,15,13,11,4,11,11,1,15,14,10,3,3,2,2,3,2,3,2,1,1,3
"3924",2000123074,"Lague Byiringiro","10/25/2000 (22 years old)","AM (RL), ST (C)","Sandvikens IF","Swedish First Division North","RWA","No","1/26/2023","12/31/2026","$0 - $110K","Right","Weak","Very Strong","6'1""","167 lbs","11","4",84,110,5,6,12,12,11,6,9,9,5,5,6,8,7,11,10,8,10,11,10,10,12,9,6,11,6,6,6,6,13,13,9,13,12,12,11,9,7,12,12,12,12,7,5,14,6,5,11,12,12,1,2,3,2,1,1,3,2,3,3,2
"3925",13147219,"Daddy Birori","12/12/1990 (32 years old)","M/AM (R), ST (C)","Vita Club","DR Congo Premier Division B","RWA","No","8/1/2022","6/30/2024","$14K - $140K","Right Only","Weak","Very Strong","6'0""","165 lbs","44","20",90,110,7,11,11,15,15,5,11,9,9,6,11,9,6,15,7,9,5,12,10,10,14,13,12,14,8,10,9,11,9,13,8,10,15,11,8,7,14,13,11,11,9,8,7,2,6,6,14,12,17,1,1,1,2,1,3,1,1,1,2,2
"3926",2000278145,"Hesbon Rutonesha","5/10/2002 (21 years old)","DM, M (C)","Police FC","Rwandan Premier Division","RWA","No","1/25/2023","6/30/2024","$0","Right","Fairly Strong","Very Strong","5'7""","143 lbs","-","-",70,108,6,6,5,5,13,4,6,8,1,4,13,6,10,9,6,7,8,7,3,13,5,5,6,6,7,8,13,8,12,9,4,1,14,10,6,6,13,16,12,12,12,10,9,13,9,2,18,13,14,3,3,3,3,3,2,3,3,2,3,3
"3927",8750479,"Jean-Pierre Ishimwe","6/16/2002 (20 years old)","GK","APR FC","Rwandan Premier Division","RWA","No","7/1/2020","6/30/2025","$1.5K - $14K","Right","Reasonable","Very Strong","6'2""","174 lbs","-","-",82,108,2,1,3,1,1,7,1,1,3,3,9,1,2,4,6,8,5,6,13,14,4,3,3,2,9,8,7,6,7,15,8,14,14,6,1,6,12,18,11,9,11,10,6,5,10,8,14,10,8,10,9,14,11,8,13,13,5,7,6,14
"3928",2000029963,"Glen Habimana","11/13/2001 (21 years old)","ST (C)","Rosport","Luxembourg National Division","RWA","Yes","8/2/2022","6/30/2026","$2.5K - $24K","Right Only","Weak","Very Strong","6'1""","171 lbs","29","4",83,108,7,7,14,9,14,5,14,6,3,6,8,5,1,13,5,10,8,14,7,8,13,13,6,7,8,13,8,13,13,13,11,12,15,10,8,9,10,10,12,13,13,9,5,7,6,2,20,12,11,1,3,2,3,1,2,2,1,1,1,2
"3929",2000208403,"Hakim Sahabo","6/16/2005 (17 years old)","AM (R), ST (C)","LOSC","Ligue 1 Uber Eats","RWA","Yes","7/1/2021","6/30/2025","$7K - $70K","Right Only","Weak","Very Strong","6'0""","158 lbs","-","-",75,107,8,11,12,13,14,4,12,5,7,6,12,2,5,11,11,8,5,7,6,11,5,15,6,7,7,8,9,9,13,10,8,8,15,12,8,7,8,17,10,13,13,9,6,8,7,3,8,7,15,1,3,2,1,1,3,3,3,3,3,1
"3930",2000278650,"Elisa Byiringiro","5/11/2004 (19 years old)","M/AM (L)","Kiyovu","Rwandan Premier Division","RWA","No","7/1/2021","6/30/2025","$0","Left","Very Strong","Reasonable","6'1""","160 lbs","-","-",60,106,4,8,11,9,11,5,4,6,5,5,8,1,7,11,14,5,2,5,2,11,2,14,9,8,5,6,5,7,13,13,6,13,14,13,8,3,13,11,12,10,13,11,7,11,12,8,12,9,15,1,3,3,1,1,2,1,1,3,1,3
"3931",2000159873,"Fiacre Ntwari","9/25/1999 (23 years old)","GK","AS Kigali","Rwandan Premier Division","RWA","No","7/1/2022","6/30/2025","$40K - $130K","Right","Fairly Strong","Very Strong","6'1""","174 lbs","-","-",90,105,4,2,2,2,5,5,1,1,2,3,8,3,3,6,5,9,13,8,8,13,6,2,11,3,10,8,7,6,11,13,3,9,8,7,1,5,9,13,9,11,13,10,9,4,8,3,12,10,10,11,12,13,5,10,13,13,5,8,13,13
"3932",13183065,"Abdul Rwatubyaye","10/23/1996 (26 years old)","D (C)","Rayon Sports","Rwandan Premier Division","RWA","No","6/30/2022","6/30/2024","$100K - $300K","Right","Reasonable","Very Strong","6'1""","176 lbs","56","7",95,105,5,6,9,5,9,7,13,7,6,11,10,4,12,10,10,13,13,12,11,9,9,4,5,5,12,13,8,13,13,12,10,13,14,14,15,13,5,10,9,10,8,7,5,5,6,6,8,12,9,1,1,1,1,1,1,1,1,1,1,1
"3933",2000214957,"Bonheur Mugisha","1/1/2000 (23 years old)","DM, M (C)","APR FC","Rwandan Premier Division","RWA","No","7/1/2021","6/30/2025","$0","Right","Reasonable","Very Strong","6'3""","176 lbs","-","-",82,105,6,5,5,7,13,5,6,6,6,8,13,4,12,13,7,9,8,8,8,12,12,5,6,8,10,8,9,12,13,12,8,14,12,12,7,6,13,20,11,14,11,10,12,16,5,3,9,12,12,2,2,2,3,3,1,2,1,2,1,2
"3934",23258400,"Muhd Nor Azam Abdul Azih","1/3/1995 (28 years old)","M (C)","Pahang","Malaysian Super League","MAS","No","1/1/2023","11/30/2024","$0 - $95K","Right","Fairly Strong","Very Strong","5'5""","132 lbs","164","10",77,87,6,4,5,4,13,6,5,12,4,8,12,2,8,9,10,6,11,8,5,11,9,5,11,8,6,8,12,12,13,13,5,4,14,13,13,6,13,14,13,10,10,9,12,14,11,1,9,10,17,2,2,3,3,1,1,1,3,1,3,2
"3935",13117786,"Meddie Kagere","10/10/1986 (36 years old)","ST (C)","Fountain Gate FC","Tanzanian Mainland Premier Division","RWA","No","8/4/2022","6/30/2024","$0 - $12K","Right","Weak","Very Strong","5'11""","165 lbs","165","79",92,105,7,8,9,12,12,7,13,10,8,4,9,11,4,11,14,12,13,12,11,12,16,11,14,13,6,11,10,13,10,10,14,13,17,10,12,14,10,10,18,14,13,11,10,12,12,6,9,10,12,2,3,3,2,2,2,3,4,4,1,3
"3936",13203786,"Abeddy Biramahire","10/4/1998 (24 years old)","AM (RL), ST (C)","UD Songo","Mozambican Premier Division","RWA","No","2/15/2023","12/31/2023","$0 - $40K","Right","Weak","Very Strong","5'10""","149 lbs","5","1",85,104,5,9,12,8,9,5,6,11,3,4,11,5,6,8,8,6,8,7,7,10,7,8,1,11,6,7,4,12,13,13,13,3,12,13,8,4,10,12,9,13,9,11,11,7,12,6,12,12,14,1,2,4,1,2,2,1,1,1,1,2
"3937",13148053,"Fitina Omborenga","5/20/1996 (27 years old)","D (RL), WB (R)","APR FC","Rwandan Premier Division","RWA","No","7/1/2020","6/30/2025","$45K - $130K","Right","Reasonable","Very Strong","6'1""","167 lbs","35","1",91,103,7,11,8,5,8,3,9,7,8,9,8,5,12,9,13,10,10,9,9,11,15,5,10,7,12,10,7,10,14,14,10,10,12,14,14,7,17,10,13,12,10,14,12,8,9,4,11,11,11,3,1,1,2,2,2,2,2,2,1,1
"3938",18007268,"Jean-Paul Lutula","10/4/1984 (38 years old)","AM (L), ST (C)","Africa FC Bruxelles","Brabant Provincial Division (Wal)","RWA","Yes","7/1/2022","-","$0","Left Only","Very Strong","Weak","5'11""","176 lbs","191","73",90,103,10,8,10,12,11,10,12,11,8,5,10,12,9,10,7,12,4,11,11,11,11,7,7,8,7,10,10,10,13,10,12,11,16,13,13,12,14,20,10,8,11,12,11,12,8,12,10,10,7,1,3,3,3,3,2,2,2,4,3,3
"3939",48044025,"Bryan Ngwabije","5/30/1998 (25 years old)","D (RC)","Andrézieux-Bouthéon FC","French National 2 - A","RWA","Yes","7/25/2022","6/30/2024","$60K - $180K","Right Only","Weak","Very Strong","6'2""","180 lbs","64","-",87,103,7,13,7,3,6,4,12,4,7,11,7,9,11,7,13,11,12,10,10,10,12,5,8,8,11,10,7,11,10,9,11,11,11,10,10,14,13,17,12,11,12,11,10,11,12,3,11,12,19,2,1,1,1,3,3,2,1,3,3,1
"3940",2000277718,"Keddy Nsamzimfura","8/1/2003 (19 years old)","AM (RLC)","APR FC","Rwandan Premier Division","RWA","No","7/1/2021","6/30/2025","$0","Right","Reasonable","Very Strong","5'10""","154 lbs","-","-",69,102,5,6,9,7,13,5,5,4,3,2,11,6,7,12,6,7,4,10,6,11,5,12,12,6,4,6,7,10,13,13,6,7,8,13,8,3,9,18,11,10,8,13,11,12,8,5,10,9,9,3,4,1,3,1,3,3,3,3,2,1
"3941",2000278157,"Pascal Iradukunda","4/26/2005 (18 years old)","AM (RLC)","Rayon Sports","Rwandan Premier Division","RWA","No","7/1/2022","6/30/2025","$0","Right","Reasonable","Very Strong","6'1""","158 lbs","-","-",70,101,6,10,12,11,11,6,6,8,1,6,12,1,6,9,8,8,8,7,5,10,9,9,7,9,5,7,9,12,13,13,7,7,14,13,7,4,11,18,12,13,12,11,8,12,7,6,9,11,12,2,1,4,3,1,2,1,3,1,3,2
"3942",13109470,"Yannick Mukunzi","10/2/1995 (27 years old)","M/AM (C)","Sandvikens IF","Swedish First Division North","RWA","No","1/14/2020","11/30/2024","$18K - $190K","Right","Reasonable","Very Strong","6'2""","171 lbs","72","4",89,100,8,10,10,7,11,7,6,7,6,9,10,7,9,11,7,10,9,11,11,11,12,8,7,9,10,11,11,11,13,12,10,14,13,12,12,10,8,11,11,12,12,11,17,8,6,7,13,12,14,1,3,1,3,1,2,2,3,1,3,3
"3943",13183064,"Rachid Kalisa","6/16/1996 (26 years old)","M (RC)","AS Kigali","Rwandan Premier Division","RWA","No","7/1/2019","6/30/2025","$0","Right","Reasonable","Very Strong","5'8""","143 lbs","24","3",88,100,7,11,9,8,14,7,7,9,1,8,13,7,9,14,5,7,7,10,8,11,17,5,13,9,6,6,12,7,14,14,8,5,13,14,12,5,8,11,10,12,10,13,7,1,12,3,9,9,10,3,3,2,3,2,1,3,2,3,1,3
"3944",12021967,"Haruna Niyonzima","11/2/1990 (32 years old)","M/AM (C)","Al-Taawon","Libyan First Division","RWA","No","1/1/2023","6/30/2024","$2K - $22K","Right","Reasonable","Very Strong","5'6""","125 lbs","-","-",98,100,8,5,10,13,14,8,8,12,5,9,14,7,10,13,8,10,6,12,8,12,7,12,15,14,9,14,10,13,12,10,11,3,6,11,9,1,14,12,11,8,10,11,5,9,6,4,12,12,14,3,1,1,2,3,3,2,2,3,2,1
"3945",2000266880,"Noel Nigg","2/2/2007 (16 years old)","D (RC)","Triesenberg","Swiss Lower Division","LIE","Yes","7/1/2022","-","$0","Right","Weak","Very Strong","6'1""","149 lbs","-","-",50,86,2,7,6,1,4,1,10,1,2,8,6,1,13,6,9,6,7,7,4,12,3,5,12,5,9,6,3,7,10,12,7,10,13,11,10,5,12,19,11,10,13,14,6,13,7,1,3,9,13,1,1,3,3,3,3,3,3,2,1,2
"3946",23494758,"Mukhairi Ajmal","11/7/2001 (21 years old)","M (C), AM (LC)","Selangor","Malaysian Super League","MAS","No","1/1/2023","11/30/2025","$24K - $230K","Right","Strong","Very Strong","5'11""","154 lbs","64","7",76,87,6,8,9,9,8,6,6,11,3,6,6,1,6,13,12,5,4,9,10,13,7,13,11,8,7,7,10,12,11,9,7,10,9,13,9,4,12,17,11,11,12,11,5,8,13,1,12,13,16,3,3,2,1,2,2,1,3,3,1,1
"3947",13161879,"Olivier Kwizera","7/30/1995 (27 years old)","GK","Al-Kawkab","Saudi Second Division Group A","RWA","No","7/1/2022","6/30/2025","$45K - $425K","Right Only","Weak","Very Strong","5'9""","149 lbs","13","-",90,100,3,3,2,2,3,7,1,2,1,1,10,3,1,3,13,6,15,7,10,8,18,2,13,2,8,6,7,7,10,14,8,7,15,11,5,6,10,18,8,9,13,9,10,5,11,7,18,11,10,9,8,13,8,10,12,13,9,9,10,9
"3948",23201328,"Ahmad Syihan Hazmi Mohamed","10/2/1996 (26 years old)","GK","Johor DT","Malaysian Super League","MAS","No","12/1/2022","11/30/2024","$0 - $28K","Right","Reasonable","Very Strong","6'0""","187 lbs","34","-",77,86,3,3,3,3,6,7,1,2,1,2,5,3,2,3,9,11,10,11,11,10,14,3,9,3,11,7,6,6,9,12,7,11,6,10,6,5,11,10,12,11,9,9,10,10,9,5,12,10,15,9,5,12,15,9,10,11,7,10,10,11
"3949",2000015801,"Muhd Feroz Baharudin","4/2/2000 (23 years old)","D (C), DM","Johor DT","Malaysian Super League","MAS","No","1/1/2023","11/30/2023","$3.5K - $10K","Right","Strong","Very Strong","5'11""","158 lbs","35","8",71,86,2,4,6,1,6,6,13,3,4,11,6,1,14,4,8,11,9,2,7,14,12,6,12,7,14,6,5,9,10,5,8,11,14,7,8,5,13,15,10,9,14,11,6,8,7,8,11,9,16,3,3,2,1,2,1,2,2,2,2,2
"3950",23120157,"Mohd Khairul Azhan Mohd Khalid","11/7/1989 (33 years old)","GK","Selangor","Malaysian Super League","MAS","No","1/1/2023","11/30/2024","$5K - $16K","Right","Reasonable","Very Strong","5'11""","169 lbs","151","-",71,86,4,1,2,3,3,8,1,3,3,1,7,2,3,3,6,9,7,6,10,13,15,1,10,2,10,7,6,6,10,9,7,7,6,11,4,5,11,16,12,11,13,11,12,10,10,1,13,11,19,9,12,10,7,6,8,13,5,11,9,5
"3951",2000093433,"V. Ruventhiran","8/24/2001 (21 years old)","D (L), AM (RL)","Selangor","Malaysian Super League","MAS","No","12/1/2022","11/30/2025","$65K - $200K","Left","Very Strong","Reasonable","5'9""","149 lbs","52","3",75,86,7,12,10,10,11,7,6,6,7,8,11,4,9,11,14,5,8,9,4,12,9,10,13,8,8,8,5,9,11,12,5,9,12,11,10,5,15,13,10,11,10,13,13,10,9,7,9,10,20,2,4,1,1,1,1,1,3,2,1,3
"3952",23318963,"M. Kogileswaran Raj","8/8/1998 (24 years old)","AM (RL), ST (C)","Cheongju","Hana 1Q K LEAGUE 2","MAS","No","1/10/2023","12/31/2024","$0","Right","Reasonable","Very Strong","5'6""","130 lbs","74","11",72,86,7,10,11,13,9,6,7,7,1,5,6,5,3,7,6,8,8,6,7,13,10,9,8,10,5,7,9,8,9,13,7,2,9,13,12,1,13,18,13,12,11,10,8,8,9,2,14,10,9,1,1,1,3,3,3,1,2,4,2,1
"3953",87029959,"Elías Vásquez","6/18/1992 (30 years old)","D (RLC)","Marquense","Primera División de Ascenso Guatemala","GUA","No","7/1/2022","6/30/2024","$35K - $350K","Right","Fairly Strong","Very Strong","6'0""","171 lbs","238","2",100,128,6,7,8,7,11,7,12,6,12,11,8,12,12,12,14,10,13,11,11,10,14,4,11,8,10,11,9,13,12,12,11,12,14,13,13,11,13,18,13,14,10,13,5,10,7,7,12,12,11,2,3,4,2,3,2,1,1,1,3,1
"3954",72049945,"Aaron Herrera","6/6/1997 (26 years old)","D (RL), WB (R)","CF Montréal","Major League Soccer","GUA","No","12/21/2022","12/31/2024","$4.5M - $8.8M","Right","Fairly Strong","Very Strong","5'11""","158 lbs","189","7",116,125,7,11,9,9,11,8,12,10,7,12,12,10,13,10,13,11,10,11,10,11,10,12,10,12,13,11,10,12,14,13,12,9,11,14,12,12,9,10,10,12,14,9,14,9,8,7,11,12,13,2,3,2,1,2,3,3,1,2,2,4
"3955",28028965,"Nathaniel Méndez-Laing","4/15/1992 (31 years old)","M (R), AM (RLC)","Derby","Sky Bet League One","GUA","No","7/2/2022","6/30/2024","$150K","Right Only","Weak","Very Strong","5'11""","169 lbs","344","48",110,125,11,13,14,12,12,9,10,13,7,8,12,9,6,12,14,10,12,10,7,7,7,14,6,11,10,12,10,12,15,12,13,9,10,14,11,14,12,9,11,6,9,9,9,10,8,9,6,9,10,1,1,1,3,4,3,1,1,3,3,3
"3956",87001000,"Ricardo Jerez","2/4/1986 (37 years old)","GK","Chattanooga","United States Soccer Leagues Division One","GUA","No","1/2/2023","11/30/2024","Not for Sale","Left","Very Strong","Weak","6'4""","180 lbs","484","-",104,125,4,2,1,2,6,7,2,1,2,1,6,3,1,8,12,10,11,11,11,10,11,2,18,2,11,12,10,12,12,12,12,13,12,12,12,12,9,12,12,13,11,9,5,12,12,11,12,12,12,12,13,13,5,11,10,12,6,11,11,12
"3957",18083972,"Dion Cools","6/4/1996 (27 years old)","D (RC), WB/M (R)","Buriram Utd","Thai League","MAS","Yes","1/3/2023","6/30/2024","$130K - $1.3M","Right","Reasonable","Very Strong","6'0""","169 lbs","178","8",109,128,10,13,10,10,10,8,10,8,11,12,11,7,13,11,5,13,12,11,13,12,14,10,12,8,12,14,9,13,14,12,8,10,13,13,12,10,15,7,11,12,12,15,7,10,5,7,10,12,8,1,1,4,2,2,3,3,1,4,1,1
"3958",87034883,"Brandon De León","5/19/1994 (29 years old)","D (C), DM","Catarina FC","-","GUA","No","6/1/2022","6/30/2024","$14K - $140K","Right","Fairly Strong","Very Strong","5'7""","141 lbs","49","-",87,122,7,5,7,5,9,6,12,6,2,8,9,1,14,5,7,9,9,8,8,14,19,6,10,7,14,7,6,9,14,14,8,6,15,14,5,8,12,7,3,10,9,11,12,4,6,3,15,11,20,3,2,3,3,1,1,1,2,2,2,1
"3959",87000675,"José Contreras","1/19/1986 (37 years old)","AM (RLC)","Comunicaciones","Liga Nacional de Guatemala","GUA","No","5/31/2019","6/30/2024","$1K - $10K","Right","Strong","Very Strong","5'9""","163 lbs","431","70",117,120,13,11,12,9,12,8,11,6,5,8,12,12,8,13,13,11,11,10,13,11,13,11,12,11,9,8,11,10,14,12,10,7,14,13,13,9,12,7,10,14,10,10,5,13,7,2,12,10,14,3,1,1,3,1,2,1,4,2,3,1
"3960",72042157,"Rubio Rubin","3/1/1996 (27 years old)","AM (RLC), ST (C)","Real Salt Lake","Major League Soccer","GUA","No","7/19/2021","12/31/2024","$2.6M - $5.2M","Right","Reasonable","Very Strong","5'10""","182 lbs","185","28",118,119,9,11,13,12,12,7,11,11,4,7,12,12,7,14,11,10,14,9,12,10,13,13,5,12,6,11,8,16,14,14,14,11,12,13,10,13,11,12,11,12,11,12,6,11,5,5,10,12,18,1,3,1,3,1,3,2,2,2,2,1
"3961",87036509,"Stheven Robles","11/12/1995 (27 years old)","WB (RL), M (L)","Comunicaciones","Liga Nacional de Guatemala","GUA","No","6/15/2020","6/30/2025","$120K - $350K","Left","Very Strong","Reasonable","5'9""","156 lbs","206","8",85,117,8,12,8,2,7,5,7,5,4,8,8,2,8,10,14,11,7,9,9,9,5,5,11,8,7,8,9,9,14,14,6,5,12,14,14,10,14,17,7,12,12,12,9,11,9,5,9,10,19,2,2,1,2,3,3,1,3,1,2,2
"3962",87033864,"Jonathan García","10/20/1993 (29 years old)","ST (C)","Xinabajul","Liga Nacional de Guatemala","GUA","No","5/31/2020","6/30/2025","$50K - $475K","Right","Reasonable","Very Strong","6'2""","165 lbs","216","6",85,116,6,2,13,13,10,6,13,7,1,4,6,3,4,6,13,13,1,9,7,13,11,9,10,13,7,6,7,7,13,13,7,11,6,13,8,5,8,12,1,12,12,12,5,19,14,7,7,8,12,1,4,1,1,3,3,2,4,1,3,3
"3963",87000840,"Minor López","2/1/1987 (36 years old)","ST (C)","Comunicaciones","Liga Nacional de Guatemala","GUA","No","6/14/2021","6/30/2024","$16K - $160K","Right","Reasonable","Very Strong","6'4""","194 lbs","305","68",94,115,3,9,10,11,9,7,13,7,3,9,10,10,10,8,13,10,14,9,8,9,12,5,12,11,10,10,10,12,11,10,14,16,13,12,12,14,13,13,6,13,11,13,4,11,7,5,10,9,10,1,4,3,1,1,2,3,2,3,3,3
"3964",87011749,"Manuel Sosa","4/5/1987 (36 years old)","GK","Xinabajul","Liga Nacional de Guatemala","GUA","No","7/1/2022","6/30/2024","$35K - $100K","Right","Reasonable","Very Strong","5'11""","163 lbs","227","-",95,115,6,3,1,1,2,8,1,1,1,1,12,1,1,6,5,10,12,4,9,14,5,1,5,3,12,9,8,8,8,15,8,6,14,9,8,7,13,17,2,10,13,9,7,11,6,2,12,10,9,6,5,9,15,13,9,10,5,10,10,11
"3965",2000264160,"Allan Pérez","2/9/2003 (20 years old)","DM, M (C)","Comunicaciones","Liga Nacional de Guatemala","GUA","No","7/1/2021","6/30/2024","$60K - $600K","Left","Very Strong","Reasonable","5'10""","158 lbs","1","-",66,115,6,6,3,7,12,6,6,13,3,7,14,4,13,10,5,4,7,6,6,8,14,5,9,8,5,8,14,12,9,12,5,9,8,12,7,5,14,12,9,13,10,9,11,14,13,4,11,12,15,2,1,3,2,3,3,2,3,2,3,2
"3966",87035808,"Diego Palma","10/19/1995 (27 years old)","ST (C)","Mictlán","Primera División de Ascenso Guatemala","GUA","No","5/31/2021","6/30/2025","$50K - $500K","Right","Reasonable","Very Strong","6'0""","163 lbs","39","2",87,115,7,6,14,14,8,7,14,6,5,7,8,5,4,8,10,11,7,11,4,12,5,7,7,14,8,7,5,8,14,13,8,8,8,14,7,8,11,9,10,7,13,10,9,14,7,4,20,9,15,1,2,1,2,3,3,3,3,1,3,1
"3967",87000790,"Wilfred Velásquez","9/10/1985 (37 years old)","D/WB (RL), DM","Nueva Concepción","Primera División de Ascenso Guatemala","GUA","No","12/31/2020","6/30/2024","$22K - $230K","Right","Fairly Strong","Very Strong","5'9""","152 lbs","319","10",107,115,10,9,10,7,10,8,12,7,6,13,10,7,12,11,14,10,12,11,12,9,9,6,12,9,11,9,9,14,13,13,10,8,13,13,13,9,17,11,5,10,11,10,8,11,5,5,11,10,9,1,1,1,3,3,3,3,3,1,3,1
"3968",67004763,"Natxo Insa","6/9/1986 (37 years old)","DM, M (C)","Johor DT","Malaysian Super League","MAS","Yes","1/1/2023","11/30/2023","$0 - $2K","Right","Reasonable","Very Strong","5'10""","145 lbs","423","24",86,125,6,7,9,6,11,8,9,9,7,7,11,8,8,10,13,10,12,10,13,11,12,10,9,11,12,13,9,14,10,12,9,7,16,9,13,6,13,12,14,13,13,12,5,12,10,8,14,12,14,1,2,1,1,2,1,2,1,1,1,2
"3969",87035803,"Cristian Jiménez","4/26/1995 (28 years old)","D/WB (R), M (RL)","Antigua","Liga Nacional de Guatemala","GUA","No","6/15/2020","6/30/2025","$18K - $170K","Right","Reasonable","Very Strong","5'9""","141 lbs","339","28",92,115,9,12,10,4,9,8,7,4,6,7,10,3,10,10,10,8,9,5,10,14,12,8,12,9,7,9,6,10,14,14,9,8,12,14,10,7,14,2,4,9,13,12,7,8,5,4,11,11,10,2,1,3,1,3,1,3,1,1,4,1
"3970",87034865,"Mynor Padilla","7/9/1993 (29 years old)","GK","Mixco","Liga Nacional de Guatemala","GUA","No","1/2/2022","6/30/2025","$90K - $275K","Right","Reasonable","Very Strong","5'9""","136 lbs","40","-",85,115,2,1,2,1,3,5,1,1,3,3,12,2,2,3,6,10,12,7,8,13,6,2,13,3,8,7,6,6,13,11,7,7,13,11,5,7,13,5,3,10,10,10,13,11,12,3,14,9,15,4,7,12,10,5,11,13,5,10,7,10
"3971",87036686,"Mauro Portillo","7/14/1995 (27 years old)","ST (C)","Sacachispas (GUA)","Primera División de Ascenso Guatemala","GUA","No","12/31/2020","6/30/2024","$50K - $500K","Left","Very Strong","Reasonable","5'9""","145 lbs","91","9",89,115,5,4,14,14,14,7,12,7,1,6,8,4,1,10,13,13,6,9,8,9,1,10,8,14,8,7,7,8,14,14,6,7,14,14,8,7,9,3,7,13,12,9,13,10,5,6,10,14,20,1,2,1,2,3,3,1,3,1,1,1
"3972",8830676,"Eddy Ortiz","11/21/1981 (41 years old)","D (RL), DM, M (C)","Heredia","Primera División de Ascenso Guatemala","GUA","No","6/14/2021","6/30/2024","$35K - $350K","Right","Fairly Strong","Very Strong","5'10""","165 lbs","201","9",105,115,7,12,11,8,11,7,11,9,1,11,12,1,12,12,11,9,12,10,12,9,12,9,8,13,9,11,11,13,13,12,11,9,12,13,13,11,1,11,6,10,11,12,11,12,7,13,11,10,9,1,1,1,1,1,1,1,1,1,1,1
"3973",87030282,"José Castañeda","10/25/1994 (28 years old)","D (RC)","Xelajú","Liga Nacional de Guatemala","GUA","No","5/31/2020","6/30/2024","$24K - $240K","Right","Reasonable","Very Strong","5'11""","143 lbs","272","5",87,113,7,11,4,5,8,3,11,4,5,13,2,2,13,6,9,9,9,7,12,10,2,5,11,4,11,6,4,8,13,13,7,7,12,13,13,10,10,12,2,11,10,11,11,4,5,5,9,9,12,1,2,1,2,2,1,2,3,2,3,3
"3974",2000274096,"Olger Escobar","9/11/2006 (16 years old)","M (R), AM (RL)","New England II","MLS Next Pro Eastern Conference","GUA","No","6/12/2023","12/31/2024","$375K - $3.8M","Left Only","Very Strong","Weak","5'10""","165 lbs","-","-",75,113,7,11,11,11,13,9,5,6,5,9,9,2,8,14,8,6,5,7,10,11,9,13,7,11,7,15,10,11,9,12,9,8,9,10,8,9,12,15,5,11,13,10,9,7,5,5,10,11,17,3,3,2,3,2,1,1,1,1,1,1
"3975",87035951,"Marlon Sequén","6/23/1993 (29 years old)","M (RC), AM (C)","Municipal (GUA)","Liga Nacional de Guatemala","GUA","No","12/31/2021","6/30/2025","$70K - $700K","Right","Reasonable","Very Strong","5'9""","143 lbs","241","15",95,113,7,9,12,13,12,9,6,9,6,9,11,5,6,12,10,10,9,9,11,10,5,9,5,11,9,9,11,12,14,13,9,5,12,12,14,6,13,8,1,11,10,9,13,8,15,1,9,12,17,1,1,3,2,2,3,2,2,3,2,2
"3976",87034477,"Johnny Navarro","8/7/1994 (28 years old)","GK","Sololá","Primera División de Ascenso Guatemala","GUA","No","7/1/2022","6/30/2024","$65K - $190K","Right","Fairly Strong","Very Strong","5'11""","180 lbs","21","-",85,112,2,3,1,2,3,6,1,1,2,2,10,2,1,3,5,11,12,8,11,14,12,1,13,1,9,8,7,7,10,8,8,6,13,12,3,7,11,8,1,14,12,12,12,12,13,6,13,10,11,8,12,14,5,11,11,14,5,10,7,9
"3977",87035983,"Frank de León","12/26/1994 (28 years old)","DM, M/AM (C)","Xelajú","Liga Nacional de Guatemala","GUA","No","12/31/2022","6/30/2024","$20K - $200K","Left","Very Strong","Reasonable","5'8""","141 lbs","272","35",90,112,7,5,10,8,12,7,10,6,1,9,6,2,13,12,6,10,9,8,8,13,10,8,13,11,10,8,10,12,13,11,8,8,9,10,7,6,13,13,2,14,13,12,9,14,8,8,13,12,9,1,1,2,1,2,1,1,3,3,3,1
"3978",87036522,"Kevin Ruiz","5/18/1995 (28 years old)","D (C)","Xelajú","Liga Nacional de Guatemala","GUA","No","6/30/2022","6/30/2024","$45K - $475K","Right","Reasonable","Very Strong","5'10""","163 lbs","290","7",90,112,2,6,4,8,9,1,12,2,5,14,9,4,14,8,13,11,10,7,10,14,14,5,6,7,13,8,7,9,14,13,9,9,12,14,6,5,12,10,6,11,11,13,14,10,6,5,20,14,18,3,1,1,2,1,1,2,1,3,3,3
"3979",2000093648,"Amirul Faqhi Jalil","6/5/2002 (21 years old)","AM (C)","Johor DT","Malaysian Super League","MAS","No","1/1/2023","11/30/2024","$30K - $300K","Right","Strong","Very Strong","5'4""","123 lbs","-","-",102,123,6,7,10,14,10,2,8,14,5,7,12,10,7,14,5,9,8,11,8,14,12,15,8,14,10,9,14,7,13,11,9,1,12,11,10,1,16,11,11,11,12,10,10,3,13,8,9,10,14,2,1,3,3,3,3,2,3,3,4,2
"3980",87031836,"Junior Carías","9/14/1991 (31 years old)","GK","Sololá","Primera División de Ascenso Guatemala","GUA","No","6/14/2021","6/30/2024","$26K - $250K","Right","Fairly Strong","Very Strong","5'11""","154 lbs","3","-",84,112,2,3,1,1,2,6,1,1,1,1,6,2,3,2,5,11,12,6,9,13,7,3,12,2,14,8,7,7,10,14,4,10,15,10,5,7,13,18,9,10,12,11,10,10,9,4,12,11,13,8,8,8,15,8,7,14,5,10,13,12
"3981",2000183151,"Daniel Cardoza","3/15/2004 (19 years old)","M (LC)","Comunicaciones","Liga Nacional de Guatemala","GUA","No","7/1/2021","6/30/2024","$14K - $150K","Left","Very Strong","Reasonable","5'6""","132 lbs","1","-",60,111,8,11,6,4,14,5,1,4,6,7,13,1,6,9,6,7,4,7,4,8,11,5,7,8,5,7,6,12,14,12,7,5,18,9,12,3,12,7,2,11,11,9,9,17,8,8,13,14,9,2,2,1,1,1,1,3,1,2,2,2
"3982",87031677,"José López","12/29/1992 (30 years old)","D (C)","San Pedro","Primera División de Ascenso Guatemala","GUA","No","6/1/2022","6/30/2025","$150K - $450K","Either","Very Strong","Very Strong","5'10""","182 lbs","43","-",87,111,4,2,1,4,7,1,13,2,4,13,6,1,13,4,5,9,9,5,9,13,11,5,8,4,8,6,1,7,13,13,7,8,13,13,4,6,14,10,5,12,10,11,9,3,10,8,10,10,14,3,1,2,1,3,2,3,2,2,3,1
"3983",87016182,"William Ramirez","4/21/1991 (32 years old)","D (RLC), WB (RL)","Zacapa","Liga Nacional de Guatemala","GUA","No","12/31/2020","6/30/2025","Not for Sale","Left","Very Strong","Fairly Strong","5'9""","160 lbs","83","1",90,110,4,8,11,4,11,1,10,8,7,10,7,5,11,12,14,9,12,8,9,11,8,5,12,6,9,9,7,13,13,12,9,9,14,13,13,8,14,4,1,10,12,13,4,16,11,1,13,10,8,3,3,1,2,3,3,3,3,1,3,1
"3984",87036868,"Gerson Tun","10/1/1995 (27 years old)","ST (C)","Carchá","Segunda División de Guatemala","GUA","No","6/15/2020","6/30/2024","$26K - $275K","Right","Reasonable","Very Strong","5'8""","154 lbs","13","-",88,110,1,3,11,14,14,6,13,6,1,6,7,2,3,13,11,13,7,8,7,8,14,13,3,14,8,7,8,8,14,14,8,3,14,14,13,7,13,11,5,10,11,13,11,12,6,7,15,10,14,2,4,1,3,3,2,2,1,1,3,3
"3985",87016553,"Ángelo Padilla","3/5/1990 (33 years old)","ST (C)","Quiche","Primera División de Ascenso Guatemala","GUA","No","5/31/2019","6/30/2024","$70K - $200K","Right","Fairly Strong","Very Strong","5'9""","143 lbs","185","27",91,110,8,4,12,11,10,8,12,8,4,8,9,11,7,14,15,14,8,12,9,14,19,13,12,11,9,8,9,9,12,10,9,8,10,12,12,12,10,5,9,13,11,11,7,11,6,1,13,9,15,3,1,1,1,2,2,3,2,3,3,3
"3986",87035906,"Wilson Pineda","9/25/1993 (29 years old)","D (RC), WB (R)","Guastatoya","Liga Nacional de Guatemala","GUA","No","6/15/2020","6/30/2024","$55K - $550K","Right","Reasonable","Very Strong","5'8""","147 lbs","339","13",90,110,4,10,4,4,10,1,7,3,7,9,10,1,8,9,13,8,10,9,10,11,14,7,11,7,11,9,8,8,14,14,8,3,14,13,14,8,15,5,5,13,12,12,10,10,11,1,10,10,19,2,1,2,3,1,3,2,3,3,3,3
"3987",87000677,"Marvin Ávila","12/6/1985 (37 years old)","M (R), AM (RC), ST (C)","Heredia","Primera División de Ascenso Guatemala","GUA","No","6/1/2023","6/30/2024","$70K - $210K","Right","Fairly Strong","Very Strong","6'2""","160 lbs","400","45",102,110,10,11,9,10,8,9,12,7,8,11,11,7,11,11,14,9,13,9,11,7,9,9,10,11,10,10,9,13,13,11,11,13,14,13,13,11,11,10,7,13,8,13,5,8,7,8,13,11,8,3,2,2,2,3,3,1,3,1,3,3
"3988",87000845,"Jhonathan López","5/10/1988 (35 years old)","WB (R), M (RL), AM (RLC), ST (C)","Quiche","Primera División de Ascenso Guatemala","GUA","No","1/2/2022","6/30/2024","$55K - $170K","Right","Fairly Strong","Very Strong","5'9""","141 lbs","363","19",105,110,7,9,12,8,12,5,9,5,10,9,11,3,9,11,12,10,11,9,11,11,13,9,11,12,9,10,10,14,13,12,7,6,14,13,12,8,11,6,11,13,12,11,4,12,7,4,12,12,9,3,4,1,2,2,2,1,1,3,2,3
"3989",87035720,"Aslinn Rodas","7/10/1992 (30 years old)","M/AM (C)","Xelajú","Liga Nacional de Guatemala","GUA","No","5/31/2021","6/30/2024","$50K - $500K","Right","Reasonable","Very Strong","5'10""","149 lbs","251","11",98,110,10,8,13,9,14,9,10,7,8,7,12,4,9,14,8,11,8,10,12,11,12,11,8,11,11,11,11,12,12,13,11,8,13,12,13,9,11,11,10,8,11,13,6,19,10,2,9,12,14,3,1,1,1,2,1,2,2,2,2,1
"3990",19256400,"Endrick","3/7/1995 (28 years old)","M (C), AM (LC)","Johor DT","Malaysian Super League","MAS","No","1/5/2023","11/30/2023","$0 - $50K","Left Only","Very Strong","Weak","5'10""","143 lbs","109","18",88,115,6,8,12,8,13,3,6,8,1,6,11,6,4,13,7,9,8,9,11,12,13,14,8,12,6,7,12,12,13,13,4,9,10,12,13,5,10,20,6,11,12,10,10,10,9,4,13,11,9,4,2,4,3,3,4,1,3,2,3,2
"3991",87034872,"Jorge Aparicio","11/21/1992 (30 years old)","DM, M (C)","Comunicaciones","Liga Nacional de Guatemala","GUA","No","12/31/2019","6/30/2025","$150K - $1.5M","Right","Reasonable","Very Strong","5'9""","145 lbs","336","14",98,110,8,7,4,4,14,8,8,7,4,12,12,3,14,11,9,12,9,9,7,8,6,5,9,9,12,9,11,8,14,14,9,5,15,14,13,12,15,8,2,10,10,11,14,1,10,4,7,11,9,2,1,3,2,4,2,1,3,3,1,1
"3992",87016503,"Kenroy Arana","2/6/1992 (31 years old)","M (C), AM (RC)","Petapa","Segunda División de Guatemala","GUA","No","7/1/2018","6/30/2024","$12K - $120K","Right","Reasonable","Very Strong","5'7""","141 lbs","79","2",85,110,6,8,8,13,14,7,7,9,5,6,10,4,8,10,7,9,6,6,7,11,14,9,14,12,8,8,11,13,13,14,8,6,15,11,13,5,12,16,11,13,13,11,9,14,13,8,9,13,18,1,4,1,3,3,3,1,2,3,4,2
"3993",87041914,"Rudy Barrientos","3/1/1999 (24 years old)","DM, M (C)","Municipal (GUA)","Liga Nacional de Guatemala","GUA","No","5/31/2019","6/30/2025","$55K - $550K","Right","Reasonable","Very Strong","5'9""","158 lbs","200","17",85,110,7,5,8,7,11,7,7,10,3,9,10,1,13,14,9,9,8,8,9,10,4,5,1,6,12,8,12,11,14,14,8,8,12,14,14,5,10,10,1,12,10,11,8,1,12,6,8,13,12,1,1,2,4,1,4,2,3,1,1,2
"3994",87032048,"Carlos Mejía","11/13/1991 (31 years old)","WB (RL), DM, M (RLC), AM (RL)","Antigua","Liga Nacional de Guatemala","GUA","No","1/15/2021","6/30/2025","Not for Sale","Right","Fairly Strong","Very Strong","5'7""","141 lbs","372","46",95,110,8,9,10,9,11,6,9,7,8,7,10,7,7,12,11,8,9,8,11,8,3,9,13,11,8,9,8,12,12,12,4,1,13,12,12,4,14,16,1,9,11,11,5,3,10,4,13,10,17,3,1,2,3,3,3,2,1,1,1,2
"3995",2000016094,"Oscar Santis","3/25/1999 (24 years old)","M/AM (RL)","Antigua","Liga Nacional de Guatemala","GUA","No","12/15/2022","6/30/2025","$160K - $1.6M","Right","Reasonable","Very Strong","5'8""","143 lbs","146","33",99,110,7,11,13,11,12,7,3,5,2,7,9,4,7,13,11,7,9,10,7,8,4,14,9,11,6,8,8,11,13,13,8,1,5,13,13,8,15,7,3,9,11,12,7,15,5,2,9,11,17,2,2,2,2,3,3,2,1,1,1,2
"3996",87016265,"José Pinto","6/16/1993 (29 years old)","D (RLC)","Comunicaciones","Liga Nacional de Guatemala","GUA","No","7/4/2022","6/30/2025","$475K - $1.4M","Right","Reasonable","Very Strong","5'10""","163 lbs","384","2",102,110,5,7,9,2,12,9,13,10,8,12,10,9,12,7,13,10,13,10,12,10,5,6,12,11,10,13,12,13,13,13,13,12,12,13,14,13,14,16,5,9,11,11,13,1,6,8,11,12,13,3,1,2,1,3,3,4,2,3,4,3
"3997",87039436,"Nicholas Hagen","8/2/1996 (26 years old)","GK","HamKam","Norwegian Premier Division","GUA","No","6/30/2021","7/31/2023","$0","Right Only","Weak","Very Strong","6'4""","187 lbs","205","1",104,109,4,2,3,2,8,6,1,3,2,2,7,1,1,6,6,12,11,11,13,11,12,3,9,2,12,11,9,10,9,11,11,14,13,10,10,12,10,1,3,12,11,13,9,2,7,5,12,9,14,10,12,13,10,12,11,13,8,10,12,13
"3998",87033800,"Germán Esquivel","11/17/1993 (29 years old)","AM (RC), ST (C)","Suchitepéquez","Primera División de Ascenso Guatemala","GUA","No","6/15/2020","6/30/2024","$55K - $550K","Right","Fairly Strong","Very Strong","5'9""","138 lbs","140","18",90,109,7,9,13,13,8,7,12,9,1,7,9,9,3,10,8,11,8,11,8,10,7,10,7,13,8,7,8,9,13,13,8,6,13,13,9,6,11,19,1,11,12,9,9,8,15,3,14,12,8,3,2,2,1,1,3,3,1,1,1,3
"3999",87016440,"Manuel Moreno","6/18/1992 (30 years old)","D (C)","Mixco","Liga Nacional de Guatemala","GUA","No","12/31/2022","6/30/2025","$30K - $325K","Right","Reasonable","Very Strong","5'11""","156 lbs","269","14",89,109,3,1,1,6,7,2,13,6,2,13,6,3,13,2,9,8,9,7,8,13,5,5,13,6,13,6,2,7,13,13,7,10,10,13,12,4,16,4,5,12,11,12,8,3,7,1,20,11,19,4,3,2,3,4,1,3,3,1,3,2
"4000",7700229,"Henry Medina","3/16/1981 (42 years old)","D (C)","Mictlán","Primera División de Ascenso Guatemala","GUA","No","6/14/2021","6/30/2024","$45K - $140K","Right","Fairly Strong","Very Strong","5'11""","169 lbs","329","3",102,108,6,2,10,8,11,7,13,8,3,10,11,3,12,11,12,10,13,12,11,10,12,4,12,9,9,12,11,12,12,11,12,11,13,13,12,12,11,12,7,11,10,12,4,13,9,7,14,12,9,2,1,3,3,1,1,3,3,4,2,3
"4001",2000187194,"Prince Buregeya","10/17/1999 (23 years old)","D (C)","APR FC","Rwandan Premier Division","RWA","No","6/15/2020","6/30/2025","$0 - $14K","Right","Reasonable","Very Strong","5'11""","154 lbs","-","-",80,100,3,1,1,2,6,1,11,1,1,13,7,4,13,1,9,12,9,7,11,13,3,5,11,6,11,4,1,7,13,13,7,9,15,13,9,5,15,20,10,13,12,12,12,3,13,6,15,10,19,3,4,3,3,2,1,2,3,1,2,3
"4002",2000248935,"Moses Nyamurangwa","12/10/2003 (19 years old)","M/AM (C)","Police FC","Rwandan Premier Division","RWA","No","6/9/2023","6/30/2025","$0","Right","Weak","Very Strong","6'1""","171 lbs","-","-",70,98,5,7,10,15,14,8,5,12,2,5,13,7,9,15,11,8,6,5,6,7,11,13,1,5,7,9,13,11,12,7,9,15,12,8,9,7,14,12,13,11,14,10,10,16,6,3,18,11,14,3,3,1,3,1,2,1,4,3,3,1
"4003",93033266,"Mehdi Khalil","9/19/1991 (31 years old)","GK","Ahed","Lebanese Premier League","LIB","No","6/14/2021","6/30/2024","$0 - $55K","Right","Reasonable","Very Strong","6'4""","176 lbs","114","-",102,108,5,1,2,3,2,6,2,2,3,2,11,2,2,6,13,13,13,10,7,7,9,1,4,2,14,11,10,10,16,14,15,18,12,13,8,15,11,15,14,14,12,12,5,15,6,5,13,11,14,14,8,12,8,11,8,13,5,11,13,9
"4004",2000259584,"Ali Haidar","8/29/2002 (20 years old)","ST (C)","Ahed","Lebanese Premier League","LIB","No","7/1/2019","6/30/2024","$0","Right","Reasonable","Very Strong","5'10""","156 lbs","28","5",75,108,6,4,9,12,13,4,7,5,6,4,6,7,3,10,5,9,6,12,6,13,5,10,1,11,7,6,6,7,13,13,3,7,11,11,6,6,9,19,11,9,13,10,5,3,12,4,12,10,17,2,2,2,1,3,2,2,2,3,1,2
"4005",93080540,"Mouhammed-Ali Dhaini","3/1/1994 (29 years old)","D (C), DM, M (C)","Trelleborgs FF","Swedish First Division Elite","LIB","Yes","1/14/2021","12/31/2023","$12K - $130K","Right","Reasonable","Very Strong","6'1""","180 lbs","230","11",94,108,6,8,7,7,10,6,11,7,6,11,11,6,11,10,11,12,9,11,12,11,10,3,12,6,12,14,11,14,10,10,12,13,12,11,13,13,8,10,10,10,10,9,11,7,6,7,13,9,17,3,1,3,3,1,3,3,1,3,2,3
"4006",2000092754,"Philippe Ayoub","3/21/2001 (22 years old)","M/AM (C)","Salam Zgharta","Lebanese Second Division","LIB","No","7/1/2020","6/30/2024","$0 - $18K","Right","Reasonable","Very Strong","5'9""","152 lbs","55","5",70,107,6,6,4,7,7,6,6,9,1,7,7,3,7,12,6,7,6,8,7,13,13,12,11,9,8,7,13,12,13,12,4,4,7,12,8,5,12,10,10,11,10,11,5,9,8,4,12,10,10,2,3,3,1,1,2,2,2,3,3,2
"4007",2000092637,"Tarek Turkmani","11/11/2003 (19 years old)","M (C)","Safa","Lebanese Premier League","LIB","No","7/1/2020","6/30/2025","$1.5K - $4K","Right","Strong","Very Strong","6'1""","165 lbs","12","-",61,107,5,2,3,7,13,4,5,6,1,7,13,1,5,10,14,7,1,8,6,10,9,9,1,6,5,6,9,11,13,9,4,13,11,11,7,5,9,17,13,12,10,10,10,9,12,5,7,11,8,1,4,1,3,3,2,2,2,1,3,2
"4008",2000092796,"Jawad Koutharani","7/9/2002 (20 years old)","M/AM (C)","Tadamoun","Lebanese Premier League","LIB","No","7/1/2020","6/30/2025","$0 - $22K","Left","Very Strong","Reasonable","6'0""","167 lbs","23","-",65,107,6,6,9,8,12,7,7,8,5,8,9,6,9,11,8,10,7,5,9,15,12,9,13,10,9,8,13,9,8,10,9,9,6,11,7,5,11,11,12,11,10,11,12,5,6,8,9,10,19,3,2,1,2,3,2,3,2,1,2,3
"4009",2000114384,"Ali Kassas","3/25/2003 (20 years old)","ST (C)","Nejmeh","Lebanese Premier League","LIB","No","7/1/2020","6/30/2024","$0","Right","Reasonable","Very Strong","6'2""","167 lbs","8","-",75,106,6,4,11,13,13,4,12,7,2,4,7,8,1,9,13,13,4,11,7,13,10,9,8,12,7,6,7,7,13,13,7,12,13,13,5,5,10,10,9,11,12,14,8,15,10,7,17,13,18,2,1,2,1,3,1,2,1,1,1,3
"4010",2000253304,"Hussein Reda","4/7/2004 (19 years old)","D (R)","Ahed","Lebanese Premier League","LIB","No","7/1/2021","6/30/2026","$0","Right","Reasonable","Very Strong","6'4""","185 lbs","1","-",65,106,3,9,1,5,7,1,6,1,5,8,7,6,13,7,7,7,8,4,9,12,14,6,10,3,7,7,7,7,14,11,7,12,12,13,8,8,15,10,12,12,11,12,8,10,11,5,7,10,9,3,1,1,3,2,4,2,3,2,3,2
"4011",23480338,"Ali Al-Haj","2/2/2001 (22 years old)","AM (C)","Ahed","Lebanese Premier League","LIB","No","7/1/2020","6/30/2024","$0 - $40K","Right","Reasonable","Very Strong","5'7""","134 lbs","26","2",87,105,7,8,9,8,11,6,7,7,4,7,10,4,7,11,8,9,5,6,6,14,9,10,9,9,7,8,14,11,14,14,8,6,13,14,7,2,13,17,12,10,11,10,5,14,7,2,12,11,11,4,2,3,3,3,2,2,2,3,3,2
"4012",23316903,"Hussein Al-Zein","1/27/1995 (28 years old)","D/WB (R)","Bourj","Lebanese Premier League","LIB","No","6/15/2020","6/30/2024","$1K - $8K","Right","Reasonable","Very Strong","5'7""","154 lbs","144","11",91,105,9,18,9,5,11,4,10,7,8,11,12,5,14,15,12,12,11,8,11,13,10,9,15,9,12,18,10,12,8,11,10,6,7,9,11,7,16,17,13,10,11,11,11,3,5,6,10,11,8,1,2,2,4,1,1,3,3,1,1,1
"4013",13161877,"Kévin Muhire","10/17/1998 (24 years old)","M/AM (C)","Yarmouk (KUW)","Kuwaiti First Division","RWA","No","8/7/2022","6/30/2023","$26K - $75K","Right Only","Weak","Very Strong","5'8""","145 lbs","22","-",90,97,6,6,7,12,11,7,3,13,1,7,6,6,9,13,10,9,9,8,8,13,7,13,14,9,9,8,13,9,13,13,8,4,10,13,13,5,14,20,11,10,10,9,12,11,15,8,11,13,13,2,2,3,1,2,4,3,3,2,2,3
"4014",2000186434,"Ali Al-Moussa","8/3/2001 (21 years old)","D (C)","Shabab Sahel","Lebanese Premier League","LIB","No","7/1/2022","6/30/2024","$0","Right","Reasonable","Very Strong","6'0""","160 lbs","-","-",75,105,3,3,4,5,7,1,13,3,1,12,7,1,13,6,10,11,9,3,12,13,16,5,9,6,13,6,3,7,13,10,7,9,15,11,9,6,12,11,12,11,13,10,8,9,8,8,20,11,11,1,2,3,1,3,2,2,1,1,3,2
"4015",2000092449,"Said Saad","5/21/2002 (21 years old)","M/AM (C)","Shabab Sahel","Lebanese Premier League","LIB","No","5/27/2023","6/30/2028","$9K - $28K","Right","Reasonable","Very Strong","5'9""","149 lbs","32","3",77,105,7,4,9,10,11,7,7,11,6,9,12,4,9,14,12,7,8,7,8,14,10,13,5,10,8,6,13,11,12,11,8,7,10,10,7,5,12,20,12,12,11,12,6,8,14,5,12,11,12,1,3,3,1,3,1,3,2,2,1,2
"4016",2000017518,"Hussein Awada","2/28/2000 (23 years old)","M/AM (C)","Ahed","Lebanese Premier League","LIB","No","7/1/2018","6/30/2024","$0 - $26K","Right","Reasonable","Very Strong","5'8""","143 lbs","48","10",81,105,7,4,6,11,14,7,7,8,1,9,13,5,7,12,11,9,7,6,8,11,11,11,3,9,9,8,10,9,12,14,8,2,16,14,9,6,13,19,11,11,10,10,9,7,8,6,18,12,19,1,1,2,2,2,3,3,2,1,3,1
"4017",2000092345,"Hassan Kraytem","2/19/2000 (23 years old)","DM, M (C)","Shabab Sahel","Lebanese Premier League","LIB","No","5/16/2023","6/30/2028","$6K - $18K","Right","Reasonable","Very Strong","6'0""","163 lbs","40","1",71,105,7,4,6,8,9,4,8,7,6,12,14,3,13,14,9,9,8,9,7,11,10,5,7,8,13,8,10,12,9,11,8,9,15,11,7,6,12,16,11,12,10,10,10,2,5,2,13,9,9,3,1,1,2,1,1,2,1,1,3,1
"4018",2000017897,"Mohammad Haidar","1/1/2001 (22 years old)","M/AM (C)","Shabab Sahel","Lebanese Premier League","LIB","No","7/1/2019","6/30/2025","$5K - $16K","Right","Reasonable","Very Strong","5'8""","143 lbs","54","4",81,104,6,6,8,7,13,4,4,9,1,6,10,6,4,13,9,10,8,6,7,11,9,13,9,4,8,7,13,12,13,13,3,2,14,13,7,5,14,12,11,9,14,14,9,1,5,2,11,11,8,3,2,2,2,3,1,1,2,2,1,3
"4019",2000092882,"Mohammed Safwan","3/10/2003 (20 years old)","D (L), DM, M (C)","Nejmeh","Lebanese Premier League","LIB","No","6/1/2023","6/30/2024","$0 - $28K","Right","Reasonable","Very Strong","5'9""","145 lbs","11","-",80,104,7,7,5,4,14,7,7,7,2,9,9,1,14,9,9,8,8,9,9,11,15,7,11,8,11,7,9,12,14,14,5,5,16,14,9,5,16,13,9,12,12,12,13,10,5,8,20,12,8,1,1,1,2,3,2,2,2,3,2,1
"4020",2000019250,"Abdelrazzak Dakramanji","2/22/2001 (22 years old)","M (RL), AM (L)","Tripoli SC","Lebanese Premier League","LIB","No","7/1/2019","6/30/2025","$0 - $22K","Right","Reasonable","Very Strong","5'10""","149 lbs","22","1",70,104,8,12,10,11,10,7,5,3,7,6,12,1,7,9,15,7,8,5,8,10,9,11,13,12,7,8,7,11,14,8,8,9,17,12,7,5,17,16,9,13,12,9,12,14,12,7,12,9,10,3,2,2,3,1,2,1,2,3,3,3
"4021",23452634,"Karim Darwiche","11/2/1998 (24 years old)","ST (C)","Al-Ansar","Lebanese Premier League","LIB","Yes","7/11/2020","6/30/2024","$0","Right","Reasonable","Very Strong","6'2""","171 lbs","54","14",85,103,6,6,12,12,13,2,9,6,3,5,8,3,4,8,12,10,8,9,8,14,8,8,13,14,8,7,4,8,14,12,8,12,12,14,8,7,10,14,9,13,12,9,7,4,11,8,11,11,17,1,2,2,1,1,3,3,3,4,1,3
"4022",2000180915,"Ali Ismail","7/8/2003 (19 years old)","D/M (R)","Nejmeh","Lebanese Premier League","LIB","No","7/1/2020","6/30/2024","$1K - $9K","Right","Reasonable","Very Strong","5'10""","152 lbs","26","-",78,103,5,8,9,7,11,6,7,7,6,7,7,5,8,11,6,8,8,8,9,10,17,5,7,8,8,9,7,9,14,12,8,5,8,14,13,5,12,17,11,11,12,14,5,3,7,2,10,13,12,3,3,1,3,1,1,2,3,3,3,1
"4023",23190951,"Mohammad Jaafar","8/24/1991 (31 years old)","M (R), AM (RL)","Bourj","Lebanese Premier League","LIB","No","6/28/2019","6/30/2025","$500 - $3K","Right","Strong","Very Strong","6'2""","171 lbs","123","29",72,103,9,12,8,10,9,7,7,8,6,6,9,4,8,14,6,10,1,9,8,13,4,13,4,12,7,8,6,11,12,7,3,13,12,8,8,5,11,18,8,11,10,12,10,2,10,7,13,11,12,1,3,3,1,2,4,3,2,2,1,1
"4024",2000189589,"Kevin Mugabe","3/13/2002 (21 years old)","ST (C)","TuS Bad Gleichenberg","Austrian Regional League Central","RWA","No","7/12/2022","-","$0","Right","Reasonable","Very Strong","5'9""","154 lbs","24","4",71,96,4,6,13,13,13,6,13,3,1,5,7,3,4,10,6,12,3,7,6,9,6,10,11,11,7,6,7,7,11,11,4,8,12,9,4,6,10,19,9,11,10,11,12,2,11,2,10,14,17,2,1,1,4,2,1,4,3,2,3,2
"4025",23232245,"Mohammad Markabawi","9/25/1994 (28 years old)","AM (L), ST (C)","Nejmeh","Lebanese Premier League","LIB","No","7/1/2022","6/30/2024","$5K - $16K","Left","Very Strong","Reasonable","6'0""","165 lbs","59","11",69,103,6,9,15,9,10,6,7,7,5,6,11,1,2,9,9,12,6,8,7,8,12,11,7,11,5,7,7,8,11,13,5,9,12,12,12,7,10,14,9,10,10,8,7,7,6,2,10,12,15,3,1,3,2,3,3,3,3,3,2,1
"4026",2000168272,"Abdullah Halwa","4/18/2001 (22 years old)","D (C)","Chabab Ghazieh","Lebanese Premier League","LIB","No","7/1/2022","6/30/2025","$0 - $24K","Right","Weak","Very Strong","6'4""","182 lbs","22","2",69,103,4,5,1,1,6,1,10,4,1,10,6,1,11,5,9,7,8,5,8,13,18,5,3,5,13,5,4,6,11,9,6,11,13,9,6,8,11,13,12,9,9,13,6,6,11,6,10,9,13,4,3,2,2,2,1,3,1,1,1,2
"4027",23190659,"Rabih Ataya","7/16/1989 (33 years old)","M (RC), AM (R)","Nejmeh","Lebanese Premier League","LIB","No","3/23/2023","6/30/2024","$0","Left","Very Strong","Fairly Strong","5'9""","145 lbs","163","23",92,103,7,10,5,6,15,6,6,9,7,7,14,15,6,12,5,10,5,13,8,13,16,11,13,9,7,8,11,5,9,11,6,3,15,11,8,5,9,5,1,3,11,9,6,6,5,17,11,12,13,1,1,3,2,2,2,1,4,3,3,1
"4028",2000092734,"Arij Hilal","2/26/2004 (19 years old)","DM, M (C)","Ikhaa Ahli","Lebanese Second Division","LIB","No","7/1/2020","6/30/2028","$0 - $18K","Right","Reasonable","Very Strong","6'0""","158 lbs","16","-",65,103,4,4,7,7,14,6,6,9,1,11,10,6,12,14,9,6,7,5,8,11,2,5,9,7,11,8,10,10,8,13,7,10,13,10,6,4,8,14,12,10,13,11,6,6,15,6,17,11,7,2,1,1,1,2,1,2,1,1,2,3
"4029",23480350,"Andrew Sawaya","5/1/1999 (24 years old)","D/WB (R)","Safa","Lebanese Premier League","LIB","No","5/13/2023","6/30/2025","$0 - $9K","Either","Very Strong","Very Strong","5'6""","136 lbs","40","1",79,103,4,9,6,1,7,1,8,6,6,8,9,6,14,9,11,10,9,8,7,11,5,7,4,7,9,8,4,8,14,14,8,3,15,14,13,2,12,16,10,11,12,12,9,3,8,1,12,13,17,3,1,2,3,1,1,3,2,3,3,2
"4030",37018795,"Fernando Lewis","1/31/1993 (30 years old)","D/WB (R)","OFC","-","ARU","Yes","6/30/2022","-","$0","Right","Reasonable","Very Strong","5'11""","165 lbs","130","12",107,125,8,10,10,9,10,10,10,8,10,12,11,10,11,11,5,11,11,12,11,10,8,12,8,12,12,11,12,12,14,11,11,11,6,13,11,13,11,11,12,11,9,8,12,10,8,1,11,5,10,3,1,1,3,1,3,1,3,3,2,2
"4031",37021991,"Gregor Breinburg","9/16/1991 (31 years old)","DM, M (C)","ADO Den Haag","Keuken Kampioen Divisie","ARU","Yes","8/6/2021","6/30/2025","Not for Sale","Left","Very Strong","Reasonable","5'9""","156 lbs","309","5",104,120,14,11,12,6,10,7,7,3,6,10,13,12,12,13,11,12,11,12,12,13,15,11,14,13,12,14,12,15,11,12,13,8,12,11,12,9,10,10,14,13,13,14,8,12,8,7,13,14,14,3,4,2,3,2,2,1,3,4,1,2
"4032",37007234,"Marlon Pereira","3/26/1987 (36 years old)","D (RL), WB (R)","Steeds Hooger","-","ARU","Yes","7/1/2022","-","$0","Right Only","Weak","Very Strong","5'10""","178 lbs","191","4",75,109,6,11,9,6,10,9,9,10,7,11,11,9,11,9,11,12,10,9,10,10,10,6,7,10,11,11,10,11,10,8,12,9,12,11,8,9,13,14,13,12,6,12,4,10,6,4,9,10,12,3,1,1,3,3,1,3,3,1,1,2
"4033",2000191414,"Kymani Nedd","6/10/2004 (19 years old)","ST (C)","Excelsior","Eredivisie","ARU","Yes","6/13/2022","6/30/2024","$55K - $550K","Right","Weak","Very Strong","6'0""","165 lbs","-","-",65,104,5,3,8,14,6,6,12,5,4,4,7,3,1,11,10,7,4,10,7,11,15,10,8,14,6,6,6,4,12,12,7,8,13,14,6,8,7,17,10,11,10,8,8,8,13,4,10,9,20,4,1,3,2,3,2,3,2,4,2,3
"4034",37089072,"Javier Valerio","1/18/2003 (20 years old)","AM (RL)","VVV-Venlo","Keuken Kampioen Divisie","ARU","Yes","7/1/2018","6/30/2024","$50K - $500K","Right","Reasonable","Very Strong","5'9""","152 lbs","-","-",85,99,8,10,10,11,13,7,8,13,7,8,10,5,7,13,11,10,9,11,8,10,8,11,7,10,7,9,10,14,13,9,15,10,11,8,9,5,15,15,11,12,14,12,14,1,10,7,12,11,19,1,4,4,2,2,3,3,1,1,2,2
"4035",13203798,"Innocent Nshuti","1/31/1998 (25 years old)","AM (L), ST (C)","APR FC","Rwandan Premier Division","RWA","No","7/1/2022","6/30/2024","$0","Left","Very Strong","Reasonable","5'9""","147 lbs","-","-",82,95,6,10,13,8,9,4,8,7,5,6,7,5,3,11,10,6,8,5,6,8,17,11,2,10,5,7,6,12,13,13,12,5,14,13,9,4,11,13,12,10,14,11,6,8,7,4,4,11,19,3,2,1,1,1,2,3,1,2,2,3
"4036",37065752,"Darryl Baly","1/19/1998 (25 years old)","D (LC)","OFC","-","ARU","Yes","6/30/2020","-","$0","Left Only","Very Strong","Weak","5'10""","174 lbs","127","6",85,95,5,9,8,1,7,4,12,6,8,11,9,2,12,9,12,9,10,8,9,15,8,5,8,6,11,9,5,9,11,12,9,7,10,12,11,8,13,18,14,13,9,9,9,7,11,4,8,10,19,3,1,3,3,2,2,3,3,3,1,2
"4037",2000094879,"Benjamin Maria","9/19/2001 (21 years old)","M (L), AM (RL)","DUNO","Dutch Eerste Klasse G","ARU","Yes","1/1/2023","-","$0","Right","Fairly Strong","Very Strong","5'10""","145 lbs","3","-",68,93,6,11,10,10,12,5,5,6,3,3,13,1,5,11,5,10,7,3,6,10,13,11,6,6,3,6,6,11,12,12,2,7,16,12,12,3,13,17,11,10,11,11,12,2,5,3,10,13,9,3,1,3,4,1,1,1,3,2,3,2
"4038",82050132,"Nickenson Paul","8/24/1997 (25 years old)","D (C)","Dakota","Aruban Division di Honor","ARU","Yes","5/1/2023","6/30/2024","$0 - $8K","Right","Reasonable","Very Strong","6'0""","178 lbs","13","-",75,90,2,4,1,3,7,4,9,1,3,12,7,3,12,6,15,9,9,6,13,13,6,7,11,5,13,6,2,7,9,10,7,10,15,9,8,13,12,14,9,12,9,14,6,2,8,4,9,13,8,4,1,2,1,2,2,3,3,2,1,2
"4039",861755,"Gino Mulder","10/9/1987 (35 years old)","AM (R)","Die Haghe","Dutch Eerste Klasse C","ARU","Yes","7/1/2019","-","$0","Left","Very Strong","Reasonable","5'9""","149 lbs","24","6",63,90,7,9,10,5,7,5,3,6,4,4,9,4,1,10,8,9,7,8,8,13,7,8,14,9,4,10,8,9,13,10,10,8,12,12,10,7,11,13,13,9,10,12,5,6,8,3,7,13,8,2,3,2,1,3,2,3,1,3,1,2
"4040",82089092,"Glenbert Croes","6/17/2001 (21 years old)","D/WB/M/AM (R)","Academia Rey","Venezuelan Second Division","ARU","No","2/27/2020","12/31/2025","$20K - $190K","Right","Reasonable","Very Strong","5'11""","132 lbs","16","4",76,90,8,11,13,8,9,6,5,5,6,7,7,3,8,9,10,8,6,4,8,8,17,9,3,11,7,5,6,10,13,13,13,9,7,13,5,3,14,18,9,11,10,9,11,2,11,7,12,10,20,2,1,4,2,3,1,1,1,2,1,3
"4041",2000088056,"Shermar Monticeuex","8/7/2000 (22 years old)","M/AM (R)","Dakota","Aruban Division di Honor","ARU","No","6/15/2020","6/30/2025","$0","Right","Weak","Very Strong","6'2""","165 lbs","-","-",55,89,6,10,6,6,9,4,4,3,1,4,8,2,4,10,14,5,5,2,5,7,9,11,10,9,4,6,4,11,12,12,3,11,15,12,10,4,13,11,12,13,11,11,8,1,5,6,13,11,11,4,2,4,3,1,2,3,3,4,2,2
"4042",82089091,"Joshua Faro","3/30/2001 (22 years old)","GK","RCA","Aruban Division di Honor","ARU","No","7/1/2022","6/30/2025","$0","Right","Strong","Very Strong","6'0""","160 lbs","14","-",61,88,3,1,3,1,2,6,1,1,3,2,11,1,1,3,10,4,8,4,10,13,17,3,12,2,9,6,4,5,9,9,3,6,9,13,4,4,8,13,10,10,11,8,5,13,5,4,13,13,15,8,15,13,7,7,10,12,5,6,6,9
"4043",2000191417,"Mishawn Molina","1/16/2005 (18 years old)","M (C)","Excelsior","Eredivisie","ARU","Yes","6/13/2022","6/30/2025","$110K - $325K","Right","Reasonable","Very Strong","5'7""","134 lbs","-","-",65,87,6,3,2,6,14,3,6,5,1,10,11,1,10,13,7,7,6,4,7,13,14,5,6,7,8,8,7,12,14,12,4,2,11,12,7,2,10,18,9,12,11,11,5,3,9,2,10,13,9,1,2,2,3,2,2,3,1,1,1,1
"4044",2000205514,"Juan Villarraga","5/13/2003 (20 years old)","ST (C)","RCA","Aruban Division di Honor","ARU","No","7/1/2020","6/30/2025","$0","Right","Fairly Strong","Very Strong","6'0""","167 lbs","-","-",60,86,4,3,12,13,11,5,13,6,1,3,6,10,1,8,8,8,2,12,1,7,13,12,2,11,5,5,5,6,7,9,2,9,13,9,8,8,11,10,11,12,12,9,7,13,7,5,20,11,12,1,4,3,4,1,4,2,3,2,1,2
"4045",37069314,"Terence Groothusen","9/16/1996 (26 years old)","ST (C)","Poros Irakleiou","Greek Amateur Lower Division - Irakleio","ARU","Yes","1/17/2023","6/30/2024","$0 - $12K","Right Only","Weak","Very Strong","6'4""","185 lbs","72","4",65,85,5,2,13,11,7,5,13,6,1,4,4,1,1,7,7,7,7,7,5,7,16,7,7,6,6,5,5,5,13,13,6,14,15,13,8,12,8,12,12,12,14,12,11,13,7,2,8,11,8,2,2,3,2,1,2,3,1,3,1,2
"4046",12021968,"Jean-Baptiste Mugiraneza","2/17/1991 (32 years old)","DM, M (C)","Police FC","Rwandan Premier Division","RWA","No","7/1/2022","6/30/2024","$0 - $60K","Right Only","Weak","Very Strong","6'2""","165 lbs","-","-",87,95,7,5,7,9,14,6,7,10,3,7,13,5,12,10,13,10,6,7,9,13,12,5,12,9,12,7,13,12,9,10,7,12,13,8,13,7,12,13,10,11,12,13,5,4,11,4,19,12,9,1,2,1,2,2,3,2,3,3,1,1
"4047",216475,"Jonathan Richard","6/21/1991 (31 years old)","D (C), DM","JOS Watergraafsmeer","Dutch Vierde Divisie A","ARU","Yes","11/8/2021","-","$0","Left","Very Strong","Reasonable","5'11""","160 lbs","183","8",60,84,1,5,1,1,7,4,6,3,4,11,7,1,12,6,15,8,8,6,5,13,7,5,8,5,13,5,6,7,8,8,6,9,12,9,8,5,14,12,11,13,10,10,8,5,5,2,9,12,18,3,2,3,2,1,3,3,3,3,2,2
"4048",2000242944,"Josthan Maduro","8/30/2006 (16 years old)","GK","River Plate (ARU)","Aruban Division di Honor","ARU","No","7/1/2021","6/30/2026","$0","Right","Reasonable","Very Strong","5'11""","147 lbs","-","-",55,82,3,1,2,3,2,7,1,3,1,2,9,2,3,1,10,8,7,4,11,13,9,2,1,2,6,6,5,4,10,10,2,10,11,8,1,4,5,10,8,14,9,10,5,7,5,1,9,11,8,7,9,13,12,5,11,13,5,9,9,8
"4049",73100049,"Harmannus Ridderbos","10/20/1981 (41 years old)","D (C), DM, M (C)","Jong Aruba","Aruban Division Uno","ARU","No","6/14/2021","-","$0","Right","Reasonable","Very Strong","5'11""","158 lbs","-","-",50,80,2,4,2,3,12,5,8,8,1,7,8,1,12,7,6,10,7,7,10,12,15,5,9,6,14,7,7,11,4,4,4,6,16,4,6,4,11,13,8,11,10,10,10,9,11,1,7,11,18,4,2,1,1,1,3,1,3,2,1,1
"4050",2000088052,"Joshua Aguirre","7/2/2001 (21 years old)","AM (C), ST (C)","Nacional (ARU)","Aruban Division di Honor","ARU","No","7/1/2018","6/30/2025","$0","Right","Weak","Very Strong","5'11""","149 lbs","15","6",62,80,5,4,9,12,10,5,7,7,5,3,3,5,2,12,5,6,4,7,6,12,9,12,13,6,6,5,5,7,13,11,6,10,15,13,12,3,8,16,12,10,11,11,8,4,8,3,4,9,14,2,3,1,2,3,2,3,1,1,1,3
"4051",82085144,"Edward Clarissa","3/26/2000 (23 years old)","M/AM (RC)","Maarssen","Dutch Tweede Klasse Zaterdag B","ARU","No","7/1/2022","-","$0","Right","Reasonable","Very Strong","6'1""","169 lbs","-","-",65,80,5,8,8,10,8,6,6,5,6,6,7,2,5,13,5,9,5,8,7,14,15,12,12,8,6,8,13,12,10,10,7,9,6,10,7,4,10,19,12,13,15,10,9,12,6,3,15,12,7,1,2,3,1,3,1,3,1,1,3,3
"4052",2000243190,"Trevor Faro","7/22/2001 (21 years old)","ST (C)","Estrella","Aruban Division di Honor","ARU","No","7/1/2019","6/30/2025","$0","Right","Reasonable","Very Strong","5'10""","152 lbs","12","11",61,79,2,1,12,13,13,2,8,3,1,5,6,3,1,10,5,10,6,9,6,9,9,10,14,11,6,5,5,6,13,10,6,6,9,9,8,4,11,16,9,9,9,11,10,7,12,5,17,12,12,2,1,2,1,3,3,2,2,3,1,3
"4053",37067387,"Walter Bennett","3/18/1997 (26 years old)","M (C)","SC Feyenoord","Dutch Vierde Divisie B","ARU","Yes","7/1/2021","-","$0","Right","Fairly Strong","Very Strong","6'1""","156 lbs","31","-",58,79,4,4,2,5,11,2,4,4,2,8,7,1,6,6,5,7,1,5,5,10,12,5,4,6,6,6,12,11,12,12,5,11,18,12,12,3,10,10,12,10,11,11,12,2,9,7,6,12,13,4,2,1,2,3,2,2,1,2,2,1
"4054",82089075,"Ethan Tromp","1/17/2002 (21 years old)","M/AM (C)","SV Britannia","Aruban Division di Honor","ARU","No","7/1/2021","6/30/2025","$0","Right","Reasonable","Very Strong","5'7""","136 lbs","20","3",63,78,4,6,8,6,10,6,6,7,3,7,7,5,3,14,11,5,5,4,6,10,15,13,1,9,4,7,11,12,14,14,7,7,9,14,7,2,11,16,10,13,9,11,5,12,5,3,10,10,7,2,2,3,2,2,4,3,4,4,2,2
"4055",2000040614,"Javier Jiménez","5/27/2000 (23 years old)","M (R), AM (RC)","Staaken","German Div. North East - North","ARU","Yes","7/1/2022","6/30/2025","$0","Right Only","Weak","Very Strong","6'0""","156 lbs","56","13",63,78,6,9,9,10,10,5,2,2,4,5,11,5,1,13,15,8,4,8,3,10,10,13,12,8,4,7,4,11,13,12,6,9,13,13,6,3,12,11,12,12,11,11,5,7,7,3,20,12,17,3,3,3,3,1,3,2,1,2,3,1
"4056",37005324,"David Abdul","8/17/1989 (33 years old)","AM (RL), ST (C)","Dakota","Aruban Division di Honor","ARU","Yes","7/1/2019","6/30/2024","$0","Right","Fairly Strong","Very Strong","6'0""","147 lbs","20","4",51,77,5,8,5,9,9,5,2,6,5,2,6,4,2,9,10,7,6,6,6,10,12,9,6,10,2,6,7,7,9,10,3,9,14,9,11,4,7,11,10,9,11,10,5,10,5,2,11,14,10,4,3,3,2,2,1,3,1,1,2,2
"4057",2000277728,"Didier Mugisha","1/26/2001 (22 years old)","ST (C)","Police FC","Rwandan Premier Division","RWA","No","7/1/2021","6/30/2025","$0","Right","Reasonable","Very Strong","6'0""","160 lbs","-","-",74,95,6,4,13,13,13,4,13,7,4,6,7,6,2,10,5,9,8,9,6,10,2,10,13,11,7,6,7,7,13,11,7,7,15,12,7,5,11,13,9,10,11,11,14,3,5,2,12,9,10,3,4,4,3,1,2,1,3,1,2,2
"4058",82085156,"Gilbert Bautista","6/15/1998 (24 years old)","GK","La Fama","Aruban Division di Honor","ARU","No","6/15/2020","6/30/2025","$0","Either","Very Strong","Very Strong","6'0""","167 lbs","-","-",53,77,3,2,1,2,4,5,1,2,1,1,6,2,2,4,7,9,12,4,5,9,7,1,1,3,7,7,6,6,12,10,7,6,15,12,6,9,10,17,10,9,10,14,11,8,12,8,4,11,7,7,5,8,9,10,7,14,5,7,10,8
"4059",2000068336,"Fercand Sophia","9/22/1997 (25 years old)","M/AM (C)","Nacional (ARU)","Aruban Division di Honor","ARU","No","7/1/2019","6/30/2025","$0","Right","Fairly Strong","Very Strong","6'0""","160 lbs","-","-",60,75,5,4,7,7,12,5,5,7,1,6,9,1,4,9,7,5,7,9,4,9,12,9,14,7,7,6,11,11,13,12,4,5,10,13,8,4,13,19,13,9,9,10,7,13,10,6,9,8,15,3,3,1,1,2,1,1,2,1,1,3
"4060",82089066,"Mark Jacobs","10/28/1999 (23 years old)","D (LC), DM","Orion","Dutch Vierde Divisie C","ARU","No","6/12/2023","-","$0","Left Only","Very Strong","Weak","6'0""","174 lbs","-","-",65,75,7,10,2,5,8,6,9,6,3,10,8,5,8,5,13,6,8,5,10,14,13,5,9,6,11,7,4,8,10,11,7,9,15,12,11,7,10,10,14,12,11,12,5,10,8,5,8,11,9,3,2,3,2,3,3,2,2,3,1,1
"4061",73100035,"Frederick Gomez","10/25/1984 (38 years old)","D (LC), WB (L), DM, M/AM (L)","RCA","Aruban Division di Honor","ARU","No","6/14/2021","6/30/2024","$0","Left","Very Strong","Reasonable","6'1""","171 lbs","-","-",65,75,5,5,6,13,8,7,8,6,6,8,12,4,12,7,6,11,4,8,7,10,14,7,13,13,10,8,8,9,8,6,8,11,13,8,8,8,10,14,10,12,11,11,11,5,10,5,11,13,16,1,3,3,1,1,2,2,1,3,1,2
"4062",16005398,"Rashidi Gilkes","8/30/1983 (39 years old)","ST (C)","VCS","-","ARU","Yes","7/1/2020","-","$0","Right","Reasonable","Very Strong","6'1""","187 lbs","77","22",60,75,7,3,7,15,14,7,10,8,3,6,7,6,1,9,11,12,3,9,8,11,3,7,10,12,8,7,4,8,7,7,7,14,13,7,5,5,9,17,11,12,9,10,7,14,11,5,11,12,15,1,1,3,3,3,2,2,1,3,2,3
"4063",37072329,"Jayson Halman","11/17/1997 (25 years old)","AM (L)","Noordwijk","Dutch Tweede Divisie","ARU","Yes","1/25/2023","-","$0","Left","Very Strong","Fairly Strong","6'2""","169 lbs","91","16",65,75,6,10,9,7,10,5,4,4,4,4,6,3,2,12,7,4,3,5,3,10,15,14,4,8,3,5,6,7,12,12,5,9,12,12,12,5,13,13,14,10,10,10,8,5,10,8,5,11,8,3,1,3,2,2,3,2,1,1,1,3
"4064",37059576,"Noah Harms","5/5/1997 (26 years old)","D/WB/M (L)","Zwaluwen","Dutch Vierde Divisie B","ARU","Yes","7/1/2022","-","$0","Left","Very Strong","Weak","5'11""","156 lbs","-","-",57,75,5,10,6,1,7,5,6,5,4,7,7,4,10,5,13,4,7,7,7,13,9,9,9,3,5,6,7,7,13,13,6,5,15,13,11,7,11,16,11,8,10,13,6,5,14,1,19,13,11,2,3,3,2,1,3,2,1,2,2,1
"4065",82050128,"Raizel Jansen","3/29/1993 (30 years old)","GK","RCA","Aruban Division di Honor","ARU","No","6/14/2021","6/30/2025","$0","Right","Reasonable","Very Strong","6'3""","176 lbs","-","-",62,75,2,1,2,3,1,3,1,1,2,1,6,1,1,3,6,8,10,5,5,12,13,1,7,3,8,5,4,4,10,9,5,14,12,9,3,5,8,16,9,13,13,10,8,2,6,3,11,13,15,5,11,12,12,7,9,12,5,8,6,12
"4066",73100052,"Erik Santos de Gouveia","8/30/1990 (32 years old)","M/AM (RC)","RCA","Aruban Division di Honor","ARU","Yes","6/14/2021","6/30/2024","$0","Right","Reasonable","Very Strong","5'8""","145 lbs","57","15",62,75,7,5,10,8,12,10,7,9,7,7,12,4,9,9,9,9,6,9,7,11,14,14,13,14,8,8,6,9,9,7,10,4,15,7,14,5,15,13,11,12,11,9,6,16,11,7,11,10,9,2,3,2,4,2,2,3,4,3,1,2
"4067",73100055,"Annuar Kock","12/3/1991 (31 years old)","M/AM (RLC), ST (C)","Estrella","Aruban Division di Honor","ARU","Yes","6/14/2021","6/30/2024","$0 - $1.5K","Right","Fairly Strong","Very Strong","5'10""","156 lbs","62","26",75,75,6,9,6,11,8,11,8,7,1,4,12,11,6,6,9,8,1,10,6,13,11,8,11,14,8,8,8,9,9,11,4,8,8,10,7,5,12,5,10,11,10,13,5,10,5,14,10,11,11,3,2,3,1,3,2,3,1,3,2,2
"4068",2000213797,"Fred Muhozi","4/11/1999 (24 years old)","AM (R), ST (C)","Kiyovu","Rwandan Premier Division","RWA","No","1/29/2022","6/30/2025","$35K - $110K","Either","Very Strong","Very Strong","5'9""","147 lbs","-","-",84,95,5,10,12,5,13,1,7,3,6,6,11,1,4,10,10,8,5,6,6,13,15,15,5,8,3,7,6,8,13,13,7,5,10,13,10,5,11,19,8,10,7,12,5,16,9,7,16,11,9,2,3,3,3,2,2,1,3,3,2,2
"4069",82085006,"Jean-Pierre Heyden","2/25/2000 (23 years old)","D/WB/M/AM (L), ST (C)","Dakota","Aruban Division di Honor","ARU","No","7/1/2018","6/30/2025","$0","Left","Very Strong","Reasonable","5'6""","134 lbs","-","-",60,74,4,7,4,4,10,4,5,1,3,5,6,1,6,9,5,9,6,5,6,8,18,10,11,11,4,5,5,6,12,12,5,3,11,12,9,1,12,13,11,10,12,12,10,12,10,2,9,11,15,1,1,2,2,3,1,4,2,3,1,2
"4070",41026568,"Emile Linkers","9/25/1990 (32 years old)","ST (C)","RBC","Dutch Eerste Klasse E","ARU","Yes","8/6/2022","-","$0","Right","Fairly Strong","Very Strong","5'10""","163 lbs","46","8",55,71,5,7,10,11,13,6,8,3,3,6,7,7,1,12,8,8,4,9,7,8,14,11,13,6,7,6,6,7,12,6,10,4,5,9,11,8,7,12,14,9,12,13,12,8,6,1,9,9,13,1,3,1,2,2,2,2,1,1,1,2
"4071",82050103,"Luis Carlos Croes","9/28/1985 (37 years old)","M (C)","SV Britannia","Aruban Division di Honor","ARU","No","6/14/2021","6/30/2024","$0","Right","Fairly Strong","Very Strong","6'1""","163 lbs","-","-",54,71,6,5,2,5,8,6,6,6,4,11,11,1,5,12,7,8,5,8,7,14,8,8,10,8,7,8,7,13,7,8,6,11,17,5,8,4,9,11,11,10,9,11,7,7,10,8,9,12,10,1,2,2,1,1,2,2,1,1,1,3
"4072",2000088049,"Kenderic Poulina","6/10/1999 (24 years old)","DM, M/AM (C)","River Plate (ARU)","Aruban Division di Honor","ARU","No","6/15/2020","-","$0","Right","Reasonable","Very Strong","5'9""","154 lbs","-","-",57,70,4,1,6,5,10,4,4,4,2,6,7,1,10,8,8,5,6,5,6,12,4,9,10,6,7,6,5,10,12,12,5,6,10,12,9,8,13,18,10,11,10,9,10,13,11,6,11,12,12,1,3,4,2,1,1,2,3,1,3,3
"4073",37007058,"Eric Abdul","2/26/1986 (37 years old)","GK","RCA","Aruban Division di Honor","ARU","Yes","7/1/2021","6/30/2024","$0","Right","Reasonable","Very Strong","6'0""","160 lbs","18","-",65,70,2,1,1,1,3,4,1,3,3,3,9,1,1,1,12,8,15,6,12,13,13,3,8,3,10,7,6,6,5,7,6,10,14,4,2,4,8,13,13,15,9,11,15,1,6,4,9,11,9,9,14,8,12,6,14,14,5,7,8,12
"4074",37085746,"Josh Gross","5/13/1993 (30 years old)","M/AM (LC)","Dakota","Aruban Division di Honor","ARU","Yes","7/1/2021","6/30/2025","$0","Left","Very Strong","Reasonable","5'9""","143 lbs","7","2",65,70,5,10,7,3,7,3,3,6,4,5,7,1,6,10,14,9,2,10,6,9,8,10,6,8,5,6,10,11,13,13,6,6,16,13,11,3,12,17,9,10,10,9,11,8,13,2,9,10,8,1,3,3,2,1,3,3,3,2,2,2
"4075",2000243184,"Jhon Silva","4/7/1995 (28 years old)","ST (C)","RCA","Aruban Division di Honor","ARU","No","1/2/2021","6/30/2025","$0","Right","Fairly Strong","Very Strong","6'2""","171 lbs","26","31",64,70,4,3,13,11,11,5,13,3,1,5,2,3,1,9,10,10,4,9,4,6,14,14,7,8,3,5,6,6,11,11,6,9,12,10,8,6,10,17,11,11,13,10,5,18,6,3,17,10,17,1,1,3,2,2,2,2,1,3,3,1
"4076",2000182710,"Jeremy van Uunen","10/28/1993 (29 years old)","ST (C)","Westlandia","Dutch Vierde Divisie B","ARU","Yes","6/30/2022","-","$0","Right","Strong","Very Strong","6'1""","171 lbs","11","3",61,70,2,4,5,10,10,4,7,3,1,3,2,6,1,7,13,6,6,9,2,10,11,11,8,11,5,4,4,6,12,10,5,11,12,11,11,7,9,14,11,12,9,9,13,3,5,7,10,9,18,1,1,1,3,1,3,3,2,1,1,2
"4077",2000178133,"Alexon Simmons","8/6/2002 (20 years old)","ST (C)","RCA","Aruban Division di Honor","ARU","No","6/13/2022","6/30/2025","$0","Right","Fairly Strong","Very Strong","6'1""","171 lbs","-","-",52,70,4,3,10,12,12,4,12,4,1,4,4,8,1,11,5,4,5,11,5,10,17,12,9,9,5,4,4,5,11,9,5,10,9,10,6,6,10,10,8,8,13,10,13,4,10,8,10,9,15,1,1,2,1,1,2,2,3,2,1,2
"4078",73100051,"Maurice Escalona","1/27/1980 (43 years old)","ST (C)","Bubali","Aruban Division di Honor","ARU","No","6/14/2021","6/30/2024","$0","Right","Fairly Strong","Very Strong","5'9""","152 lbs","41","6",50,70,7,3,5,14,13,7,14,3,4,6,7,7,7,10,11,8,5,12,5,13,15,9,12,15,6,6,7,8,5,5,5,8,14,4,5,5,8,15,11,11,9,10,10,4,13,3,9,10,14,2,3,2,1,1,2,1,3,1,2,3
"4079",13185389,"Olivier Niyonzima","12/20/1993 (29 years old)","DM, M (C)","Rayon Sports","Rwandan Premier Division","RWA","No","6/15/2020","6/30/2025","$0","Right","Reasonable","Very Strong","5'10""","156 lbs","-","-",89,95,7,4,5,10,15,8,6,7,2,10,15,4,7,15,12,10,9,11,10,14,16,5,11,9,7,14,14,10,7,10,15,5,8,10,10,5,14,15,13,11,13,13,7,11,12,7,13,11,14,1,3,2,2,1,3,1,2,2,4,3
"4080",73100058,"Jean-Luc Bergen","12/8/1988 (34 years old)","ST (C)","RCA","Aruban Division di Honor","ARU","No","6/14/2021","6/30/2024","$0","Right","Reasonable","Very Strong","5'9""","149 lbs","-","-",50,68,5,2,10,13,9,3,10,5,1,3,4,6,1,7,12,8,7,6,6,6,12,8,4,13,6,5,6,6,8,9,6,6,15,9,6,6,10,13,10,11,11,10,10,4,7,7,20,10,7,1,4,3,3,1,2,1,1,1,2,3
"4081",73100056,"Rensy Barradas","10/21/1990 (32 years old)","AM (L), ST (C)","TAC '90","Dutch Eerste Klasse C","ARU","Yes","7/1/2021","-","$0","Left","Very Strong","Reasonable","5'8""","154 lbs","26","8",66,68,6,9,11,11,12,6,7,7,4,4,9,3,4,10,5,8,3,11,6,13,11,9,12,10,4,6,5,6,12,10,9,5,7,11,10,8,8,11,13,10,13,13,7,8,10,6,12,10,17,3,1,1,1,1,1,1,4,2,2,4
"4082",89068676,"Franklin Lewis","4/19/1999 (24 years old)","AM (C)","FC Lisse","Dutch Tweede Divisie","ARU","Yes","7/1/2022","-","$0","Right","Weak","Very Strong","6'4""","171 lbs","87","7",58,68,5,4,4,5,10,5,4,3,4,3,8,1,1,10,6,7,4,8,6,8,14,12,5,6,6,6,7,7,13,13,6,10,15,13,10,5,10,11,11,11,11,12,11,9,13,3,20,12,11,3,2,1,1,2,3,3,2,2,3,3
"4083",82085010,"Liomar Croes","2/12/1996 (27 years old)","M (C)","Dakota","Aruban Division di Honor","ARU","No","6/15/2020","6/30/2025","$0","Right","Fairly Strong","Very Strong","5'10""","154 lbs","-","-",52,68,4,4,2,4,11,4,1,7,1,12,8,3,6,6,7,5,3,6,5,12,2,5,9,5,5,4,9,8,12,12,5,5,5,12,12,4,11,13,10,13,11,10,5,1,13,3,20,9,20,2,3,2,1,1,1,3,2,3,1,3
"4084",82084979,"Ricky Hodge","6/5/1996 (27 years old)","AM (C), ST (C)","Dakota","Aruban Division di Honor","ARU","No","6/15/2020","8/31/2023","$0","Right","Fairly Strong","Very Strong","5'10""","160 lbs","-","-",65,67,5,6,8,10,7,5,7,7,5,3,4,7,1,7,6,8,5,12,6,9,6,8,12,10,5,5,5,7,13,13,6,6,6,13,12,6,12,15,10,12,14,13,7,8,6,8,13,12,13,1,2,2,2,1,3,3,2,3,2,2
"4085",29214946,"Chris Forino","4/26/2000 (23 years old)","D (C)","Wycombe","Sky Bet League One","LCA","Yes","12/11/2021","6/30/2024","$70K - $700K","Right","Weak","Very Strong","6'4""","182 lbs","66","6",98,125,6,4,8,4,11,6,14,4,7,11,9,7,12,8,8,8,11,10,9,9,10,3,8,6,12,12,6,12,14,12,12,15,14,14,11,12,5,10,11,14,10,11,4,8,8,7,9,11,5,2,1,2,3,3,1,1,1,1,1,2
"4086",29086222,"Janoi Donacien","11/3/1993 (29 years old)","D (RLC), WB (R)","Ipswich","Sky Bet Championship","LCA","No","3/4/2023","6/30/2024","$130K - $1.3M","Right Only","Weak","Very Strong","6'2""","165 lbs","283","1",110,121,3,10,10,4,10,3,13,4,13,14,9,7,14,9,12,13,11,9,10,9,12,2,10,7,13,13,8,14,12,13,11,13,13,13,14,13,13,11,8,12,9,9,6,10,6,6,13,12,9,2,1,1,3,2,2,4,2,2,3,2
"4087",29139360,"Reeco Hackett","1/9/1998 (25 years old)","WB (L), AM (RLC), ST (C)","Portsmouth","Sky Bet League One","LCA","No","1/8/2020","6/30/2025","$16K - $150K","Left","Very Strong","Reasonable","6'3""","160 lbs","141","19",103,115,2,9,12,9,9,11,11,11,3,5,8,12,7,9,12,9,8,9,6,8,12,13,4,11,7,11,9,11,13,14,8,13,12,13,14,13,13,9,10,12,7,10,11,9,7,5,11,10,7,4,1,4,3,3,2,2,3,1,1,3
"4088",28059138,"Dominic Poleon","9/7/1993 (29 years old)","AM (RL), ST (C)","Ebbsfleet","Vanarama National League","LCA","No","2/9/2021","6/30/2025","$26K - $250K","Right Only","Weak","Very Strong","5'10""","180 lbs","302","88",84,115,5,9,12,12,9,5,10,10,2,4,8,9,7,10,9,11,7,11,8,7,9,13,5,11,7,8,8,11,14,11,11,9,13,14,10,9,12,10,8,7,12,10,6,8,9,15,9,11,16,1,2,1,1,1,3,1,1,1,2,1
"4089",82000301,"Sheldon Emmanuel","11/25/1979 (43 years old)","D (LC), WB (L), DM, M (LC)","AS Samaritaine","Martinican Trophee Gerard Janvion R1","LCA","No","6/14/2021","6/30/2024","$1.5K - $5K","Left","Very Strong","Reasonable","6'4""","182 lbs","-","-",70,111,5,10,5,8,11,8,9,9,8,12,11,5,10,10,14,13,8,10,9,13,12,6,15,8,11,9,8,7,5,5,5,14,10,5,5,5,11,10,12,17,9,12,7,11,5,6,20,11,15,3,3,3,2,1,3,1,4,3,2,1
"4090",13225548,"Aime Placide","8/6/1999 (23 years old)","D (C)","APR FC","Rwandan Premier Division","RWA","No","1/2/2020","7/31/2024","$0","Right","Fairly Strong","Very Strong","6'0""","167 lbs","-","-",75,95,4,1,5,4,8,1,14,1,1,14,8,1,14,4,9,12,9,8,11,6,2,5,8,6,11,7,6,8,13,10,8,9,12,11,5,7,10,19,11,11,14,12,15,16,8,5,11,10,9,3,2,4,1,2,2,2,2,2,3,1
"4091",29102058,"Terell Thomas","10/18/1995 (27 years old)","D (C)","Charlton","Sky Bet League One","LCA","No","9/7/2022","6/30/2025","$30K - $300K","Right","Strong","Very Strong","6'3""","182 lbs","167","6",102,110,5,8,11,5,10,4,13,5,9,11,10,4,12,10,11,12,14,10,11,11,14,3,9,6,11,10,9,13,11,10,9,14,15,11,13,12,9,15,11,14,12,14,12,8,7,3,12,12,11,2,1,2,3,2,3,2,1,1,1,2
"4092",82084819,"Vino Barclett","10/12/1999 (23 years old)","GK","Cavalier","Jamaican Premier League","LCA","No","1/1/2022","6/30/2026","$0","Right Only","Weak","Very Strong","5'11""","160 lbs","37","-",90,105,2,2,2,2,3,6,2,3,1,2,12,4,3,4,9,10,12,10,10,10,6,3,12,1,15,10,9,9,15,11,10,11,10,14,6,8,13,17,10,12,10,10,10,4,9,4,14,13,15,8,7,12,10,11,9,10,6,8,11,12
"4093",2000289420,"Elijah Joseph","11/17/2005 (17 years old)","M/AM (C)","DCYO","SLFA Second Division","LCA","No","6/13/2022","-","$0","Right","Reasonable","Very Strong","6'1""","156 lbs","-","-",66,104,3,1,7,9,13,4,4,6,1,4,11,2,5,11,15,4,7,5,6,13,16,11,9,9,2,6,13,11,13,13,6,10,12,13,8,3,12,17,10,12,8,10,10,9,5,8,6,10,10,1,2,2,3,2,1,3,3,3,2,2
"4094",82084505,"Melvin Doxilly","1/2/1998 (25 years old)","D (RC), DM, M (C)","Mount Pleasant FC","Jamaican Premier League","LCA","No","9/30/2022","6/30/2025","$0","Right","Weak","Very Strong","5'10""","171 lbs","42","1",86,99,5,10,5,4,9,8,10,6,1,9,10,2,11,9,9,11,9,8,9,10,5,5,5,8,10,9,10,10,11,13,9,10,7,11,15,14,17,11,10,12,11,14,7,6,6,7,13,13,18,3,2,4,1,2,1,2,3,3,2,2
"4095",2000083404,"Dahmanii Berthier","3/3/2004 (19 years old)","M/AM (C), ST (C)","All Stars (LCA)","SLFA First Division","LCA","No","1/1/2020","-","$0","Right Only","Weak","Very Strong","6'2""","169 lbs","8","3",60,99,5,4,10,12,9,3,8,7,1,5,10,6,7,8,12,8,7,9,7,10,12,14,1,11,7,7,7,11,11,13,11,14,13,13,7,5,8,20,13,13,10,10,8,12,5,6,7,12,14,3,3,1,2,2,1,3,3,3,2,3
"4096",30001506,"Kurt Frederick","4/27/1991 (32 years old)","D/WB/M/AM (L)","Grenades","Antigua and Barbuda Premier Division","LCA","No","9/25/2022","6/30/2024","$0 - $7K","Left","Very Strong","Reasonable","5'10""","152 lbs","45","4",87,93,9,12,7,15,11,9,9,7,7,10,12,6,10,11,10,11,9,11,11,12,14,12,12,13,11,10,10,11,12,10,10,9,8,10,8,12,14,13,10,14,9,15,7,9,6,5,11,13,13,2,3,2,1,4,3,1,2,3,2,2
"4097",82071667,"Antonio Joseph","9/8/1996 (26 years old)","M/AM (C), ST (C)","Platinum (LCA)","SLFA First Division","LCA","No","1/1/2021","12/31/2024","$500 - $3.5K","Right","Reasonable","Very Strong","5'9""","149 lbs","13","9",80,92,3,5,8,10,10,6,9,6,6,6,10,5,4,9,14,9,1,10,7,12,2,11,11,11,9,8,8,9,14,14,8,4,13,14,14,7,11,18,11,13,11,11,12,8,5,4,10,10,15,2,3,1,2,3,3,3,2,2,2,3
"4098",43111343,"Zaine Pierre","9/21/1993 (29 years old)","DM, M (C)","Valley Soccer","SLFA Third Division","LCA","No","1/2/2023","-","$0","Left Only","Very Strong","Weak","5'10""","160 lbs","27","-",80,92,8,11,11,7,12,6,10,10,9,10,13,7,10,13,10,10,10,12,7,8,12,11,8,8,11,12,11,12,12,12,8,9,15,11,10,8,13,13,11,14,14,15,13,3,11,8,11,11,17,1,2,2,4,1,3,2,2,1,3,1
"4099",2000083148,"Keegan Caull","3/20/2004 (19 years old)","M/AM (C), ST (C)","Europa Point","Gibraltar Football League","LCA","No","6/12/2023","6/30/2024","$0","Right","Reasonable","Very Strong","5'9""","152 lbs","12","5",60,92,6,6,10,10,8,6,8,8,1,6,7,3,2,9,13,4,7,6,7,8,13,11,10,12,8,7,8,8,14,11,7,6,7,14,7,5,9,18,12,15,11,11,13,13,5,1,11,12,9,1,2,2,1,2,2,3,3,1,3,3
"4100",2000289429,"Saviola Elva","6/19/2001 (21 years old)","ST (C)","Platinum (LCA)","SLFA First Division","LCA","No","1/1/2022","12/31/2025","$1.5K - $5K","Right","Reasonable","Very Strong","6'2""","174 lbs","-","-",70,90,5,2,8,12,10,5,12,4,4,5,3,8,4,5,5,7,7,12,6,9,17,6,7,12,6,5,4,6,12,12,6,11,11,12,4,8,12,19,9,10,10,10,8,13,10,6,17,11,17,2,3,2,2,3,1,1,1,2,1,3
"4101",13109464,"Eric Iradukunda","11/2/1994 (28 years old)","D/M/AM (R)","Police FC","Rwandan Premier Division","RWA","No","6/1/2020","6/30/2024","$0 - $100K","Right","Reasonable","Very Strong","6'2""","169 lbs","-","-",85,95,6,9,9,11,9,6,6,2,6,7,11,4,8,7,7,6,8,6,8,9,12,7,10,9,7,8,7,8,13,13,8,11,12,13,13,5,16,10,10,8,13,11,5,1,5,3,12,10,9,2,2,2,3,4,3,4,1,3,2,1
"4102",2000202040,"Sherman Augustin","10/20/2002 (20 years old)","DM, M (C)","Grenades","Antigua and Barbuda Premier Division","LCA","No","1/1/2023","6/30/2025","$0 - $6K","Right","Reasonable","Very Strong","5'9""","165 lbs","-","-",70,90,5,6,3,7,13,1,6,8,4,8,6,2,13,9,7,7,8,6,5,13,8,6,1,7,10,7,12,12,8,11,4,7,12,11,10,6,13,18,12,12,10,10,7,15,12,6,10,8,14,1,3,1,2,3,3,2,3,3,2,2
"4103",82071605,"Otev Lawrence","12/21/1996 (26 years old)","D (RC), WB (R)","Monchy Utd","SLFA First Division","LCA","No","1/1/2021","-","$0","Right","Fairly Strong","Very Strong","6'0""","171 lbs","18","-",87,90,5,11,8,4,11,3,12,4,4,15,9,1,14,10,5,11,10,10,8,8,12,5,10,9,9,9,9,10,12,8,10,9,14,11,13,10,14,16,10,8,9,13,15,11,7,8,10,11,20,1,2,4,3,1,3,2,1,2,1,1
"4104",20048617,"Peter Pearson","12/17/1995 (27 years old)","DM, M (C)","Ennepetal","German Div. Westphalia","LCA","No","1/6/2023","6/30/2025","$45K - $140K","Right","Reasonable","Very Strong","5'5""","141 lbs","74","4",82,88,6,6,4,9,10,8,8,10,7,9,9,4,15,9,15,10,14,10,10,10,5,5,3,9,10,7,9,13,10,13,13,5,13,11,13,7,10,11,12,12,9,11,7,15,13,6,20,10,7,3,2,1,2,3,4,3,2,1,2,2
"4105",28085947,"Kieran Monlouis","4/15/1996 (27 years old)","M (RC)","Ebbsfleet","Vanarama National League","LCA","No","6/30/2021","6/30/2024","$1K - $8K","Right Only","Weak","Very Strong","6'2""","156 lbs","106","8",62,88,4,5,6,5,9,5,5,7,4,6,11,4,8,7,14,5,2,7,5,8,10,5,14,7,7,6,7,13,13,13,6,12,12,13,13,6,13,10,10,10,11,12,5,7,9,2,9,11,7,2,2,2,3,2,2,1,1,1,2,2
"4106",82084911,"Keeroy Lionel","8/26/1999 (23 years old)","D/WB/M/AM (L)","Caledonia Utd","TT Premier Football League Tier 1","LCA","No","1/1/2023","6/30/2025","$0 - $2K","Left","Very Strong","Fairly Strong","5'11""","158 lbs","-","-",75,87,5,10,9,10,9,7,7,4,7,9,10,5,9,7,14,9,8,7,8,14,11,6,8,12,9,8,5,9,12,13,8,11,12,12,5,5,10,12,13,11,12,11,11,6,6,3,10,11,12,3,3,1,2,2,2,4,1,3,3,3
"4107",2000289329,"Cassius Joseph","1/25/1998 (25 years old)","M/AM (C)","Northern Utd","SLFA First Division","LCA","No","8/1/2020","-","$0","Right","Fairly Strong","Very Strong","5'4""","119 lbs","-","-",70,85,6,6,8,7,13,4,6,7,3,6,9,6,5,13,10,11,6,7,2,13,11,14,11,11,8,7,6,5,13,13,7,1,15,13,10,1,13,11,13,11,10,13,6,14,10,8,13,13,19,1,3,3,3,2,2,3,1,1,1,3
"4108",2000201733,"Shanoi Evans","1/17/1995 (28 years old)","D (RC), DM","Arnett Gardens","Jamaican Premier League","LCA","No","10/1/2022","6/30/2024","$0","Right Only","Weak","Very Strong","5'9""","167 lbs","64","1",79,85,4,9,3,6,9,6,7,7,4,8,8,1,10,7,15,9,9,7,9,14,19,5,3,7,11,8,7,9,13,13,8,4,14,12,14,8,11,19,12,11,12,12,7,10,14,6,9,11,18,1,2,3,2,3,1,2,4,2,1,1
"4109",82071805,"Lester Joseph","2/23/1993 (30 years old)","M/AM (R)","Portmore Utd","Jamaican Premier League","LCA","No","10/1/2022","6/30/2026","$0","Right","Reasonable","Very Strong","5'10""","158 lbs","15","-",84,84,8,11,8,8,8,6,7,7,6,4,8,1,5,13,13,8,8,8,7,12,6,13,12,8,6,7,6,8,13,10,7,4,8,13,13,6,12,12,9,11,11,8,9,1,8,4,11,10,18,1,4,1,1,1,1,3,1,2,4,4
"4110",2000289332,"Brandon Sandiford","9/20/2003 (19 years old)","M/AM (C)","GMC Utd","SLFA Second Division","LCA","No","1/1/2023","-","$0","Right","Reasonable","Very Strong","5'8""","143 lbs","-","-",69,80,6,6,11,10,13,6,6,9,6,3,11,6,6,14,7,5,3,10,5,9,14,15,9,9,8,7,13,10,12,12,7,2,12,14,5,4,9,18,13,10,13,10,11,7,15,5,8,12,7,3,4,1,2,1,1,2,2,2,3,3
"4111",2000261394,"Donovan Jean Baptiste","6/27/1996 (26 years old)","ST (C)","Grenades","Antigua and Barbuda Premier Division","LCA","No","1/1/2023","6/30/2025","$0 - $4K","Right","Reasonable","Very Strong","5'10""","160 lbs","9","10",70,80,5,1,13,13,13,6,12,2,1,6,7,8,2,8,8,8,6,13,6,8,11,8,12,10,5,6,2,7,13,13,6,7,11,13,5,8,12,16,12,10,10,11,10,10,5,5,10,13,16,3,2,2,1,1,3,3,2,1,1,3
"4112",13167681,"Jacques Tuyisenge","9/22/1991 (31 years old)","AM (RL), ST (C)","AS Kigali","Rwandan Premier Division","RWA","No","8/1/2022","6/30/2023","$3.5K - $10K","Right Only","Weak","Very Strong","5'11""","154 lbs","105","52",99,100,9,8,13,14,12,9,15,6,9,7,14,5,7,9,5,13,9,9,10,15,6,7,5,14,9,9,11,11,9,15,9,8,15,12,14,8,9,13,11,9,10,12,15,14,9,7,12,10,14,2,2,2,3,1,1,3,1,2,1,1
"4113",13176648,"Heritier Ahishakiye","4/28/1998 (25 years old)","GK","APR FC","Rwandan Premier Division","RWA","No","7/1/2019","6/30/2025","$0","Right","Fairly Strong","Very Strong","6'3""","174 lbs","-","-",81,95,5,1,2,3,3,8,1,1,1,3,8,3,3,2,12,10,11,7,11,13,18,3,5,3,10,4,6,6,12,16,7,14,15,11,6,6,10,14,11,11,12,11,11,1,6,5,10,11,11,8,7,13,10,10,8,8,10,9,9,13
"4114",82073639,"Noah Nicholas","3/27/1999 (24 years old)","M/AM (L), ST (C)","Platinum (LCA)","SLFA First Division","LCA","No","1/1/2019","12/31/2025","$0 - $1.5K","Left","Very Strong","Reasonable","5'11""","154 lbs","20","6",70,80,7,10,10,8,8,5,6,6,3,5,9,2,1,8,10,11,5,8,6,11,17,9,5,9,5,6,6,7,12,12,6,4,15,12,12,3,9,19,12,12,12,13,14,3,8,4,5,9,18,3,3,1,2,1,3,3,3,3,3,1
"4115",82084898,"Jevick McFarlane","8/7/1996 (26 years old)","ST (C)","Portmore Utd","Jamaican Premier League","LCA","No","7/1/2020","6/30/2024","$0","Right","Weak","Very Strong","6'2""","165 lbs","39","6",75,80,6,3,8,10,12,6,13,3,2,5,7,5,2,10,11,12,2,8,5,6,4,10,1,11,6,6,7,7,13,13,7,9,14,13,11,4,8,16,14,7,11,12,6,1,5,12,11,10,12,1,1,3,3,2,3,3,1,3,3,3
"4116",82050356,"Eden Charles","10/29/1993 (29 years old)","M (C), AM (RC), ST (C)","Caledonia Utd","TT Premier Football League Tier 1","LCA","No","1/1/2023","6/30/2024","$0 - $5K","Right","Reasonable","Very Strong","6'1""","165 lbs","17","1",75,80,2,6,8,12,13,4,7,8,1,7,11,4,6,12,13,11,7,7,8,8,12,12,9,9,5,7,11,8,13,11,7,13,9,13,12,4,11,20,9,13,8,11,11,5,13,3,11,11,11,2,1,3,2,1,3,1,3,1,3,2
"4117",30001496,"Emmery Edward","10/11/1994 (28 years old)","D (C), DM","Valley Soccer","SLFA Third Division","LCA","No","6/15/2020","-","$0","Right","Reasonable","Very Strong","6'4""","180 lbs","-","-",60,80,3,1,1,5,3,5,8,2,2,8,4,3,13,7,11,8,7,6,8,13,13,5,11,6,13,5,2,7,8,8,6,10,15,7,6,6,12,7,6,9,11,15,5,11,15,11,9,16,7,3,3,3,3,1,2,1,3,3,1,1
"4118",2000292215,"Jahlil Evans","9/3/2004 (18 years old)","M/AM (C)","Chapelton Maroons","Jamaican Football Federation Championship","LCA","No","2/1/2023","6/30/2025","$0","Right","Weak","Very Strong","5'7""","143 lbs","8","-",57,79,7,7,6,9,11,7,1,10,2,4,12,6,9,8,15,8,4,6,5,14,2,9,1,6,8,8,10,9,9,11,5,5,14,9,5,5,11,12,13,12,11,12,9,8,7,7,14,10,8,3,1,1,3,2,3,2,2,3,3,2
"4119",30001502,"Shawn Evans","1/17/1995 (28 years old)","D/WB/M/AM (L)","Empire Club","BFA Digicel Premier League","LCA","No","7/1/2018","-","$0","Left","Very Strong","Reasonable","6'0""","156 lbs","-","-",70,78,8,11,6,6,9,6,6,5,5,7,5,2,5,7,9,10,6,8,8,11,16,7,3,13,5,8,8,8,13,13,6,10,13,13,12,4,14,19,13,11,11,9,14,4,6,6,10,11,15,1,1,1,1,2,1,1,4,3,2,2
"4120",82084824,"Andrus Remy","9/1/1993 (29 years old)","AM (RL), ST (C)","Grenades","Antigua and Barbuda Premier Division","LCA","No","1/1/2020","6/30/2023","$0","Right","Reasonable","Very Strong","5'10""","156 lbs","22","15",75,78,3,8,12,9,13,4,9,5,4,7,10,4,6,8,10,9,7,8,8,13,8,13,12,10,7,8,7,12,11,11,10,6,7,10,12,10,10,17,13,12,12,10,7,15,5,4,17,11,7,1,2,2,3,2,1,3,1,3,1,3
"4121",82084918,"Aaron Richard","2/10/1999 (24 years old)","M/AM (R), ST (C)","Monchy Utd","SLFA First Division","LCA","No","7/30/2020","-","$0","Right","Reasonable","Very Strong","5'4""","127 lbs","-","-",70,78,6,9,10,9,12,6,8,4,5,6,12,2,2,7,7,7,3,10,4,11,14,7,11,9,6,7,8,8,13,13,7,2,10,13,6,4,8,15,10,12,11,10,12,5,9,3,19,12,14,3,3,4,3,3,2,2,2,2,2,2
"4122",30001552,"Pernal Williams","8/15/1991 (31 years old)","D/WB/M/AM (R)","Aiglon","Martinican Trophee Gerard Janvion R1","LCA","No","6/14/2021","6/30/2025","Not for Sale","Right","Reasonable","Very Strong","5'3""","125 lbs","-","-",75,77,6,9,6,9,8,7,7,7,7,8,9,1,9,10,5,7,8,7,6,14,9,9,9,11,6,8,9,9,9,14,3,1,12,10,14,3,15,20,10,9,11,13,5,8,10,3,11,10,15,3,2,2,3,3,2,3,2,1,1,4
"4123",2000202037,"Tev Lawrence","11/30/1998 (24 years old)","ST (C)","Grenades","Antigua and Barbuda Premier Division","LCA","No","8/15/2022","6/30/2025","$1.5K - $5K","Right","Weak","Very Strong","5'11""","160 lbs","5","4",71,77,6,6,8,13,13,6,9,5,3,6,5,4,2,10,11,9,7,10,7,13,13,10,5,10,6,6,7,7,13,13,6,6,10,13,6,6,9,13,11,12,11,14,9,14,6,4,17,11,15,3,3,1,3,4,1,3,2,2,2,3
"4124",2000163436,"Marc Nkubana","6/30/1999 (23 years old)","D/WB (R)","Police FC","Rwandan Premier Division","RWA","No","8/1/2022","6/30/2025","$0","Right","Reasonable","Very Strong","6'0""","160 lbs","-","-",76,95,8,12,5,7,9,5,9,7,2,10,9,3,11,7,9,12,9,8,7,10,11,5,1,7,12,8,8,9,14,13,8,11,12,14,7,5,15,11,10,13,11,11,5,6,5,7,10,11,11,2,1,1,2,3,1,2,2,3,2,1
"4125",82084839,"Alvinus Myers","6/3/1996 (27 years old)","D (C), DM","Portmore Utd","Jamaican Premier League","LCA","No","7/1/2020","6/30/2025","$0","Right Only","Weak","Very Strong","6'4""","176 lbs","48","-",73,77,4,5,4,5,8,6,10,3,3,10,6,1,10,5,15,6,9,5,10,13,3,5,11,6,10,6,6,8,13,13,7,14,10,13,4,6,14,17,12,11,11,11,10,11,10,3,18,15,15,4,1,1,3,3,2,3,3,3,2,3
"4126",2000201908,"Ridel Stanislas","9/7/1997 (25 years old)","M (L), AM (RL), ST (C)","Grenades","Antigua and Barbuda Premier Division","LCA","No","8/16/2022","6/30/2025","$0 - $6K","Left","Very Strong","Reasonable","5'9""","160 lbs","-","-",73,77,8,11,11,8,12,6,7,8,1,3,12,2,2,9,9,9,4,7,5,13,15,13,10,9,5,7,6,8,10,9,10,3,15,12,11,10,10,15,12,14,12,10,11,18,5,1,10,16,15,1,1,2,3,1,2,1,2,2,3,2
"4127",82084913,"Zacherinus Simon","3/28/1998 (25 years old)","M/AM (R)","Challengers","SLFA Third Division","LCA","No","6/15/2020","12/31/2023","$0","Right","Reasonable","Very Strong","5'8""","141 lbs","-","-",62,76,5,9,8,9,9,5,5,6,1,5,8,1,4,10,15,7,7,9,6,11,4,10,12,9,5,6,5,10,13,13,6,6,12,13,8,3,11,10,11,12,10,13,5,13,14,6,18,11,15,3,1,2,2,2,1,2,1,2,2,2
"4128",82050355,"Jamil Joseph","1/17/1991 (32 years old)","D (C), ST (C)","VSADC","SLFA First Division","LCA","No","6/14/2021","12/31/2024","Not for Sale","Right","Reasonable","Very Strong","6'1""","178 lbs","-","-",72,76,3,5,7,10,9,6,12,3,4,11,6,5,9,6,15,12,9,6,7,12,12,7,9,7,11,5,2,6,9,6,6,8,13,6,9,11,8,19,11,11,11,12,9,15,10,5,13,11,16,2,1,2,3,3,2,2,3,3,1,1
"4129",2000083321,"Shaquille Degazon","8/1/1997 (25 years old)","ST (C)","VSADC","SLFA First Division","LCA","No","6/15/2020","12/31/2024","$1.5K - $5K","Right","Reasonable","Very Strong","5'10""","154 lbs","16","11",70,75,6,5,11,13,13,6,9,3,1,3,7,9,2,13,11,9,6,11,7,8,6,13,14,10,7,6,3,7,10,13,7,4,16,12,12,8,11,12,11,12,9,10,5,1,15,6,13,12,18,3,2,3,2,4,3,3,2,1,1,2
"4130",29236490,"Nahum Melvin-Lambert","10/21/2002 (20 years old)","ST (C)","Reading","Sky Bet League One","LCA","No","7/1/2019","6/30/2026","$26K - $275K","Right","Weak","Very Strong","6'2""","176 lbs","25","4",72,75,7,8,8,11,8,7,8,5,4,6,7,3,1,9,12,9,12,8,6,12,10,8,9,9,6,8,6,9,13,10,9,9,12,12,11,9,9,20,8,8,7,11,13,8,5,6,9,13,12,2,2,3,4,2,1,2,4,2,2,1
"4131",2000164239,"Sherwin Simon","4/28/2000 (23 years old)","ST (C)","Northern Utd","SLFA First Division","LCA","No","1/1/2020","-","$0","Right","Weak","Very Strong","6'0""","158 lbs","8","7",65,75,4,2,9,13,11,5,5,5,2,5,7,5,1,11,8,9,5,10,6,8,9,11,14,11,4,6,6,11,13,10,8,6,13,12,13,4,11,10,11,11,10,9,14,16,8,3,11,13,9,2,3,2,2,2,3,1,1,2,1,1
"4132",82071671,"Antonius Myers","7/26/1996 (26 years old)","DM, M (C)","Uptown Rebels","SLFA First Division","LCA","No","6/15/2020","-","$0","Right","Reasonable","Very Strong","5'10""","149 lbs","-","-",60,75,4,1,3,5,11,5,5,12,4,6,9,1,12,6,6,9,3,5,7,13,5,5,9,4,11,6,8,11,13,12,6,5,12,11,13,3,14,13,12,11,11,12,7,16,12,1,9,9,19,1,2,2,1,1,4,1,3,1,1,3
"4133",82084844,"Gregson President","1/30/1996 (27 years old)","M/AM (C)","Platinum (LCA)","SLFA First Division","LCA","No","7/1/2020","12/31/2024","$0 - $6K","Right","Reasonable","Very Strong","6'0""","158 lbs","8","5",74,74,3,3,7,7,12,5,4,12,5,6,8,1,5,9,9,6,7,8,6,10,14,10,8,10,7,6,12,11,12,12,6,8,13,12,11,3,12,12,10,13,10,9,6,12,15,4,7,11,13,1,1,2,3,2,1,1,3,1,1,3
"4134",2000083319,"Kennedy Duncan","10/13/1991 (31 years old)","GK","VSADC","SLFA First Division","LCA","No","6/14/2021","12/31/2024","Not for Sale","Right","Reasonable","Very Strong","5'10""","156 lbs","16","-",72,72,5,1,1,1,1,8,1,2,1,3,8,3,2,1,12,8,9,7,6,10,16,1,15,1,11,8,6,12,14,6,6,7,8,12,7,5,10,20,12,18,12,12,7,4,5,6,11,11,19,10,12,12,5,8,11,14,15,9,14,12
"4135",2000214949,"Fiston Ishimwe","5/23/2000 (23 years old)","M/AM (C)","APR FC","Rwandan Premier Division","RWA","No","8/1/2022","6/30/2025","$0","Right","Reasonable","Very Strong","5'6""","134 lbs","-","-",75,95,7,7,9,11,12,7,6,6,2,9,14,2,9,13,9,9,4,9,8,13,12,12,10,8,9,8,9,12,11,14,5,5,12,12,7,2,13,18,11,13,14,11,14,3,9,8,9,12,18,1,3,1,1,3,1,1,2,1,1,3
"4136",2000288777,"Devone St. Prix","9/1/1997 (25 years old)","GK","El Niños","SLFA First Division","LCA","No","1/1/2023","-","$0","Right","Reasonable","Very Strong","6'6""","189 lbs","-","-",68,72,2,2,1,3,3,6,1,2,3,1,8,2,3,4,10,10,13,7,11,7,5,1,13,2,6,7,6,6,12,6,7,14,15,12,5,9,11,16,9,10,12,10,5,4,6,1,19,13,14,6,5,8,9,11,12,14,5,11,9,14
"4137",82071829,"Erickson Reid","2/20/1995 (28 years old)","ST (C)","Young Stars (LCA)","SLFA Third Division","LCA","No","6/15/2020","-","$0","Right","Weak","Very Strong","6'2""","169 lbs","-","-",62,70,5,2,7,10,11,4,9,5,1,3,5,5,1,6,12,11,7,5,6,10,5,7,12,12,6,5,6,6,13,13,6,13,14,13,11,5,9,14,14,12,9,13,7,7,10,3,10,12,14,1,3,2,1,2,2,2,1,3,2,2
"4138",82073630,"Jamie Prospere","3/26/1999 (24 years old)","M/AM (L), ST (C)","Young Stars (LCA)","SLFA Third Division","LCA","No","7/1/2022","-","$0","Left","Very Strong","Reasonable","5'11""","163 lbs","-","-",63,70,5,6,9,12,10,4,8,6,4,3,6,5,1,8,5,8,2,9,5,7,13,8,8,12,4,6,4,7,13,12,3,9,10,13,12,9,12,18,10,12,12,12,9,13,11,6,5,9,17,1,2,1,1,2,3,3,2,3,3,1
"4139",2000289316,"Leaus Henville","12/7/1996 (26 years old)","AM (R)","Platinum (LCA)","SLFA First Division","LCA","No","1/1/2020","12/31/2024","$0 - $4.5K","Right","Fairly Strong","Very Strong","5'6""","130 lbs","-","-",66,68,5,10,7,9,11,5,1,5,5,5,5,4,5,8,10,5,3,7,6,6,5,9,7,11,5,6,5,8,13,13,6,1,15,13,12,1,9,14,12,10,11,8,13,14,12,5,9,10,17,1,4,1,2,3,3,1,4,3,2,3
"4140",2000281579,"Shane Emmanuel","7/3/1989 (33 years old)","GK","B1","SLFA First Division","LCA","No","1/1/2019","-","$0","Right","Reasonable","Very Strong","6'0""","156 lbs","-","-",60,66,4,3,2,2,2,8,3,3,3,2,11,2,2,6,11,12,15,9,9,8,12,1,10,1,12,9,8,8,9,10,9,10,14,9,8,6,10,10,9,9,10,10,8,4,5,2,8,10,15,10,10,11,17,10,3,5,6,11,7,12
"4141",19001687,"Rodriguinho","11/24/1987 (35 years old)","M/AM (C)","REM","Brazilian National Third Division","TLS","No","12/15/2022","12/31/2023","$0","Right Only","Weak","Very Strong","6'0""","176 lbs","252","65",97,124,9,9,8,10,10,7,7,9,5,10,11,5,10,10,15,10,15,9,10,10,7,9,13,12,11,15,15,13,12,10,12,9,10,12,14,12,14,19,12,10,11,10,8,12,6,2,13,13,16,3,3,2,1,3,3,3,2,1,3,2
"4142",23270192,"Pedro Henrique","1/17/1992 (31 years old)","ST (C)","Persikabo 1973","Indonesian League One","TLS","No","1/11/2023","5/31/2024","$0","Left","Very Strong","Reasonable","6'0""","154 lbs","120","34",75,93,2,4,13,14,14,6,6,6,6,5,7,4,4,10,5,7,8,9,6,11,4,10,5,14,7,7,8,8,12,10,4,8,11,8,13,8,8,16,13,8,10,10,7,1,10,7,12,11,9,3,2,2,1,3,1,1,1,4,2,3
"4143",41039986,"Diogo Rangel","8/19/1991 (31 years old)","D (RC)","Novo Hamburgo","Brazilian National Fourth Division","TLS","No","3/23/2023","12/31/2024","$0","Right Only","Weak","Very Strong","6'1""","180 lbs","90","6",77,92,4,11,7,3,7,1,10,4,7,10,6,4,14,5,8,12,9,7,10,12,12,6,6,7,11,7,2,9,7,8,8,13,13,9,13,15,12,18,10,13,10,9,11,6,11,2,11,11,19,2,2,2,2,2,1,3,4,1,3,2
"4144",2000031052,"Mouzinho","6/26/2002 (20 years old)","AM (RL), ST (C)","Visakha","Cambodian Premier League","TLS","No","1/6/2023","5/30/2025","$0 - $20K","Right Only","Weak","Very Strong","5'8""","132 lbs","7","3",70,90,10,10,11,11,10,8,4,5,4,3,9,10,3,11,8,6,9,7,7,7,13,12,6,10,3,11,7,12,13,13,6,5,12,13,8,5,10,12,12,11,8,5,13,10,7,6,11,12,13,1,3,1,3,4,1,2,3,1,3,1
"4145",23396789,"João Pedro","8/20/2000 (22 years old)","AM (RL), ST (C)","Benfica (MAC)","Macanese First Division","TLS","No","2/11/2023","12/31/2023","$0","Left","Very Strong","Reasonable","5'8""","149 lbs","22","2",72,85,7,10,11,12,11,6,10,7,2,6,11,7,6,6,12,10,8,8,7,10,12,6,2,13,6,7,6,8,10,13,7,6,7,11,5,6,11,12,12,10,12,8,9,2,9,5,15,11,20,2,3,2,3,1,4,2,3,1,2,2
"4146",2000123072,"Christian Ishimwe","2/1/1999 (24 years old)","D/WB (L)","APR FC","Rwandan Premier Division","RWA","No","8/1/2022","6/30/2024","$0 - $40K","Left Only","Very Strong","Weak","5'11""","158 lbs","-","-",82,95,5,12,8,3,10,2,7,5,7,8,8,1,12,9,15,7,7,7,8,10,13,5,1,5,9,8,8,9,14,14,8,9,5,14,12,5,14,13,9,12,12,12,11,7,5,2,9,11,19,3,2,2,2,1,3,2,2,2,1,3
"4147",2000017018,"Elias Mesquita","3/27/2002 (21 years old)","AM (RL)","Kota Ranger","Bruneian Super League","TLS","No","5/23/2023","5/31/2024","$0","Right","Reasonable","Very Strong","5'5""","130 lbs","8","2",60,80,5,7,13,9,12,1,6,3,1,5,6,2,3,7,14,8,4,8,6,8,6,12,7,8,4,6,6,7,13,12,3,1,10,12,12,1,15,18,11,12,12,9,11,15,5,5,10,9,8,3,1,1,1,2,2,3,2,2,1,3
"4148",67269204,"Kornelis Portela","10/3/2001 (21 years old)","DM, M (C)","Benfica Laulara","East Timorese Premier Division","TLS","No","1/1/2020","12/31/2023","$0","Right","Strong","Very Strong","5'3""","119 lbs","5","1",56,76,5,5,4,3,11,5,5,3,3,7,12,1,7,6,14,8,7,3,2,11,15,5,7,7,7,7,6,11,13,13,6,1,15,13,6,1,10,10,12,11,11,10,13,8,13,2,11,12,20,1,2,2,1,2,3,2,2,2,3,1
"4149",2000017854,"Paulo Gali","12/31/1996 (26 years old)","AM (RLC)","PSIS","Indonesian League One","TLS","No","6/2/2023","5/31/2024","$0 - $90K","Left","Very Strong","Reasonable","5'5""","130 lbs","7","5",74,76,10,10,13,11,12,10,4,10,3,2,8,5,3,12,11,7,11,5,4,6,12,14,5,9,3,4,8,5,12,14,13,4,12,13,10,8,10,6,7,8,11,12,12,11,12,18,7,10,8,2,1,2,3,2,3,3,3,2,1,2
"4150",2000301212,"Mário Quintão","2/18/2004 (19 years old)","AM (RL)","Emmanuel FC","East Timorese Premier Division","TLS","No","1/1/2022","-","$0","Right","Reasonable","Very Strong","5'5""","125 lbs","6","1",55,75,8,11,12,9,11,6,6,5,6,3,14,6,7,6,8,6,4,7,6,9,5,6,10,7,6,7,8,8,14,8,7,5,13,11,6,1,12,18,9,9,13,12,13,1,7,7,10,13,18,1,3,2,1,2,2,2,2,3,3,1
"4151",2000022543,"Gumário Moreira","10/18/2001 (21 years old)","D (C)","Assalam","East Timorese Premier Division","TLS","No","7/9/2022","12/31/2023","$0","Right","Reasonable","Very Strong","5'9""","154 lbs","2","-",50,75,2,1,1,2,6,1,9,2,1,12,3,1,6,1,15,6,5,6,5,13,15,5,13,4,12,5,5,6,11,13,6,7,15,13,3,3,10,19,10,10,12,10,7,8,7,1,9,9,7,2,1,1,1,3,4,2,3,3,3,2
"4152",2000017980,"Tiago","4/13/1999 (24 years old)","M/AM (C)","Greenvale United","Victorian State League 4 - North","TLS","No","11/17/2022","-","$0","Right","Reasonable","Very Strong","5'5""","132 lbs","4","1",52,72,2,2,6,6,12,4,1,11,1,5,10,1,5,11,13,4,3,8,4,8,9,12,10,6,3,6,7,11,12,12,5,2,13,12,10,1,14,13,10,12,10,11,7,10,11,7,10,11,20,2,1,2,3,2,2,2,2,1,1,3
"4153",23396591,"Rufino Gama","6/20/1998 (24 years old)","AM (RLC), ST (C)","Atl. Ultramar/Coração FC","East Timorese Premier Division","TLS","No","1/1/2023","-","$0","Right Only","Weak","Very Strong","5'7""","141 lbs","8","4",60,72,4,8,10,10,8,4,6,5,4,3,7,3,4,10,12,7,11,6,8,7,12,9,5,10,3,10,8,12,12,11,6,5,12,12,8,6,14,18,11,11,8,14,9,6,8,5,9,11,10,2,1,3,2,2,3,2,2,2,3,1
"4154",2000154956,"Anizo Correia","5/23/2003 (20 years old)","ST (C)","Ponta Leste","East Timorese Premier Division","TLS","No","6/13/2022","12/31/2023","$0","Right","Reasonable","Very Strong","5'9""","160 lbs","2","-",57,72,1,2,11,10,4,4,13,5,2,3,6,1,1,9,7,7,6,7,5,8,17,9,2,13,1,5,6,6,13,10,4,7,12,13,8,13,9,10,11,13,11,11,5,11,5,8,20,12,7,1,2,2,2,1,1,3,4,3,3,1
"4155",2000035503,"Jhon Frith","7/17/2002 (20 years old)","DM, M (C)","Benfica Laulara","East Timorese Premier Division","TLS","No","7/2/2021","12/31/2023","$0","Right Only","Weak","Very Strong","5'5""","134 lbs","8","1",59,72,7,6,8,6,9,6,4,6,4,8,11,3,10,10,12,10,11,9,8,8,11,8,6,5,8,14,11,13,11,12,11,5,12,11,11,5,12,12,11,11,9,6,5,7,7,5,10,13,7,1,2,3,1,2,1,3,1,2,3,1
"4156",2000017999,"Yohanes Gusmão","10/1/2000 (22 years old)","D/WB/M/AM (L)","Ponta Leste","East Timorese Premier Division","TLS","No","7/3/2021","12/31/2023","$0","Left Only","Very Strong","Very Weak","5'5""","132 lbs","2","-",56,70,6,7,8,5,7,6,3,5,8,7,9,2,8,10,13,8,12,5,11,6,13,10,6,6,5,13,8,13,12,12,6,4,11,12,10,4,18,15,12,11,10,10,11,9,11,6,8,11,11,2,3,3,3,1,3,3,2,3,3,3
"4157",2000159081,"Ramadhan Niyibizi","7/9/2000 (22 years old)","AM (C)","APR FC","Rwandan Premier Division","RWA","No","8/1/2022","6/30/2025","$50K - $150K","Left","Very Strong","Reasonable","6'0""","158 lbs","-","-",85,95,7,6,8,14,12,7,7,9,3,7,13,4,8,14,9,6,5,5,8,11,15,13,5,10,5,8,12,9,13,11,8,9,17,11,14,5,13,12,11,12,10,11,12,1,8,2,11,10,8,2,3,1,3,3,1,1,2,2,3,3
"4158",23396367,"Avigmas","12/24/1999 (23 years old)","D/WB (R)","Greenvale United","Victorian State League 4 - North","TLS","No","11/14/2022","-","$0","Right Only","Weak","Very Strong","5'8""","143 lbs","1","-",59,68,5,7,8,6,8,2,6,8,8,7,7,2,10,10,12,7,13,6,11,7,13,10,6,9,5,11,7,13,12,12,10,4,12,12,11,4,11,12,12,13,8,11,4,10,5,5,10,13,17,2,2,2,3,1,2,1,3,2,3,1
"4159",23396769,"Armindo de Almeida","4/18/1998 (25 years old)","D (C), DM, M (C)","Greenvale United","Victorian State League 4 - North","TLS","No","1/1/2023","-","$0","Right Only","Very Weak","Very Strong","5'5""","141 lbs","2","-",61,68,3,4,5,3,5,3,8,4,10,12,7,4,11,6,15,13,13,4,11,8,16,4,12,2,9,12,3,12,10,11,11,5,12,11,12,11,13,9,11,14,13,10,6,10,13,11,12,12,19,2,3,3,3,3,3,2,2,3,1,2
"4160",23331850,"José Guterres","4/24/1998 (25 years old)","D/WB (L)","Karketu Dili","East Timorese Premier Division","TLS","No","1/1/2021","12/31/2023","$0","Left Only","Very Strong","Weak","6'0""","158 lbs","8","-",53,68,4,8,5,4,7,1,6,1,5,7,6,1,9,5,8,6,6,6,11,12,4,5,4,4,5,6,6,7,13,13,6,8,13,13,12,4,13,11,8,11,12,10,5,8,10,1,20,10,13,1,2,3,2,2,2,2,3,3,1,3
"4161",23396463,"Cândido Oliveira","12/2/1997 (25 years old)","D/WB (R)","Ponta Leste","East Timorese Premier Division","TLS","No","8/1/2020","12/31/2023","$0","Right","Weak","Very Strong","5'5""","123 lbs","6","-",52,68,1,6,4,1,6,1,2,4,6,8,8,5,12,8,7,5,8,6,7,9,15,6,7,5,7,7,4,7,14,14,7,1,14,14,12,1,12,17,11,12,12,10,15,8,5,7,11,10,18,3,4,3,1,2,2,2,1,1,1,1
"4162",23396372,"Jaimito Soares","6/10/2003 (20 years old)","D/WB (R), DM, M (C)","Assalam","East Timorese Premier Division","TLS","No","7/3/2021","12/31/2023","$0","Right","Weak","Very Strong","5'9""","149 lbs","2","-",55,66,4,7,5,5,9,3,3,4,1,7,8,5,8,6,9,6,7,7,8,14,16,5,13,7,10,7,6,7,12,12,7,5,9,12,5,6,14,20,11,12,11,12,5,8,7,8,15,13,20,1,2,3,3,1,2,1,3,3,1,3
"4163",15024712,"Isac","2/2/1988 (35 years old)","D (C)","Greenvale United","Victorian State League 4 - North","TLS","No","6/1/2022","-","$0","Right","Reasonable","Very Strong","6'3""","158 lbs","-","-",51,66,1,1,1,3,5,1,11,1,1,13,4,1,12,5,11,7,8,6,8,11,5,5,11,5,13,5,3,6,7,8,6,12,15,8,5,4,13,11,11,10,14,13,11,8,12,1,12,12,13,3,3,2,3,3,1,2,2,3,3,1
"4164",23396384,"Gelvânio Costa","10/8/1998 (24 years old)","AM (RLC)","Karketu Dili","East Timorese Premier Division","TLS","No","1/1/2019","12/31/2023","$0","Left Only","Very Strong","Weak","5'3""","132 lbs","11","3",55,66,3,6,9,5,9,5,4,7,4,3,9,1,6,12,14,7,1,7,5,9,5,12,5,8,4,6,7,7,13,13,6,1,7,13,10,1,11,11,9,11,9,12,5,8,11,8,17,8,20,2,3,3,2,2,4,2,3,1,3,3
"4165",23103921,"Angiso Barbosa","3/16/1993 (30 years old)","D (C), DM, M (C)","Porto Taibesse","East Timorese Premier Division","TLS","No","1/1/2023","-","$0","Right","Weak","Very Strong","5'7""","143 lbs","13","-",59,65,5,2,3,5,10,6,8,6,6,8,11,2,10,8,10,12,5,7,6,11,15,5,4,7,9,7,6,8,14,10,7,4,15,12,11,2,12,17,10,13,10,11,7,4,5,8,8,11,15,2,4,3,1,3,3,1,3,1,3,2
"4166",23396554,"Gaudêncio Monteiro","1/26/1999 (24 years old)","AM (RL)","Karketu Dili","East Timorese Premier Division","TLS","No","1/1/2021","12/31/2023","$0","Right Only","Weak","Very Strong","5'8""","138 lbs","11","4",53,64,4,8,9,7,8,4,4,2,2,4,5,1,2,10,5,7,6,5,5,5,13,11,8,8,4,6,3,11,12,12,5,1,15,12,12,2,11,11,11,11,12,12,9,6,9,5,11,10,12,2,1,2,3,1,4,1,3,2,2,1
"4167",23396644,"João Panji","10/29/2000 (22 years old)","D (RC), WB (R)","Assalam","East Timorese Premier Division","TLS","No","7/10/2022","12/31/2023","$0","Right Only","Weak","Very Strong","5'7""","154 lbs","2","-",53,64,5,6,8,2,4,1,9,3,8,9,8,3,12,9,13,12,14,4,12,5,15,4,9,3,7,11,4,13,11,8,11,7,12,11,10,12,3,14,10,12,11,10,10,7,13,3,10,12,16,3,3,2,1,3,1,1,1,4,1,2
"4168",72052873,"Siad Haji","12/1/1999 (23 years old)","M/AM (RC)","Tulsa","USSL Championship Eastern Conference","SOM","No","1/19/2023","11/30/2023","$500K - $1.5M","Right Only","Weak","Very Strong","5'8""","154 lbs","91","18",103,125,9,11,13,10,11,7,7,10,8,6,11,9,8,13,6,9,8,11,10,9,15,14,6,10,6,9,9,10,15,14,12,7,16,14,10,9,8,20,11,10,11,9,5,17,11,7,11,8,13,2,3,3,1,1,3,3,2,3,3,2
"4169",23396553,"Feliciano Pinheiro","2/11/1997 (26 years old)","D/WB/M/AM (R)","DIT","East Timorese Second Division","TLS","No","1/1/2020","12/31/2023","$0","Right","Reasonable","Very Strong","5'3""","119 lbs","6","-",51,64,3,8,6,5,5,1,3,2,1,5,6,1,4,5,15,9,4,6,6,6,5,8,8,12,5,5,6,6,12,12,5,1,16,12,6,1,8,10,11,12,13,12,9,10,8,1,6,11,9,3,4,2,2,1,3,3,2,2,2,1
"4170",2000031069,"Danilson","5/15/2001 (22 years old)","AM (RL)","Porto Taibesse","East Timorese Premier Division","TLS","No","1/1/2023","-","$0","Right Only","Weak","Very Strong","5'3""","119 lbs","10","2",50,63,4,9,8,7,11,4,3,1,3,4,11,1,6,6,7,6,7,3,6,13,8,14,3,6,5,7,5,12,13,10,6,1,14,11,6,1,10,11,9,12,11,9,6,13,14,3,20,11,11,1,3,1,1,1,3,1,3,1,1,2
"4171",2000035500,"Cristevão Fernandes","1/16/2004 (19 years old)","M (C)","Benfica Laulara","East Timorese Premier Division","TLS","No","1/1/2020","12/31/2023","$0","Right Only","Weak","Very Strong","5'7""","134 lbs","7","-",50,62,5,4,1,6,10,5,4,6,2,10,11,2,7,8,6,6,1,4,6,14,12,5,2,7,8,7,13,9,14,12,4,3,11,14,4,2,10,19,12,11,11,11,13,8,14,8,17,12,10,3,2,3,3,1,1,3,2,2,2,2
"4172",23331851,"Rickie Cruz","12/6/1997 (25 years old)","ST (C)","Karketu Dili","East Timorese Premier Division","TLS","No","1/1/2023","12/31/2023","$0","Left","Very Strong","Reasonable","5'11""","163 lbs","-","-",56,62,4,1,10,12,9,4,7,2,3,1,4,6,1,4,5,9,4,5,4,8,15,7,6,12,5,4,4,6,12,12,5,8,15,12,11,9,9,15,10,11,13,11,7,5,8,2,13,13,12,4,2,2,2,2,1,2,4,1,3,1
"4173",2000031064,"Filomeno Junior","6/21/1998 (24 years old)","D (C), DM","Benfica (MAC)","Macanese First Division","TLS","No","3/2/2023","12/31/2024","$0","Right Only","Weak","Very Strong","5'9""","154 lbs","1","-",55,62,2,3,3,3,5,2,8,4,9,12,6,2,10,4,13,10,15,3,10,6,14,2,10,3,9,10,2,14,11,10,10,7,11,11,10,11,12,20,11,12,11,12,9,8,10,3,11,12,15,3,2,1,3,1,1,2,1,3,1,2
"4174",36524457,"Tirjon Maia","8/25/1996 (26 years old)","AM (RLC), ST (C)","Assalam","East Timorese Premier Division","TLS","Yes","3/1/2023","12/31/2023","$0","Right Only","Weak","Very Strong","5'3""","121 lbs","11","8",53,62,5,7,9,7,7,5,7,6,4,5,7,1,1,9,6,9,7,9,5,11,3,9,4,11,5,6,5,7,13,13,4,1,13,13,9,1,10,13,11,9,10,14,7,8,10,7,9,12,8,1,3,1,1,3,2,2,3,4,2,1
"4175",23396586,"Abrão Mendonça","6/18/1997 (25 years old)","D/WB (R), DM","Nagardjo","East Timorese Second Division","TLS","No","1/1/2023","-","$0","Right Only","Weak","Very Strong","5'4""","123 lbs","5","-",50,62,5,7,5,3,7,5,5,6,5,7,8,1,10,6,9,6,6,6,9,13,9,5,9,5,11,7,5,7,13,13,7,1,12,12,9,1,12,16,10,11,12,9,12,3,14,8,10,12,16,3,2,1,2,2,3,2,2,3,1,3
"4176",23320583,"Nataniel Reis","3/25/1995 (28 years old)","DM, M (C)","Karketu Dili","East Timorese Premier Division","TLS","No","10/19/2021","12/31/2023","$0","Right","Reasonable","Very Strong","5'9""","147 lbs","9","-",57,62,4,4,2,3,10,4,4,5,1,9,9,1,11,7,15,10,6,6,6,12,11,5,10,4,9,6,9,11,12,11,5,3,16,11,9,6,13,19,11,11,11,12,13,5,14,6,11,12,10,1,3,2,3,3,1,3,2,1,2,3
"4177",2000301216,"José Pereira","12/20/1999 (23 years old)","M (C)","Ponta Leste","East Timorese Premier Division","TLS","No","1/1/2022","12/31/2023","$0","Right","Weak","Very Strong","5'7""","138 lbs","7","1",55,60,1,4,5,5,12,3,4,13,1,8,13,2,3,10,8,5,4,6,3,13,3,5,12,5,5,7,11,11,11,7,5,1,12,6,11,1,12,18,12,11,12,13,10,3,8,3,16,9,15,3,3,3,3,2,2,4,1,2,2,1
"4178",23396756,"Olegário Boavida","10/24/1994 (28 years old)","DM, M (C)","Karketu Dili","East Timorese Premier Division","TLS","No","1/1/2023","12/31/2023","$0","Right","Reasonable","Very Strong","5'3""","123 lbs","5","-",52,58,5,4,3,5,8,5,5,5,5,7,12,2,12,9,12,8,7,7,5,7,9,5,13,7,6,7,9,11,13,13,6,2,12,13,6,4,10,19,11,12,9,11,14,1,12,4,11,10,13,2,2,3,3,4,2,3,2,2,3,2
"4179",72051124,"Handwalla Bwana","6/25/1999 (23 years old)","AM (RLC)","Charleston","USSL Championship Eastern Conference","SOM","No","1/11/2023","11/30/2023","$95K - $950K","Right","Reasonable","Very Strong","5'9""","143 lbs","59","6",100,117,11,13,12,9,11,10,8,14,7,8,13,9,6,12,8,10,10,12,9,11,11,13,10,13,8,9,13,13,13,12,13,9,9,13,10,6,9,12,12,8,13,12,9,11,9,1,9,12,13,1,3,2,2,2,2,2,3,1,1,2
"4180",23396423,"Silveiro Garcia","4/2/1994 (29 years old)","ST (C)","Ponta Leste","East Timorese Premier Division","TLS","No","8/1/2020","12/31/2023","$0","Left","Very Strong","Reasonable","5'9""","149 lbs","5","-",56,58,2,2,7,13,11,5,12,5,1,4,5,3,1,7,13,8,2,9,4,7,13,12,7,10,6,4,3,7,12,12,6,6,8,13,11,3,11,17,9,11,13,12,11,5,13,1,8,10,15,3,1,3,2,2,3,1,1,3,2,2
"4181",23396636,"Hasan Ramos Costa","3/14/1996 (27 years old)","AM (R), ST (C)","Assalam","East Timorese Premier Division","TLS","No","7/10/2022","12/31/2023","$0","Right","Weak","Very Strong","5'7""","143 lbs","6","4",52,57,5,8,7,4,10,4,5,1,4,1,7,4,1,7,9,6,6,4,2,6,11,14,4,9,4,5,5,7,12,12,5,5,9,12,12,4,11,16,12,15,10,10,11,1,6,7,9,11,12,3,2,1,2,1,4,1,2,3,1,3
"4182",23396541,"Nobel","4/30/2001 (22 years old)","D/WB (L)","Karketu Dili","East Timorese Premier Division","TLS","No","1/1/2021","12/31/2023","$0","Left Only","Very Strong","Weak","5'7""","136 lbs","6","-",52,56,5,10,6,3,8,1,7,4,4,5,8,2,11,8,10,4,8,7,4,14,4,5,1,6,8,7,4,7,14,11,2,5,13,12,7,3,13,18,10,11,9,11,9,8,9,7,11,11,18,1,3,2,3,2,1,1,1,1,3,2
"4183",23396624,"Husen Ramos Costa","5/2/2004 (19 years old)","D/WB (R)","Assalam","East Timorese Premier Division","TLS","No","7/10/2022","12/31/2023","$0","Right Only","Weak","Very Strong","5'8""","147 lbs","6","1",50,54,6,10,7,5,9,1,8,5,3,7,8,2,12,7,10,5,7,6,5,10,14,10,12,5,7,8,7,8,14,11,6,7,13,13,7,7,10,10,7,12,13,13,12,10,15,3,7,14,18,1,3,1,1,3,3,3,2,3,2,2
"4184",2000290832,"Edoardo Cavaliere","5/30/2006 (17 years old)","ST (C)","OGC Nice","Ligue 1 Uber Eats","MON","No","7/1/2022","6/30/2025","$120K - $1.2M","Left","Very Strong","Reasonable","6'2""","156 lbs","-","-",70,124,5,6,13,13,11,6,13,7,6,5,7,6,4,9,13,12,8,10,5,11,15,9,5,4,5,6,4,7,13,11,7,13,12,11,5,6,8,18,12,12,13,15,12,12,6,1,8,10,9,2,2,3,1,4,2,3,3,1,2,1
"4185",48044605,"Florian Antognelli","1/14/2005 (18 years old)","DM","RC Grasse","French National 2 - A","MON","Yes","9/28/2022","6/30/2025","$75K - $230K","Right Only","Weak","Very Strong","5'10""","160 lbs","21","-",90,113,8,8,9,6,11,7,11,9,6,10,12,8,12,11,12,12,13,11,11,11,13,7,12,7,11,13,11,12,11,11,12,9,13,9,12,10,8,14,13,14,13,16,13,11,8,4,12,12,16,1,1,1,1,4,2,3,1,3,1,4
"4186",2000082493,"Abubeker Nasir","2/23/2000 (23 years old)","AM (RL), ST (C)","Sundowns","South African Premier Soccer League","ETH","No","1/31/2022","6/30/2025","$100K - $300K","Right","Strong","Very Strong","5'10""","152 lbs","32","31",115,122,9,14,14,10,11,9,11,11,7,8,14,4,8,13,7,14,8,7,7,14,7,14,11,13,9,10,9,9,14,12,10,8,17,11,10,7,10,10,8,11,10,11,8,14,13,7,16,10,14,1,2,1,1,3,1,3,1,3,2,1
"4187",2000314277,"Harun Anter","7/30/2007 (15 years old)","ST (C)","Saint George","Ethiopian Premier Division","ETH","No","6/12/2023","6/30/2027","$14K - $45K","Right","Reasonable","Very Strong","5'8""","125 lbs","-","-",65,121,7,6,8,9,12,7,9,8,3,7,8,6,3,9,15,12,10,8,6,13,18,7,12,6,5,14,8,14,8,12,11,8,13,12,11,5,6,20,10,10,12,10,13,6,9,8,9,8,9,2,4,3,3,1,1,3,4,4,1,2
"4188",2000177007,"Biniyam Fikru","4/21/2004 (19 years old)","M/AM (R)","Wolaita Dicha","Ethiopian Premier Division","ETH","No","7/1/2019","6/30/2025","$1K - $8K","Right","Fairly Strong","Very Strong","6'0""","160 lbs","56","3",70,119,5,11,10,12,11,1,2,5,6,5,12,6,6,13,11,8,6,5,5,12,17,13,10,8,6,7,5,6,13,13,7,9,9,13,7,4,12,14,11,12,12,10,8,5,9,6,12,12,9,1,1,1,3,3,1,1,3,1,2,3
"4189",2000291391,"Yitagesu Tariku","12/23/2005 (17 years old)","M (C)","Ethiopian Coffee","Ethiopian Premier Division","ETH","No","7/1/2022","6/30/2025","$1.5K - $14K","Right","Reasonable","Very Strong","5'7""","127 lbs","5","-",63,119,3,5,2,4,12,5,5,8,1,11,13,4,8,7,15,10,3,5,4,13,14,6,2,8,7,6,13,11,13,10,6,4,14,12,7,1,7,18,11,10,10,10,13,11,11,3,8,11,12,3,3,2,1,1,1,1,2,2,3,3
"4190",2000022636,"Saadiq Faisal Elmi","11/11/2000 (22 years old)","WB (L), M (LC), AM (L)","Grorud","Norwegian Second Division Group 1","SOM","Yes","6/15/2020","12/31/2023","$0 - $22K","Left","Very Strong","Reasonable","6'0""","167 lbs","114","8",90,110,9,7,11,11,10,8,6,12,8,8,8,5,9,12,10,10,7,6,6,8,12,14,9,9,8,11,11,11,13,11,10,7,13,13,11,8,13,14,12,13,13,13,13,7,11,4,12,12,19,3,1,1,1,1,2,3,4,2,1,2
"4191",2000171612,"Alazar Samuel","9/10/2005 (17 years old)","DM, M (C)","Saint George","Ethiopian Premier Division","ETH","No","6/13/2022","6/30/2025","$0 - $50K","Right","Fairly Strong","Very Strong","5'9""","149 lbs","15","-",70,117,3,6,6,6,14,6,7,8,3,9,12,1,14,13,8,7,8,4,8,9,14,5,6,9,11,8,12,12,13,9,8,7,6,10,7,7,10,13,12,8,12,11,5,3,7,8,14,11,14,2,3,3,2,3,3,1,1,2,1,1
"4192",2000177006,"Sintayehu Mengistu","6/16/2001 (21 years old)","ST (C)","Wolaita Dicha","Ethiopian Premier Division","ETH","No","7/1/2020","6/30/2023","$0","Right","Strong","Very Strong","6'1""","171 lbs","67","23",84,117,2,4,10,13,11,2,9,7,3,3,5,4,1,10,5,13,8,9,7,6,12,10,12,13,7,6,7,7,13,11,2,13,12,13,5,7,10,14,11,12,11,11,8,6,15,1,11,10,11,1,3,2,1,1,4,1,3,2,2,1
"4193",2000168697,"Surafel Seyfu","12/17/2004 (18 years old)","M (C)","Ethiopian Coffee","Ethiopian Premier Division","ETH","No","7/1/2021","6/30/2025","$10K - $30K","Right","Fairly Strong","Very Strong","5'5""","123 lbs","6","-",57,116,2,3,4,6,13,5,5,5,5,7,11,2,11,11,14,5,7,5,6,11,9,5,10,3,9,7,4,12,13,11,6,1,12,13,9,1,14,14,12,12,12,8,6,12,5,6,7,12,11,2,3,2,1,2,2,1,2,2,2,2
"4194",2000219083,"Habtom Gebregziabher","12/17/2003 (19 years old)","ST (C)","Saint George","Ethiopian Premier Division","ETH","No","1/1/2020","6/30/2024","$500 - $3.5K","Right","Reasonable","Very Strong","5'10""","154 lbs","4","-",68,115,3,4,13,13,10,5,13,6,1,5,6,8,3,13,8,10,7,11,6,11,7,13,2,10,6,5,4,6,12,10,6,7,15,11,6,6,7,16,11,12,10,12,5,15,5,1,8,12,8,1,3,2,1,2,3,1,3,2,1,3
"4195",2000161121,"Yoseph Tarekegn","7/17/2003 (19 years old)","AM (L), ST (C)","Adama City","Ethiopian Premier Division","ETH","No","7/1/2021","6/30/2025","$9K - $28K","Left","Very Strong","Fairly Strong","6'0""","167 lbs","18","8",80,114,8,12,13,13,11,6,13,7,1,5,7,6,1,13,14,8,3,7,6,5,14,13,12,9,5,6,4,8,10,13,6,10,6,13,8,6,9,16,10,10,11,9,6,11,7,3,9,12,18,1,3,1,1,4,1,1,3,1,2,3
"4196",2000291327,"Wogene Gezahegn","6/19/2004 (18 years old)","M/AM (C)","Ethiopia Medin","Ethiopian Premier Division","ETH","No","7/1/2022","6/30/2025","$1.5K - $12K","Right","Fairly Strong","Very Strong","5'10""","149 lbs","22","5",88,113,6,6,8,13,13,6,5,9,1,5,10,4,8,9,12,8,6,5,7,13,16,14,1,9,8,7,13,8,13,13,7,7,12,13,8,4,13,17,12,11,11,12,12,13,6,5,11,11,16,2,2,1,1,3,1,3,1,2,3,2
"4197",2000219683,"Zenebe Kedir","1/28/1999 (24 years old)","D/WB/M/AM (R)","Legetafo","Ethiopian Higher League","ETH","No","1/27/2023","6/30/2024","$500 - $3.5K","Right","Weak","Very Strong","5'10""","149 lbs","20","-",74,112,6,10,8,13,12,6,5,6,6,7,8,8,4,13,12,5,7,8,8,13,9,13,7,11,7,7,8,8,13,13,7,5,11,13,12,4,14,10,12,11,11,12,6,11,5,4,11,11,12,3,2,4,1,4,2,3,2,1,2,1
"4198",2000161114,"Abdisa Jemal","4/4/2000 (23 years old)","AM (RL), ST (C)","Adama City","Ethiopian Premier Division","ETH","No","7/1/2020","6/30/2025","$0 - $45K","Right","Fairly Strong","Very Strong","5'5""","127 lbs","59","15",81,111,6,7,10,10,13,1,7,4,5,5,13,5,4,10,10,12,7,6,5,12,16,11,11,10,5,6,6,11,12,12,13,1,10,12,9,1,9,16,10,10,11,11,15,8,5,7,20,12,15,2,1,1,1,2,3,2,1,1,3,1
"4199",13133288,"Shimelis Bekele","10/17/1990 (32 years old)","AM (LC)","ENPPI","Egyptian Premier League","ETH","No","10/8/2022","7/31/2024","Not for Sale","Right","Reasonable","Very Strong","5'9""","149 lbs","167","37",104,110,9,12,15,12,16,5,10,12,8,10,16,8,8,16,6,14,6,11,10,10,6,13,7,11,11,11,13,12,12,9,12,11,14,9,10,6,17,15,10,10,11,13,5,11,11,8,14,11,19,3,3,1,1,3,1,1,3,1,2,1
"4200",2000117873,"Chernet Gugsa","9/13/1999 (23 years old)","M (L), AM (RL)","Saint George","Ethiopian Premier Division","ETH","No","7/15/2021","6/30/2023","$0","Left","Very Strong","Fairly Strong","6'2""","182 lbs","92","15",90,110,8,10,11,5,12,10,10,12,10,10,11,3,12,11,7,6,10,5,6,5,18,14,7,16,10,10,12,14,13,11,12,12,9,12,11,11,11,20,12,11,9,14,11,11,10,8,17,9,14,1,2,2,3,1,1,3,2,2,3,3
"4201",2000300476,"Yasiin Abdelqadir","8/23/2006 (16 years old)","AM (LC), ST (C)","Lyn","Norwegian Second Division Group 1","SOM","Yes","6/13/2022","12/31/2025","$0","Right Only","Very Weak","Very Strong","5'10""","149 lbs","3","-",67,109,7,7,9,10,10,7,7,7,2,7,9,9,6,9,14,8,7,7,6,7,13,13,6,9,7,9,10,13,12,10,6,8,13,13,12,6,9,7,7,10,13,11,7,8,14,11,13,15,13,2,2,1,3,2,1,1,3,1,1,1
"4202",2000219810,"Teshome Belachew","9/20/2000 (22 years old)","ST (C)","Mekelakeya","Ethiopian Premier Division","ETH","No","7/1/2021","6/30/2025","$0 - $50K","Right","Fairly Strong","Very Strong","5'11""","160 lbs","33","6",77,110,5,2,12,12,12,5,12,6,1,5,5,7,2,10,8,7,5,12,6,12,6,11,7,12,6,5,6,6,12,11,2,7,6,12,11,6,12,10,12,10,11,14,10,11,6,5,13,10,10,3,1,2,3,2,1,1,3,1,3,1
"4203",13101470,"Getaneh Kebede","4/2/1992 (31 years old)","ST (C)","Wolkite City","Ethiopian Premier Division","ETH","No","7/1/2021","6/30/2023","$0","Right","Reasonable","Very Strong","5'10""","154 lbs","134","57",98,110,7,7,11,12,7,7,11,8,4,4,11,10,7,10,8,10,8,11,7,8,3,11,7,12,12,11,13,12,14,8,10,8,13,13,14,10,8,16,10,12,9,9,11,10,8,7,10,11,20,2,1,1,2,1,2,1,3,3,3,2
"4204",2000118675,"Bereket Desta","10/20/2000 (22 years old)","M (L), AM (RL)","Mekelakeya","Ethiopian Premier Division","ETH","No","7/13/2022","6/30/2024","$1.5K - $18K","Right","Reasonable","Very Strong","5'3""","119 lbs","94","15",88,110,7,10,12,12,12,7,5,10,8,8,10,2,7,15,5,10,4,9,9,5,8,13,6,7,8,9,10,7,15,15,15,1,15,15,7,1,12,16,12,12,14,14,11,9,9,1,12,11,10,1,3,1,3,3,1,2,1,1,1,2
"4205",13200994,"Amanuel Gebremikael","2/5/1999 (24 years old)","AM (R), ST (C)","Saint George","Ethiopian Premier Division","ETH","No","9/29/2022","6/30/2023","$0","Right Only","Weak","Very Strong","6'2""","176 lbs","82","18",94,110,9,8,15,15,15,9,11,11,7,8,9,6,8,13,11,7,4,6,6,7,13,11,7,7,10,6,7,11,12,13,12,11,11,12,15,9,12,19,13,10,11,10,13,3,5,4,13,12,15,3,1,1,4,2,3,3,2,2,2,3
"4206",2000168696,"Redwan Nasir","11/10/2001 (21 years old)","M (C)","Ethiopian Coffee","Ethiopian Premier Division","ETH","No","7/1/2019","6/30/2025","$0 - $45K","Right","Reasonable","Very Strong","5'10""","152 lbs","26","-",70,109,7,6,4,9,11,7,7,9,1,9,10,3,9,12,8,12,6,6,9,14,7,7,12,9,9,8,7,12,13,10,8,6,16,12,7,6,12,19,11,10,11,11,8,14,12,8,13,10,11,3,2,4,3,1,3,1,1,2,3,2
"4207",2000219685,"Kedir Ali","9/30/2002 (20 years old)","ST (C)","Ethiopian Coffee","Ethiopian Premier Division","ETH","No","1/1/2019","6/30/2025","$12K - $35K","Right Only","Very Weak","Very Strong","5'9""","147 lbs","4","-",64,108,4,3,13,13,9,1,13,6,1,5,4,6,1,12,13,6,7,11,5,7,7,12,2,7,6,5,6,7,13,12,6,6,15,13,12,6,10,18,12,12,11,10,14,14,12,1,11,13,15,2,2,2,2,3,1,2,2,3,2,3
"4208",53142115,"Horenus Tadesse","5/22/1998 (25 years old)","M/AM (C)","Sandnes Ulf","Norwegian First Division","ETH","Yes","8/30/2021","12/31/2023","$2K - $18K","Right","Reasonable","Very Strong","5'8""","143 lbs","185","15",94,108,8,8,12,10,13,9,6,10,6,6,10,8,10,13,12,8,8,14,11,7,14,12,6,12,8,14,12,14,13,13,8,6,12,12,14,8,11,14,9,11,10,8,6,7,13,13,14,14,13,3,2,3,1,2,3,3,2,3,1,3
"4209",2000168011,"Fitsum Tilahun","7/8/2001 (21 years old)","M (R), AM (RL)","Bahir Dar","Ethiopian Premier Division","ETH","No","7/12/2022","6/30/2024","$1.5K - $18K","Right","Strong","Very Strong","5'5""","130 lbs","51","12",92,108,9,12,14,13,14,8,4,8,8,8,12,7,9,10,14,11,9,8,9,12,14,9,14,12,7,9,10,13,12,10,9,2,13,11,10,2,10,13,11,12,12,10,7,6,6,3,12,11,16,3,3,1,3,2,1,2,3,1,3,3
"4210",2000158078,"Mesfin Tafesse","2/13/2002 (21 years old)","AM (L), ST (C)","Ethiopian Coffee","Ethiopian Premier Division","ETH","No","7/1/2022","6/30/2024","$0 - $45K","Left","Very Strong","Reasonable","5'7""","132 lbs","71","26",82,108,6,10,9,12,13,6,4,8,6,5,10,7,6,8,9,7,5,8,7,12,2,15,12,13,7,7,8,8,13,13,3,2,17,13,9,1,10,12,13,11,11,12,5,3,10,7,12,11,8,2,2,1,1,3,2,1,1,2,1,1
"4211",43191424,"Eyob Zambataro","8/18/1998 (24 years old)","D/WB (L), M (RL)","Lecco","Italian Serie B","ETH","Yes","7/27/2022","6/30/2024","$45K - $450K","Left","Very Strong","Reasonable","5'10""","154 lbs","117","9",102,108,11,11,10,10,10,10,10,9,13,10,10,10,12,10,11,11,10,10,10,11,12,8,10,10,10,12,11,11,11,11,11,10,14,11,13,12,10,11,14,14,8,15,6,11,10,8,12,13,15,3,2,1,1,2,3,3,3,1,2,3
"4212",2000127606,"Muqtar Ahmed","4/15/2005 (18 years old)","DM, M (C)","Winterthur","Swiss First League Classic Group 3","SOM","No","1/17/2022","6/30/2024","$18K - $180K","Right","Reasonable","Very Strong","5'7""","134 lbs","-","-",69,101,6,1,8,5,13,5,6,8,1,7,14,3,13,10,15,6,7,9,7,14,4,5,1,7,9,13,8,12,7,9,14,5,12,9,9,3,10,13,11,12,10,11,9,10,11,1,7,12,19,2,3,3,1,2,3,3,3,2,2,3
"4213",2000168385,"Mesay Agegnehu","12/2/2000 (22 years old)","D (RC), WB (R)","Bahir Dar","Ethiopian Premier Division","ETH","No","7/1/2021","6/30/2025","$14K - $40K","Right","Strong","Very Strong","6'4""","185 lbs","51","1",75,107,4,9,6,3,8,1,8,6,4,6,8,1,12,8,15,7,9,6,7,13,12,5,12,1,9,7,8,8,13,8,7,13,8,12,6,7,18,20,12,11,10,10,12,15,10,4,10,12,7,3,2,1,2,1,1,1,1,2,1,2
"4214",2000171688,"Desta Wamisho","3/13/2003 (20 years old)","ST (C)","Hadiya Hossana","Ethiopian Premier Division","ETH","No","7/1/2020","6/30/2025","$0 - $35K","Right","Reasonable","Very Strong","5'9""","156 lbs","9","2",69,107,5,3,13,13,13,5,13,6,1,5,5,8,2,10,5,8,2,10,6,12,7,10,6,13,6,5,6,6,12,6,6,5,7,9,11,6,10,13,11,11,11,9,14,11,9,1,10,11,13,2,1,3,3,2,2,3,2,2,1,2
"4215",2000117894,"William Solomon","8/26/2002 (20 years old)","M/AM (C)","Adama City","Ethiopian Premier Division","ETH","No","7/1/2022","6/30/2024","$0 - $30K","Right","Reasonable","Very Strong","5'10""","154 lbs","57","5",86,107,7,3,13,10,15,6,8,7,1,8,15,1,10,15,8,9,2,8,7,14,11,15,7,12,9,12,15,7,10,11,9,8,14,10,8,5,12,15,11,13,13,10,7,20,7,8,9,11,13,3,2,2,2,1,1,1,1,3,1,1
"4216",2000088241,"Ramadan Yusef","2/12/2001 (22 years old)","D (RL), WB (L)","Saint George","Ethiopian Premier Division","ETH","No","7/10/2022","6/30/2024","$18K - $55K","Left Only","Very Strong","Weak","5'10""","158 lbs","91","4",93,107,9,13,10,7,9,4,10,6,9,11,10,4,12,10,8,11,11,6,9,14,10,7,1,9,13,11,11,11,12,12,11,5,14,12,8,8,14,17,12,12,10,11,13,5,5,1,20,13,10,1,2,2,3,3,1,1,2,1,3,1
"4217",13211558,"Amanuel Yohannes","4/14/1999 (24 years old)","DM, M (C)","Ethiopian Coffee","Ethiopian Premier Division","ETH","No","6/15/2020","6/30/2025","$0 - $60K","Right","Reasonable","Very Strong","5'8""","149 lbs","80","7",89,105,9,9,7,11,16,9,9,10,6,11,14,4,10,11,12,12,9,10,9,10,14,5,12,8,11,15,9,11,11,9,16,7,15,11,10,6,13,17,14,10,11,9,14,7,13,1,11,12,12,1,1,2,1,2,3,1,3,1,3,2
"4218",2000168394,"Hailemichael Ketemaw","5/20/2002 (21 years old)","DM, M (C)","Bahir Dar","Ethiopian Premier Division","ETH","No","7/1/2020","6/30/2024","$0 - $20K","Right","Weak","Very Strong","5'7""","141 lbs","2","-",53,105,4,4,1,5,12,4,4,2,1,6,10,1,12,9,15,6,6,2,6,12,9,6,2,5,7,6,10,11,12,12,5,4,10,12,6,3,15,20,11,8,10,14,9,14,9,7,8,10,7,1,1,2,2,1,3,1,3,2,3,3
"4219",2000218143,"Tegenu Teshome","10/21/2002 (20 years old)","AM (L), ST (C)","Saint George","Ethiopian Premier Division","ETH","No","7/1/2021","6/30/2025","$1.5K - $14K","Left","Very Strong","Reasonable","5'11""","154 lbs","27","1",70,105,6,9,13,13,12,6,8,7,6,5,11,2,2,7,10,8,4,9,6,13,6,12,1,11,4,7,5,8,13,9,7,8,15,12,9,5,9,13,10,9,14,11,7,1,12,2,10,14,20,1,2,2,1,3,3,3,2,2,1,2
"4220",2000176386,"Yigezu Bogale","1/1/2001 (22 years old)","AM (R), ST (C)","Sidama Coffee","Ethiopian Premier Division","ETH","No","6/15/2020","6/30/2026","$0 - $45K","Right","Reasonable","Very Strong","5'11""","163 lbs","83","34",88,105,8,10,11,14,13,8,15,4,2,8,8,6,6,12,11,12,5,11,9,12,15,12,5,14,8,8,7,10,11,12,9,7,13,10,10,7,10,12,12,11,11,11,8,5,14,6,14,11,18,3,2,1,3,3,1,3,3,2,2,1
"4221",2000171646,"Kaleab Wubishet","3/12/2003 (20 years old)","D (C)","Hadiya Hossana","Ethiopian Premier Division","ETH","No","9/5/2022","6/30/2024","$0 - $35K","Right","Reasonable","Very Strong","6'1""","176 lbs","28","2",74,105,2,4,5,1,7,1,11,6,1,8,5,4,13,6,9,9,9,7,10,13,11,5,6,3,13,6,1,7,13,11,7,13,7,12,4,9,16,10,9,12,10,12,6,11,9,8,10,11,12,1,2,1,1,1,2,1,2,1,2,1
"4222",13200984,"Kenean Markneh","3/30/1998 (25 years old)","M/AM (C)","Mekelakeya","Ethiopian Premier Division","ETH","No","7/13/2022","6/30/2024","$0 - $24K","Right","Reasonable","Very Strong","6'3""","180 lbs","84","16",97,105,7,9,13,10,14,4,3,10,8,6,13,8,10,10,15,8,7,13,10,14,4,15,8,12,10,13,11,10,12,11,9,15,11,12,6,9,12,12,10,9,11,11,12,10,10,6,12,13,7,2,1,2,2,1,1,2,4,2,1,1
"4223",13176651,"Jean-Bosco Ruboneka","1/1/1999 (24 years old)","M (L), AM (LC)","APR FC","Rwandan Premier Division","RWA","No","7/1/2020","6/30/2025","$6K - $60K","Left","Very Strong","Reasonable","6'2""","169 lbs","-","-",86,100,7,11,12,9,14,7,7,4,2,7,9,3,9,9,8,8,8,9,7,9,14,8,6,13,7,9,5,9,14,14,9,12,10,14,11,5,12,12,11,13,13,12,9,6,7,5,11,12,11,1,1,2,2,3,4,1,1,1,1,1
"4224",72052914,"Abdi Mohamed","10/25/1996 (26 years old)","D (RL)","Columbus 2","MLS Next Pro Eastern Conference","SOM","No","2/25/2022","12/31/2023","$0 - $120K","Right Only","Weak","Very Strong","5'11""","152 lbs","76","-",88,101,7,11,8,8,11,5,9,6,7,15,12,7,14,11,12,8,10,10,10,10,10,5,9,9,12,11,8,15,10,12,8,10,10,13,10,9,12,15,11,14,12,10,11,4,6,2,18,12,14,3,1,3,1,4,3,3,1,2,2,1
"4225",13232479,"Surafel Dagnachew","9/11/1997 (25 years old)","M/AM (C)","Fasil Kenema","Ethiopian Premier Division","ETH","No","7/1/2018","6/30/2024","$1.5K - $16K","Right","Reasonable","Very Strong","5'5""","127 lbs","79","4",97,105,8,7,14,13,13,8,7,8,3,9,8,6,6,10,14,9,9,9,9,12,4,10,8,10,8,9,9,10,14,14,7,1,15,14,13,2,17,17,10,13,10,10,9,13,5,2,20,12,17,3,1,3,1,3,2,1,3,3,1,4
"4226",13160975,"Dawa Hotessa","3/9/1996 (27 years old)","AM (C), ST (C)","Adama City","Ethiopian Premier Division","ETH","No","7/1/2021","6/30/2023","$0","Right","Reasonable","Very Strong","5'10""","160 lbs","72","23",94,105,7,9,9,13,12,11,10,9,4,7,8,10,3,13,8,8,8,11,8,13,14,13,14,9,8,8,6,9,13,13,8,6,11,13,13,9,11,11,8,10,12,10,8,11,9,8,11,10,18,3,3,3,3,2,1,1,1,2,1,3
"4227",13209726,"Mujib Kasim","10/19/1995 (27 years old)","AM (C), ST (C)","Hawassa","Ethiopian Premier Division","ETH","No","7/12/2022","6/30/2024","$0 - $45K","Right","Reasonable","Very Strong","5'10""","174 lbs","77","49",90,105,7,7,10,13,9,7,9,9,1,4,9,5,4,12,10,11,7,11,7,11,10,12,7,12,7,7,8,9,13,13,8,6,12,13,13,9,12,17,9,9,9,10,11,9,11,2,11,9,14,2,2,4,2,3,2,3,2,1,1,1
"4228",2000177194,"Chala Teshita","9/11/2000 (22 years old)","M/AM (L), ST (C)","Ethiopian Coffee","Ethiopian Premier Division","ETH","No","7/1/2022","6/30/2025","$0 - $50K","Left","Very Strong","Reasonable","5'8""","147 lbs","71","13",83,105,4,9,13,13,13,6,8,5,1,6,9,5,7,8,5,4,6,5,7,13,4,8,10,11,6,7,9,8,13,13,7,2,7,13,4,4,11,12,12,12,11,13,12,11,10,6,10,12,15,1,3,4,2,1,3,3,2,3,3,3
"4229",2000168201,"Habib Kemal","3/13/2001 (22 years old)","M/AM (L)","Ethiopia Medin","Ethiopian Premier Division","ETH","No","7/14/2022","6/30/2025","$16K - $45K","Left","Very Strong","Reasonable","5'9""","147 lbs","46","13",83,105,7,11,14,11,14,7,5,8,7,7,11,3,4,10,7,9,8,9,8,12,5,13,2,14,7,8,7,9,14,13,8,8,12,13,5,4,13,12,13,15,9,10,7,9,15,4,11,11,20,2,1,2,1,2,1,2,1,3,3,2
"4230",2000158079,"Fasil Gebremichael","10/17/2000 (22 years old)","GK","Bahir Dar","Ethiopian Premier Division","ETH","No","7/1/2021","6/30/2024","$500 - $6K","Right Only","Very Weak","Very Strong","5'10""","165 lbs","45","-",82,105,1,2,2,1,2,4,1,2,2,3,8,1,2,2,9,5,12,2,6,13,5,3,8,1,10,7,6,6,11,16,10,7,9,12,5,10,9,17,10,10,10,9,12,7,6,8,9,13,15,9,13,13,6,10,10,11,5,6,11,7
"4231",2000225502,"Amanuel Admassu","1/7/2003 (20 years old)","ST (C)","Ethiopian Coffee","Ethiopian Premier Division","ETH","No","7/1/2022","6/30/2025","$0 - $26K","Right","Fairly Strong","Very Strong","5'10""","152 lbs","10","-",59,104,4,4,12,12,12,4,12,1,2,3,5,5,1,7,10,8,3,5,4,10,6,13,8,12,2,4,3,5,12,12,5,3,9,12,7,2,12,14,13,10,12,11,7,11,14,5,11,13,17,2,1,2,3,1,3,1,3,3,3,3
"4232",2000158086,"Mignot Debebe","9/2/1995 (27 years old)","D (C)","Saint George","Ethiopian Premier Division","ETH","No","7/1/2021","6/30/2023","$0","Right Only","Weak","Very Strong","6'0""","174 lbs","80","2",96,103,4,3,4,3,9,5,14,5,4,14,11,7,10,5,15,9,11,9,11,11,8,5,6,6,14,8,5,9,12,11,12,11,12,11,12,11,16,18,12,12,11,10,12,8,7,5,11,12,16,2,2,2,3,3,4,1,3,2,1,4
"4233",2000161110,"Biruk Mengesha","8/16/2002 (20 years old)","DM, M (C)","Adama City","Ethiopian Premier Division","ETH","No","7/1/2020","6/30/2025","$0 - $24K","Right","Reasonable","Very Strong","5'10""","152 lbs","4","-",50,103,4,1,2,5,8,4,2,7,4,4,11,2,9,9,7,8,6,5,6,12,6,5,12,5,9,6,11,9,12,11,5,3,13,12,4,4,13,13,11,12,9,9,5,6,8,6,11,8,18,3,3,2,2,2,2,1,1,1,2,2
"4234",2000174870,"Eyob Alemayehu","2/27/2002 (21 years old)","M (L), AM (LC)","Hawassa","Ethiopian Premier Division","ETH","No","7/1/2022","6/30/2024","$0 - $45K","Left","Very Strong","Strong","5'11""","154 lbs","62","9",72,103,7,12,10,13,13,3,6,6,6,6,11,4,8,11,8,8,5,9,7,7,6,11,13,8,6,7,5,11,10,12,7,8,9,13,6,4,14,18,11,11,13,13,11,9,5,2,10,8,19,1,1,1,2,3,1,4,3,2,1,2
"4235",43056629,"Abel Gigli","8/16/1990 (32 years old)","D (C)","Correggese","Italian Eccellenza Emilia-Romagna Grp.A","SOM","Yes","1/2/2023","6/30/2024","$16K - $45K","Right Only","Very Weak","Very Strong","6'2""","174 lbs","206","8",76,101,4,7,5,4,9,4,12,5,6,9,9,4,12,8,7,9,7,10,10,9,10,5,11,9,13,9,8,7,11,10,13,14,13,12,10,10,7,9,10,12,10,11,10,9,8,4,10,11,12,2,1,2,2,3,2,3,1,3,2,3
"4236",2000226445,"Yared Kasaye","6/16/2002 (20 years old)","D (L)","Ethiopia Medin","Ethiopian Premier Division","ETH","No","7/1/2020","6/30/2025","$10K - $30K","Left","Very Strong","Reasonable","5'9""","149 lbs","21","-",73,103,7,13,4,1,5,3,8,1,7,11,6,7,13,7,14,9,9,8,8,14,9,5,11,7,9,8,7,8,14,12,8,9,11,12,5,5,13,12,12,8,10,12,7,14,5,4,19,9,12,2,3,3,3,2,2,2,2,2,2,2
"4237",29162872,"Aschalew Tamene","11/22/1991 (31 years old)","D (C)","Fasil Kenema","Ethiopian Premier Division","ETH","No","7/1/2021","6/30/2023","$0","Right","Reasonable","Very Strong","6'4""","189 lbs","63","1",88,102,4,6,1,3,9,1,12,6,2,15,8,7,15,6,11,10,9,8,12,11,16,6,2,8,13,8,5,9,10,11,9,13,13,9,8,11,11,10,11,12,12,11,11,11,11,2,11,10,10,3,3,1,4,3,3,4,3,3,2,3
"4238",2000176076,"Yonas Abule","11/21/2003 (19 years old)","D/WB (R)","Sebeta Kenema","Ethiopian Lower Divisions","ETH","No","11/5/2022","6/30/2023","$0","Right","Reasonable","Very Strong","6'1""","158 lbs","7","-",61,102,5,6,6,2,9,1,5,1,5,5,7,1,6,5,13,6,7,6,10,9,18,5,2,6,6,6,4,7,13,13,6,11,15,13,12,4,12,20,10,10,9,12,7,4,6,6,10,12,9,1,3,4,3,3,3,2,2,3,2,1
"4239",2000161117,"Biniam Ayten","3/31/2003 (20 years old)","M (C)","Adama City","Ethiopian Premier Division","ETH","No","7/1/2020","6/30/2025","$9K - $28K","Right","Fairly Strong","Very Strong","5'9""","147 lbs","37","4",60,102,2,3,4,5,12,4,4,8,1,9,12,1,8,12,14,4,5,7,5,11,11,5,4,9,5,6,5,11,12,12,5,3,11,12,6,3,8,16,12,13,13,10,7,8,9,5,11,12,11,1,2,3,2,1,1,1,2,2,2,2
"4240",29178756,"Binyam Belay","7/18/1998 (24 years old)","DM, M/AM (C)","Saint George","Ethiopian Premier Division","ETH","No","7/12/2022","6/30/2024","$0 - $40K","Right","Weak","Very Strong","5'8""","154 lbs","137","9",98,101,10,10,13,8,12,10,6,8,6,7,11,7,7,12,11,11,10,10,10,9,11,12,6,11,9,11,11,11,15,14,8,6,12,14,12,7,6,10,10,11,11,8,7,5,10,9,11,11,12,3,3,3,4,2,3,3,3,2,2,4
"4241",2000226364,"Matiyas Woldearegay","7/29/2000 (22 years old)","M (C)","Wolkite City","Ethiopian Premier Division","ETH","No","9/28/2022","6/30/2025","$0 - $26K","Right","Reasonable","Very Strong","5'11""","152 lbs","6","-",70,101,3,6,3,5,13,6,1,4,1,9,13,3,7,13,6,10,7,8,5,11,10,7,9,8,8,7,13,6,11,13,7,10,15,12,6,4,14,20,11,10,12,10,13,11,10,1,12,10,8,2,2,3,3,1,1,3,3,2,3,3
"4242",23189906,"Abdul Salam Al-Mukhaini","4/7/1988 (35 years old)","D (C)","Dhofar","Omani Professional League","OMA","No","10/4/2021","6/30/2024","$0 - $7K","Right","Reasonable","Very Strong","6'2""","185 lbs","79","4",102,122,7,5,1,5,9,7,15,8,6,15,9,1,15,4,10,15,11,10,11,10,19,5,11,9,15,9,9,10,10,11,10,10,14,11,7,8,12,11,11,10,10,8,10,4,5,3,12,11,10,1,1,3,2,3,3,3,3,2,3,3
"4243",23357530,"Saad Suhail","9/6/1987 (35 years old)","D (RL)","Al-Orouba","Omani Professional League","OMA","No","8/10/2022","6/30/2023","$0","Right","Reasonable","Very Strong","5'7""","147 lbs","87","10",108,122,10,15,7,4,11,6,11,7,9,14,11,4,16,11,8,12,11,11,13,14,6,7,5,10,12,11,8,11,12,12,7,8,7,10,12,6,14,10,9,9,12,14,5,12,10,7,9,12,18,3,1,3,3,1,3,1,2,2,2,1
"4244",23166223,"Mohamed Al-Musalami","4/27/1990 (33 years old)","D (C)","Al-Seeb","Omani Professional League","OMA","No","6/16/2022","6/30/2023","$0","Left","Very Strong","Reasonable","5'9""","154 lbs","41","2",91,117,3,2,6,1,9,1,14,6,5,14,9,7,12,5,10,12,10,8,9,14,6,5,7,8,14,8,8,9,10,12,9,4,14,10,6,9,12,16,12,12,12,12,9,17,9,6,10,10,18,1,3,1,3,3,3,3,3,4,2,3
"4245",64047615,"Arshad Al-Alawi","4/12/2000 (23 years old)","M/AM (C)","Al-Seeb","Omani Professional League","OMA","No","6/1/2023","6/30/2024","$1.5K - $16K","Right","Weak","Very Strong","5'11""","174 lbs","10","-",95,115,8,8,9,13,11,8,8,8,5,8,13,6,4,14,10,9,8,10,8,12,13,13,1,10,3,9,12,10,14,14,9,9,13,14,7,6,12,20,10,11,8,9,7,12,5,7,10,11,19,2,2,3,4,2,3,3,1,3,2,1
"4246",20503478,"Ali Musse","1/1/1996 (27 years old)","AM (R), ST (C)","Cavalry FC","Canadian Premier League","SOM","No","1/25/2023","11/30/2024","$60K - $600K","Left Only","Very Strong","Weak","5'11""","163 lbs","92","25",92,100,7,9,13,11,9,8,8,8,7,9,9,3,9,11,12,12,12,8,7,11,13,10,14,12,9,10,11,14,14,10,9,9,11,14,9,10,13,15,12,9,12,11,7,6,7,3,11,13,19,3,1,2,1,1,2,3,2,3,1,4
"4247",23277015,"Qasim Said","4/20/1989 (34 years old)","M (L), AM (LC)","Dhofar","Omani Professional League","OMA","No","10/4/2021","6/30/2024","$500 - $4K","Left","Very Strong","Reasonable","5'11""","156 lbs","37","6",96,114,9,14,8,10,11,9,8,11,5,9,12,9,7,14,8,12,10,9,10,15,13,12,5,15,9,9,10,13,11,8,10,12,7,9,8,7,18,19,12,13,9,11,13,19,13,5,12,10,13,3,2,3,3,3,1,4,1,1,3,2
"4248",23191271,"Eid Al-Farsi","11/8/1990 (32 years old)","M (C)","Al-Seeb","Omani Professional League","OMA","No","6/6/2022","6/30/2023","$0","Right","Reasonable","Very Strong","6'0""","169 lbs","99","9",87,113,3,6,6,4,14,7,6,8,1,12,14,2,9,13,5,13,8,9,8,7,5,5,10,13,8,8,13,10,9,11,8,11,7,11,7,7,12,10,11,11,10,13,5,3,10,2,11,10,9,2,3,1,1,1,3,3,2,3,3,3
"4249",23291804,"Mohammed Al-Mashari","12/4/1990 (32 years old)","M/AM (C)","Al-Suwaiq","Omani Lower Division","OMA","No","6/30/2022","6/30/2024","$0","Right","Fairly Strong","Very Strong","5'10""","149 lbs","51","3",94,112,2,6,4,14,13,6,4,10,8,9,11,4,10,14,15,11,9,9,8,14,4,13,8,14,8,7,14,7,13,12,9,9,9,10,12,6,15,18,9,11,7,11,7,13,10,6,13,10,20,1,3,2,3,2,3,1,1,1,2,1
"4250",64048230,"Zahir Al-Aghbari","5/28/1999 (24 years old)","M/AM (RL)","Al-Khalidiya","Bahrain Premier League","OMA","No","7/21/2022","6/30/2024","$0 - $35K","Right","Reasonable","Very Strong","5'10""","152 lbs","7","-",96,112,8,13,10,14,14,8,6,10,3,5,10,7,5,10,14,10,8,14,7,11,14,9,12,14,6,9,10,12,14,14,9,4,11,14,10,6,12,18,9,11,10,12,8,16,13,8,17,12,19,2,1,3,1,1,2,2,3,3,3,2
"4251",23227648,"Abdulaziz Al-Muqbali","4/23/1989 (34 years old)","ST (C)","Al-Seeb","Omani Professional League","OMA","No","6/6/2022","6/30/2023","$0","Right","Fairly Strong","Very Strong","5'11""","165 lbs","99","32",97,112,6,7,8,14,11,8,14,7,8,6,9,10,1,12,5,13,3,11,9,13,7,11,13,12,7,8,6,9,11,11,7,10,7,9,11,6,13,12,10,10,10,10,5,14,5,4,9,10,20,2,2,2,2,2,3,2,3,2,2,2
"4252",64043431,"Mataz Saleh","5/28/1996 (27 years old)","D/WB (L), M (RL), AM (L)","Dhofar","Omani Professional League","OMA","No","10/4/2021","6/30/2024","$500 - $6K","Right","Fairly Strong","Very Strong","5'10""","163 lbs","-","-",90,110,7,12,7,13,8,7,7,5,7,7,11,6,8,11,7,6,9,9,9,13,8,11,10,13,8,9,8,9,13,13,9,6,7,13,5,5,13,17,14,14,11,12,11,1,5,5,9,11,11,3,3,1,1,2,1,2,1,2,2,3
"4253",23291778,"Ali Al-Jabri","1/29/1990 (33 years old)","DM","Al-Nahda","Omani Professional League","OMA","No","6/8/2022","6/30/2023","$0","Right","Fairly Strong","Very Strong","5'9""","152 lbs","12","-",91,110,7,8,4,8,14,5,8,11,2,13,13,5,14,10,8,10,9,10,10,14,5,5,10,8,13,9,11,13,7,11,7,6,8,8,9,6,17,17,12,13,11,11,9,15,8,1,20,9,20,3,1,3,1,1,1,3,2,3,1,3
"4254",64048296,"Muayyad Al-Balushi","6/19/1999 (23 years old)","ST (C)","Muscat","Omani First Division Group B","OMA","No","7/1/2022","6/30/2024","$0 - $16K","Right","Reasonable","Very Strong","5'10""","160 lbs","-","-",76,110,6,4,11,13,10,6,13,7,1,6,7,5,4,10,7,6,4,11,7,10,15,13,8,12,5,6,7,7,13,13,7,4,10,13,5,9,9,18,12,10,9,7,8,8,12,5,17,11,19,1,2,1,1,2,1,3,3,2,3,1
"4255",23459442,"Harib Al-Saadi","2/1/1990 (33 years old)","AM (C)","Al-Suwaiq","Omani Lower Division","OMA","No","8/31/2022","6/30/2024","$0 - $14K","Right","Weak","Very Strong","5'6""","138 lbs","41","2",95,110,5,9,12,13,14,6,5,10,4,6,15,6,9,15,14,12,6,7,9,15,14,13,14,15,8,10,13,13,11,8,10,2,12,11,8,4,12,13,12,15,9,12,6,10,6,6,20,12,19,2,3,3,3,3,1,3,2,1,3,3
"4256",23079693,"Younis Khalifa Al-Mushaifri","10/24/1981 (41 years old)","AM (RC), ST (C)","Al-Ittihad","Omani First Division Group A","OMA","No","9/18/2021","6/30/2024","$0","Right","Reasonable","Very Strong","5'10""","163 lbs","-","-",80,110,9,11,6,14,9,8,15,9,7,9,16,9,8,11,15,13,9,8,9,12,12,8,13,16,9,10,9,11,6,6,6,9,6,6,6,6,8,15,9,9,11,13,8,5,12,8,20,9,9,2,2,1,2,3,3,4,3,2,1,2
"4257",2000088387,"Omar Kale","6/21/2001 (21 years old)","D (C)","Horseed","Somali Premier Division","SOM","No","7/1/2019","6/30/2024","$0","Right","Fairly Strong","Very Strong","6'4""","182 lbs","-","-",61,97,1,1,1,1,4,1,13,4,1,11,6,1,11,5,13,9,5,5,8,13,8,5,9,5,13,5,1,6,11,9,6,10,10,8,4,7,12,16,10,11,10,10,9,15,5,8,9,13,7,4,4,2,2,3,3,1,2,4,3,2
"4258",64045483,"Muhsen Al-Ghassani","3/27/1997 (26 years old)","ST (C)","Al-Seeb","Omani Professional League","OMA","No","3/1/2021","6/30/2024","$3K - $30K","Right","Reasonable","Very Strong","5'10""","152 lbs","49","22",100,110,7,5,11,14,13,8,14,7,3,7,7,4,4,14,12,14,8,8,9,10,3,13,13,11,7,8,8,9,14,13,9,7,7,14,9,8,10,12,10,9,11,10,6,9,10,4,9,13,17,1,3,3,1,2,3,2,1,4,2,3
"4259",2000142657,"Qusai Adel","9/2/2003 (19 years old)","GK","Dhofar","Omani Professional League","OMA","No","10/4/2021","6/30/2024","$9K - $28K","Right","Reasonable","Very Strong","6'0""","138 lbs","-","-",70,109,2,3,2,1,5,4,1,2,1,2,7,3,2,3,12,6,11,2,9,13,16,3,9,1,6,7,5,6,11,6,7,9,13,10,1,5,9,14,10,9,8,10,8,4,8,6,18,12,19,6,10,13,5,9,9,12,5,10,12,9
"4260",2000181110,"Harib Al-Adawi","6/13/2002 (20 years old)","M (RL)","Al-Seeb","Omani Professional League","OMA","No","7/1/2020","6/30/2025","$0 - $16K","Left","Very Strong","Reasonable","5'10""","154 lbs","-","-",72,109,9,13,6,8,13,4,5,7,5,7,9,8,4,8,13,8,3,12,6,9,5,5,2,6,5,3,7,8,14,11,8,4,12,11,13,5,12,16,12,10,9,11,11,11,5,7,16,10,12,3,2,4,3,3,3,2,3,1,1,2
"4261",2000018206,"Amran Al-Hidi","4/7/1998 (25 years old)","D (C), DM","Al-Nahda","Omani Professional League","OMA","No","6/8/2022","6/30/2023","$0","Right","Fairly Strong","Very Strong","6'4""","174 lbs","34","5",87,109,5,2,3,6,8,7,14,6,2,12,9,3,13,4,11,8,9,7,6,14,7,5,12,7,13,7,9,9,14,9,8,12,16,13,9,7,15,17,12,10,13,12,5,8,7,8,13,10,20,3,1,1,1,1,3,2,3,1,3,1
"4262",23301249,"Said Al-Ruzaiqi","12/12/1986 (36 years old)","ST (C)","Al-Nasr (OMA)","Omani Professional League","OMA","No","9/10/2021","6/30/2024","$1.5K - $5K","Right","Reasonable","Very Strong","5'11""","169 lbs","57","49",99,108,6,9,10,15,14,8,15,7,7,5,10,12,7,9,12,14,9,14,9,15,11,10,12,11,10,9,9,10,10,10,10,11,5,10,10,10,11,15,11,13,10,8,12,11,10,6,5,10,10,3,3,2,3,3,1,3,3,1,3,3
"4263",2000142548,"Abu Bakar Al-Dabdoub","1/15/2004 (19 years old)","DM, M (C)","Sohar","Omani Professional League","OMA","No","7/1/2020","6/30/2024","$0 - $22K","Right","Fairly Strong","Very Strong","5'9""","152 lbs","-","-",60,108,2,5,7,4,7,6,6,7,3,9,9,1,6,8,6,9,7,8,8,9,7,5,1,7,8,8,10,12,14,14,4,7,8,11,7,5,10,19,11,11,12,11,6,8,6,7,8,13,16,1,3,2,1,2,1,3,1,3,3,2
"4264",2000142861,"Al-Azhar Al-Balushi","11/15/2002 (20 years old)","M (C)","Al-Orouba","Omani Professional League","OMA","No","8/11/2022","6/30/2023","$0","Right","Reasonable","Very Strong","5'11""","138 lbs","-","-",67,108,1,5,3,7,11,5,6,7,1,13,10,5,8,13,14,8,6,9,7,11,17,8,11,7,7,8,13,12,12,9,7,9,11,10,9,6,13,19,12,10,11,10,11,13,11,5,12,11,11,3,3,1,1,3,2,2,2,3,2,1
"4265",64045378,"Faiz Al-Rushaidi","7/19/1988 (34 years old)","GK","Al-Suwaiq","Omani Lower Division","OMA","No","7/1/2022","6/30/2024","$0 - $16K","Right","Fairly Strong","Very Strong","6'1""","185 lbs","85","-",105,108,2,3,3,2,6,7,1,1,3,1,11,1,3,1,7,9,11,8,12,15,11,2,8,3,10,10,9,8,12,10,9,9,13,11,3,8,11,12,11,14,11,12,9,3,5,4,20,10,11,9,6,11,9,12,10,15,5,9,11,11
"4266",2000142678,"Hussein Al-Shehri","12/26/2002 (20 years old)","ST (C)","Dhofar","Omani Professional League","OMA","No","10/4/2021","6/30/2024","$0 - $18K","Right","Fairly Strong","Very Strong","5'10""","147 lbs","-","-",81,106,6,2,10,13,10,6,13,7,1,6,7,6,6,12,11,9,7,6,7,9,3,12,1,12,7,6,6,7,13,13,7,6,15,13,12,6,10,10,11,11,12,12,15,10,13,6,10,13,13,2,3,1,1,2,3,3,3,1,3,2
"4267",2000143780,"Al-Baraa Al-Maawali","9/2/1999 (23 years old)","D (R)","Al-Musannah","Omani Professional League","OMA","No","9/21/2021","6/30/2024","$0 - $12K","Right","Fairly Strong","Very Strong","5'10""","141 lbs","9","-",75,105,6,12,1,4,11,2,6,5,7,9,9,6,11,9,7,8,9,7,10,12,9,8,4,6,10,8,8,8,14,14,8,9,15,14,7,5,14,11,10,11,9,14,6,7,5,7,13,11,11,1,3,1,3,2,2,2,1,1,2,3
"4268",93126011,"Isse Ismail","3/8/1999 (24 years old)","M/AM (C)","IFK Stocksund","Swedish First Division North","SOM","Yes","2/20/2023","12/31/2023","$0","Left Only","Very Strong","Weak","6'3""","165 lbs","47","2",60,96,8,9,9,6,9,7,7,7,7,8,9,8,8,9,10,9,8,7,8,8,10,9,6,9,9,9,9,9,12,10,7,13,14,12,11,7,7,10,10,10,10,10,5,5,9,7,9,10,11,3,3,1,1,2,2,3,2,1,1,4
"4269",2000142651,"Nayef Faraj","9/18/2001 (21 years old)","D/WB/M (L)","Dhofar","Omani Professional League","OMA","No","10/4/2021","6/30/2024","$1K - $8K","Left","Very Strong","Reasonable","5'9""","130 lbs","-","-",70,105,7,11,8,6,9,5,6,1,4,8,9,3,9,9,12,9,8,8,9,8,7,5,2,5,5,8,7,9,13,11,8,8,15,12,14,5,13,15,11,10,10,11,10,13,5,1,20,9,10,1,3,2,3,2,3,1,2,3,1,3
"4270",2000181338,"Issam Al-Makhzoomi","9/28/2000 (22 years old)","M/AM (C)","Al-Seeb","Omani Professional League","OMA","No","7/1/2019","6/30/2025","$0 - $40K","Right","Fairly Strong","Very Strong","5'5""","127 lbs","14","-",82,105,7,7,9,10,14,3,7,7,1,8,13,8,6,12,9,8,8,14,7,13,10,11,7,7,4,8,9,13,11,12,8,1,12,11,11,1,11,11,13,12,11,8,11,11,9,5,14,12,15,1,3,2,3,2,3,1,2,2,3,1
"4271",2000142136,"Naguib Mahfouz","5/27/2001 (22 years old)","M (C)","Al-Nasr (OMA)","Omani Professional League","OMA","No","8/5/2021","6/30/2023","$0 - $10K","Right","Reasonable","Very Strong","5'10""","160 lbs","-","-",70,105,6,3,2,4,13,6,6,6,2,8,10,1,7,9,11,8,1,4,6,12,7,5,9,12,11,7,11,12,13,13,7,6,15,13,8,6,11,19,11,11,11,11,11,12,11,4,18,10,10,2,2,1,2,2,2,2,3,2,1,1
"4272",64048236,"Mohammed Al-Ghassani","4/1/1985 (38 years old)","AM (C), ST (C)","Sur","Omani Professional League","OMA","No","6/25/2022","6/30/2024","$0","Right","Reasonable","Very Strong","5'10""","160 lbs","6","-",90,105,9,9,8,15,11,9,10,11,9,9,10,8,5,11,11,12,9,15,7,14,4,15,15,14,9,9,9,11,8,7,8,7,18,8,8,7,9,18,13,7,10,11,6,15,10,8,12,10,10,1,3,3,1,3,2,1,3,3,1,3
"4273",64047655,"Sultan Saeed","9/15/2000 (22 years old)","DM, M (RLC)","Al-Nasr (OMA)","Omani Professional League","OMA","No","7/29/2021","6/30/2023","$0","Left","Very Strong","Reasonable","5'11""","160 lbs","-","-",77,105,6,9,8,7,12,4,6,8,2,7,10,1,10,13,8,6,8,5,8,11,7,6,11,7,8,7,6,8,13,13,5,9,6,13,13,5,15,20,13,9,10,12,5,16,10,5,12,12,16,2,1,3,1,1,3,1,1,4,2,1
"4274",64043275,"Ali Al-Busaidi","1/21/1991 (32 years old)","D (RL), WB/M/AM (L)","Al-Seeb","Omani Professional League","OMA","No","6/12/2022","6/30/2023","$0","Right","Reasonable","Very Strong","5'8""","152 lbs","85","10",97,105,9,11,9,13,12,9,4,2,9,10,10,7,5,9,11,12,10,9,11,12,16,15,6,12,11,6,9,11,9,11,10,8,13,10,14,8,13,12,10,11,11,12,13,2,5,8,12,9,10,3,3,2,3,1,3,2,3,2,3,1
"4275",2000142668,"Ammar Abed","2/16/2003 (20 years old)","D (C)","Dhofar","Omani Professional League","OMA","No","10/4/2021","6/30/2024","$0 - $8K","Right","Reasonable","Very Strong","5'9""","143 lbs","-","-",67,105,2,1,4,1,7,1,9,4,6,14,6,4,14,2,8,11,8,6,5,13,14,5,3,4,12,6,3,7,8,11,7,5,12,9,8,7,14,11,10,10,10,12,6,11,13,7,10,13,19,3,3,1,2,1,1,2,3,1,2,3
"4276",64043430,"Salaah Al-Yahyaei","8/17/1998 (24 years old)","M/AM (C)","Al-Seeb","Omani Professional League","OMA","No","12/1/2020","6/30/2024","$0 - $40K","Right","Fairly Strong","Very Strong","5'10""","138 lbs","65","12",100,105,8,6,10,12,14,8,8,10,4,10,8,8,8,11,14,10,6,12,8,14,16,10,11,9,10,9,12,12,14,14,9,9,12,14,7,6,11,10,10,8,10,8,5,9,12,6,20,9,19,3,3,2,3,3,3,1,3,1,2,3
"4277",2000105045,"Yazed Al-Maashani","5/13/1998 (25 years old)","M/AM (L)","Dhofar","Omani Professional League","OMA","No","6/15/2020","6/30/2024","$8K - $26K","Right","Reasonable","Very Strong","5'10""","167 lbs","52","10",90,105,8,13,8,12,13,7,9,9,6,3,13,3,7,11,11,9,2,9,7,13,11,11,13,12,7,8,12,7,9,12,8,7,9,12,14,3,11,20,8,9,12,9,13,4,12,1,16,11,18,1,1,2,1,3,3,1,3,3,2,3
"4278",64050172,"Marwan Talal","2/23/1999 (24 years old)","M/AM (L)","Al-Nasr (OMA)","Omani Professional League","OMA","No","9/9/2021","6/30/2023","$0 - $7K","Left","Very Strong","Weak","6'0""","163 lbs","3","-",79,105,8,12,8,10,11,7,4,6,6,5,8,5,7,11,10,9,6,11,6,14,9,10,8,11,7,8,5,7,14,12,6,6,9,13,6,5,15,10,7,9,12,12,11,18,8,6,10,12,10,1,2,2,3,3,2,1,1,2,1,1
"4279",88025271,"Mohamed Awad","5/7/1994 (29 years old)","M (RL), AM (RLC)","Sliema W.","Maltese Premier League","SOM","No","5/9/2023","5/31/2024","$8K - $85K","Left Only","Very Strong","Weak","5'8""","136 lbs","134","43",81,95,7,7,13,9,11,6,3,9,5,1,9,8,4,11,8,11,9,10,7,8,16,16,7,8,5,7,9,9,13,15,14,5,12,11,8,4,12,10,12,9,11,13,5,2,7,7,10,9,18,2,2,1,2,1,2,3,1,3,1,3
"4280",2000142674,"Mohammed Al-Sim","11/10/1999 (23 years old)","D/WB (L)","Dhofar","Omani Professional League","OMA","No","10/4/2021","6/30/2023","$0 - $7K","Left","Very Strong","Fairly Strong","5'10""","163 lbs","-","-",83,105,9,12,8,2,13,4,7,7,8,10,9,4,14,8,8,12,9,7,12,14,5,10,3,8,11,5,9,10,9,11,10,9,14,12,10,6,12,18,14,13,10,13,5,1,8,4,10,7,18,3,3,3,3,2,2,2,3,3,2,3
"4281",23291793,"Raed Ibrahim Saleh","6/9/1992 (31 years old)","M/AM (C)","Dhofar","Omani Professional League","OMA","No","7/19/2022","6/30/2024","$18K - $55K","Right","Reasonable","Very Strong","5'10""","147 lbs","56","17",95,105,8,9,9,12,14,8,6,10,1,8,7,3,9,14,11,13,4,9,6,14,3,13,14,10,8,9,11,11,13,14,9,6,14,12,8,6,13,15,10,13,10,13,11,14,6,4,11,9,16,3,1,2,2,1,2,2,2,3,1,2
"4282",2000285886,"Musaab Al-Maamari","1/22/2000 (23 years old)","M/AM (C)","Al-Rustaq","Omani Professional League","OMA","No","6/15/2020","6/30/2026","$0","Right","Reasonable","Very Strong","6'0""","160 lbs","30","4",85,105,7,7,8,8,12,7,6,8,6,9,10,3,9,10,11,9,6,8,6,14,14,13,13,9,8,8,9,9,14,10,8,9,15,12,10,6,11,18,12,8,11,11,7,11,5,2,10,11,17,1,1,2,1,3,3,3,1,3,1,1
"4283",64048767,"Ibrahim Al-Mukhaini","6/20/1997 (25 years old)","GK","Al-Nahda","Omani Professional League","OMA","No","6/9/2022","6/30/2025","$500 - $4.5K","Right","Fairly Strong","Very Strong","6'1""","171 lbs","61","-",100,105,3,2,3,2,1,7,1,1,1,2,8,2,1,3,9,8,15,8,9,13,8,3,10,2,9,8,7,7,12,13,8,11,8,10,2,6,13,11,10,10,11,10,13,9,8,2,10,10,16,9,12,13,9,6,12,12,5,11,8,12
"4284",2000181344,"Mohammed Ahmed Allah","11/4/1999 (23 years old)","WB (L)","Dhofar","Omani Professional League","OMA","No","7/1/2020","6/30/2024","$0 - $10K","Right","Reasonable","Very Strong","5'9""","152 lbs","-","-",74,104,5,8,8,6,12,1,5,7,5,6,5,2,8,14,13,9,3,8,9,9,5,8,1,8,8,8,7,8,14,14,8,4,13,14,9,7,12,10,12,11,10,12,6,14,5,1,13,13,16,1,1,2,4,2,1,1,3,2,2,1
"4285",64043449,"Al-Mandhar Al-Alawi","3/31/1995 (28 years old)","M (C)","Al-Nahda","Omani Professional League","OMA","No","6/14/2022","6/30/2025","$14K - $40K","Right","Fairly Strong","Very Strong","6'0""","169 lbs","50","8",95,103,8,7,7,5,14,8,8,11,1,14,10,5,10,9,13,10,6,12,8,14,15,10,9,11,9,9,14,9,14,12,9,9,7,14,13,7,15,12,11,12,10,10,6,10,8,8,17,10,16,2,3,4,2,2,1,4,3,1,1,1
"4286",64048769,"Mohamed Khasib","3/24/1994 (29 years old)","M/AM (RL)","Al-Nahda","Omani Professional League","OMA","No","1/26/2020","6/30/2024","$16K - $50K","Right","Reasonable","Very Strong","5'6""","141 lbs","75","8",89,103,8,13,12,6,10,7,5,8,7,7,11,1,7,11,14,6,6,6,6,11,16,12,6,12,7,8,6,12,14,14,7,1,14,14,7,4,15,20,8,11,11,13,9,13,9,1,14,12,20,3,1,2,4,2,2,2,4,1,1,3
"4287",64043450,"Abdullah Fawaz","10/3/1996 (26 years old)","DM, M/AM (C)","Dhofar","Omani Professional League","OMA","No","6/15/2020","6/30/2024","$0","Right","Reasonable","Very Strong","5'9""","165 lbs","65","8",95,103,4,3,9,8,13,7,7,13,6,6,9,5,11,8,15,9,9,9,9,11,10,8,11,9,12,8,12,12,13,13,8,5,15,13,11,5,12,12,10,9,10,12,7,7,15,5,12,11,15,1,3,2,3,1,3,2,2,3,1,1
"4288",64043292,"Ali Salim","8/21/1992 (30 years old)","D (L)","Dhofar","Omani Professional League","OMA","No","10/4/2021","6/30/2024","$0 - $16K","Left","Very Strong","Reasonable","5'6""","163 lbs","25","3",98,103,7,12,7,3,12,3,10,6,8,12,8,6,13,9,9,12,11,10,13,10,13,7,15,8,13,10,9,10,15,15,10,3,16,15,7,4,12,20,13,10,11,13,6,5,10,8,13,11,15,1,2,1,3,4,1,3,1,3,1,2
"4289",64047826,"Nadhir Awadh","12/5/1994 (28 years old)","D (RC)","Al-Nasr (OMA)","Omani Professional League","OMA","No","9/11/2019","6/30/2024","$0 - $18K","Right","Reasonable","Very Strong","5'10""","158 lbs","6","-",91,103,7,10,4,4,10,4,10,3,2,14,9,1,14,8,15,12,10,9,12,10,13,5,10,5,9,8,7,9,14,14,9,8,15,14,10,8,20,11,10,11,10,12,9,6,12,1,12,13,20,1,1,1,3,1,2,2,3,1,3,2
"4290",2000103077,"Osman Abdi","3/7/2006 (17 years old)","M (C)","FK Austria Vienna","Austrian Premier Division","SOM","No","6/13/2022","6/30/2025","$200K - $600K","Right","Reasonable","Very Strong","6'4""","182 lbs","-","-",74,94,8,6,4,9,13,8,8,10,1,10,14,2,9,12,14,8,5,9,8,8,9,5,10,8,6,8,8,13,12,12,9,18,8,13,11,9,13,19,12,13,11,13,12,7,14,5,11,10,16,3,3,3,3,1,3,1,3,2,3,1
"4291",54200095,"Mohammed Faraj","4/26/1993 (30 years old)","D (C)","Al-Ittihad","Omani First Division Group A","OMA","No","8/31/2022","6/30/2023","$0","Left Only","Very Strong","Very Weak","5'11""","167 lbs","41","2",51,103,6,8,8,5,9,8,7,6,4,9,10,7,8,10,12,9,10,7,6,6,9,9,7,8,9,9,11,7,11,13,11,11,8,10,8,10,10,18,14,12,9,9,12,3,6,4,7,12,15,2,1,3,2,3,1,2,2,3,2,1
"4292",64047859,"Mohammed Al-Ghafri","5/17/1997 (26 years old)","ST (C)","Al-Rustaq","Omani Professional League","OMA","No","6/12/2022","6/30/2023","$0","Right","Reasonable","Very Strong","6'0""","152 lbs","22","4",94,103,5,7,13,13,12,7,13,6,4,5,8,10,3,8,12,10,9,13,7,13,4,8,1,13,5,7,8,8,13,10,6,5,14,13,13,10,13,16,10,10,10,11,12,9,12,1,7,9,13,2,1,2,2,1,1,2,1,2,1,1
"4293",2000181340,"Mohammed Al-Hatmi","10/27/2001 (21 years old)","ST (C)","Al-Seeb","Omani Professional League","OMA","No","7/1/2020","6/30/2025","$0 - $28K","Left","Very Strong","Reasonable","6'0""","160 lbs","9","-",72,103,4,3,10,13,13,2,13,6,3,5,7,10,1,9,5,5,8,12,7,11,15,10,2,13,6,6,7,5,12,12,6,9,15,11,6,6,9,20,12,10,11,10,5,14,12,5,17,13,16,3,1,3,3,1,3,3,1,2,2,3
"4294",64047335,"Youssef Al-Shayadi","8/21/1998 (24 years old)","GK","Sohar","Omani Professional League","OMA","No","6/9/2022","6/30/2023","$500 - $2.5K","Right","Reasonable","Very Strong","6'0""","169 lbs","16","-",80,103,3,1,1,2,2,5,1,1,1,2,9,3,3,1,9,11,15,4,8,13,14,1,11,2,9,7,6,6,11,9,7,6,6,12,6,9,11,12,13,12,12,12,13,1,12,5,12,11,20,7,13,13,8,12,10,10,5,11,8,9
"4295",2000142653,"Abdullah Al-Awfi","3/27/2000 (23 years old)","GK","Dhofar","Omani Professional League","OMA","No","10/4/2021","6/30/2024","$4.5K - $14K","Right","Fairly Strong","Very Strong","6'0""","141 lbs","-","-",70,103,3,3,1,2,2,4,1,2,3,1,7,2,1,5,11,6,10,7,9,8,16,2,11,3,10,7,6,6,7,13,7,5,11,10,3,5,11,20,8,12,12,10,10,9,10,8,12,13,11,7,14,13,9,7,8,13,15,7,10,8
"4296",64047464,"Juma Darwish","9/29/1984 (38 years old)","M/AM (C)","Al-Orouba","Omani Professional League","OMA","No","8/2/2022","6/30/2024","$0","Either","Very Strong","Very Strong","5'8""","152 lbs","-","-",83,102,7,3,7,9,10,7,1,8,2,8,14,4,7,7,12,6,3,10,8,14,6,6,8,11,8,8,14,12,7,7,7,4,10,7,7,6,12,19,9,10,11,10,5,9,11,7,12,11,13,1,3,2,2,2,1,3,1,3,2,3
"4297",97100406,"Jekob Jeno","6/22/2000 (22 years old)","D (C), DM, M (C)","Grenoble","Ligue 2 BKT","NCL","Yes","2/24/2022","6/30/2025","$140K - $1.4M","Right","Fairly Strong","Very Strong","6'0""","165 lbs","31","-",100,121,6,7,7,8,14,8,12,6,5,8,9,2,12,9,8,14,9,10,10,14,4,5,9,8,14,9,11,12,11,14,9,11,14,12,14,7,12,17,12,10,11,9,6,10,8,5,12,11,9,1,2,2,3,1,3,2,2,2,2,1
"4298",85102080,"César Zeoula","8/29/1989 (33 years old)","M (L), AM (RLC)","US Chauvigny","French National 3 - Group C","NCL","Yes","7/1/2022","6/30/2024","$0 - $30K","Right Only","Weak","Very Strong","5'8""","154 lbs","210","32",81,109,12,10,12,9,12,10,7,12,5,6,12,10,6,12,9,8,8,9,9,11,11,11,6,11,8,12,12,10,11,11,10,7,13,11,11,8,13,15,8,12,10,13,4,11,8,1,11,9,5,2,1,1,1,2,1,3,2,1,2,3
"4299",85122489,"Georges Gope-Fenepej","10/23/1988 (34 years old)","AM (RL)","Concarneau","Ligue 2 BKT","NCL","Yes","8/2/2021","6/30/2024","$14K - $45K","Right","Weak","Very Strong","6'0""","163 lbs","166","34",94,104,9,11,13,9,12,8,8,8,5,5,11,12,3,13,7,11,9,11,9,12,14,11,6,10,6,11,12,11,12,12,9,11,13,12,11,11,8,16,16,12,12,13,13,10,10,5,11,11,10,1,3,2,2,3,1,3,3,2,2,3
"4300",2000244285,"Nolhann Alebate","7/10/2006 (16 years old)","AM (RC)","Hienghène Sport","New Caledonian Championnat Super Ligue","NCL","Yes","1/1/2022","12/31/2025","$0","Right","Fairly Strong","Very Strong","6'0""","147 lbs","-","-",55,103,3,7,11,8,7,3,5,5,3,3,11,1,6,6,12,4,6,11,4,5,12,6,4,8,2,6,10,11,13,10,4,5,11,12,11,4,11,18,11,9,9,9,5,9,15,6,9,12,10,1,2,1,3,1,4,1,3,2,3,2
"4301",33058648,"Omar Jama","5/21/1998 (25 years old)","DM, M (RC)","JäPS","Finnish First Division","SOM","Yes","12/1/2022","11/15/2023","$0 - $18K","Right","Reasonable","Very Strong","5'9""","138 lbs","183","7",77,94,7,10,11,7,10,8,6,10,5,8,11,6,9,12,10,11,10,11,10,12,12,10,12,10,9,13,10,12,11,11,8,7,11,10,10,6,8,10,13,13,9,13,4,10,7,12,12,11,6,4,3,3,1,3,4,1,1,3,2,3
"4302",83185096,"Jean-Gilles Hnamuko","2/3/1996 (27 years old)","GK","Alisontia Steinsel","Luxembourg Division of Honour","NCL","Yes","7/1/2022","6/30/2023","$0","Right Only","Weak","Very Strong","6'6""","196 lbs","7","-",62,88,3,2,1,2,1,6,1,2,2,1,9,2,3,1,12,7,9,6,7,13,5,1,8,2,7,6,5,5,13,5,6,16,10,9,4,8,11,10,10,8,11,3,12,2,11,8,8,14,15,5,7,13,11,6,11,13,5,7,9,13
"4303",2000215670,"Alexandre Deplanque","1/2/2001 (22 years old)","D/WB/M (L)","Vendée Fontenay Foot","French National 3 - Group D","NCL","Yes","7/1/2019","6/30/2024","$0 - $50K","Left Only","Very Strong","Weak","6'1""","167 lbs","51","2",70,86,4,8,6,5,8,7,7,6,6,8,9,4,6,7,5,10,7,6,9,11,12,10,10,8,9,8,8,9,14,14,8,11,8,14,7,5,13,16,9,11,13,14,5,3,15,4,9,12,14,1,1,3,3,1,1,1,2,2,2,3
"4304",50082768,"Louis Ukajo","2/3/1989 (34 years old)","D (C)","SO Châtellerault","French National 3 - Group C","NCL","Yes","7/1/2020","6/30/2024","$0 - $14K","Right","Reasonable","Very Strong","6'2""","180 lbs","132","2",78,84,4,2,6,1,8,1,9,1,2,14,6,7,8,7,15,13,9,7,9,14,16,5,9,7,14,7,7,4,10,8,8,10,5,9,5,8,10,15,9,11,11,13,8,15,5,7,10,11,19,3,2,1,3,1,1,1,1,2,2,2
"4305",2000030173,"Antoine Roïné","4/16/1992 (31 years old)","M/AM (L)","Hienghène Sport","New Caledonian Championnat Super Ligue","NCL","Yes","1/1/2019","12/31/2024","Not for Sale","Left","Very Strong","Reasonable","6'0""","158 lbs","65","59",68,84,6,10,5,9,6,6,8,6,6,5,7,4,4,7,5,11,6,9,5,8,16,8,3,10,4,7,8,8,14,12,7,8,14,12,13,5,9,20,9,12,10,10,12,15,9,6,14,9,18,3,3,1,2,2,1,3,1,2,1,2
"4306",2000029281,"Christopher Wacalié","1/31/1995 (28 years old)","AM (RC), ST (C)","AS Wetr","New Caledonian Championnat Super Ligue","NCL","Yes","1/1/2019","12/31/2024","$0","Right","Weak","Very Strong","6'2""","169 lbs","42","16",63,81,5,7,9,10,13,5,10,7,3,3,9,3,2,8,11,9,7,7,6,7,7,10,13,11,5,6,7,7,13,11,6,10,12,13,12,5,8,14,10,10,10,13,5,10,11,1,19,9,12,3,2,3,3,2,2,3,2,3,3,1
"4307",97101472,"Paul Gope-Fenepej","8/10/2000 (22 years old)","ST (C)","ES La Rochelle","French Regional 1 - Nouvelle Aquitaine - Group A","NCL","Yes","7/1/2022","-","$0","Right","Weak","Very Strong","6'0""","167 lbs","25","4",65,81,6,2,10,14,10,6,11,7,2,6,6,7,2,12,12,11,7,9,6,11,4,11,3,12,7,6,7,7,14,9,7,7,13,11,7,7,8,14,13,10,10,13,14,3,6,1,15,13,7,2,3,1,3,3,3,2,2,2,1,3
"4308",97100431,"Titouan Richard","12/4/2000 (22 years old)","M (R), AM (RL)","Olympique Salaise Rhodia","French Regional 1 - Auvergne Rhône Alpes - Group B","NCL","Yes","7/1/2022","-","$0","Left","Very Strong","Fairly Strong","5'8""","154 lbs","28","12",65,80,10,11,11,7,9,5,5,6,5,3,8,5,6,9,11,11,4,9,10,10,9,8,2,8,5,8,10,9,11,11,8,5,9,11,6,8,14,10,11,12,14,11,13,4,10,6,8,11,13,2,1,1,1,1,2,2,3,3,2,3
"4309",2000028934,"Lues Waya","8/1/2001 (21 years old)","ST (C)","Laval MFC","French National 3 - Group D","NCL","Yes","2/1/2023","6/30/2026","$0 - $65K","Right","Weak","Very Strong","6'1""","167 lbs","45","43",66,80,8,5,9,10,8,8,9,7,1,7,7,6,4,7,5,11,5,10,11,9,13,6,4,12,9,7,7,12,10,12,11,16,14,10,7,6,10,19,13,10,12,11,8,10,8,6,20,11,9,3,1,1,3,1,2,2,2,1,2,2
"4310",97101025,"Jean-Yann Dounezek","1/20/1986 (37 years old)","GK","Tiga Sport","New Caledonian Championnat Super Ligue","NCL","Yes","1/1/2022","12/31/2024","$0","Right","Reasonable","Very Strong","6'5""","185 lbs","21","-",61,76,4,2,3,1,1,5,1,3,2,1,9,2,2,1,15,8,15,6,11,13,13,1,7,2,11,6,5,5,7,8,6,16,12,7,4,6,8,18,12,10,9,13,12,5,12,5,16,11,16,4,13,7,13,8,7,12,5,7,10,13
"4311",2000029268,"Kenny Hnau","2/7/1989 (34 years old)","AM (RL), ST (C)","Horizon Patho","New Caledonian Championnat Super Ligue","NCL","Yes","1/1/2019","12/31/2024","$0","Left","Very Strong","Fairly Strong","5'10""","154 lbs","27","5",55,76,3,8,8,10,11,5,13,5,5,4,5,2,3,12,8,6,7,8,5,10,9,12,12,12,5,6,7,7,8,7,6,6,14,8,10,4,7,18,13,10,12,13,11,6,5,8,13,13,13,3,1,2,2,3,3,3,2,1,1,2
"4312",15061936,"Yusuf Ahmed","4/24/1997 (26 years old)","M (C), AM (RLC), ST (C)","Avondale","National Premier Leagues - Victoria","SOM","No","6/15/2020","9/30/2023","$0 - $28K","Right Only","Weak","Very Strong","6'1""","158 lbs","51","20",83,94,5,10,13,13,12,6,8,9,2,1,5,7,1,12,4,9,4,12,8,10,11,16,1,9,3,4,9,7,11,14,7,14,15,14,8,8,6,11,10,13,10,4,10,8,5,1,8,11,19,2,3,2,3,1,2,2,1,2,2,3
"4313",49037779,"Joris Kenon","1/29/1998 (25 years old)","AM (RC)","UA Cognac","French Regional Divisions","NCL","Yes","7/1/2021","-","$0","Right Only","Weak","Very Strong","5'11""","156 lbs","40","3",68,76,10,10,12,9,11,8,8,7,4,4,10,11,5,11,7,8,9,10,9,10,9,12,8,11,6,10,10,7,11,11,10,8,9,10,9,8,15,18,12,10,9,12,5,10,7,8,10,10,18,3,3,2,3,1,2,3,2,1,3,1
"4314",97101456,"Martin Makam","9/15/2001 (21 years old)","D (C)","AS Magenta","New Caledonian Championnat Super Ligue","NCL","Yes","6/13/2022","12/31/2025","$0","Right","Weak","Very Strong","5'11""","163 lbs","38","2",65,75,2,1,1,2,4,1,11,1,3,13,7,5,8,5,5,12,8,7,5,14,7,6,1,6,11,6,2,7,13,10,7,8,14,11,9,7,11,18,11,12,13,10,12,7,8,2,12,12,16,1,1,1,1,3,2,3,2,1,1,1
"4315",2000036057,"Jorys Mène","1/2/1995 (28 years old)","D (R)","Alisontia Steinsel","Luxembourg Division of Honour","NCL","Yes","7/1/2020","6/30/2023","$0","Right Only","Weak","Very Strong","5'9""","147 lbs","55","1",50,75,3,8,5,1,7,1,7,6,1,10,5,3,11,7,9,7,3,7,8,7,9,6,12,4,8,7,5,7,14,14,7,4,17,14,12,6,11,15,11,12,10,11,10,10,8,6,11,10,20,2,2,2,2,4,4,1,3,4,4,1
"4316",2000029301,"Cyril Drawilo","4/11/2000 (23 years old)","M/AM (C)","AS Magenta","New Caledonian Championnat Super Ligue","NCL","Yes","6/12/2023","12/31/2025","$0","Right","Reasonable","Very Strong","5'9""","147 lbs","26","15",65,75,3,6,9,13,9,6,5,9,2,6,8,3,6,12,15,8,3,8,5,11,6,11,9,9,8,8,13,8,9,14,6,10,12,14,7,5,10,16,10,12,12,9,10,10,10,2,11,11,20,2,2,4,1,2,3,2,1,2,3,3
"4317",49040289,"Joseph Athalé","7/10/1995 (27 years old)","D (RC), DM","Olympique Saint-Quentin","French National 2 - D","NCL","Yes","1/1/2023","6/30/2024","$14K - $45K","Right","Reasonable","Very Strong","5'9""","156 lbs","64","21",70,75,5,7,5,1,9,6,6,6,6,10,9,1,13,8,11,11,9,8,9,13,10,5,5,6,13,7,7,8,10,7,7,7,12,9,13,7,9,10,10,7,10,8,13,4,9,2,12,8,16,2,1,1,1,3,2,2,3,3,1,1
"4318",97100762,"Mickaël Ulile","7/16/1997 (25 years old)","GK","AS Magenta","New Caledonian Championnat Super Ligue","NCL","Yes","1/1/2022","12/31/2024","$0","Right","Fairly Strong","Very Strong","6'4""","178 lbs","39","-",68,75,1,3,1,1,1,5,1,1,1,2,4,1,2,1,6,6,14,5,5,12,16,3,9,1,10,5,4,4,10,15,6,12,12,10,1,5,11,10,9,10,12,11,10,4,8,6,9,10,12,8,12,12,7,8,8,11,5,6,6,9
"4319",2000029267,"Jean-Paul Wamejo","7/15/1990 (32 years old)","ST (C)","Horizon Patho","New Caledonian Championnat Super Ligue","NCL","Yes","6/14/2021","12/31/2024","Not for Sale","Right","Weak","Very Strong","6'1""","171 lbs","38","13",52,74,2,6,6,13,12,6,9,7,3,5,7,4,4,7,12,9,7,9,7,8,3,10,8,9,7,6,6,8,10,9,2,12,15,9,4,7,9,14,11,10,8,10,6,16,15,8,8,12,10,3,2,1,2,3,1,3,2,3,3,2
"4320",2000028907,"Daniel Kouathe","4/15/1991 (32 years old)","M/AM (C)","AS Kunié","New Caledonian Championnat Super Ligue","NCL","Yes","1/1/2020","12/31/2024","Not for Sale","Right","Fairly Strong","Very Strong","6'1""","169 lbs","18","-",55,74,4,4,5,9,11,5,4,4,2,7,11,1,7,6,6,6,6,7,4,13,8,11,4,8,7,7,8,12,7,9,6,8,12,9,11,5,10,19,12,12,9,10,11,12,12,6,17,10,15,2,2,1,2,1,1,1,2,3,4,2
"4321",97100913,"Gabriel Vakoume","2/28/1989 (34 years old)","D (R)","AS Kunié","New Caledonian Championnat Super Ligue","NCL","Yes","1/1/2022","12/31/2024","$0","Right","Reasonable","Very Strong","6'5""","191 lbs","43","-",60,74,6,13,4,3,9,3,6,6,5,9,7,3,11,8,5,8,8,8,10,8,14,5,9,6,12,8,6,8,11,12,8,16,10,10,8,10,20,14,11,13,10,9,11,8,12,8,10,9,10,1,1,1,3,3,1,2,3,1,3,2
"4322",85121616,"Stéphane Tein-Padom","6/8/1994 (29 years old)","ST (C)","FC Balagne","French National 3 - Group H","NCL","Yes","7/1/2022","6/30/2024","$0 - $45K","Right","Reasonable","Very Strong","6'2""","174 lbs","28","-",65,74,5,1,7,13,12,5,13,5,1,3,6,6,1,7,10,12,2,7,6,9,13,8,9,11,3,5,5,7,13,9,6,11,12,12,12,7,12,16,11,10,11,9,11,16,9,5,11,12,18,3,2,2,2,1,3,1,3,1,2,2
"4323",2000280521,"Hassan Gabo","1/1/2003 (20 years old)","D (C)","Greenville","United States Soccer Leagues Division One","SOM","No","2/24/2023","11/30/2023","$70K - $210K","Right","Weak","Very Strong","6'1""","176 lbs","-","-",75,93,9,4,8,4,10,7,11,9,8,11,10,8,16,7,9,10,10,12,9,11,11,5,5,9,8,9,5,8,11,9,10,12,17,8,10,10,10,13,13,12,10,11,5,18,14,6,11,14,8,1,1,1,2,2,3,3,2,1,3,1
"4324",97100329,"Shene Wélépane","12/9/1997 (25 years old)","AM (LC), ST (C)","Tiga Sport","New Caledonian Championnat Super Ligue","NCL","Yes","1/1/2021","12/31/2024","$1.5K - $4K","Right","Weak","Very Strong","5'9""","145 lbs","59","23",67,74,11,7,10,9,9,5,5,4,5,5,7,3,3,11,10,8,7,4,7,8,5,9,11,10,9,10,6,10,13,11,4,4,5,13,10,2,9,18,12,13,10,9,9,4,10,2,9,10,19,2,3,2,2,1,1,2,2,3,3,1
"4325",8455622,"Mone Wamowé","10/31/1986 (36 years old)","M/AM (C)","AS Lössi","New Caledonian Championnat Super Ligue","NCL","Yes","12/31/2022","12/31/2024","$0","Right","Reasonable","Very Strong","6'4""","187 lbs","40","11",63,73,8,4,10,13,10,12,8,7,5,7,10,12,9,10,13,8,6,8,11,11,4,13,14,13,7,8,12,12,8,8,4,12,9,8,8,9,13,14,10,11,11,10,6,12,5,7,13,10,18,3,1,1,3,1,3,1,3,3,1,2
"4326",2000029284,"Germain Haewegené","7/13/1996 (26 years old)","AM (L), ST (C)","AS Magenta","New Caledonian Championnat Super Ligue","NCL","Yes","4/1/2022","12/31/2024","$0 - $3.5K","Left","Very Strong","Reasonable","6'0""","167 lbs","63","41",66,73,3,5,11,11,7,3,7,4,1,2,8,8,1,6,10,7,6,9,4,4,3,8,12,8,4,3,5,5,13,11,10,3,14,14,12,10,12,11,11,13,12,10,11,4,8,8,10,11,14,1,1,1,1,1,2,4,1,2,1,2
"4327",2000119152,"Willy Read","1/11/2003 (20 years old)","AM (L), ST (C)","AS Lössi","New Caledonian Championnat Super Ligue","NCL","Yes","1/1/2020","12/31/2025","$0","Left","Very Strong","Fairly Strong","5'11""","163 lbs","19","8",60,72,4,7,13,13,8,5,5,3,3,5,7,5,3,10,7,9,3,8,4,8,4,10,11,9,4,5,4,7,13,11,6,8,12,11,8,8,8,11,9,10,12,11,14,2,8,6,10,10,15,2,3,2,1,4,4,3,2,1,2,3
"4328",2000116986,"David Béaruné","6/17/1994 (28 years old)","D/WB/M/AM (RL)","Tiga Sport","New Caledonian Championnat Super Ligue","NCL","Yes","7/2/2019","12/31/2024","$0","Right","Fairly Strong","Very Strong","6'4""","178 lbs","45","14",65,72,6,9,5,8,6,4,4,1,4,4,7,1,4,8,14,5,6,6,6,8,9,11,8,7,6,5,2,6,12,12,5,13,13,12,11,5,16,17,10,12,13,12,6,1,7,1,12,12,12,1,3,1,1,3,2,2,2,3,3,1
"4329",2000185901,"Warren Hlupa","4/14/2004 (19 years old)","GK","AS Lössi","New Caledonian Championnat Super Ligue","NCL","Yes","1/1/2022","12/31/2025","$0","Right","Weak","Very Strong","6'5""","185 lbs","15","-",60,71,4,3,2,3,1,7,1,1,3,3,7,1,1,2,10,4,10,5,9,13,15,2,9,1,9,6,5,5,13,5,6,16,11,12,1,7,8,12,10,10,12,9,8,6,7,5,4,13,8,4,12,13,11,7,11,6,5,7,8,12
"4330",97100402,"Jules Omei","7/14/2001 (21 years old)","M (C)","AS Mont-Dore","New Caledonian Championnat Super Ligue","NCL","Yes","1/1/2019","12/31/2025","$0","Right","Reasonable","Very Strong","5'4""","121 lbs","37","2",60,71,6,5,2,6,13,6,1,9,1,12,9,4,6,13,9,11,3,8,8,12,4,8,9,6,9,7,7,12,14,13,5,1,14,14,7,1,13,15,12,10,12,10,8,9,5,1,15,14,16,2,2,2,2,1,2,3,4,3,3,1
"4331",2000242706,"Gilbert Kugogne","5/4/2004 (19 years old)","ST (C)","AS Magenta","New Caledonian Championnat Super Ligue","NCL","Yes","1/1/2022","12/31/2025","$0","Right","Reasonable","Very Strong","5'11""","160 lbs","8","6",61,71,4,1,10,12,12,2,6,5,1,4,7,4,2,7,14,4,7,10,4,7,6,7,3,11,6,5,4,7,13,13,6,10,8,13,7,6,10,20,11,12,10,10,6,8,12,4,8,11,19,1,1,3,3,3,3,2,2,4,1,3
"4332",97100411,"Pierre Bako","8/9/2001 (21 years old)","DM, M (C)","FC Gaïtcha","New Caledonian Championnat Super Ligue","NCL","Yes","2/1/2022","-","$0","Right","Weak","Very Strong","5'9""","145 lbs","34","9",64,71,6,6,4,7,14,12,6,8,12,8,13,1,13,12,5,8,6,8,11,12,11,5,3,7,12,12,13,10,8,9,7,7,7,10,5,6,12,15,12,11,11,14,7,20,6,7,13,13,18,4,2,2,2,1,3,2,3,2,1,2
"4333",2000086805,"Claude Forest","9/9/2003 (19 years old)","M (C), AM (LC)","Ne Drehu","New Caledonian Championnat Super Ligue","NCL","Yes","1/1/2020","12/31/2025","$0","Left","Very Strong","Reasonable","5'10""","152 lbs","19","1",58,70,7,8,12,11,13,7,6,8,2,7,7,5,9,13,5,5,3,5,5,11,6,11,3,9,8,8,9,13,8,11,8,6,13,10,8,5,10,14,12,9,9,10,7,5,5,8,8,13,15,1,3,3,3,2,2,2,2,2,1,2
"4334",12013677,"Jean-Claude Ndoli","10/7/1986 (36 years old)","GK","Gorilla","Rwandan Premier Division","RWA","No","7/1/2021","6/30/2024","$0","Right","Reasonable","Very Strong","6'4""","213 lbs","-","-",85,100,3,1,3,1,5,3,1,3,1,2,9,1,1,8,8,13,15,6,12,10,5,1,10,3,13,9,8,8,10,7,5,13,9,10,6,8,12,13,11,11,11,9,7,12,5,1,17,12,14,9,12,10,13,9,12,9,5,9,15,15
"4335",33074754,"Hussein Mohamed","3/20/1997 (26 years old)","D/M (R), AM (RL)","JäPS","Finnish First Division","SOM","Yes","1/1/2023","11/15/2023","$0 - $65K","Right","Weak","Very Strong","5'11""","163 lbs","118","21",81,92,9,9,11,9,13,9,5,8,5,7,8,4,11,10,10,8,9,7,8,9,9,11,13,10,8,10,8,10,12,10,8,8,9,13,11,8,11,17,8,13,13,13,10,10,15,2,8,9,7,2,1,3,4,3,3,3,1,3,3,1
"4336",49040372,"Jean-Christ Wajoka","9/6/1992 (30 years old)","D/WB/M/AM (R)","AS Magenta","New Caledonian Championnat Super Ligue","NCL","Yes","1/1/2022","12/31/2024","$0","Right Only","Weak","Very Strong","5'9""","163 lbs","68","9",64,70,7,7,7,13,6,7,6,4,7,7,7,7,8,7,12,13,8,9,10,9,14,11,13,11,7,10,8,13,12,11,13,7,6,9,9,10,10,11,10,11,7,13,11,13,9,8,10,9,14,1,1,1,1,2,2,2,1,1,3,1
"4337",2000119082,"Kenny Waitreu","8/19/2002 (20 years old)","D (C), DM","AS Magenta","New Caledonian Championnat Super Ligue","NCL","Yes","1/1/2021","12/31/2025","$0","Right","Reasonable","Very Strong","6'1""","167 lbs","25","2",58,70,5,3,2,5,8,5,8,6,1,8,6,1,12,7,10,8,7,3,6,14,18,5,5,6,14,7,5,8,7,7,7,9,12,7,10,5,9,14,12,11,11,11,5,8,8,4,11,13,7,1,2,2,3,1,1,3,2,3,3,4
"4338",2000029272,"Steeve Wahopié","9/8/1986 (36 years old)","D (RL)","Horizon Patho","New Caledonian Championnat Super Ligue","NCL","Yes","1/1/2020","12/31/2024","$0","Right","Reasonable","Very Strong","6'2""","171 lbs","53","4",53,70,5,11,3,3,8,3,8,5,6,11,7,2,13,8,14,8,7,8,9,15,17,5,12,6,12,8,6,8,9,9,8,10,12,8,6,5,13,11,10,12,10,11,9,2,9,4,16,8,9,1,3,3,2,1,2,3,1,3,1,2
"4339",2000028910,"Gianni Manmieu","8/3/1994 (28 years old)","M/AM (R)","AS Kunié","New Caledonian Championnat Super Ligue","NCL","Yes","1/1/2020","12/31/2024","$0 - $4K","Right","Reasonable","Very Strong","6'0""","154 lbs","28","16",65,70,6,12,13,11,11,2,5,6,5,5,5,1,3,7,15,6,7,7,6,10,8,7,12,12,5,7,6,10,13,12,4,10,13,13,5,3,13,14,8,12,13,10,14,9,10,8,8,9,20,3,3,1,4,1,1,2,1,4,3,2
"4340",2000244282,"Yaël Wejieme","1/21/2004 (19 years old)","D (LC)","AS Lössi","New Caledonian Championnat Super Ligue","NCL","Yes","1/1/2022","12/31/2025","$0","Left","Very Strong","Reasonable","5'11""","158 lbs","1","-",52,70,3,7,4,3,7,2,5,3,1,5,6,6,11,3,7,8,8,7,8,13,10,5,3,3,11,6,4,7,9,13,5,10,15,11,8,7,12,10,11,11,12,10,12,12,10,8,10,10,20,3,3,2,2,2,1,2,3,1,3,1
"4341",2000119561,"Eugène Maeli","3/31/1999 (24 years old)","D (R)","AS Qanono Sports","New Caledonian Championnat Super Ligue","NCL","Yes","1/1/2021","12/31/2025","$0","Right","Fairly Strong","Very Strong","6'1""","169 lbs","19","1",51,70,4,6,1,2,5,1,6,3,3,7,7,1,12,2,13,5,8,6,6,9,6,8,10,5,7,6,6,6,13,13,6,13,12,13,6,6,11,15,13,10,10,10,5,10,12,5,10,11,7,1,1,3,1,1,2,4,2,1,2,3
"4342",2000185899,"Paul Jone","4/28/2003 (20 years old)","M/AM (C)","SNID","French Regional Divisions","NCL","Yes","12/31/2022","-","$0","Right","Strong","Very Strong","5'7""","143 lbs","18","-",60,70,5,5,6,6,8,5,5,5,3,5,6,5,6,7,12,5,4,7,6,12,14,7,3,3,6,6,6,7,13,13,6,4,9,13,5,4,13,17,12,12,11,9,13,7,5,7,8,13,19,1,3,1,3,3,2,1,2,3,2,3
"4343",2000029274,"Yoan Béaruné","3/22/2002 (21 years old)","M/AM (C)","Horizon Patho","New Caledonian Championnat Super Ligue","NCL","Yes","1/1/2019","12/31/2025","$0","Right","Reasonable","Very Strong","6'3""","178 lbs","32","1",60,70,8,5,9,10,14,8,8,6,4,10,9,1,9,9,15,9,7,4,3,4,8,13,7,10,5,4,4,9,12,11,8,18,14,12,10,9,12,15,13,7,11,11,14,2,15,3,7,12,17,2,2,3,1,2,1,3,3,3,2,2
"4344",97100314,"Jeremie Dokunengo","8/4/1989 (33 years old)","D (C)","FC Gaïtcha","New Caledonian Championnat Super Ligue","NCL","Yes","12/31/2022","-","$0","Left Only","Very Strong","Weak","6'0""","158 lbs","32","-",52,70,1,5,1,1,5,1,9,2,7,9,7,2,9,7,7,10,9,9,9,12,18,5,14,4,11,10,1,12,10,8,5,9,10,10,8,2,11,15,11,9,9,12,12,7,9,3,17,9,10,2,1,3,2,1,1,3,3,4,4,2
"4345",2000098433,"Jacky Meindu","6/6/1989 (34 years old)","M/AM (LC)","US Raon-l'Etape","French National 3 - Group I","NCL","Yes","7/1/2022","6/30/2023","$0","Left Only","Very Strong","Very Weak","5'9""","152 lbs","29","2",62,70,7,8,9,9,7,7,6,9,7,6,10,6,6,11,7,9,7,9,6,7,6,9,13,12,8,8,6,9,9,14,13,5,13,12,11,8,16,19,12,10,11,12,5,15,5,1,6,10,10,3,3,1,1,1,3,1,3,3,2,3
"4346",2000006599,"Aweys Ali","9/21/2000 (22 years old)","GK","Mogadishu City Club","Somali Premier Division","SOM","No","6/15/2020","6/30/2024","$0","Left","Very Strong","Reasonable","6'4""","176 lbs","-","-",72,90,5,1,1,1,4,7,1,1,2,3,8,2,1,1,11,7,14,6,10,12,6,3,11,1,8,6,2,5,10,15,6,12,15,10,1,4,13,13,9,11,11,11,5,13,9,6,13,10,9,6,5,12,14,8,10,8,12,9,7,12
"4347",2000029302,"Dylan Sio","8/30/1997 (25 years old)","D (RLC)","Ne Drehu","New Caledonian Championnat Super Ligue","NCL","Yes","1/1/2021","12/31/2024","$0","Left","Very Strong","Reasonable","6'4""","178 lbs","40","-",58,70,6,9,6,3,6,1,8,3,4,10,8,3,13,6,7,10,8,7,8,10,4,6,3,5,6,7,4,7,14,10,7,12,12,11,9,11,15,15,10,14,8,10,11,11,13,6,13,13,12,3,3,1,1,2,1,3,3,2,2,2
"4348",97100396,"Bernard Iwa","5/26/2000 (23 years old)","D (RC)","AS Lössi","New Caledonian Championnat Super Ligue","NCL","Yes","2/1/2022","12/31/2025","$0","Right","Weak","Very Strong","5'10""","154 lbs","42","1",60,70,2,5,3,2,5,1,12,6,6,10,5,1,14,6,12,6,8,7,7,13,4,5,12,6,10,6,6,7,10,14,7,5,16,13,7,7,12,13,11,12,13,11,6,8,6,2,11,11,11,3,3,3,3,2,1,3,3,1,2,3
"4349",97100953,"Nicodem Hmaen","3/5/1993 (30 years old)","GK","Ne Drehu","New Caledonian Championnat Super Ligue","NCL","Yes","1/1/2021","12/31/2024","$0","Right","Reasonable","Very Strong","6'4""","182 lbs","40","-",55,70,3,2,3,3,2,4,1,2,3,1,10,3,2,1,8,7,7,6,9,13,13,2,8,1,9,4,5,5,9,8,6,10,7,12,2,6,8,10,11,11,12,12,5,2,12,8,20,11,15,4,5,8,6,5,8,13,15,6,9,7
"4350",2000185953,"Sake Forest","8/13/2003 (19 years old)","D (C)","Tiga Sport","New Caledonian Championnat Super Ligue","NCL","Yes","1/1/2022","12/31/2025","$0","Right","Fairly Strong","Very Strong","6'4""","185 lbs","19","1",62,70,1,3,1,2,6,1,10,3,1,13,6,1,13,2,9,10,5,5,4,13,11,5,11,5,13,5,1,6,8,6,6,15,13,6,5,8,11,12,10,13,10,9,11,3,13,7,9,9,15,3,1,2,3,3,3,4,2,3,2,2
"4351",2000204373,"Wilfrid Katenga","5/6/2003 (20 years old)","D (C)","AS Mont-Dore","New Caledonian Championnat Super Ligue","NCL","Yes","12/31/2022","12/31/2025","$0","Right","Fairly Strong","Very Strong","6'2""","169 lbs","-","-",50,70,2,1,1,1,1,1,12,4,3,12,2,1,6,3,14,10,7,4,10,12,3,5,4,3,12,4,1,5,11,9,5,6,13,10,2,5,13,19,11,12,9,9,10,6,6,2,8,12,13,2,2,3,1,3,3,2,1,1,2,3
"4352",2000119160,"Jean-Claude Ihily","7/16/1995 (27 years old)","DM, M (C)","Hienghène Sport","New Caledonian Championnat Super Ligue","NCL","Yes","1/1/2021","12/31/2024","$0","Right","Reasonable","Very Strong","5'10""","152 lbs","26","-",63,69,3,2,3,4,12,5,6,5,6,8,9,4,9,7,8,10,7,8,7,7,14,5,13,8,8,7,6,12,14,13,7,7,10,14,14,6,12,16,12,13,10,9,9,6,5,5,15,11,12,2,1,1,2,3,3,1,3,1,1,3
"4353",85028290,"Ludovic Grondin","7/9/1987 (35 years old)","GK","AS Marsouins","Réunion D2 Regionale","REU","Yes","7/1/2020","-","$0","Right Only","Weak","Very Strong","5'10""","196 lbs","277","-",50,120,3,2,2,3,7,5,1,2,1,1,7,3,2,7,5,8,12,7,9,11,13,3,5,2,9,7,6,6,10,6,7,8,13,10,3,13,1,13,12,12,12,10,9,9,5,3,10,11,9,7,6,10,13,9,9,10,7,11,6,11
"4354",49062372,"Ryan Ponti","6/22/1998 (24 years old)","WB/M/AM (L)","Bourg en B.","French National 2 - D","REU","Yes","7/1/2022","6/30/2026","$35K - $350K","Left Only","Very Strong","Weak","6'1""","163 lbs","65","3",93,107,8,11,7,7,13,8,12,10,8,9,8,4,8,8,9,9,9,10,10,12,11,8,7,14,10,9,9,14,13,12,12,12,14,12,13,11,13,12,11,10,9,11,6,10,9,2,11,14,11,3,2,1,1,2,3,1,2,3,2,3
"4355",2000023339,"Quentin Rebeca","3/25/2004 (19 years old)","D (LC)","FC Vaulx","French Regional 1 - Auvergne Rhône Alpes - Group C","REU","No","7/1/2022","6/30/2023","$0","Left","Very Strong","Reasonable","6'3""","171 lbs","3","-",65,104,7,11,6,3,5,3,10,2,1,10,6,5,11,2,14,10,8,7,7,14,6,5,7,6,10,6,4,7,14,8,7,11,13,10,5,4,11,14,12,11,12,9,15,6,12,4,12,9,17,3,1,3,3,1,2,1,2,3,2,1
"4356",2000193233,"Djanis Bluker","4/9/2006 (17 years old)","AM (R), ST (C)","Niort","French National","REU","No","7/1/2021","6/30/2025","$65K - $200K","Right","Weak","Very Strong","5'6""","145 lbs","-","-",63,86,5,10,14,10,13,6,10,5,1,3,7,2,6,8,6,9,7,8,4,7,18,8,5,8,4,6,7,8,13,14,7,2,9,14,6,2,9,17,11,11,10,8,12,8,13,1,8,10,9,2,1,2,3,2,3,1,3,2,3,3
"4357",2000147701,"Ali Omar Ali","3/4/2000 (23 years old)","DM, M (C)","Mogadishu City Club","Somali Premier Division","SOM","No","7/1/2019","6/30/2024","$0","Right","Reasonable","Very Strong","6'4""","178 lbs","-","-",71,90,6,4,4,6,13,6,6,8,3,7,13,2,13,11,11,10,8,8,8,11,10,5,11,8,9,8,6,12,13,8,8,14,15,10,7,5,8,13,10,13,12,10,10,16,10,6,20,11,18,3,3,1,4,3,3,2,1,2,1,1
"4358",8434740,"Gaël Payet","1/4/1984 (39 years old)","D (C)","AS Excelsior","Réunion Regional 1","REU","Yes","6/14/2021","-","$0","Right","Reasonable","Very Strong","6'3""","185 lbs","361","25",55,85,1,2,1,6,4,1,12,4,1,10,6,4,13,4,9,6,8,4,5,13,8,5,7,5,13,5,2,6,4,4,5,15,12,2,3,13,5,10,9,11,10,10,9,2,5,10,16,14,11,2,4,3,1,2,3,1,2,3,2,3
"4359",48042640,"Guillaume Dugain","4/12/1998 (25 years old)","AM (C), ST (C)","AC Amboise","French Regional Divisions","REU","Yes","7/1/2022","-","$0","Right Only","Weak","Very Strong","6'2""","169 lbs","19","2",72,81,6,2,7,13,13,4,7,8,1,6,10,5,5,9,13,5,5,5,7,11,8,9,5,13,6,6,10,8,13,13,7,7,9,13,13,5,11,17,11,14,10,8,12,11,5,3,10,10,12,1,3,2,3,3,2,2,1,3,1,2
"4360",85028018,"Alexis Siala-Chamba","1/14/1993 (30 years old)","AM (RL)","Saint-Pauloise FC","Réunion Regional 1","REU","Yes","7/1/2020","12/31/2024","$0 - $6K","Right","Weak","Very Strong","5'5""","141 lbs","186","13",76,80,8,10,11,7,11,11,5,6,6,1,8,3,2,13,6,8,6,9,7,8,12,12,5,11,3,6,8,8,14,13,7,4,13,12,10,7,10,11,13,8,12,11,7,15,6,1,12,10,8,1,3,1,4,2,2,1,3,1,3,1
"4361",2000090730,"Anjy Vardapin","10/13/1994 (28 years old)","M/AM (C)","JS Saint-Pierroise","Réunion Regional 1","REU","Yes","1/1/2023","12/31/2023","$0","Right","Reasonable","Very Strong","5'10""","160 lbs","7","1",70,80,5,3,7,5,12,5,3,6,2,6,12,3,5,7,14,6,5,7,6,12,15,8,12,7,7,6,7,7,12,12,6,7,14,12,12,9,10,20,12,10,12,12,12,6,15,6,10,10,12,3,2,2,2,3,3,2,3,3,1,3
"4362",29107001,"Jean-Michel Fontaine","8/28/1988 (34 years old)","AM (C), ST (C)","La Tamponnaise","Réunion Regional 1","REU","Yes","1/1/2023","12/31/2023","$0","Right Only","Weak","Very Strong","6'1""","182 lbs","293","151",64,75,1,4,6,9,8,5,12,3,4,3,6,10,1,9,11,9,13,8,8,8,8,9,7,10,6,10,7,12,12,10,14,12,15,9,13,13,8,11,7,8,6,10,11,14,11,6,12,10,10,1,1,3,1,3,2,3,4,3,3,2
"4363",73200753,"Akbar Assoumani","1/21/1997 (26 years old)","AM (L), ST (C)","Saint-Denis FC","Réunion D2 Regionale","REU","Yes","7/1/2020","12/31/2024","$0","Left","Very Strong","Reasonable","5'11""","156 lbs","103","35",60,75,3,8,6,9,12,4,9,5,1,3,9,1,1,7,6,7,2,7,5,12,14,11,4,7,5,5,6,7,12,9,5,8,14,12,12,6,9,14,11,12,12,11,8,1,15,3,16,12,16,3,3,3,2,2,2,2,3,3,1,3
"4364",73200617,"Simon Benoist","6/8/1997 (26 years old)","AM (C)","JS Saint-Pierroise","Réunion Regional 1","REU","Yes","1/1/2023","12/31/2023","$0","Right","Reasonable","Very Strong","5'10""","152 lbs","46","6",60,75,3,4,7,10,12,4,5,6,1,4,5,4,3,12,5,8,6,7,2,10,7,13,12,8,5,5,9,7,12,12,5,3,12,12,11,3,14,18,12,10,13,14,7,6,9,2,6,12,8,2,1,2,1,4,3,2,1,1,3,4
"4365",73200790,"Loïc Myrthe","2/17/1992 (31 years old)","M/AM (L)","US Sainte-Marienne","Réunion Regional 1","REU","Yes","7/1/2022","6/30/2023","$0","Left Only","Very Strong","Weak","6'1""","165 lbs","117","26",65,72,6,11,13,13,6,5,6,6,1,6,9,3,5,6,10,10,7,8,7,11,17,6,9,8,6,6,6,7,10,12,6,12,10,11,12,4,16,11,10,14,11,12,7,18,12,5,9,15,12,2,3,2,1,2,3,2,4,2,1,2
"4366",49062373,"Alexandre Loricourt","3/24/1992 (31 years old)","D (R), AM (L)","JS Saint-Pierroise","Réunion Regional 1","REU","Yes","1/1/2023","12/31/2023","$0","Left","Very Strong","Fairly Strong","6'0""","163 lbs","183","30",60,70,6,10,4,10,11,6,6,2,6,7,10,6,8,7,7,6,8,7,8,9,19,8,3,9,7,7,6,8,14,11,7,7,11,9,9,4,13,16,11,12,11,13,12,11,15,2,7,11,20,3,1,3,1,2,1,2,2,3,2,2
"4367",2000090361,"Florent Ichiza","2/2/1993 (30 years old)","D/WB (R)","Saint-Pauloise FC","Réunion Regional 1","REU","Yes","7/1/2021","12/31/2024","$0","Right","Reasonable","Very Strong","5'10""","145 lbs","68","9",63,70,5,9,7,2,6,1,6,5,6,9,13,4,13,9,15,9,5,8,9,15,11,5,13,7,9,8,5,13,9,9,8,8,12,8,14,5,12,17,10,10,11,12,6,11,13,3,12,12,8,2,1,1,1,4,1,1,1,2,2,1
"4368",2000088669,"Farhan Mohamed Ahmed","11/15/2000 (22 years old)","ST (C)","Horseed","Somali Premier Division","SOM","No","7/1/2018","6/30/2024","$0","Right","Reasonable","Very Strong","6'0""","167 lbs","-","-",69,90,5,4,13,10,13,5,13,5,4,5,6,4,3,9,10,8,6,9,6,11,17,9,12,11,6,4,5,7,13,11,6,10,9,11,12,6,9,11,10,13,11,12,12,15,10,8,11,12,10,3,2,3,4,2,1,2,2,3,1,2
"4369",73200619,"Marc Dorilas","10/9/1995 (27 years old)","M (C)","AS Excelsior","Réunion Regional 1","REU","No","7/1/2020","12/31/2024","$0","Right","Fairly Strong","Very Strong","5'9""","145 lbs","100","10",60,69,4,2,2,4,9,4,4,4,1,11,12,4,5,9,13,4,1,6,5,12,5,5,11,7,4,6,7,11,12,12,5,6,13,12,12,4,12,17,11,11,10,10,6,9,9,5,9,12,19,2,1,2,4,3,2,2,3,2,2,2
"4370",2000170759,"Gauthier Robin","7/3/1995 (27 years old)","DM, M (C)","Cockburn City","Western Australia State League Division 1","REU","Yes","1/1/2022","6/30/2024","$0","Left","Very Strong","Reasonable","5'10""","156 lbs","-","-",62,68,5,6,3,2,11,6,5,3,1,10,9,1,14,8,15,12,7,7,11,11,10,5,7,6,9,13,5,13,8,8,7,4,5,8,12,9,11,19,12,12,12,11,5,2,7,8,12,12,18,3,2,2,2,2,3,3,3,2,1,1
"4371",73200647,"Florian Turpin","3/3/1994 (29 years old)","AM (LC)","SS Jeanne d'Arc","Réunion Regional 1","REU","Yes","1/1/2023","-","$0","Left","Very Strong","Fairly Strong","5'11""","158 lbs","86","21",50,65,4,5,6,9,9,4,4,6,1,4,7,4,5,5,12,5,1,5,4,9,11,6,3,7,4,5,4,6,12,12,4,5,9,12,11,4,10,16,12,13,10,9,10,12,7,5,3,10,16,3,3,3,4,2,1,2,2,2,1,2
"4372",2000090308,"Joé Damour","1/26/1990 (33 years old)","D (L)","Saint-Denis FC","Réunion D2 Regionale","REU","Yes","2/11/2020","12/31/2023","$0","Left","Very Strong","Weak","5'9""","149 lbs","22","2",55,65,5,10,3,1,7,1,8,5,6,9,7,7,12,9,9,9,9,8,7,11,16,5,13,7,8,8,7,8,11,10,7,6,15,10,7,7,7,15,12,13,11,11,6,7,15,4,12,8,11,1,3,2,1,2,1,2,3,2,2,1
"4373",73200754,"Sébastien K'Bidi","2/2/1987 (36 years old)","D/M (C)","Saint-Denis FC","Réunion D2 Regionale","REU","Yes","7/1/2020","12/31/2024","$0","Right","Fairly Strong","Very Strong","5'11""","156 lbs","100","6",60,65,6,2,2,3,12,5,8,6,1,13,7,1,14,6,15,9,4,8,7,14,14,5,14,8,9,7,7,7,7,9,6,9,12,6,9,4,11,10,14,12,14,11,10,8,12,8,9,9,10,1,3,2,2,3,3,1,1,2,1,2
"4374",73200618,"Jonathan Boyer","12/9/1992 (30 years old)","D (C), DM","JS Saint-Pierroise","Réunion Regional 1","REU","Yes","1/1/2023","12/31/2023","$0","Right","Reasonable","Very Strong","6'2""","169 lbs","190","5",60,65,1,5,2,2,4,5,5,4,4,9,9,1,13,6,5,6,6,6,7,13,13,5,5,5,10,6,4,11,13,10,6,7,13,13,13,6,9,16,10,10,11,11,6,10,13,6,9,13,16,3,1,3,1,2,1,4,2,1,1,3
"4375",49039396,"Kévin Androge","1/24/1990 (33 years old)","M (C)","AS Ste-Suzanne","Réunion Regional 1","REU","Yes","7/1/2020","12/31/2024","Not for Sale","Left","Very Strong","Reasonable","5'9""","141 lbs","230","13",50,60,6,5,2,6,14,6,4,10,2,9,11,6,7,13,5,10,7,13,6,6,8,5,14,8,8,7,7,11,8,10,5,6,16,9,7,7,10,15,11,7,12,14,15,11,9,7,20,7,20,1,2,1,2,1,2,3,3,1,3,3
"4376",49047584,"Christopher Pythie","6/13/1989 (33 years old)","M (C)","AF Saint-Louis","Réunion Regional 1","REU","No","6/30/2020","-","$0","Right","Reasonable","Very Strong","5'10""","152 lbs","212","22",55,60,6,6,3,5,9,6,6,9,5,11,11,1,7,10,10,8,4,8,7,12,8,5,7,11,8,7,14,12,12,6,7,4,11,9,7,6,12,13,9,13,13,14,7,7,5,8,10,10,10,1,1,3,2,2,1,2,1,2,3,2
"4377",49054917,"Sylvain Philéas","1/24/1993 (30 years old)","ST (C)","AF Saint-Louis","Réunion Regional 1","REU","Yes","6/14/2021","-","$0","Right","Reasonable","Very Strong","6'0""","167 lbs","110","34",55,60,1,4,11,12,7,1,7,5,2,3,4,8,1,7,8,6,6,11,3,10,2,10,9,12,4,4,2,6,12,12,2,8,12,12,11,7,9,18,13,13,12,12,12,8,8,7,9,10,12,1,1,3,3,2,2,1,2,2,1,3
"4378",49046532,"Mathieu Pélops","11/7/1986 (36 years old)","GK","Saint-Pauloise FC","Réunion Regional 1","REU","Yes","7/1/2020","12/31/2024","$0","Right","Reasonable","Very Strong","6'2""","174 lbs","302","-",50,60,3,3,3,2,2,7,1,3,3,1,7,2,2,1,9,9,10,5,8,11,10,1,11,3,9,6,5,5,7,10,4,13,9,6,1,4,8,13,11,9,10,13,11,4,14,7,9,7,16,5,6,6,7,6,11,9,13,5,12,13
"4379",2000008430,"Mustapha Yuusuf","3/12/2002 (21 years old)","GK","IFK Berga","Swedish Second Division South Götaland","SOM","Yes","11/29/2022","11/30/2024","$0 - $6K","Right Only","Weak","Very Strong","6'3""","165 lbs","24","-",59,90,3,2,4,2,6,4,2,3,3,3,6,2,2,7,9,7,14,6,7,7,10,3,10,1,7,9,6,8,11,13,8,18,12,10,9,8,9,10,10,10,10,10,5,9,7,5,9,10,12,8,13,10,7,11,9,9,15,7,7,13
"4380",2000090360,"Mickael Dubaril","12/2/1990 (32 years old)","WB (L)","Trois-Bassins FC","Réunion Regional 1","REU","Yes","6/14/2021","-","$0","Left","Very Strong","Weak","5'10""","152 lbs","31","2",50,60,5,12,7,4,8,2,1,2,4,6,9,3,7,10,11,6,5,5,11,10,11,8,11,6,9,7,5,8,11,7,7,5,10,10,13,4,10,11,10,12,7,12,8,4,9,1,9,12,16,3,2,1,1,1,3,2,3,1,1,3
"4381",8448698,"Yohan Guichard","9/9/1986 (36 years old)","D (C), DM","Saint-Denis FC","Réunion D2 Regionale","REU","Yes","7/1/2020","12/31/2024","$0","Right Only","Weak","Very Strong","6'4""","189 lbs","339","41",50,60,5,6,7,11,9,7,12,7,1,2,7,3,2,13,11,11,9,5,9,15,14,5,8,7,8,6,6,9,9,8,8,17,12,6,5,10,14,19,11,12,12,12,5,10,8,8,18,9,7,3,2,3,3,2,1,1,2,2,3,1
"4382",73200646,"Damien Mallard","3/11/1997 (26 years old)","D/M (L)","AS Ste-Suzanne","Réunion Regional 1","REU","Yes","7/1/2020","12/31/2024","$0","Left","Very Strong","Reasonable","6'4""","180 lbs","56","1",50,55,5,5,4,2,8,5,6,3,4,5,5,4,8,5,6,9,8,6,8,11,6,5,12,5,5,7,4,7,12,9,7,15,14,12,12,7,9,14,10,11,12,10,5,7,8,2,7,10,12,1,2,2,3,2,2,3,1,2,2,3
"4383",912021,"Wilfried Dalmat","7/17/1982 (40 years old)","M/AM (R)","US Portugaise Joué","French Regional Divisions","SMA","Yes","12/31/2021","-","$0","Right Only","Weak","Very Strong","5'9""","165 lbs","394","58",75,120,12,13,13,9,13,10,8,10,10,5,11,13,6,14,14,9,12,10,6,9,11,14,7,12,6,9,9,8,10,10,13,8,12,8,7,13,10,5,14,8,7,4,18,11,6,6,10,12,6,3,2,1,1,1,2,1,3,3,3,1
"4384",48037692,"Yoann Vardin","3/18/1998 (25 years old)","M/AM (C)","Sannois SG","French National 3 - Group G","SMA","Yes","7/7/2019","6/30/2025","$20K - $190K","Right Only","Weak","Very Strong","5'6""","132 lbs","63","-",83,106,11,10,11,9,10,12,6,11,6,7,12,11,6,11,10,11,10,10,10,10,11,11,9,10,9,11,11,11,12,12,10,6,13,11,12,10,10,8,11,11,10,11,8,10,8,6,10,10,10,1,3,3,2,1,1,1,3,4,2,3
"4385",49033518,"Laurent Amiens","12/17/1993 (29 years old)","D (RC)","Stade Poitevin FC","French National 3 - Group C","SMA","Yes","7/1/2021","6/30/2024","$14K - $150K","Right Only","Weak","Very Strong","6'0""","176 lbs","159","3",82,98,7,11,7,7,10,7,13,6,4,10,10,6,11,9,13,10,10,11,11,10,11,5,8,7,10,11,9,12,11,10,9,12,13,11,12,12,11,20,14,12,9,13,13,4,5,5,11,13,19,2,3,1,3,3,2,3,3,3,2,3
"4386",85074513,"Romuald Lacazette","1/3/1994 (29 years old)","DM, M/AM (C)","FC Wacker Innsbruck","Austrian Tyrol League","SMA","Yes","6/30/2022","6/30/2024","$140K - $425K","Right Only","Weak","Very Strong","5'9""","169 lbs","95","8",87,94,6,7,10,6,11,6,7,9,10,12,12,7,13,11,15,12,15,9,11,8,9,9,10,12,11,13,10,13,12,12,14,8,16,12,13,12,7,10,12,7,11,10,12,14,11,9,11,13,11,2,1,3,1,1,3,2,2,1,2,3
"4387",85027989,"Belony Dumas","7/18/1989 (33 years old)","D (C)","EFC Fréjus Saint-Raphaël","French National 2 - A","SMA","Yes","6/14/2021","6/30/2024","$12K - $35K","Right Only","Weak","Very Strong","6'1""","194 lbs","229","8",84,93,4,8,6,6,7,11,13,10,5,12,8,7,11,7,13,11,11,11,10,11,15,8,11,6,11,11,8,10,11,8,10,12,13,10,12,12,5,11,11,12,11,11,7,13,13,8,13,12,11,1,2,2,2,1,1,1,3,1,3,2
"4388",49034580,"Jordan Etienne","5/7/1997 (26 years old)","GK","Moulins Yzeure Foot","French National 3 - Group J","SMA","Yes","7/1/2021","6/30/2024","$0 - $55K","Right Only","Weak","Very Strong","6'2""","174 lbs","46","-",77,93,4,2,2,3,3,5,1,1,3,3,7,4,2,1,8,10,14,6,7,12,6,1,12,1,11,6,5,5,12,13,6,10,11,11,5,4,13,19,12,10,11,11,15,1,11,1,8,10,17,4,6,12,14,5,10,7,7,10,11,10
"4389",2000253044,"Pierre-Bertrand Arné","9/30/2000 (22 years old)","AM (C)","US Castanet-Tolosan","French National 3 - Group B","SMA","Yes","7/1/2022","6/30/2024","$0 - $85K","Right Only","Weak","Very Strong","5'6""","134 lbs","52","12",74,92,6,6,12,9,14,4,10,9,6,8,10,7,9,11,11,11,8,7,4,15,15,9,1,10,10,9,13,10,11,8,9,4,14,11,10,2,15,13,12,12,12,11,11,2,14,5,19,8,16,1,2,3,3,2,2,3,4,2,3,1
"4390",33082629,"Fahad Mohammed","3/21/2000 (23 years old)","D (LC), DM, M (C)","EIF","Finnish First Division","SOM","Yes","1/29/2023","11/15/2023","$16K - $50K","Left","Very Strong","Reasonable","6'0""","167 lbs","65","2",80,90,6,8,10,5,11,5,12,5,6,6,11,5,9,11,12,8,9,6,7,8,11,6,6,9,10,9,12,9,11,11,12,13,11,12,8,8,8,11,9,11,10,10,6,9,8,8,9,13,11,1,4,1,1,2,1,2,3,1,3,3
"4391",49054410,"Ismaël Petchy","4/24/2001 (22 years old)","D (R)","FC Villefranche","French National","SMA","Yes","7/1/2021","6/30/2024","$0 - $20K","Right","Reasonable","Very Strong","5'9""","154 lbs","-","-",73,92,6,12,6,8,10,2,8,3,8,10,10,4,11,8,13,10,7,8,9,13,12,6,1,8,13,9,8,9,10,10,9,6,5,13,11,7,13,16,11,12,11,10,14,2,12,6,11,11,13,3,2,2,3,2,2,2,2,3,1,3
"4392",50053945,"Stéphan Varsovie","10/28/1990 (32 years old)","D (R)","AS Saint-Priest","French National 3 - Group K","SMA","Yes","7/1/2022","6/30/2024","$24K - $70K","Right Only","Weak","Very Strong","5'10""","160 lbs","284","14",85,90,6,13,5,8,11,2,10,3,3,11,10,5,15,6,13,12,10,10,9,14,9,10,12,9,13,10,8,10,10,13,9,6,11,12,9,9,12,13,13,13,10,11,6,8,12,5,10,10,11,3,3,2,1,3,3,2,3,3,1,2
"4393",48047546,"Axel Raga","7/27/1997 (25 years old)","ST (C)","FC Vaulx","French National 3 - Group K","SMA","Yes","7/29/2022","6/30/2024","$0 - $70K","Right Only","Weak","Very Strong","5'11""","163 lbs","53","16",73,89,5,4,10,13,12,6,13,5,1,6,4,8,2,13,5,13,6,10,7,9,14,15,3,8,6,6,5,7,13,13,7,7,15,13,5,10,10,20,10,14,9,12,7,4,10,8,8,13,11,1,1,2,1,2,2,2,2,2,1,3
"4394",2000024422,"Ulrick Luperon","12/11/2000 (22 years old)","GK","Red Star (GP)","Guadeloupe Ligue Régionale 2 Poule B","SMA","Yes","8/1/2020","6/30/2024","$0","Right","Reasonable","Very Strong","6'0""","158 lbs","-","-",60,87,3,1,3,2,1,6,1,1,3,1,4,1,2,3,5,5,15,4,6,13,15,3,6,3,6,6,5,5,10,14,4,6,14,12,1,4,12,19,12,11,8,12,13,7,5,7,12,12,15,5,5,13,5,5,8,13,5,5,7,4
"4395",34008101,"Sébastien Raphose","6/29/1980 (42 years old)","GK","Sannois SG","French National 3 - Group G","SMA","Yes","6/14/2021","6/30/2024","$3K - $9K","Right Only","Weak","Very Strong","5'11""","156 lbs","158","-",80,85,4,1,3,1,1,8,1,1,2,1,7,1,3,6,10,12,11,9,13,13,7,2,6,1,14,9,7,8,5,10,10,10,13,5,3,10,1,10,10,9,11,14,9,9,10,7,12,11,12,11,7,10,8,11,11,10,15,12,10,10
"4396",85097020,"Adrien Ribac","9/12/1993 (29 years old)","D/WB/M/AM (L)","Red Star (GP)","Guadeloupe Ligue Régionale 2 Poule B","SMA","Yes","8/1/2020","-","$0","Left Only","Very Strong","Weak","5'9""","163 lbs","100","2",73,84,5,10,9,9,10,7,7,5,11,6,5,4,9,6,14,8,8,9,9,9,16,15,1,14,7,8,8,9,12,12,11,7,5,13,14,7,12,10,11,12,13,11,6,8,11,6,15,10,9,2,2,3,1,1,3,1,1,2,2,1
"4397",8445816,"Sébastien Célina","1/4/1985 (38 years old)","D (C)","Solidarité Scolaire","Guadeloupe Ligue Régionale 1","SMA","Yes","7/1/2020","6/30/2024","$0","Right Only","Weak","Very Strong","6'2""","187 lbs","304","20",81,83,4,5,6,7,8,6,13,7,6,12,8,7,10,8,14,12,12,7,11,10,13,5,9,6,10,12,7,12,10,7,14,14,13,9,13,12,7,9,9,10,8,12,6,8,14,7,12,11,8,3,1,4,2,1,2,1,1,3,3,1
"4398",85092123,"Kévin Zonzon","7/6/1989 (33 years old)","M (C)","US Pays du Valois","French National 3 - Group G","SMA","Yes","7/1/2022","6/30/2024","$1K - $8K","Right Only","Weak","Very Strong","5'9""","152 lbs","100","2",76,82,8,11,12,6,9,7,9,11,3,8,10,1,9,11,9,12,13,7,8,14,6,7,11,11,11,7,6,9,12,12,10,11,13,12,11,7,14,16,11,11,12,14,12,2,9,5,12,10,19,1,3,1,4,1,2,4,4,3,2,1
"4399",49048551,"Darren Pompé","1/23/2000 (23 years old)","D (L)","Olympic Charleroi","Belgian First National Amateur Division","SMA","Yes","7/1/2022","6/30/2024","$1.5K - $12K","Left Only","Very Strong","Weak","5'8""","132 lbs","18","-",70,82,6,9,4,4,7,3,7,4,7,8,7,5,7,5,11,10,9,8,11,11,13,9,13,7,10,8,3,8,14,10,8,3,15,13,13,6,15,11,11,9,10,13,7,2,5,7,15,13,15,3,1,3,1,3,1,1,3,1,1,2
"4400",50074018,"Mickaël Clio","2/26/1994 (29 years old)","D (C)","US Ivry Football","French National 3 - Group H","SMA","Yes","7/1/2022","6/30/2023","$0","Right Only","Weak","Very Strong","6'0""","182 lbs","47","3",72,81,3,2,2,6,7,1,11,2,1,9,5,3,13,6,8,8,7,7,11,13,14,5,10,5,11,10,5,7,13,9,11,11,12,10,12,12,5,10,13,10,8,12,9,4,9,5,12,9,16,3,2,1,2,3,1,3,1,3,2,3
"4401",2000007398,"Mukhtar Suleiman","8/10/1998 (24 years old)","AM (L), ST (C)","Katwijk","Dutch Tweede Divisie","SOM","Yes","6/30/2021","-","$0","Right","Reasonable","Very Strong","5'10""","156 lbs","89","29",73,87,7,11,11,13,12,6,8,8,5,2,11,8,2,7,10,6,6,9,8,13,16,9,2,13,2,7,7,8,14,12,10,3,8,13,7,4,10,20,11,11,11,12,13,1,12,5,9,10,20,3,3,2,3,3,1,4,3,1,3,1
"4402",2000289741,"Christopher Despeine","4/4/2001 (22 years old)","D (C)","Juventus Ste-Anne","Guadeloupe Ligue Régionale 1","SMA","Yes","7/1/2022","6/30/2025","$0","Right","Reasonable","Very Strong","5'11""","158 lbs","-","-",57,78,4,2,1,2,7,2,9,3,4,14,3,1,14,5,10,11,8,7,8,13,15,5,8,6,10,6,1,7,9,11,7,8,8,10,8,4,16,14,13,10,13,10,8,8,12,8,10,10,14,2,2,2,2,2,1,2,2,3,3,2
"4403",2000281922,"Ismaël Marcelin","9/14/2001 (21 years old)","DM, M (C)","Junior Stars","Saint-Martin Championship","SMA","No","1/1/2023","-","$0","Right","Reasonable","Very Strong","5'10""","158 lbs","-","-",60,73,5,7,6,3,10,7,7,12,1,8,8,2,10,11,8,7,7,9,4,12,13,5,10,8,10,10,8,12,12,9,8,9,10,9,13,7,11,18,11,14,9,11,11,7,7,5,10,10,12,4,1,2,2,1,1,3,2,2,3,3
"4404",2000289846,"Romalli Chilin","9/30/2005 (17 years old)","ST (C)","St. Louis Stars (SMT)","Saint-Martin Championship","SMA","Yes","6/13/2022","-","$0","Right","Fairly Strong","Very Strong","5'7""","121 lbs","-","-",52,72,3,2,8,13,13,5,6,3,1,3,6,8,4,10,12,7,7,8,4,4,9,10,11,12,3,5,4,6,9,13,6,3,12,12,5,1,8,19,10,12,11,9,10,5,9,4,9,10,16,2,2,3,1,1,3,1,2,2,3,1
"4405",2000289819,"Ricky Page","10/5/2004 (18 years old)","M/AM (R)","Attackers","Saint-Martin Championship","SMA","No","6/13/2022","-","$0","Right","Fairly Strong","Very Strong","5'8""","134 lbs","-","-",53,72,2,7,10,7,9,4,2,5,2,4,7,1,2,9,7,2,6,9,3,10,10,13,9,8,2,6,6,11,12,10,4,1,10,12,6,2,10,14,10,11,10,10,5,13,11,7,19,10,15,2,4,3,1,3,1,1,3,2,3,3
"4406",2000281936,"Steven Laguerre","5/9/2001 (22 years old)","D (LC), DM","Junior Stars","Saint-Martin Championship","SMA","Yes","1/1/2022","-","$0","Left Only","Very Strong","Weak","6'2""","174 lbs","-","-",53,70,6,6,5,4,3,6,8,2,2,7,9,4,10,8,7,10,8,6,10,12,11,5,9,6,7,7,8,9,8,9,10,14,12,7,10,10,14,7,9,9,13,9,7,10,13,6,14,11,19,3,2,2,3,1,2,1,2,3,3,3
"4407",2000289799,"Noha Mauvais","7/21/2004 (18 years old)","D (C), DM","Junior Stars","Saint-Martin Championship","SMA","Yes","6/13/2022","-","$0","Right Only","Weak","Very Strong","5'9""","145 lbs","-","-",54,68,5,5,4,2,3,5,11,5,1,10,8,2,8,9,15,10,12,6,9,12,5,5,8,5,9,5,9,7,10,10,6,5,11,9,9,6,10,13,12,10,11,8,6,7,9,3,8,13,7,1,1,2,1,3,1,2,2,1,1,1
"4408",2000282204,"Alain Cordero","6/15/2002 (20 years old)","D/WB/M/AM (R)","Junior Stars","Saint-Martin Championship","SMA","Yes","1/1/2021","-","$0","Right","Weak","Very Strong","5'11""","156 lbs","-","-",53,66,7,10,9,8,8,5,6,3,4,5,5,1,8,6,11,7,7,6,7,11,5,9,1,6,7,4,5,8,8,11,7,7,7,13,13,4,11,10,13,10,12,11,14,6,8,2,8,13,7,1,4,1,3,2,3,3,3,2,2,1
"4409",88025864,"Nicolas Chalmet","11/12/1988 (34 years old)","M/AM (C)","FC Clifton Hill","Victorian State League 2 North-West","SMA","Yes","6/12/2023","-","$0","Right","Fairly Strong","Very Strong","6'0""","160 lbs","27","-",58,65,5,7,4,6,12,4,6,8,2,7,8,1,4,8,14,9,1,6,7,12,3,8,7,10,8,7,9,8,11,10,7,8,10,10,11,4,11,14,10,9,10,8,12,9,10,4,9,11,11,2,1,1,3,3,2,2,3,4,1,3
"4410",2000289738,"Lenny Foy","12/29/1998 (24 years old)","GK","Red Star (GP)","Guadeloupe Ligue Régionale 2 Poule B","SMA","Yes","1/1/2020","6/30/2024","$0","Right Only","Weak","Very Strong","6'2""","167 lbs","-","-",52,65,1,3,2,2,1,6,1,1,3,2,6,3,3,1,5,9,9,6,8,13,11,3,7,3,11,6,5,5,12,9,6,13,15,11,5,5,9,18,11,11,11,10,12,6,9,6,10,13,19,6,5,5,6,7,6,13,13,4,8,13
"4411",2000113977,"Jason Maccow","8/23/1999 (23 years old)","D (LC)","Junior Stars","Saint-Martin Championship","SMA","Yes","1/1/2022","-","$0","Left","Very Strong","Weak","5'11""","167 lbs","-","-",53,64,2,7,4,1,7,1,8,1,5,11,4,3,9,6,15,9,8,6,5,13,7,5,13,3,10,5,4,7,11,10,7,8,12,11,9,4,14,12,10,13,9,10,5,1,12,1,8,9,14,1,3,1,1,2,1,3,3,3,2,4
"4412",2000299225,"Mohamed Hussein Farah","5/14/2005 (18 years old)","D/WB (R)","Gaadiidka","Somali Premier Division","SOM","No","7/1/2022","6/30/2024","$0","Right","Reasonable","Very Strong","5'5""","123 lbs","-","-",56,86,5,11,8,7,10,2,7,5,7,9,9,3,9,9,11,7,7,9,5,8,16,7,10,8,4,8,5,9,13,14,8,1,12,12,10,1,10,11,11,10,11,10,9,8,7,7,14,12,13,3,1,2,2,1,1,2,2,4,1,1
"4413",2000097145,"Yannick Bellechasse","10/26/1992 (30 years old)","AM (C), ST (C)","Junior Stars","Saint-Martin Championship","SMA","No","6/12/2023","-","$0","Right","Reasonable","Very Strong","5'11""","176 lbs","2","3",63,63,3,3,9,12,9,5,9,8,1,4,9,5,8,11,5,9,7,8,4,12,13,12,13,13,7,9,10,9,7,8,10,10,5,6,9,10,8,9,8,10,12,10,11,1,9,8,8,12,18,3,3,1,3,2,1,3,2,2,2,1
"4414",2000281935,"Pablo Adams","12/28/2001 (21 years old)","AM (RLC), ST (C)","Junior Stars","Saint-Martin Championship","SMA","Yes","1/1/2021","-","$0","Right","Reasonable","Very Strong","5'10""","196 lbs","-","-",54,62,2,5,10,12,13,4,8,11,3,6,8,8,4,9,14,6,7,11,7,7,12,12,4,11,3,7,8,8,8,9,10,4,6,7,9,10,9,7,6,9,12,10,6,2,15,3,9,12,9,1,2,3,1,3,2,1,1,3,2,3
"4415",2000281938,"Thierry Seguin","6/7/2003 (20 years old)","D (C), AM (L)","Junior Stars","Saint-Martin Championship","SMA","No","1/1/2021","-","$0","Right","Weak","Very Strong","5'10""","152 lbs","-","-",51,61,1,5,8,9,7,5,8,4,3,3,6,2,8,7,15,7,7,5,3,13,11,9,1,8,6,5,3,7,13,13,6,3,10,13,10,5,9,13,12,10,8,13,10,10,7,8,9,12,17,2,3,2,2,3,1,3,3,2,1,3
"4416",2000049984,"Emmanuel Richardson","12/15/2001 (21 years old)","D (RC), DM","Junior Stars","Saint-Martin Championship","SMA","Yes","6/1/2022","-","$0","Right","Weak","Very Strong","6'0""","167 lbs","-","-",53,60,4,8,5,2,7,6,8,7,6,9,5,1,12,8,7,6,8,8,5,14,14,5,11,6,13,7,6,8,11,7,5,6,14,7,6,6,12,20,12,13,9,5,15,4,6,1,9,12,16,1,2,3,2,1,3,1,1,3,3,2
"4417",2000281937,"Aneudy Martínez","4/26/1999 (24 years old)","D/WB/M (R)","Junior Stars","Saint-Martin Championship","SMA","No","1/1/2021","-","$0","Right","Weak","Very Strong","5'9""","152 lbs","-","-",56,60,6,7,7,4,8,2,6,2,6,7,8,1,10,7,12,11,11,8,7,7,12,5,10,7,8,7,7,8,13,12,7,7,14,9,13,6,12,11,12,12,10,13,12,10,5,5,19,12,12,1,3,1,3,2,1,2,1,1,2,3
"4418",2000289734,"Karl Momperousse","2/18/2000 (23 years old)","GK","Phoenicks","Saint-Martin Championship","SMA","No","1/1/2019","-","$0","Right Only","Weak","Very Strong","5'10""","154 lbs","-","-",50,60,2,3,2,2,1,4,1,2,2,1,3,3,2,2,12,6,13,5,7,11,16,1,12,3,9,5,4,4,8,13,5,5,12,4,4,4,9,19,9,14,10,11,8,9,14,1,10,11,15,5,5,12,12,7,9,11,5,9,6,5
"4419",2000281934,"Kearney Chance","5/18/2001 (22 years old)","M (L), AM (RLC), ST (C)","Junior Stars","Saint-Martin Championship","SMA","Yes","1/1/2022","-","$0","Right","Weak","Very Strong","6'0""","149 lbs","-","-",50,60,4,6,7,8,7,1,7,5,4,4,9,2,2,10,7,8,1,6,5,5,5,11,1,6,2,5,3,6,12,12,5,12,10,12,5,3,11,11,11,10,10,12,7,3,6,5,13,11,9,2,3,2,3,2,2,3,2,3,2,2
"4420",82079519,"Danilo Cocks","8/17/1995 (27 years old)","ST (C)","Phoenicks","Saint-Martin Championship","SMA","Yes","7/1/2020","-","$0","Right","Reasonable","Very Strong","5'9""","149 lbs","-","-",50,50,4,3,5,12,6,4,10,5,1,2,4,4,2,9,8,10,6,8,3,9,13,10,3,12,5,4,4,5,12,12,5,2,12,12,8,6,8,14,12,9,11,12,12,7,6,7,9,11,14,1,2,1,2,3,1,1,3,1,1,2
"4421",28100014,"Easah Suliman","1/26/1998 (25 years old)","D (C)","VTSC","Portuguese Premier League","PAK","No","1/21/2020","6/30/2025","$0","Right","Reasonable","Very Strong","6'2""","176 lbs","61","-",103,120,4,8,9,5,10,4,13,6,8,13,11,12,11,10,7,12,12,10,9,10,3,6,10,6,11,12,8,12,11,11,10,14,14,12,13,14,11,11,12,12,7,12,8,12,8,4,10,11,19,1,2,3,3,1,3,3,3,1,3,3
"4422",2000148556,"Alamgir Ghazi","5/9/2001 (22 years old)","M/AM (C)","W.A.P.D.A.","Pakistani Premier League","PAK","No","7/1/2022","6/30/2024","$0 - $5K","Right","Fairly Strong","Very Strong","5'11""","149 lbs","-","-",65,120,6,8,7,8,8,5,3,7,1,3,11,7,5,12,10,7,8,6,7,7,13,13,6,5,6,8,9,9,10,11,9,6,9,12,9,6,11,13,8,13,8,12,9,8,11,3,12,15,13,3,3,1,3,3,2,2,3,3,2,1
"4423",2000147675,"Seydouba Camara","1/18/2000 (23 years old)","M/AM (C)","Gendarmerie","Djiboutian Premier Division","SOM","No","7/1/2021","6/30/2024","$0","Right","Strong","Very Strong","5'10""","152 lbs","-","-",65,85,2,2,7,6,13,4,1,7,5,5,10,4,6,10,9,7,7,5,6,12,8,13,13,7,7,6,6,7,8,12,6,5,13,11,7,3,14,19,12,11,10,8,5,2,10,6,17,10,10,3,3,1,2,3,1,3,3,1,3,3
"4424",2000253169,"Omer Rao","10/22/1996 (26 years old)","D/WB (R), DM, M (RC)","W.A.P.D.A.","Pakistani Premier League","PAK","No","6/15/2020","6/30/2024","$2.5K - $7K","Right","Fairly Strong","Very Strong","5'8""","154 lbs","-","-",85,120,4,11,8,7,11,7,6,7,9,12,8,2,6,8,10,8,10,9,11,8,15,11,10,11,6,8,8,14,11,14,8,4,10,10,14,9,10,8,15,13,14,14,10,15,6,7,5,12,14,2,2,2,2,3,2,2,2,3,4,3
"4425",29107387,"Otis Khan","9/5/1995 (27 years old)","M (R), AM (RLC)","Grimsby","Sky Bet League Two","PAK","No","7/1/2022","6/30/2024","$7K - $70K","Right","Fairly Strong","Very Strong","5'7""","156 lbs","236","33",89,120,10,10,12,9,11,10,6,8,2,6,12,9,6,12,9,11,9,13,9,10,13,12,6,11,9,10,11,10,11,13,9,6,12,12,10,7,13,6,8,12,12,12,10,12,5,12,10,16,15,1,2,2,2,2,2,4,1,2,2,4
"4426",2000238632,"Shayek Dost","5/1/2002 (21 years old)","AM (RL)","W.A.P.D.A.","Pakistani Premier League","PAK","No","7/1/2022","6/30/2024","$0","Left","Very Strong","Weak","5'10""","165 lbs","-","-",70,118,7,9,8,9,9,8,8,9,5,5,7,7,9,8,14,13,10,9,7,5,16,10,6,7,5,9,10,16,12,9,9,9,13,12,14,12,9,10,14,15,14,14,7,4,7,5,11,18,10,3,1,1,2,2,2,3,3,1,1,3
"4427",2000012167,"Ali Uzair","10/14/1996 (26 years old)","D/WB (RL), DM","W.A.P.D.A.","Pakistani Premier League","PAK","No","7/1/2020","6/30/2024","$500 - $2.5K","Left","Very Strong","Weak","5'10""","158 lbs","-","-",80,110,9,12,7,5,9,8,4,9,3,6,6,3,11,7,15,9,13,14,6,7,16,8,6,5,9,9,6,14,9,9,9,8,15,10,17,9,15,4,9,13,15,17,5,10,10,4,10,13,10,3,3,3,2,2,1,1,1,4,3,3
"4428",27110316,"Adnan Mohammad","7/2/1996 (26 years old)","M/AM (RL)","VB 1968","Denmark's Series Group 2","PAK","Yes","3/2/2022","-","$0","Right","Reasonable","Very Strong","5'10""","154 lbs","134","15",64,95,8,10,12,8,11,8,5,10,5,4,11,4,5,11,12,11,5,10,6,8,5,14,14,9,4,6,9,7,12,12,5,7,10,11,9,6,11,17,7,3,4,10,9,10,3,7,6,16,19,2,2,1,1,1,1,1,1,1,2,2
"4429",53001870,"Yasir Bashir","9/25/1983 (39 years old)","M (RLC)","Oslo City","Norwegian Lower Division","PAK","Yes","6/14/2021","-","$0","Right","Weak","Very Strong","6'1""","163 lbs","71","6",55,90,6,7,13,6,7,8,6,7,1,7,8,6,5,12,11,7,8,5,8,7,12,8,13,10,8,11,11,10,12,7,13,6,17,10,12,8,7,16,14,10,9,8,5,11,7,1,9,14,12,3,3,2,1,1,4,3,3,2,1,2
"4430",2000070566,"Abdullah Iqbal","7/27/2002 (20 years old)","D (RLC), DM","B.93","NordicBet Liga","PAK","Yes","2/1/2022","12/31/2024","$0 - $35K","Right","Reasonable","Very Strong","6'4""","187 lbs","56","1",78,90,8,10,8,8,9,8,12,5,8,10,12,3,15,10,8,10,10,9,10,9,17,5,9,8,9,9,8,10,6,12,12,12,13,7,6,10,13,16,10,12,9,10,6,8,8,1,9,11,19,3,3,3,2,1,2,2,3,3,2,2
"4431",63033372,"Navid Rahman","5/26/1996 (27 years old)","M (C), ST (C)","Woodbridge Strikers","League1 Ontario","PAK","No","12/31/2022","-","$0","Right","Reasonable","Very Strong","5'5""","130 lbs","61","5",68,90,5,5,8,11,11,5,7,5,1,7,9,5,2,8,12,7,5,8,6,12,13,9,13,13,7,6,8,8,13,13,6,1,13,13,13,2,9,16,13,12,11,11,8,2,11,2,14,10,7,1,2,1,2,3,1,3,1,1,3,2
"4432",2000070564,"Abdul Arshad","2/26/2003 (20 years old)","M (L), AM (RL)","HB Køge","NordicBet Liga","PAK","Yes","2/11/2022","12/31/2023","$0 - $14K","Left","Very Strong","Fairly Strong","5'7""","134 lbs","15","1",72,90,8,13,12,10,9,7,4,6,3,6,8,2,8,10,12,9,7,10,6,13,9,9,1,11,7,9,7,12,11,8,9,6,12,9,9,1,12,17,10,9,13,10,13,9,15,1,9,9,16,2,2,1,2,2,3,2,1,1,3,1
"4433",28101150,"Samir Nabi","12/16/1996 (26 years old)","M/AM (C)","Sutton Coldfield","English Northern Premier League Division One Mids","PAK","No","1/30/2023","6/30/2024","$0 - $14K","Right","Reasonable","Very Strong","5'11""","160 lbs","39","-",50,83,8,9,9,6,9,8,7,9,3,8,9,5,6,9,6,9,9,10,9,8,13,8,6,8,6,11,9,11,10,8,9,10,8,11,11,6,10,10,13,11,11,10,7,13,5,3,8,11,12,1,3,3,3,1,4,1,1,2,2,1
"4434",2000088670,"Anwar Shakunda","4/12/1999 (24 years old)","ST (C)","Horseed","Somali Premier Division","SOM","No","9/13/2021","6/30/2024","$0","Right","Fairly Strong","Very Strong","5'10""","160 lbs","-","-",75,85,5,5,9,12,12,5,12,5,3,4,2,5,1,10,8,9,7,7,4,8,18,11,12,12,6,5,4,6,12,12,6,4,8,12,11,9,10,11,12,11,11,10,7,15,6,3,9,12,16,1,2,3,4,1,2,1,2,4,2,2
"4435",63033371,"Adel Rahman","6/6/1995 (28 years old)","M/AM (C)","ProStars FC","League1 Ontario","PAK","No","6/18/2022","-","$0","Right Only","Weak","Very Strong","5'10""","160 lbs","58","16",71,82,4,6,8,6,14,6,6,7,6,7,10,4,8,10,6,9,8,9,8,11,11,9,3,9,8,8,12,9,14,14,8,7,14,14,6,5,11,15,10,12,10,12,6,10,7,5,14,9,17,2,1,2,3,2,2,2,3,2,3,2
"4436",2000073900,"Hamza Mahmood","12/31/1997 (25 years old)","GK","Al-Rams","UAE First Division","PAK","No","1/2/2022","6/30/2024","$0","Right","Reasonable","Very Strong","6'0""","160 lbs","29","-",65,80,4,3,2,1,1,6,1,3,3,1,9,1,1,1,9,8,14,5,8,9,16,1,7,1,8,5,4,4,12,14,5,9,9,11,3,3,9,18,12,8,9,8,8,4,13,7,9,11,18,5,9,12,9,4,8,12,5,6,11,12
"4437",2000176187,"Inayatullah Nawaz","3/27/1997 (26 years old)","GK","HPC","UAE Second Division","PAK","No","7/1/2021","-","$0","Right","Fairly Strong","Very Strong","6'4""","189 lbs","28","-",65,80,2,1,2,1,3,5,1,2,3,3,3,2,2,1,14,10,11,6,8,13,12,1,7,2,7,4,1,5,9,8,6,13,12,9,5,9,8,18,8,11,11,10,7,7,12,7,18,9,15,6,8,9,9,8,13,13,5,5,10,13
"4438",2000238481,"Muhammad Waheed","10/15/2002 (20 years old)","ST (C)","S.N.G.P.L.","Pakistani Premier League","PAK","No","7/1/2021","6/30/2024","$1.5K - $4K","Right","Fairly Strong","Very Strong","5'11""","141 lbs","-","-",55,76,4,6,9,9,8,5,7,6,1,2,6,7,5,8,7,8,5,8,6,8,13,13,5,7,6,7,6,9,13,11,6,6,9,13,7,5,9,15,13,10,18,8,11,9,8,5,8,12,7,2,1,3,3,3,3,3,1,1,3,3
"4439",27019641,"Yousuf Butt","10/18/1989 (33 years old)","GK","Ishøj IF","3. Division","PAK","Yes","7/1/2022","6/30/2024","$1.5K - $4.5K","Left Only","Very Strong","Weak","6'2""","165 lbs","292","-",63,73,3,1,1,1,3,5,3,3,1,3,8,1,2,6,10,9,6,9,10,9,5,2,12,2,10,9,8,8,13,8,9,12,12,12,11,5,10,16,12,12,4,4,5,6,5,8,11,9,15,8,12,10,6,9,8,12,5,8,12,10
"4440",2000164534,"Imran Ibrahim","12/16/2003 (19 years old)","WB (L)","Ittihad Kalba","UAE Professional League","PAK","No","7/1/2021","6/30/2024","$0 - $65K","Left","Very Strong","Reasonable","5'11""","156 lbs","-","-",55,65,3,7,6,4,11,1,5,5,4,7,9,1,8,6,9,7,5,4,7,5,16,5,12,3,4,7,4,8,12,14,7,7,9,13,12,5,12,10,11,14,9,13,9,9,8,6,8,12,11,1,3,4,1,2,3,3,2,3,3,2
"4441",23216170,"Saqib Hanif","4/23/1994 (29 years old)","GK","Green Streets","Maldivian Dhivehi League","PAK","No","10/22/2020","12/31/2023","$0","Right","Reasonable","Very Strong","6'0""","169 lbs","-","-",50,61,1,1,1,3,1,3,1,3,1,3,5,4,2,1,5,6,8,5,7,12,13,1,9,2,9,5,4,4,7,12,5,5,13,7,1,7,11,11,13,11,11,10,8,9,5,1,12,11,20,6,6,12,15,5,7,12,5,4,12,9
"4442",23216167,"Mansoor Khan","2/20/1997 (26 years old)","ST (C)","P.A.F.","Pakistani Premier League","PAK","No","6/15/2020","6/30/2024","$0 - $1.5K","Right","Weak","Very Strong","5'9""","156 lbs","-","-",50,60,5,3,11,6,10,5,7,7,1,5,5,1,1,9,9,11,1,8,3,10,5,9,12,9,4,5,3,7,13,13,6,8,12,13,9,10,9,10,11,9,12,12,9,13,9,4,10,12,13,2,3,2,4,1,1,3,2,1,4,1
"4443",37073812,"Omran Haydary","1/13/1998 (25 years old)","AM (RLC), ST (C)","Lechia","Polish First Division","AFG","Yes","2/11/2020","6/30/2024","$0","Right Only","Weak","Very Strong","5'8""","141 lbs","115","35",104,120,8,10,13,10,11,8,6,8,2,5,10,9,5,13,11,11,10,11,10,11,14,8,6,14,5,11,10,8,14,13,11,6,12,14,12,8,11,10,15,15,12,12,5,8,4,4,11,14,13,3,2,2,2,1,4,3,2,2,2,4
"4444",37045857,"Farshad Noor","10/2/1994 (28 years old)","D/WB (R), DM, M (RC)","DPMM","Singaporean Premier League","AFG","Yes","6/1/2023","12/31/2023","$60K - $180K","Right Only","Weak","Very Strong","5'10""","154 lbs","193","14",97,115,10,9,8,6,11,10,12,7,10,11,11,6,10,11,9,10,13,11,10,11,13,8,10,12,11,12,11,13,11,12,9,11,14,12,10,12,14,8,10,12,11,10,7,15,5,5,10,11,12,3,3,1,2,3,2,3,2,1,2,3
"4445",13186111,"Emmanuel Imanishimwe","2/2/1995 (28 years old)","D/WB (L)","FAR Rabat","Botola Pro 1","RWA","No","7/1/2021","6/30/2024","$4.5K - $45K","Left","Very Strong","Reasonable","5'11""","158 lbs","56","-",90,100,4,9,6,6,10,1,8,3,4,11,9,8,12,11,15,10,9,8,13,12,4,8,5,6,9,9,8,10,14,14,9,9,9,15,6,7,10,11,11,10,11,13,12,13,6,8,11,11,13,2,1,2,3,1,1,2,4,1,3,2
"4446",2000076648,"Ayman Hussein","12/12/2000 (22 years old)","D (C)","Horseed","Somali Premier Division","SOM","No","7/1/2020","6/30/2024","$0","Right","Reasonable","Very Strong","6'1""","171 lbs","-","-",68,85,6,4,1,7,7,6,10,8,2,10,9,4,16,4,11,10,9,6,10,10,6,5,13,7,10,8,4,9,5,10,9,16,14,10,8,8,13,17,10,10,9,13,14,13,15,2,11,13,10,3,2,2,3,1,3,2,3,2,1,1
"4447",2000103096,"Mohamed Hosein Saidi","7/6/2007 (15 years old)","WB (L)","FK Austria Vienna","Austrian Premier Division","AFG","No","6/13/2022","6/30/2027","$200K - $2M","Left","Very Strong","Fairly Strong","5'3""","110 lbs","-","-",61,114,5,11,8,7,12,3,7,2,7,6,8,1,10,15,12,7,4,8,6,7,10,8,7,8,6,8,3,8,11,15,4,6,14,13,9,1,6,15,9,11,10,10,11,2,11,4,14,11,7,3,2,1,3,1,2,1,3,3,1,1
"4448",2000080458,"Faisal Abu Bakr","3/13/1997 (26 years old)","D (L)","Al-Batin","Saudi First Division League","SOM","No","7/1/2022","6/30/2024","$0","Left","Very Strong","Reasonable","6'1""","158 lbs","33","1",80,85,5,9,5,2,9,1,9,3,6,10,11,5,14,8,13,10,9,7,9,14,11,9,10,7,10,8,7,12,9,12,8,9,12,11,7,8,11,17,11,12,12,11,14,5,5,6,12,14,16,3,2,1,3,2,1,3,2,2,2,3
"4449",2000088675,"Mahad Abdul Kadir","5/5/1999 (24 years old)","ST (C)","Jeenyo Utd","Somali Premier Division","SOM","No","7/1/2018","6/30/2024","$0","Right","Reasonable","Very Strong","6'2""","180 lbs","-","-",65,85,4,2,12,12,12,4,9,5,1,4,5,5,1,10,5,6,6,8,5,10,7,15,1,10,3,4,5,5,12,12,5,10,15,12,6,12,10,12,8,11,10,13,10,5,9,8,17,12,8,2,3,1,3,3,1,1,3,1,1,1
"4450",2000088661,"Meyman Abdi Nur","9/13/1997 (25 years old)","ST (C)","Horseed","Somali Premier Division","SOM","No","7/1/2019","6/30/2024","$0","Right","Fairly Strong","Very Strong","6'0""","167 lbs","-","-",66,85,5,3,6,13,13,5,13,6,1,5,6,7,4,10,5,8,7,7,6,10,16,10,13,10,6,5,1,6,12,9,6,7,13,12,9,8,11,18,12,11,11,10,13,1,6,7,18,11,20,3,1,1,3,1,1,3,1,1,2,4
"4451",20503443,"Abd-Al-Aziz Yousef","10/5/1999 (23 years old)","M/AM (R)","Rivers FC","League1 British Columbia","SOM","No","6/15/2020","-","$0","Right","Reasonable","Very Strong","5'11""","154 lbs","-","-",65,84,4,8,10,9,13,5,1,6,5,5,10,5,5,13,15,7,2,7,6,9,4,13,7,9,5,6,7,11,13,13,6,10,9,13,6,3,11,16,12,13,12,11,11,5,15,2,20,9,13,2,1,2,2,1,3,2,3,1,2,1
"4452",2000214275,"Ismael Sulub","12/30/2002 (20 years old)","M (C), AM (LC)","Christiania","Norwegian Fourth Division Oslo 1","SOM","Yes","1/1/2023","-","$0","Right Only","Very Weak","Very Strong","5'11""","158 lbs","44","4",61,83,8,8,12,7,11,7,4,8,3,4,10,7,4,12,9,11,8,9,9,9,12,14,7,11,4,10,11,12,11,11,6,10,10,10,8,6,11,7,9,9,12,11,5,3,11,10,12,14,11,2,1,2,3,3,2,1,3,1,1,2
"4453",2000039592,"Ismail Haji","7/29/2001 (21 years old)","D (C)","Kingston City","National Premier Leagues - Victoria 2","SOM","No","6/12/2023","9/30/2023","$0","Right","Reasonable","Very Strong","6'0""","165 lbs","12","-",58,83,4,4,1,6,9,2,10,8,4,10,9,3,16,5,18,10,8,7,10,8,8,5,10,8,9,8,7,9,10,10,9,12,13,9,10,6,15,4,5,8,6,3,10,9,10,13,9,8,8,3,2,2,2,3,1,3,1,1,4,1
"4454",2000088431,"Omar Haji","7/17/2000 (22 years old)","M (C)","Heegan","Somali Premier Division","SOM","No","7/1/2018","6/30/2024","$0","Right","Reasonable","Very Strong","5'8""","145 lbs","-","-",62,83,5,5,6,6,13,2,4,13,2,5,13,3,8,10,10,10,7,3,6,13,12,5,3,9,3,7,8,11,12,13,6,2,6,13,6,3,15,11,12,11,11,10,11,11,10,3,10,11,16,3,3,1,3,3,3,2,1,3,3,1
"4455",2000088388,"Abdulwali Mohamed","1/1/2000 (23 years old)","WB (L)","Dekedaha","Somali Premier Division","SOM","No","7/1/2019","6/30/2024","$0","Left","Very Strong","Reasonable","5'10""","154 lbs","-","-",63,83,5,10,8,6,13,1,7,1,7,8,9,2,10,11,12,8,3,7,7,13,13,8,4,7,7,8,8,8,12,13,8,6,16,10,8,6,12,14,10,9,11,12,5,11,7,5,13,9,11,2,3,2,1,1,3,1,3,3,3,3
"4456",53141019,"Liban Ali","2/1/1999 (24 years old)","AM (RL), ST (C)","Brodd","Norwegian Third Division Group 3","SOM","Yes","8/1/2019","-","$0","Right","Reasonable","Very Strong","6'0""","141 lbs","64","19",62,82,4,4,9,9,7,5,6,8,4,3,6,7,3,9,9,8,8,7,5,9,10,7,5,9,6,10,7,10,14,10,9,11,12,12,11,3,10,7,8,6,8,8,12,8,6,4,8,11,6,2,3,1,3,1,3,2,1,4,3,3
"4457",13203789,"Muhadjiri Hakizimana","8/13/1994 (28 years old)","M (L), AM (LC)","Police FC","Rwandan Premier Division","RWA","No","1/4/2023","6/30/2024","$85K - $250K","Right Only","Weak","Very Strong","5'9""","176 lbs","18","2",93,100,8,11,11,14,11,8,9,8,8,6,13,10,9,12,14,9,4,11,10,13,14,14,8,10,8,9,10,10,14,14,10,8,13,14,10,6,16,20,10,9,10,13,7,9,11,2,11,10,7,1,3,2,1,3,4,2,1,1,2,2
"4458",2000088629,"Hassan Abdinur Gesey","5/5/1998 (25 years old)","DM, M (C)","Horseed","Somali Premier Division","SOM","No","7/1/2019","6/30/2024","$0","Right","Reasonable","Very Strong","5'10""","156 lbs","-","-",64,82,2,5,7,7,12,5,6,9,1,6,12,2,12,7,5,10,6,5,8,10,11,5,14,6,6,7,8,12,12,14,4,4,12,13,7,9,13,11,13,12,13,9,7,11,13,1,11,13,17,2,3,1,2,3,4,4,3,4,2,2
"4459",43273322,"Mohammed Sagaf","11/12/1997 (25 years old)","M (RC), AM (C)","Dag & Red","Vanarama National League","SOM","No","1/30/2021","6/30/2024","$0 - $60K","Right Only","Weak","Very Strong","5'9""","156 lbs","177","19",75,82,9,9,11,7,9,5,9,6,10,7,9,4,9,11,9,9,10,9,8,10,11,11,15,9,8,11,9,13,12,9,10,9,12,12,12,11,11,6,11,5,4,7,5,9,5,13,5,12,14,1,2,2,3,4,4,1,3,1,1,2
"4460",53152719,"Mahad Abdillahi","1/1/2000 (23 years old)","DM, M (C)","Brumunddal","Norwegian Third Division Group 2","SOM","Yes","12/1/2019","-","$0","Right Only","Weak","Very Strong","5'10""","149 lbs","112","5",71,82,8,9,7,4,8,7,5,7,10,12,10,3,12,8,15,7,14,5,6,10,12,12,8,8,10,10,8,14,13,10,8,10,13,13,15,8,10,18,11,13,14,9,6,10,17,7,13,10,12,3,3,1,3,2,2,3,2,3,2,1
"4461",2000088432,"Mahad Hussein Basey","2/14/2000 (23 years old)","M (C)","Heegan","Somali Premier Division","SOM","No","7/1/2018","6/30/2024","$0","Right","Reasonable","Very Strong","5'10""","149 lbs","-","-",64,82,1,5,6,6,12,5,4,13,3,5,13,4,8,13,11,6,4,6,5,5,15,10,11,5,8,7,13,11,13,12,6,8,12,11,6,4,10,19,11,11,10,11,9,10,11,2,8,11,19,2,1,1,1,3,1,3,2,1,3,3
"4462",88023163,"Jama Boss","3/5/1994 (29 years old)","AM (LC), ST (C)","Whittlesea Utd","Victorian State League 1 North-West","SOM","No","1/1/2022","-","$0","Right","Reasonable","Very Strong","5'11""","156 lbs","89","47",75,81,6,8,10,8,13,6,8,4,3,6,8,1,7,10,8,7,3,10,6,8,14,13,6,12,6,7,7,7,13,13,13,10,11,13,12,4,12,13,13,11,12,13,10,3,10,1,10,14,9,1,2,1,2,1,1,4,1,3,3,1
"4463",2000299222,"Mohamed Osman","9/18/2003 (19 years old)","M/AM (C)","Gaadiidka","Somali Premier Division","SOM","No","6/12/2023","6/30/2024","$0","Right","Reasonable","Very Strong","6'3""","176 lbs","-","-",59,81,2,4,7,7,9,3,5,10,1,6,13,1,12,8,12,5,7,2,6,13,6,12,6,7,4,7,9,11,13,10,3,10,7,11,6,4,12,17,10,9,10,10,7,8,5,8,7,13,11,2,1,2,2,1,2,2,1,1,3,2
"4464",2000088638,"Abas Amin","1/1/1996 (27 years old)","DM, M (C)","Dekedaha","Somali Premier Division","SOM","No","6/15/2020","6/30/2024","$0","Right","Reasonable","Very Strong","5'7""","136 lbs","-","-",70,81,6,4,4,5,13,6,4,9,1,10,11,6,12,11,5,10,8,7,7,13,9,5,10,7,11,7,12,12,13,13,7,4,7,13,13,1,12,17,9,10,14,13,7,13,5,4,20,13,16,2,3,3,2,1,2,3,3,3,2,2
"4465",2000088677,"Abdumajid Osman","1/1/2000 (23 years old)","ST (C)","Dekedaha","Somali Premier Division","SOM","No","7/1/2018","6/30/2024","$0","Right","Reasonable","Very Strong","6'2""","165 lbs","-","-",63,80,5,2,10,13,9,5,11,6,1,5,6,5,1,6,14,8,7,10,5,11,5,9,5,13,4,5,4,6,13,13,6,13,11,13,5,3,7,10,10,9,12,11,5,4,5,2,16,11,16,2,3,3,1,2,3,3,3,4,2,1
"4466",37046945,"Liban Abdulahi","11/2/1995 (27 years old)","DM, M/AM (C)","TEC","Dutch Derde Divisie B","SOM","Yes","1/1/2023","-","$0","Right","Reasonable","Very Strong","5'10""","160 lbs","86","5",75,80,5,7,9,13,14,7,8,10,1,10,11,4,13,10,10,8,8,10,10,9,10,9,7,10,12,11,8,11,11,9,9,8,10,9,8,8,10,10,14,10,13,10,9,5,8,5,9,10,9,3,2,2,3,3,3,2,2,2,1,3
"4467",33069277,"Abdulkadir Said Ahmed","7/17/1999 (23 years old)","DM, M (C)","VJS","Finnish Third Division","SOM","Yes","2/9/2022","11/30/2024","$1.5K - $4K","Right","Fairly Strong","Very Strong","6'0""","167 lbs","77","1",70,80,9,7,8,7,10,9,10,7,7,8,10,3,8,11,13,12,10,8,8,8,12,6,1,10,12,8,10,7,11,12,12,11,14,11,8,9,9,14,13,9,10,11,6,10,8,2,11,12,8,2,3,1,2,3,3,1,3,3,3,1
"4468",2000300395,"Pacifique Ngabonziza","7/1/1996 (26 years old)","M (R)","Police FC","Rwandan Premier Division","RWA","No","6/12/2023","6/30/2025","$0","Right","Reasonable","Very Strong","6'1""","160 lbs","-","-",73,99,8,11,8,4,12,6,6,4,6,6,8,4,7,7,9,8,7,11,7,9,11,9,4,7,5,6,9,11,13,12,7,11,14,13,8,4,12,17,10,12,9,10,12,11,5,1,14,13,19,1,2,1,4,1,2,3,3,3,3,1
"4469",2000147674,"Isse Abdulkadir","7/1/1999 (23 years old)","D (C)","Mogadishu City Club","Somali Premier Division","SOM","No","7/1/2019","6/30/2024","$0","Right","Weak","Very Strong","6'0""","165 lbs","-","-",66,80,1,1,1,4,7,1,14,1,1,14,6,3,12,6,9,10,8,7,6,14,19,5,2,4,14,6,2,7,7,10,7,6,12,11,9,7,10,11,11,11,10,12,7,9,12,8,15,12,10,1,2,1,2,2,3,2,1,1,1,2
"4470",2000299218,"Abdiwali Mohamed","1/1/2000 (23 years old)","D (C)","Gaadiidka","Somali Premier Division","SOM","No","6/12/2023","6/30/2024","$0","Right","Strong","Very Strong","6'2""","174 lbs","-","-",60,80,1,1,1,4,6,1,11,3,1,8,6,1,12,2,15,12,8,6,8,12,10,5,14,5,9,5,2,6,8,10,6,7,13,6,8,6,12,19,14,11,13,13,13,7,10,6,9,13,14,2,4,1,2,1,1,3,3,1,1,2
"4471",2000088630,"Noor Ali Hasan","11/28/1998 (24 years old)","DM, M (C)","Horseed","Somali Premier Division","SOM","No","7/1/2018","6/30/2024","$0","Right","Reasonable","Very Strong","5'10""","156 lbs","-","-",58,80,4,4,5,5,10,5,4,4,1,7,10,1,12,13,6,10,7,7,7,11,18,5,7,5,7,5,9,9,13,13,5,2,9,13,4,6,13,13,14,12,11,10,11,10,6,7,11,11,10,3,1,3,1,1,3,3,3,2,1,3
"4472",2000088377,"Nur Ibrahim Ali","6/1/1999 (24 years old)","D (C)","Elman","Somali Premier Division","SOM","No","7/1/2018","6/30/2024","$0","Right","Strong","Very Strong","5'11""","163 lbs","-","-",64,80,2,4,1,1,6,1,11,1,1,8,5,5,10,5,13,10,8,3,7,13,10,5,3,4,13,5,2,6,13,11,6,10,10,10,8,8,10,13,10,9,11,10,5,1,9,6,7,12,10,3,2,3,1,3,3,3,3,1,1,3
"4473",2000088657,"Feysal Hashi","8/8/1999 (23 years old)","ST (C)","Mogadishu City Club","Somali Premier Division","SOM","No","7/1/2020","6/30/2024","$0","Either","Very Strong","Very Strong","6'1""","163 lbs","-","-",64,80,1,1,8,8,12,2,12,4,1,1,3,5,2,9,7,12,1,8,3,10,2,11,1,11,5,4,2,5,12,9,5,9,11,10,5,3,10,20,10,13,11,11,8,5,10,3,20,12,19,2,3,2,2,2,1,1,3,2,2,2
"4474",51016028,"Gibrán Lajud","12/25/1993 (29 years old)","GK","Santos Laguna","Mexican First Division","LIB","No","7/10/2020","6/30/2025","$190K - $1.9M","Right","Reasonable","Very Strong","6'0""","158 lbs","135","-",115,125,2,2,4,3,9,5,3,2,1,3,9,4,1,6,9,12,15,11,11,10,8,8,12,1,11,10,9,11,16,13,12,11,10,14,11,12,1,17,12,11,11,10,11,9,5,3,11,12,17,11,9,13,16,13,13,13,11,11,13,13
"4475",2000114392,"Ali Akbar Mannah","6/23/2003 (19 years old)","DM, M (C)","Ikhaa Ahli","Lebanese Second Division","LIB","No","7/1/2022","6/30/2024","$0","Right","Reasonable","Very Strong","5'9""","152 lbs","21","1",84,123,7,5,5,8,13,5,7,10,3,6,13,1,9,12,11,5,8,8,9,10,6,6,1,9,11,8,12,9,13,9,4,9,12,11,14,6,15,10,11,10,11,12,11,1,9,6,17,11,12,1,1,3,2,2,3,1,3,3,2,3
"4476",2000114391,"Mohammad Omar Sadek","10/25/2003 (19 years old)","AM (RLC), ST (C)","Nejmeh","Lebanese Premier League","LIB","No","4/25/2023","6/30/2024","$1.5K - $14K","Right","Reasonable","Very Strong","5'7""","136 lbs","41","8",85,123,7,7,14,9,14,7,8,9,6,7,12,16,6,9,5,8,8,10,5,11,4,10,13,10,5,8,7,9,13,13,8,4,12,9,7,3,10,20,10,12,9,13,9,10,11,5,14,10,18,4,3,2,1,3,3,3,3,3,1,3
"4477",51072271,"Daniel Lajud","1/22/1999 (24 years old)","AM (RL), ST (C)","Atlante","Mexican Expansion League","LIB","No","7/1/2022","6/30/2024","$35K - $350K","Left","Very Strong","Reasonable","5'9""","138 lbs","143","30",109,120,8,9,12,13,10,10,10,11,10,9,11,11,11,10,6,11,8,9,10,10,18,10,8,12,10,10,9,10,13,13,13,8,13,15,11,6,9,14,10,9,13,13,12,9,5,7,8,9,12,2,1,1,3,1,3,2,3,1,1,1
"4478",23190854,"Haitham Faour","2/27/1990 (33 years old)","DM, M (C)","Shabab Sahel","Lebanese Premier League","LIB","No","5/31/2023","6/30/2026","Not for Sale","Right","Reasonable","Very Strong","5'6""","149 lbs","164","2",92,119,6,4,13,4,8,7,9,10,3,12,16,6,15,12,11,10,17,9,10,13,13,8,15,9,12,13,7,14,8,9,10,5,11,10,11,11,14,11,18,10,11,10,3,18,5,2,12,9,18,1,3,1,1,1,1,1,3,3,3,1
"4479",13218639,"Adolphe Hakizimana","2/5/2002 (21 years old)","GK","Rayon Sports","Rwandan Premier Division","RWA","No","7/1/2021","6/30/2025","$0","Right","Reasonable","Very Strong","6'4""","180 lbs","-","-",71,99,1,1,2,3,2,6,1,1,1,2,9,4,1,6,8,9,11,7,10,13,15,2,5,3,9,7,6,6,11,11,2,12,13,11,4,7,10,13,14,7,10,13,7,7,5,2,13,10,14,8,14,13,11,6,11,13,5,7,7,10
"4480",23191054,"Mohammad Haidar","11/8/1989 (33 years old)","AM (L), ST (C)","Ahed","Lebanese Premier League","LIB","No","9/7/2020","6/30/2026","Not for Sale","Left","Very Strong","Strong","5'9""","138 lbs","170","46",102,116,8,14,16,14,14,8,8,9,8,8,8,6,6,10,10,11,7,11,9,14,17,9,9,14,8,9,4,10,12,10,9,7,15,10,12,7,11,12,11,13,10,10,7,12,10,8,6,12,16,3,1,3,3,1,3,1,3,2,1,3
"4481",93024202,"Alexander Michel","11/14/1992 (30 years old)","D (C)","United FC","Swedish First Division North","LIB","Yes","2/23/2023","11/30/2024","$0","Right Only","Weak","Very Strong","6'0""","171 lbs","213","4",94,115,7,9,8,5,10,9,12,10,8,12,11,10,12,11,10,12,8,10,12,12,11,10,10,11,11,12,10,11,10,9,12,11,12,11,12,12,12,12,11,12,12,10,5,8,14,7,13,9,15,3,2,3,3,3,4,2,2,2,2,1
"4482",2000194384,"Maxime Aoun","3/4/2001 (22 years old)","D (C)","Al-Ansar","Lebanese Premier League","LIB","No","7/1/2019","6/30/2024","$0 - $28K","Right","Fairly Strong","Very Strong","6'3""","176 lbs","21","-",88,115,5,1,3,2,7,1,13,5,2,13,7,3,11,6,8,13,9,7,8,12,11,5,4,6,12,6,5,7,13,12,7,14,10,12,9,6,13,18,10,13,8,11,12,12,8,5,10,9,9,1,2,2,3,2,4,3,1,3,2,1
"4483",93049466,"Felix Michel","7/23/1994 (28 years old)","D (C), DM, M (C)","Ahed","Lebanese Premier League","LIB","Yes","1/6/2023","6/30/2023","$0","Right Only","Weak","Very Strong","6'4""","187 lbs","120","4",94,115,7,11,9,7,10,7,13,9,8,11,11,7,11,11,15,11,13,10,11,11,11,5,7,11,11,14,7,14,11,7,11,15,12,12,11,13,18,7,10,11,11,7,12,8,15,8,12,10,14,3,3,3,2,2,1,2,3,1,1,2
"4484",2000092453,"Mohammad Masri","6/22/2001 (21 years old)","M/AM (L)","Ahed","Lebanese Premier League","LIB","No","7/1/2018","6/30/2024","$0","Left","Very Strong","Reasonable","6'0""","158 lbs","45","7",75,113,7,12,10,11,13,4,6,7,6,6,13,2,6,13,8,8,8,10,6,6,8,13,13,9,6,7,9,11,13,13,4,10,13,13,6,4,15,16,11,13,12,12,12,14,11,4,11,9,16,2,1,2,1,3,3,2,3,2,2,1
"4485",23019672,"Hassan Maatouk","10/8/1987 (35 years old)","AM (RLC)","Al-Ansar","Lebanese Premier League","LIB","No","5/14/2022","6/30/2024","$0 - $16K","Left","Very Strong","Strong","5'8""","152 lbs","240","110",106,113,9,10,8,14,14,9,10,11,6,7,15,6,9,12,5,11,7,14,9,11,4,15,14,12,9,10,9,11,11,11,11,7,14,11,11,7,11,11,11,12,14,10,11,10,10,4,13,9,11,1,2,2,1,2,3,2,3,3,3,2
"4486",23480341,"Khalil Bader","7/27/1999 (23 years old)","AM (RL)","Nejmeh","Lebanese Premier League","LIB","No","6/5/2023","6/30/2026","$14K - $45K","Right","Reasonable","Very Strong","5'6""","134 lbs","55","11",100,111,8,8,14,9,13,8,7,7,8,8,10,5,6,9,9,12,3,9,9,9,14,15,3,12,5,9,6,13,14,14,9,1,13,14,11,1,10,13,12,12,12,11,15,17,12,4,11,11,17,2,1,3,1,3,3,3,1,2,1,1
"4487",23019254,"Mohammad Nasser","10/16/2001 (21 years old)","ST (C)","Ahed","Lebanese Premier League","LIB","No","3/1/2021","6/30/2024","$0","Right","Reasonable","Very Strong","6'2""","180 lbs","53","6",86,111,7,8,13,14,12,7,14,8,4,6,6,7,7,13,7,11,5,9,5,10,2,12,5,14,8,7,8,8,13,9,8,8,6,10,8,9,12,20,10,12,10,11,9,8,15,6,12,11,11,3,2,1,2,1,2,3,1,3,1,2
"4488",2000092628,"Talal Dandachli","5/29/2001 (22 years old)","GK","Safa","Lebanese Premier League","LIB","No","7/1/2019","6/30/2025","$0","Right","Reasonable","Very Strong","6'3""","174 lbs","12","-",75,111,3,1,2,1,3,6,1,3,1,2,8,3,2,3,13,8,13,7,8,13,6,3,6,1,7,7,6,6,12,9,7,12,13,10,1,5,13,16,11,11,11,14,13,15,13,8,10,9,8,7,15,13,12,11,9,8,5,8,10,13
"4489",2000020252,"Hadi Kanj","9/14/2001 (21 years old)","GK","Al-Ansar","Lebanese Premier League","LIB","No","9/15/2020","6/30/2025","$0 - $16K","Right","Reasonable","Very Strong","6'4""","176 lbs","15","1",80,110,3,1,1,3,3,6,1,1,1,1,11,3,3,2,14,7,14,7,9,13,6,2,13,1,7,7,6,6,11,9,6,14,16,6,1,6,13,11,11,12,11,13,10,1,14,4,11,11,18,7,11,13,12,8,8,10,5,10,11,13
"4490",2000248818,"Kamanzi Ashraf","12/25/2001 (21 years old)","M (L), AM (LC)","MV Sport","Rwandan Premier Division","RWA","No","6/13/2022","6/30/2025","$0","Right","Reasonable","Very Strong","5'8""","145 lbs","-","-",69,98,6,9,13,6,9,6,4,4,6,5,12,5,7,11,5,9,7,6,6,6,5,10,10,14,6,7,7,12,13,12,4,1,9,14,8,4,12,17,12,12,11,11,13,8,8,8,10,10,15,2,1,1,1,1,2,3,2,3,1,2
"4491",23190911,"Ali Hamam","8/25/1989 (33 years old)","D (RC), WB (R)","Nejmeh","Lebanese Premier League","LIB","No","6/3/2022","6/30/2024","$500 - $4K","Right","Reasonable","Very Strong","5'10""","152 lbs","202","21",102,110,12,12,11,9,7,8,10,9,9,11,9,7,8,8,9,14,15,7,10,12,15,7,12,9,12,12,9,13,11,12,10,10,8,12,15,11,11,17,11,11,12,12,7,17,13,6,12,10,11,1,2,1,3,3,2,2,1,2,1,1
"4492",23336558,"Edmond Chehade","9/30/1993 (29 years old)","AM (LC), ST (C)","Al-Ansar","Lebanese Premier League","LIB","No","5/4/2023","6/30/2024","$0 - $35K","Left","Very Strong","Reasonable","5'9""","167 lbs","99","13",88,110,8,11,13,13,10,6,8,8,3,6,8,4,6,9,8,8,8,8,8,12,7,9,6,10,4,7,8,8,13,13,8,5,8,13,9,4,9,19,9,11,12,12,6,8,8,1,8,10,13,2,3,3,1,2,2,1,1,1,3,3
"4493",2000258119,"Hassan Mohamad","5/12/2006 (17 years old)","DM","Paderborn","Bundesliga 2","LIB","Yes","6/13/2022","6/30/2024","$14K - $130K","Right","Weak","Very Strong","5'10""","156 lbs","-","-",69,110,6,6,7,7,14,6,6,9,1,7,10,5,13,14,13,12,7,7,5,14,6,5,6,7,10,7,12,7,8,9,7,8,5,9,6,7,11,11,11,11,10,10,9,7,8,4,17,12,8,3,1,4,2,3,2,1,3,2,1,4
"4494",23330989,"Mostafa Matar","9/10/1995 (27 years old)","GK","Ahed","Lebanese Premier League","LIB","No","7/2/2020","6/30/2025","$20K - $60K","Right","Reasonable","Very Strong","6'1""","174 lbs","96","-",105,110,5,1,3,2,4,7,2,3,1,1,12,1,3,8,15,10,13,8,9,10,4,1,10,3,15,10,9,9,12,13,10,11,13,14,9,9,9,13,13,13,12,12,12,10,6,3,14,11,16,9,8,10,13,13,10,13,5,9,11,12
"4495",23492045,"Yahya Elhindi","9/24/1998 (24 years old)","DM","Al-Ansar","Lebanese Premier League","LIB","No","12/16/2021","6/30/2024","$8K - $24K","Right","Reasonable","Very Strong","6'0""","154 lbs","53","-",82,110,6,4,7,7,11,4,6,9,6,7,9,1,12,9,5,13,8,7,10,12,8,5,5,5,13,7,4,12,13,13,7,5,13,13,13,8,14,13,11,10,9,10,7,7,5,1,13,12,15,2,2,2,3,1,3,3,2,3,2,1
"4496",23480359,"Mehdi Zein","3/25/2000 (23 years old)","M/AM (RL)","Nejmeh","Lebanese Premier League","LIB","No","6/15/2020","6/30/2024","$1K - $9K","Left","Very Strong","Reasonable","5'7""","147 lbs","57","3",85,110,7,12,11,8,14,7,7,8,7,6,10,6,5,10,6,8,5,14,8,12,8,10,7,14,6,8,6,13,13,14,8,5,12,14,8,1,20,16,9,12,12,12,9,5,14,1,15,13,11,2,3,2,4,2,3,2,1,3,2,3
"4497",2000019251,"Alaa Ezzo","7/15/2001 (21 years old)","M (C)","Nejmeh","Lebanese Premier League","LIB","No","7/1/2022","6/30/2024","$500 - $2.5K","Right","Reasonable","Very Strong","5'7""","145 lbs","34","6",80,110,7,5,4,6,14,7,7,9,1,13,14,5,8,9,6,5,4,6,8,14,5,10,13,10,5,8,11,12,14,12,8,6,10,14,7,7,10,19,12,10,11,11,12,10,9,2,12,11,14,3,1,2,3,3,4,3,2,3,3,3
"4498",2000092445,"Hassan Srour","12/18/2001 (21 years old)","M (C)","Ahed","Lebanese Premier League","LIB","No","7/1/2019","6/30/2024","$12K - $40K","Right","Fairly Strong","Very Strong","5'8""","147 lbs","48","4",81,110,6,6,7,6,13,2,5,11,1,7,13,4,8,9,8,8,6,11,7,13,16,8,14,11,8,7,8,4,13,13,7,3,8,13,7,4,16,10,10,13,10,12,13,3,15,1,7,12,8,2,2,1,3,3,1,1,1,1,3,3
"4499",23195245,"Hussein Mortada","9/14/2000 (22 years old)","DM, M (C)","Nejmeh","Lebanese Premier League","LIB","No","6/7/2023","6/30/2026","$10K - $30K","Right","Reasonable","Very Strong","5'11""","160 lbs","5","-",80,109,5,7,3,6,12,4,7,8,1,8,11,2,14,9,13,13,8,4,9,12,11,5,1,8,9,8,9,7,14,12,8,10,11,10,7,6,10,14,10,10,10,10,5,9,10,5,10,13,14,2,2,3,2,2,3,2,3,3,2,1
"4500",72025485,"Hassan Saad","8/17/1992 (30 years old)","AM (L), ST (C)","Penang","Malaysian Super League","LIB","No","12/22/2022","11/30/2023","$45K - $140K","Right","Fairly Strong","Very Strong","5'10""","158 lbs","182","33",103,108,10,12,12,13,10,11,10,13,3,7,12,12,8,11,11,13,10,12,12,11,13,11,5,12,8,12,12,13,11,11,10,11,8,10,11,11,8,13,12,14,7,7,7,7,5,8,11,14,15,1,3,4,1,1,4,3,3,1,3,3
"4501",15081349,"Rahmat Akbari","6/20/2000 (22 years old)","M/AM (C)","Brisbane Roar","Isuzu UTE A-League","AFG","No","6/15/2020","6/30/2026","$0","Right","Reasonable","Very Strong","6'1""","156 lbs","135","13",95,113,9,8,9,14,15,9,10,10,7,10,14,10,9,15,6,7,10,14,10,15,7,13,7,12,5,10,13,10,7,8,13,12,11,10,7,10,11,20,12,10,10,10,8,18,13,7,17,11,7,3,3,2,3,1,1,3,3,2,1,3
"4502",37021416,"Faysal Shayesteh","6/10/1991 (32 years old)","M/AM (L)","Sreenidi","Indian National Football League","AFG","Yes","6/5/2023","5/31/2025","$0 - $80K","Left","Very Strong","Reasonable","5'8""","134 lbs","104","12",85,105,8,12,6,10,12,12,6,11,7,7,10,4,4,14,9,11,3,9,8,13,9,14,11,10,7,8,9,13,12,9,8,6,12,11,13,5,9,17,9,10,10,9,10,12,15,4,11,14,16,2,1,3,1,1,2,1,3,2,2,3
"4503",59145157,"Shohrukh Qirghizboev","5/1/2002 (21 years old)","GK","Khujand","Tajikistani High League","TJK","No","2/24/2023","12/31/2023","$14K - $45K","Right","Reasonable","Very Strong","6'2""","167 lbs","72","-",72,116,1,1,2,2,1,3,1,1,3,3,10,3,2,1,12,11,13,6,10,12,16,3,8,1,8,4,5,5,9,8,1,11,14,8,1,4,12,14,15,12,10,12,11,10,12,2,10,12,9,9,15,12,6,10,12,11,5,10,7,12
"4504",2000103908,"Alijoni Ayni","8/6/2004 (18 years old)","M/AM (C)","Istiqlol","Tajikistani High League","TJK","No","8/11/2022","6/30/2027","$100K - $1M","Left","Very Strong","Weak","5'5""","130 lbs","10","1",70,116,8,8,13,8,15,8,5,12,2,8,11,3,8,15,15,10,6,6,7,15,15,13,10,15,5,9,8,10,10,9,8,6,15,10,7,4,12,18,12,9,11,10,8,8,9,5,9,9,8,2,2,2,2,4,4,2,2,4,2,2
"4505",59138173,"Zoir Jo'raboyev","9/16/1998 (24 years old)","D (C), DM","Neftchi Farg'ona","Uzbekistan Superleague","TJK","No","1/5/2023","12/31/2023","$35K - $100K","Left","Very Strong","Fairly Strong","6'0""","171 lbs","91","5",90,115,5,7,4,2,9,7,13,3,1,8,7,3,8,8,15,11,10,8,12,13,10,5,9,7,12,7,5,8,13,12,8,10,5,13,11,6,14,18,14,14,10,13,5,5,9,7,20,13,15,2,1,3,2,3,2,1,3,3,3,1
"4506",59148361,"Muhriddin Hasanov","9/23/2002 (20 years old)","GK","Istiqlol","Tajikistani High League","TJK","No","1/1/2021","12/31/2023","$14K - $45K","Right","Reasonable","Very Strong","6'4""","178 lbs","25","-",72,114,5,3,3,3,2,6,1,3,1,2,13,2,3,1,7,9,11,7,13,12,13,1,7,1,7,6,3,4,13,5,7,10,16,9,1,5,11,14,10,12,11,8,13,9,8,4,18,11,8,5,14,13,5,7,11,13,5,6,9,13
"4507",2000042548,"Rustam Soirov","9/12/2002 (20 years old)","ST (C)","Lokomotiv Toshkent","Uzbekistan Pro League","TJK","No","1/1/2023","12/31/2024","$16K - $150K","Left","Very Strong","Reasonable","5'7""","145 lbs","51","26",78,114,6,5,13,13,12,6,13,8,5,5,8,6,3,7,12,9,5,9,5,6,6,7,9,13,5,6,5,8,11,13,7,3,9,13,7,6,11,13,11,13,10,10,12,17,10,1,11,11,9,4,3,3,3,2,3,2,2,2,2,2
"4508",2000042951,"Alijon Karimatullozoda","5/5/2002 (21 years old)","D (C)","Istiqlol","Tajikistani High League","TJK","No","1/1/2022","12/31/2023","$1.5K - $18K","Right","Reasonable","Very Strong","5'10""","156 lbs","56","2",77,113,3,1,7,3,8,1,9,6,1,11,6,2,14,6,15,12,8,8,9,14,15,5,10,6,7,7,3,8,14,14,8,6,13,14,5,7,15,15,12,11,11,11,10,9,15,8,17,14,8,2,1,3,2,2,3,4,2,2,1,3
"4509",58058494,"Muhammad Sultonov","12/22/1992 (30 years old)","M/AM (R)","Rodina","Russian First Division","TJK","No","1/14/2023","6/10/2024","$130K - $1.3M","Right","Fairly Strong","Very Strong","6'0""","154 lbs","328","66",105,113,10,8,11,11,11,7,5,12,7,9,10,11,9,12,14,12,12,12,9,11,6,15,12,12,11,11,13,11,13,13,10,9,13,13,12,8,5,17,9,11,9,11,6,11,6,7,10,10,13,1,2,1,2,4,2,3,1,3,1,2
"4510",58045536,"Parvizjon Umarbaev","11/1/1994 (28 years old)","DM, M/AM (C)","CSKA 1948","Bulgarian First League","TJK","No","7/23/2022","6/30/2024","$150K - $1.5M","Left","Very Strong","Weak","5'6""","141 lbs","249","21",111,113,13,12,13,9,11,13,7,11,9,9,13,13,9,13,13,11,12,11,10,11,13,13,9,12,9,13,13,14,13,15,12,6,12,12,10,7,10,10,11,12,10,11,8,11,9,6,13,12,11,2,2,2,3,3,1,2,2,3,2,3
"4511",59142460,"Sheriddin Boboev","4/21/1999 (24 years old)","ST (C)","Sanat Naft","Persian Gulf Premier League","TJK","No","8/15/2022","6/30/2025","$28K - $275K","Right Only","Weak","Very Strong","6'0""","165 lbs","123","52",95,112,8,7,12,14,13,8,10,7,5,8,9,6,7,8,11,12,7,12,9,13,3,8,12,13,9,8,9,9,14,11,9,8,11,13,14,11,9,18,12,11,10,9,5,9,7,8,15,9,15,1,2,3,1,3,3,3,2,1,3,3
"4512",2000176576,"Fathullo Olimzoda","8/3/2005 (17 years old)","M (C), AM (RLC)","Ravshan","Tajikistani High League","TJK","No","2/28/2023","12/31/2024","$0","Right","Reasonable","Very Strong","5'9""","130 lbs","10","1",65,112,5,7,13,11,6,5,5,7,4,3,8,4,7,9,5,5,6,6,6,12,4,16,1,5,2,7,9,11,13,14,3,7,12,12,7,3,9,11,12,11,13,11,6,16,12,5,13,11,17,2,3,1,3,3,3,1,1,1,1,2
"4513",209094,"Iqbal Jawadi","2/9/1994 (29 years old)","DM, M (C)","Rowville Eagles","Victorian State League 3 South-East","AFG","No","6/15/2020","-","$0","Right Only","Weak","Very Strong","5'9""","141 lbs","107","9",80,103,7,5,9,7,9,8,7,12,4,10,9,5,11,8,14,10,15,10,7,11,10,12,4,9,10,8,8,13,9,12,12,7,18,9,9,11,11,2,12,2,5,5,5,12,12,19,14,14,13,1,1,1,1,1,1,1,1,1,1,1
"4514",58127550,"Rustam Yatimov","7/13/1998 (24 years old)","GK","Istiqlol","Tajikistani High League","TJK","No","6/15/2020","12/31/2023","$0 - $22K","Right","Reasonable","Very Strong","6'4""","178 lbs","58","-",89,111,3,1,3,1,5,5,1,2,2,2,13,2,1,3,10,9,10,8,11,13,14,1,12,1,8,8,7,7,12,8,8,11,12,13,7,7,12,15,10,14,12,10,8,12,15,1,12,10,7,10,5,14,11,8,11,14,5,9,12,14
"4515",2000042809,"Muhammad Naskov","5/27/1999 (24 years old)","D (C)","Ravshan","Tajikistani High League","TJK","No","1/17/2023","12/31/2023","$6K - $18K","Right Only","Weak","Very Strong","5'9""","163 lbs","64","1",75,111,7,4,2,7,9,4,13,7,4,11,7,5,11,7,8,8,9,8,11,14,17,5,5,7,7,8,2,9,11,14,9,6,8,12,14,11,11,10,9,9,11,13,7,8,5,3,12,10,15,2,4,2,2,3,2,1,1,3,3,1
"4516",2000042725,"Abdulmumin Zabirov","8/4/2001 (21 years old)","DM, M (C)","Khujand","Tajikistani High League","TJK","No","1/1/2023","12/31/2023","$14K - $45K","Right","Reasonable","Very Strong","5'10""","154 lbs","62","4",85,110,7,2,6,6,13,7,7,9,7,11,13,1,13,11,13,11,8,5,8,14,13,5,7,8,8,8,9,13,9,13,8,4,14,10,12,6,11,12,12,11,13,12,5,12,6,7,13,9,9,2,1,1,3,2,1,2,2,3,1,1
"4517",59021746,"Fatkhullo Fatkhulloev","3/24/1990 (33 years old)","AM (RLC)","Rahamatganj MFS","Bangladeshi Premier League","TJK","No","11/12/2022","12/31/2023","$0","Right","Reasonable","Very Strong","5'10""","145 lbs","207","64",86,110,9,12,6,14,14,6,7,9,7,7,12,7,5,14,5,10,4,9,8,13,3,13,7,13,7,8,12,9,12,9,8,5,13,12,8,5,12,20,12,9,12,10,6,9,11,8,13,12,9,4,2,4,3,3,2,2,2,3,2,3
"4518",2000267679,"Khaydar Sattorov","2/18/2003 (20 years old)","D (C)","Istiqlol","Tajikistani High League","TJK","No","6/13/2022","12/31/2023","$500 - $7K","Right","Reasonable","Very Strong","6'3""","174 lbs","-","-",60,110,2,1,1,3,5,1,12,2,1,12,5,4,12,1,9,9,7,5,9,12,5,5,7,3,12,4,3,5,11,8,5,10,10,10,2,4,10,10,10,9,10,11,5,16,12,1,11,12,19,1,1,1,2,3,2,2,3,1,1,1
"4519",2000044137,"Yoqubjon Ahmedov","12/22/1998 (24 years old)","D (C)","Regar","Tajikistani High League","TJK","No","6/15/2020","12/31/2023","$6K - $16K","Right","Reasonable","Very Strong","5'10""","156 lbs","31","1",73,109,1,1,3,3,6,3,13,1,2,11,7,3,13,1,13,8,9,6,8,13,13,5,6,5,13,6,1,7,10,13,7,6,11,13,9,7,13,12,11,12,12,9,9,12,13,4,13,10,10,3,2,3,3,1,3,2,1,2,2,1
"4520",2000050944,"Faridun Davlatov","2/12/2004 (19 years old)","ST (C)","Regar","Tajikistani High League","TJK","No","2/24/2022","12/31/2023","$0 - $28K","Right","Reasonable","Very Strong","5'10""","156 lbs","14","1",68,109,6,6,9,13,13,6,11,6,4,4,5,6,3,8,12,10,1,8,7,9,7,8,9,9,4,5,6,7,13,12,6,5,9,13,5,5,7,13,9,13,9,12,5,8,10,8,11,11,19,2,1,3,3,1,1,2,2,3,3,2
"4521",2000042724,"Abdusamad Samadov","9/14/2002 (20 years old)","M (C)","Eskhata","Tajikistani High League","TJK","No","1/1/2021","12/31/2023","$0 - $24K","Right","Reasonable","Very Strong","5'6""","138 lbs","34","2",69,108,7,7,5,7,9,7,7,8,5,6,15,1,10,7,13,10,6,6,7,15,16,5,10,5,9,9,13,13,9,9,8,3,18,8,8,5,11,17,12,11,10,10,11,5,6,5,9,8,19,2,3,2,2,3,3,3,2,3,3,1
"4522",2000042815,"Shahrom Ismoilov","10/16/1998 (24 years old)","GK","Hatlon","Tajikistani High League","TJK","No","1/20/2022","12/31/2023","$500 - $4.5K","Right","Fairly Strong","Very Strong","6'1""","169 lbs","18","-",72,108,3,2,3,1,1,6,1,1,2,3,9,1,1,5,5,8,12,7,10,7,7,3,10,1,10,7,6,6,13,15,7,12,13,10,5,6,11,10,13,11,10,11,6,8,5,7,14,12,19,6,13,13,10,9,7,13,5,7,8,13
"4523",59130379,"Tabrezi Davlatmir","6/6/1998 (25 years old)","D (LC)","Istiqlol","Tajikistani High League","TJK","No","12/31/2021","12/31/2023","$500 - $6K","Left","Very Strong","Reasonable","5'10""","145 lbs","98","2",90,108,5,12,5,5,8,2,10,7,6,11,7,3,13,9,14,9,10,10,8,14,17,5,9,8,11,9,8,10,14,13,9,4,7,13,8,8,16,20,10,10,10,12,6,16,8,4,13,10,10,3,3,2,1,3,2,2,1,3,3,1
"4524",2000065329,"Dilawar Ahmadzay","4/4/2004 (19 years old)","AM (RL), ST (C)","Strømsgodset","Norwegian Premier Division","AFG","Yes","6/13/2022","12/31/2025","$35K - $110K","Right","Weak","Very Strong","5'10""","158 lbs","28","14",76,103,8,8,11,11,11,9,8,9,4,7,8,9,7,10,10,9,8,10,8,7,13,12,7,11,5,8,7,12,12,9,10,9,11,11,11,10,9,11,11,13,12,12,10,9,10,8,13,14,12,2,1,3,3,2,3,2,1,1,3,2
"4525",59145161,"Vahdat Hanonov","5/27/2000 (23 years old)","D (C)","Persepolis","Persian Gulf Premier League","TJK","No","11/8/2021","6/30/2024","$190K - $550K","Right","Fairly Strong","Very Strong","6'2""","176 lbs","83","10",98,108,6,5,6,7,9,3,12,8,9,11,10,7,16,7,13,12,11,8,12,12,5,5,3,10,10,10,4,11,12,12,11,15,6,11,6,6,13,17,12,13,11,11,7,8,9,1,12,12,13,2,1,3,3,1,3,2,1,2,1,1
"4526",59021761,"Nuriddin Davronov","1/16/1991 (32 years old)","M/AM (C)","Kashmir FC","Indian National Football League","TJK","No","1/5/2023","6/30/2024","$10K - $30K","Right","Reasonable","Very Strong","5'11""","163 lbs","142","7",98,107,10,11,12,7,10,11,8,10,8,7,13,2,8,13,8,9,9,11,9,10,15,13,7,12,9,11,13,11,13,13,11,9,13,11,11,9,16,20,14,12,12,11,5,11,13,5,11,10,13,4,3,2,1,3,3,1,3,2,2,1
"4527",2000043938,"Shohruh Sangov","10/31/2002 (20 years old)","D (RC)","Regar","Tajikistani High League","TJK","No","1/1/2022","12/31/2023","$0 - $35K","Right","Fairly Strong","Very Strong","5'10""","154 lbs","59","-",67,107,4,8,2,2,8,2,13,3,1,8,7,1,8,5,10,11,8,6,6,14,11,5,1,5,12,7,7,7,14,14,7,4,12,14,6,6,11,16,11,10,10,10,5,5,6,6,11,10,7,2,1,2,2,2,2,3,3,1,1,3
"4528",2000042810,"Sunatullo Ismoilov","4/28/2002 (21 years old)","ST (C)","Hatlon","Tajikistani High League","TJK","No","1/28/2022","12/31/2023","$0 - $40K","Right","Fairly Strong","Very Strong","5'10""","156 lbs","63","4",73,106,5,3,9,14,10,7,14,8,1,7,8,10,4,10,5,10,1,12,7,11,5,9,13,9,8,7,4,8,13,10,8,4,14,11,6,7,11,10,13,12,10,11,5,1,12,8,14,12,9,3,1,3,1,1,1,1,3,3,1,3
"4529",59130381,"Amirbek Juraboev","4/13/1996 (27 years old)","DM, M (C)","Kedah","Malaysian Super League","TJK","No","12/10/2022","11/30/2024","$80K - $240K","Right","Fairly Strong","Very Strong","5'11""","160 lbs","129","5",99,105,6,11,12,11,13,12,7,11,4,5,13,8,10,13,5,12,5,12,9,12,8,8,14,11,11,11,13,10,12,12,11,7,14,11,12,10,13,17,10,10,10,13,11,10,11,1,13,11,13,1,1,4,2,1,1,1,1,3,2,3
"4530",59145057,"Shahrom Samiev","2/8/2001 (22 years old)","AM (L), ST (C)","Milsami Orhei","Moldovan Divizia Naţională","TJK","No","6/12/2023","6/30/2024","$200K - $600K","Right","Reasonable","Very Strong","6'1""","171 lbs","99","25",80,105,3,3,12,11,9,5,11,5,5,3,11,9,5,12,12,7,12,7,7,9,6,12,8,11,7,7,9,7,12,12,7,11,12,12,5,12,6,10,12,11,12,11,8,8,8,1,9,12,17,2,2,3,2,2,3,2,2,1,3,3
"4531",2000043666,"Jamshed Murodov","10/21/1998 (24 years old)","M (C)","Fayzkand","Tajikistani High League","TJK","No","1/1/2022","12/31/2023","$0 - $20K","Right","Reasonable","Very Strong","5'9""","156 lbs","47","3",70,105,6,6,4,7,8,6,1,8,3,11,6,1,5,13,6,7,6,7,8,10,6,5,9,8,6,7,11,12,13,13,7,7,9,13,9,10,12,11,11,14,10,9,13,9,7,6,8,13,11,3,3,2,1,1,3,2,3,2,3,1
"4532",2000042824,"Safialohi Nazarzoda","8/28/2001 (21 years old)","M (C)","Hatlon","Tajikistani High League","TJK","No","1/1/2020","12/31/2023","$0 - $24K","Right","Reasonable","Very Strong","5'10""","154 lbs","15","-",68,104,5,1,6,3,14,6,2,7,2,9,14,1,7,12,5,6,4,7,7,14,13,5,9,5,6,7,9,12,14,12,7,5,8,14,7,6,14,16,10,14,11,14,15,15,9,7,11,11,11,2,3,2,2,1,3,3,3,3,1,4
"4533",2000042808,"Sorbon Afghonov","11/29/2000 (22 years old)","M (RL), AM (L)","Hatlon","Tajikistani High League","TJK","No","3/28/2023","12/31/2023","$0 - $35K","Left","Very Strong","Reasonable","5'8""","143 lbs","70","2",81,104,8,13,9,8,13,7,2,8,7,6,13,1,8,9,10,5,7,8,8,8,6,8,12,12,6,8,7,13,13,10,8,3,13,11,8,5,13,11,14,10,14,10,13,12,12,3,12,9,19,1,2,2,1,1,1,1,2,3,4,1
"4534",2000042794,"Khudoydod Uzoqov","10/5/1998 (24 years old)","AM (LC)","Hatlon","Tajikistani High League","TJK","No","1/1/2023","12/31/2023","$0","Left Only","Very Strong","Weak","5'9""","152 lbs","61","9",78,103,7,9,6,8,8,7,3,8,7,7,6,2,7,11,10,6,6,8,7,13,6,10,9,11,7,8,9,9,14,14,8,7,11,14,13,9,15,15,11,10,13,10,5,10,7,2,9,11,14,2,4,1,3,3,3,2,1,3,2,3
"4535",2000258675,"Farid Hazrati","1/1/2006 (17 years old)","DM, M (RC)","Bretten","German Lower Division","AFG","No","6/12/2023","-","$0","Right","Reasonable","Very Strong","5'7""","130 lbs","-","-",61,98,3,7,8,6,9,6,4,7,6,8,6,4,6,7,7,8,7,6,8,13,15,5,1,6,7,7,12,12,14,14,7,7,13,14,7,2,10,18,12,10,12,12,10,1,14,4,9,12,19,1,3,3,1,2,2,1,1,3,3,2
"4536",2000043954,"Jonibek Sharipov","1/15/2002 (21 years old)","D (L)","KMVA Dushanbe","Tajikistani High League","TJK","No","1/1/2021","12/31/2023","$0","Left","Very Strong","Fairly Strong","5'9""","149 lbs","56","2",71,102,2,6,7,2,10,2,8,1,4,10,5,2,10,6,15,5,9,8,12,11,16,9,12,6,8,8,8,8,14,14,8,7,11,14,10,6,15,18,13,9,10,9,10,11,10,4,12,10,9,1,3,1,3,1,1,2,1,1,2,3
"4537",2000042549,"Amadoni Kamolov","1/16/2003 (20 years old)","AM (L)","Istiqlol","Tajikistani High League","TJK","No","2/19/2023","12/31/2024","$10K - $30K","Left","Very Strong","Reasonable","5'11""","160 lbs","10","-",72,101,7,11,8,12,11,5,9,3,4,5,9,5,3,9,12,7,8,9,8,9,4,8,12,9,7,8,9,9,12,14,8,7,6,14,6,6,12,14,9,11,10,12,6,11,9,3,16,11,16,3,2,1,2,1,1,2,1,2,2,1
"4538",2000043018,"Khurshed Abdulloev","5/15/2000 (23 years old)","D (R)","KMVA Dushanbe","Tajikistani High League","TJK","No","1/1/2022","12/31/2023","$0 - $24K","Right","Fairly Strong","Very Strong","5'10""","152 lbs","54","8",75,100,6,10,7,4,9,2,7,7,7,9,7,2,10,8,7,8,9,9,9,10,18,8,9,7,7,8,6,9,14,14,8,4,10,14,14,5,12,10,10,12,10,10,12,12,12,2,10,11,8,3,3,3,2,1,2,1,3,3,3,4
"4539",59142701,"Alisher Mirzoev","6/22/1998 (24 years old)","M (C)","SKA Rostov","Russian Second Division B - Group 1","TJK","No","2/21/2023","6/30/2025","$10K - $28K","Right","Reasonable","Very Strong","5'8""","149 lbs","84","6",74,100,7,6,4,6,13,7,1,9,1,13,10,4,11,8,10,12,4,9,8,8,14,8,6,11,7,8,8,12,14,13,8,2,16,14,11,5,14,14,9,12,11,11,10,8,10,1,13,11,20,3,1,2,3,3,2,2,1,2,2,1
"4540",58045537,"Alisher Jalilov","8/29/1993 (29 years old)","AM (C)","Istiqlol","Tajikistani High League","TJK","No","1/25/2023","12/31/2023","$8K - $24K","Right","Fairly Strong","Very Strong","5'6""","125 lbs","163","44",97,100,10,8,13,11,12,10,3,10,3,6,12,7,10,13,6,8,10,9,12,9,1,14,14,10,6,12,12,7,12,13,13,4,15,10,9,2,12,16,13,11,13,12,5,16,10,4,7,12,17,1,3,2,3,1,2,3,2,3,2,4
"4541",2000042814,"Umarjon Sharipov","6/5/2000 (23 years old)","M (L)","Hatlon","Tajikistani High League","TJK","No","1/18/2022","12/31/2023","$0 - $30K","Left","Very Strong","Reasonable","5'7""","138 lbs","63","10",85,100,9,13,14,5,12,5,3,7,6,6,12,5,8,9,6,7,6,9,8,13,17,7,9,7,4,8,8,13,14,12,7,7,10,10,9,3,12,18,13,10,9,12,5,13,6,2,12,11,16,1,1,2,3,3,1,3,3,2,2,1
"4542",59145164,"Shervoni Mabatshoev","12/4/2000 (22 years old)","AM (C), ST (C)","Istiqlol","Tajikistani High League","TJK","No","7/13/2021","12/31/2023","$0 - $30K","Right","Reasonable","Very Strong","6'0""","165 lbs","82","28",75,99,6,6,10,11,13,2,6,7,1,6,6,10,4,10,11,8,5,13,7,11,16,10,1,9,7,6,11,8,13,13,5,9,11,13,5,6,10,11,11,12,12,12,8,8,10,4,9,10,17,1,2,2,2,1,3,1,2,4,3,2
"4543",2000043931,"Shuhrat Elmurodov","1/31/2002 (21 years old)","DM","Regar","Tajikistani High League","TJK","No","1/1/2021","12/31/2023","$1K - $12K","Right","Reasonable","Very Strong","5'9""","152 lbs","34","-",73,99,6,2,3,8,13,7,7,7,5,7,8,6,13,10,13,12,8,9,4,14,8,5,2,7,11,8,9,12,10,10,8,9,13,7,7,5,12,19,7,9,9,11,13,6,6,1,20,12,7,1,3,3,1,3,2,3,3,1,2,2
"4544",59133692,"Dilshod Dodoboev","11/8/1996 (26 years old)","GK","Khujand","Tajikistani High League","TJK","No","8/5/2022","12/31/2023","$0 - $6K","Right","Fairly Strong","Very Strong","5'10""","160 lbs","20","-",76,98,3,1,3,2,4,4,1,1,1,1,8,1,3,6,11,10,10,8,5,14,6,2,6,1,10,8,7,7,12,13,6,8,15,11,7,5,12,13,10,11,11,13,9,12,11,2,18,10,16,6,10,12,14,8,10,14,5,8,9,11
"4545",2000044140,"Aziz Khaitov","4/6/2003 (20 years old)","M (C)","Khujand","Tajikistani High League","TJK","No","1/19/2023","12/31/2023","$0 - $18K","Right","Reasonable","Very Strong","5'10""","147 lbs","16","-",57,98,5,5,6,6,6,4,4,11,5,10,14,1,7,11,7,6,5,4,7,11,15,7,12,8,9,7,10,12,12,10,6,4,12,14,9,3,11,17,12,11,11,11,14,8,14,4,10,10,17,1,1,2,3,2,3,3,1,1,3,2
"4546",84156444,"Yama Sherzad","1/1/2001 (22 years old)","M/AM (RLC)","Neuchâtel Xamax","Swiss Challenge League","AFG","Yes","7/25/2022","6/30/2026","$0 - $16K","Right Only","Very Weak","Very Strong","5'9""","154 lbs","89","12",74,97,9,9,12,8,12,8,7,8,3,3,11,7,4,12,8,7,7,8,8,8,14,13,7,8,3,12,11,12,12,13,8,6,16,12,10,5,16,14,12,16,8,13,13,7,5,3,14,14,18,3,3,2,1,4,3,2,2,3,3,2
"4547",2000016735,"Tokhir Malodustov","9/12/2000 (22 years old)","AM (R)","Ravshan","Tajikistani High League","TJK","No","1/19/2023","12/31/2023","$1K - $10K","Right","Reasonable","Very Strong","5'10""","154 lbs","54","9",72,98,6,11,10,12,13,6,8,7,6,6,7,6,4,12,10,4,6,7,7,13,3,12,7,9,6,7,6,8,13,13,7,3,13,13,5,5,10,14,8,8,12,12,11,16,15,8,12,12,11,1,4,1,1,3,3,3,1,2,1,1
"4548",59128580,"Oybek Abdughafforov","3/30/1995 (28 years old)","D (C)","Eskhata","Tajikistani High League","TJK","No","7/2/2022","12/31/2023","$0 - $14K","Right","Reasonable","Very Strong","6'0""","178 lbs","80","4",84,98,5,5,2,5,10,3,10,9,5,10,7,3,15,6,10,9,10,9,10,9,15,5,14,7,10,8,7,10,11,9,9,11,15,10,7,13,14,11,9,11,11,11,5,7,6,5,10,11,8,2,2,1,2,2,2,3,1,3,3,1
"4549",2000215170,"Sodiqjon Qurbonov","1/19/2003 (20 years old)","D (RC)","Istiqlol","Tajikistani High League","TJK","No","2/20/2023","12/31/2024","$0 - $20K","Right","Weak","Very Strong","6'3""","178 lbs","-","-",50,98,2,6,3,3,7,1,11,4,1,10,6,1,12,2,7,8,8,2,7,13,11,6,11,4,11,4,4,6,11,8,6,12,13,6,11,5,12,20,13,11,11,10,7,13,6,8,11,10,10,1,2,2,3,1,1,3,1,2,2,2
"4550",2000042994,"Alisher Ergashev","1/25/1999 (24 years old)","D/M (L)","Dushanbe","Tajikistani First Division","TJK","No","1/1/2023","12/31/2023","$0 - $7K","Left","Very Strong","Reasonable","5'9""","152 lbs","24","-",72,97,7,10,7,1,10,6,3,3,3,6,8,4,7,8,9,9,9,8,8,13,18,5,8,6,10,7,6,8,13,13,7,3,14,13,13,9,12,18,12,13,11,11,12,6,9,5,6,10,9,1,1,1,1,4,2,2,1,4,1,2
"4551",58030854,"Manuchehr Jalilov","9/27/1990 (32 years old)","AM (RLC)","Istiqlol","Tajikistani High League","TJK","No","1/1/2020","12/31/2023","$0 - $12K","Right","Fairly Strong","Very Strong","5'9""","143 lbs","277","135",96,96,9,11,13,9,11,9,4,9,9,9,13,13,6,9,8,11,5,7,11,15,10,11,14,15,9,10,12,11,11,12,9,8,13,12,12,5,14,14,11,14,10,13,13,10,15,7,12,12,13,4,1,1,3,1,2,1,2,3,1,2
"4552",17040274,"Masrur Kiyomidinov","1/21/2002 (21 years old)","DM, M (C)","Naftan","Belarusian Highest League","TJK","No","3/17/2022","12/31/2024","$0","Right","Reasonable","Very Strong","5'8""","145 lbs","30","2",73,95,7,5,5,8,10,7,7,8,1,6,13,7,12,11,7,6,7,9,6,10,9,5,2,9,9,8,13,6,12,12,8,5,7,9,9,6,13,14,12,10,12,14,7,9,6,8,4,10,9,3,1,2,2,1,3,2,3,2,1,1
"4553",59130390,"Fathullo Boboev","10/9/1997 (25 years old)","GK","Hosilot F.","Tajikistani High League","TJK","No","1/1/2023","12/31/2023","$0 - $6K","Right","Reasonable","Very Strong","5'10""","158 lbs","43","1",70,95,3,1,1,2,2,5,1,2,3,2,7,2,2,5,10,6,11,7,10,13,3,1,3,3,11,7,6,6,11,8,7,4,12,12,6,7,11,17,11,11,9,11,12,8,7,7,8,11,20,8,9,13,10,9,11,11,5,8,9,8
"4554",2000043006,"Sino Absamadov","3/14/2000 (23 years old)","D (C)","Zhodino-Yuzhnoe","Belarusian First League","TJK","No","3/15/2023","11/30/2023","$0","Right","Reasonable","Very Strong","6'2""","163 lbs","38","4",79,95,5,4,1,6,9,2,13,7,3,15,8,5,14,7,11,12,9,9,8,8,7,5,13,3,8,8,6,9,14,10,8,14,8,10,6,5,10,15,10,13,11,7,11,9,9,3,10,12,10,1,2,2,1,2,2,2,2,3,1,2
"4555",2000242029,"Monty Enosa","2/6/2004 (19 years old)","AM (RLC)","Masitaoka","Botswanan Premier Division","BOT","No","2/2/2023","6/30/2025","$0","Right","Reasonable","Very Strong","5'6""","136 lbs","-","-",78,119,8,12,15,15,14,8,8,10,5,7,13,6,9,14,14,8,5,9,9,8,3,13,4,7,8,9,12,12,11,12,9,3,13,10,7,3,13,11,12,11,11,12,5,7,8,1,12,11,11,1,3,2,3,1,3,1,4,2,3,3
"4556",2000166440,"Omphile Ramoagi","1/3/2004 (19 years old)","AM (RLC)","Gaborone Utd","Botswanan Premier Division","BOT","No","7/1/2020","6/30/2025","$0","Right","Reasonable","Very Strong","5'9""","149 lbs","-","-",68,119,3,5,14,10,14,5,1,8,3,6,14,4,8,12,8,9,5,6,5,10,6,11,10,6,7,7,11,12,10,12,7,4,13,9,13,5,11,18,13,11,9,10,5,7,6,3,16,11,12,1,4,1,2,1,1,1,1,1,2,3
"4557",27061327,"Jabar Sharza","4/6/1994 (29 years old)","AM (RLC), ST (C)","Ariana FC","Swedish First Division South","AFG","Yes","8/27/2022","11/30/2023","$0 - $1.5K","Right","Reasonable","Very Strong","5'10""","167 lbs","191","47",69,95,10,10,11,9,11,11,6,10,5,2,10,7,3,11,9,7,9,9,7,5,12,12,5,10,5,8,7,7,11,10,10,10,12,11,10,9,14,10,9,13,10,8,8,10,5,4,7,11,12,1,1,3,1,3,1,2,1,3,2,1
"4558",13227253,"Thatayaone Ditlhokwe","9/21/1998 (24 years old)","D (C)","SuperSport Utd","South African Premier Soccer League","BOT","No","7/1/2020","6/30/2024","$0","Left","Very Strong","Reasonable","6'0""","171 lbs","82","3",110,116,7,7,4,8,12,6,11,3,8,14,9,9,12,7,10,16,12,6,13,14,7,5,6,9,11,11,8,12,12,5,7,11,13,13,14,11,14,11,10,8,11,12,8,15,11,1,12,10,9,1,3,1,1,2,2,2,2,1,2,1
"4559",2000311959,"Ronel Manyanga","11/13/2002 (20 years old)","AM (RL)","Gaborone Utd","Botswanan Premier Division","BOT","No","3/13/2022","6/30/2025","$0","Either","Very Strong","Very Strong","5'10""","154 lbs","-","-",70,113,6,8,12,12,11,5,5,6,2,5,10,2,6,12,12,5,4,3,6,9,6,15,11,12,3,6,5,11,12,11,6,7,12,9,8,3,15,20,12,12,10,11,10,7,9,7,10,11,12,1,2,3,3,2,2,3,1,3,1,2
"4560",65025734,"Kabelo Dambe","5/10/1990 (33 years old)","GK","Township Rollers","Botswanan Premier Division","BOT","No","8/20/2019","6/30/2025","Not for Sale","Right","Reasonable","Very Strong","5'9""","167 lbs","31","-",92,110,6,3,1,3,10,7,3,3,2,1,10,3,2,8,8,12,11,10,11,12,15,1,14,1,10,11,10,10,9,14,10,10,14,8,8,6,12,15,13,12,10,14,11,12,7,3,9,11,20,9,10,11,10,11,13,10,3,12,14,11
"4561",2000313497,"Onneille Moremi","12/24/2005 (17 years old)","DM, M (C)","Morupule Wanderers","Botswanan Premier Division","BOT","No","6/12/2023","6/30/2025","$0","Right","Fairly Strong","Very Strong","6'3""","165 lbs","-","-",55,109,5,4,1,6,8,5,6,5,1,6,11,1,12,7,10,8,7,7,3,11,5,6,11,3,8,7,9,11,13,10,6,13,12,11,6,4,10,14,13,12,14,12,11,16,5,5,10,11,16,3,2,4,2,2,2,1,2,1,1,1
"4562",2000311828,"Otsile Makaita","11/5/2003 (19 years old)","D/WB (L)","Sua Flamingoes","Botswanan Premier Division","BOT","No","9/16/2022","6/30/2025","$0","Left","Very Strong","Reasonable","5'10""","156 lbs","-","-",55,108,4,8,6,3,11,1,6,4,2,8,8,1,9,6,9,7,7,4,12,11,9,5,13,6,6,7,6,7,13,11,7,6,6,8,10,4,8,17,12,10,10,11,9,8,5,2,10,12,17,1,2,1,3,1,2,3,3,3,2,3
"4563",2000250413,"Thapelo Balatlheng","12/20/2003 (19 years old)","M (L), AM (RL)","Township Rollers","Botswanan Premier Division","BOT","No","7/1/2020","6/30/2025","$6K - $18K","Right","Reasonable","Very Strong","5'3""","121 lbs","-","-",67,108,7,10,10,9,11,6,6,5,6,6,11,1,7,10,12,6,5,6,7,10,7,9,4,8,5,7,9,8,14,12,3,3,12,14,6,1,14,12,12,10,11,14,5,1,10,3,9,10,7,2,3,1,3,3,3,2,1,3,1,2
"4564",29093310,"Ofentse Nato","10/1/1989 (33 years old)","DM, M/AM (C)","Extension Gunners","Botswanan Lower Divisions","BOT","No","1/1/2023","6/30/2024","$0","Right Only","Weak","Very Strong","6'2""","163 lbs","78","2",75,108,6,6,12,9,14,7,7,8,2,9,9,2,12,11,13,11,8,10,7,9,14,3,9,8,11,13,14,16,12,11,6,9,9,12,9,6,11,20,11,11,13,11,6,12,11,4,11,12,11,1,1,3,3,2,3,1,1,1,1,2
"4565",2000166502,"Larona Modisaemang","1/29/2002 (21 years old)","D/WB (R), DM","Police XI","Botswanan Premier Division","BOT","No","7/1/2020","6/30/2025","$0","Right","Strong","Very Strong","5'7""","132 lbs","-","-",69,107,5,7,6,4,10,5,5,6,5,7,6,1,11,7,9,8,7,5,6,12,10,5,2,6,10,7,5,7,13,13,7,1,15,13,7,1,12,17,12,13,9,10,11,11,8,7,10,11,7,1,2,1,3,1,1,3,3,1,2,3
"4566",2000313759,"Boikobo Matakule","4/3/2006 (17 years old)","AM (R), ST (C)","Police XI","Botswanan Premier Division","BOT","No","6/12/2023","6/30/2025","$0","Right","Reasonable","Very Strong","5'6""","125 lbs","-","-",62,106,5,10,9,11,9,5,7,6,5,3,8,5,6,10,9,5,7,4,3,6,16,10,9,10,5,6,5,7,13,13,6,6,12,13,8,1,10,17,11,12,9,10,5,12,14,1,16,11,15,3,1,3,2,3,2,3,2,1,3,3
"4567",2000313709,"Thabang Toko","9/15/2003 (19 years old)","D/WB (R)","Morupule Wanderers","Botswanan Premier Division","BOT","No","1/1/2023","6/30/2025","$0","Right","Reasonable","Very Strong","5'10""","132 lbs","-","-",60,106,5,12,3,3,9,2,6,5,6,8,7,3,10,8,5,6,7,8,5,10,9,5,10,5,6,7,4,8,14,10,7,8,18,11,7,6,11,14,13,9,10,10,10,1,11,3,9,11,15,2,1,2,2,3,3,3,3,3,4,2
"4568",92022611,"Hassan Amin","10/11/1991 (31 years old)","D/WB/M (L)","VfR Mannheim","German Div. Baden-Württemberg","AFG","Yes","7/1/2022","6/30/2023","$0 - $2K","Left Only","Very Strong","Weak","5'9""","154 lbs","263","16",91,95,12,12,10,7,10,10,6,8,10,11,12,8,13,11,13,12,9,11,11,12,10,9,12,10,11,14,10,13,12,12,8,8,12,11,12,7,10,8,10,12,9,8,6,12,11,8,13,9,11,2,2,1,1,1,2,2,3,2,2,1
"4569",13187111,"Kitso Mangolo","6/1/1999 (24 years old)","D/WB (L)","Jwaneng Galaxy","Botswanan Premier Division","BOT","No","9/26/2022","12/31/2023","$4K - $40K","Left","Very Strong","Reasonable","5'3""","149 lbs","-","-",95,105,7,9,8,6,10,5,9,7,8,11,10,8,14,6,8,13,10,10,10,14,14,6,14,8,9,9,8,10,14,14,9,1,9,14,11,1,12,10,10,12,12,11,12,15,6,8,10,12,20,3,1,1,3,2,2,1,3,2,1,3
"4570",13161936,"Kabelo Seakanyeng","6/25/1993 (29 years old)","AM (LC)","OC Khouribga","Botola Pro 2","BOT","No","11/30/2020","6/30/2024","$22K - $230K","Right","Reasonable","Very Strong","5'7""","143 lbs","62","13",100,105,7,10,8,13,12,8,8,10,2,8,12,7,9,12,7,11,9,12,9,12,12,14,13,11,9,9,8,10,14,14,9,3,13,14,14,6,15,12,12,11,9,13,6,13,14,6,18,11,18,3,1,2,3,1,2,2,1,1,3,2
"4571",2000088907,"Onkarabile Ratanang","3/16/1998 (25 years old)","D/WB (L)","Township Rollers","Botswanan Premier Division","BOT","No","7/1/2020","6/30/2025","$8K - $80K","Left","Very Strong","Reasonable","5'10""","160 lbs","12","2",92,105,6,13,8,1,7,2,9,5,8,10,10,2,8,10,13,8,10,9,14,13,13,5,3,8,11,9,8,9,14,14,9,6,11,14,14,8,14,18,11,12,12,10,8,5,7,4,14,8,18,2,1,1,2,1,1,2,1,2,2,3
"4572",13104153,"Galabgwe Moyana","5/24/1990 (33 years old)","M (L), AM (RL)","Sua Flamingoes","Botswanan Premier Division","BOT","No","1/17/2023","6/30/2024","$0","Right","Weak","Very Strong","5'11""","138 lbs","32","2",75,105,7,10,9,8,14,7,3,8,7,6,11,4,6,11,10,7,8,5,8,9,17,10,11,10,7,8,6,13,12,10,9,6,15,11,8,4,11,20,10,11,9,12,6,4,8,3,20,11,14,3,3,3,2,1,4,2,2,2,2,1
"4573",13190878,"Tumisang Orebonye","3/26/1996 (27 years old)","ST (C)","USM Alger","Algerian League 1","BOT","No","1/31/2023","6/30/2025","$0 - $95K","Right","Reasonable","Very Strong","5'11""","171 lbs","79","13",97,105,5,3,14,13,14,8,11,7,4,8,10,4,5,10,8,14,9,8,9,11,7,11,8,14,7,8,8,10,14,12,12,11,12,13,10,12,10,13,11,11,10,12,5,10,5,5,20,11,15,3,3,2,1,2,1,1,3,1,2,1
"4574",13103578,"Mogakolodi Ngele","10/6/1990 (32 years old)","AM (RLC)","Township Rollers","Botswanan Premier Division","BOT","No","8/6/2022","6/30/2024","$20K - $190K","Left","Very Strong","Reasonable","5'10""","154 lbs","193","27",97,105,8,11,12,9,11,10,6,10,4,5,9,9,6,11,8,8,7,12,10,6,2,13,7,11,10,9,12,10,16,9,10,5,13,14,10,7,11,12,12,11,11,12,12,10,6,8,11,9,9,2,3,1,2,3,1,2,1,3,3,2
"4575",2000311459,"Shaun Theron","3/11/2003 (20 years old)","M/AM (C)","Jwaneng Galaxy","Botswanan Premier Division","BOT","No","7/1/2022","6/30/2025","$500 - $4.5K","Right","Reasonable","Very Strong","5'11""","152 lbs","-","-",70,104,1,3,7,12,12,5,5,5,1,7,8,5,10,12,10,9,4,7,7,8,15,13,1,6,7,6,12,11,12,12,6,7,14,12,6,3,15,20,10,12,8,11,11,8,11,6,9,10,9,4,2,2,1,1,1,1,4,2,3,2
"4576",2000166252,"Cedric Ramojela","9/28/2002 (20 years old)","GK","Gaborone Utd","Botswanan Premier Division","BOT","No","1/2/2021","6/30/2024","$0","Right","Reasonable","Very Strong","6'4""","176 lbs","-","-",67,103,3,1,2,3,1,4,1,3,3,2,11,3,2,2,10,11,8,6,8,13,7,2,7,1,6,6,3,5,7,7,6,14,14,12,4,6,10,14,8,11,10,12,7,6,11,3,10,12,16,9,6,13,12,7,5,13,5,6,12,9
"4577",13161932,"Mpho Kgaswane","1/12/1990 (33 years old)","M (C)","Gaborone Utd","Botswanan Premier Division","BOT","No","1/29/2022","6/30/2024","$0 - $90K","Left","Very Strong","Reasonable","5'7""","147 lbs","79","12",92,103,9,9,5,8,12,9,9,12,5,14,15,5,9,15,12,9,7,9,10,11,4,9,6,11,13,10,14,13,11,10,5,4,11,12,8,8,12,20,13,10,10,11,13,14,10,3,10,9,18,1,3,2,3,2,1,2,2,3,4,1
"4578",2000247287,"Motheo Gabatlhokwe","10/18/2000 (22 years old)","M/AM (C)","Rilindja Prishtinë","Kosovan Second League","BOT","No","1/31/2023","-","$0","Right","Fairly Strong","Very Strong","5'3""","121 lbs","-","-",67,102,5,5,7,13,13,5,5,7,4,6,13,9,6,10,7,8,3,10,6,12,4,10,11,10,7,6,9,5,9,13,2,1,12,12,5,1,13,10,10,13,12,10,14,7,5,3,10,13,14,1,2,1,2,3,4,1,2,3,2,1
"4579",58058483,"Sharif Mukhammad","3/21/1990 (33 years old)","DM, M (C)","CB","Indian National Football League","AFG","No","12/1/2022","6/30/2024","$1K - $12K","Right","Reasonable","Very Strong","6'0""","154 lbs","119","9",80,95,8,7,9,6,11,12,10,6,3,6,10,9,7,8,8,12,11,10,11,9,8,14,4,12,9,9,8,11,11,13,12,12,13,12,12,8,11,13,11,9,8,12,8,9,9,12,9,4,18,3,3,1,2,1,3,3,2,1,2,3
"4580",2000166015,"Godfrey Tauyatswala","1/25/2001 (22 years old)","ST (C)","BDF XI","Botswanan Premier Division","BOT","No","7/1/2020","6/30/2025","$0","Right","Reasonable","Very Strong","6'4""","182 lbs","-","-",78,100,4,4,15,15,15,5,14,9,3,7,9,6,3,11,7,8,9,7,5,10,3,9,12,8,9,8,9,9,8,9,9,13,6,8,8,6,11,14,11,11,12,8,7,6,6,1,11,12,15,3,1,2,2,2,1,3,1,3,1,3
"4581",13227278,"Kago Monyake","7/28/1999 (23 years old)","M/AM (C)","Township Rollers","Botswanan Premier Division","BOT","No","6/15/2020","6/30/2025","$14K - $150K","Right","Reasonable","Very Strong","5'5""","127 lbs","-","-",85,100,7,8,10,8,13,7,4,9,2,8,10,5,9,14,14,10,3,8,8,11,5,13,14,9,7,8,11,13,14,13,8,3,12,10,9,1,14,18,13,11,11,9,6,8,5,5,9,11,15,1,1,3,2,1,1,2,3,2,3,2
"4582",2000092096,"Thato Ogopotse","3/11/1988 (35 years old)","DM, M (C)","Security Systems","Botswanan Premier Division","BOT","No","7/1/2019","6/30/2024","$0","Either","Very Strong","Very Strong","5'10""","165 lbs","-","-",80,100,6,4,3,8,13,6,4,8,4,7,9,3,8,13,8,8,8,8,4,12,14,5,11,7,9,8,13,12,6,7,7,3,9,7,8,9,12,10,11,11,9,11,5,10,11,3,13,11,9,1,2,3,3,1,1,2,3,1,1,1
"4583",13146379,"Onkabetse Makgantai","7/1/1995 (27 years old)","ST (C)","Gaborone Utd","Botswanan Premier Division","BOT","No","2/10/2022","6/30/2024","$9K - $95K","Right","Fairly Strong","Very Strong","5'8""","154 lbs","16","2",93,100,7,7,11,13,13,7,8,5,2,7,5,3,1,9,10,11,9,9,8,13,10,13,12,13,8,5,7,8,13,13,8,4,10,13,12,10,11,17,12,10,9,11,12,8,8,5,17,12,19,2,2,1,2,3,1,2,2,3,2,3
"4584",13227283,"Bakang Leshona","6/27/2000 (22 years old)","M/AM (L)","Jwaneng Galaxy","Botswanan Premier Division","BOT","No","8/13/2019","6/30/2025","$0","Right Only","Weak","Very Strong","6'4""","180 lbs","-","-",74,99,7,12,10,14,14,7,7,8,2,7,14,4,5,10,10,9,3,9,8,10,14,9,3,8,4,6,7,9,13,9,8,14,10,13,9,6,14,18,13,13,12,10,9,13,6,5,12,11,18,3,1,3,1,3,3,1,2,1,3,3
"4585",2000313556,"Kagiso Moilwa","1/28/2003 (20 years old)","M/AM (C)","Police XI","Botswanan Premier Division","BOT","No","7/1/2022","6/30/2025","$0","Right","Fairly Strong","Very Strong","5'6""","138 lbs","-","-",58,99,2,2,6,6,12,4,4,12,1,6,9,3,8,7,15,7,6,6,5,11,10,8,2,6,6,6,7,10,12,12,5,1,10,12,6,1,9,13,13,9,10,10,12,10,13,6,8,14,17,4,3,2,2,3,2,1,1,3,3,2
"4586",2000313499,"Tsholofelo Speakson","6/17/2005 (17 years old)","AM (RL)","Morupule Wanderers","Botswanan Premier Division","BOT","No","6/12/2023","6/30/2025","$0","Right","Reasonable","Very Strong","5'8""","134 lbs","-","-",52,98,6,9,10,8,7,5,5,6,1,5,10,4,1,12,11,4,7,6,6,10,3,12,1,6,2,6,5,9,13,13,6,5,13,13,7,3,11,12,13,12,10,11,12,8,7,3,19,11,17,3,3,4,2,1,2,1,4,3,3,2
"4587",2000250253,"Losika Ratshukudu","2/1/2006 (17 years old)","AM (RLC)","Masitaoka","Botswanan Premier Division","BOT","No","7/1/2022","6/30/2025","$0","Right","Reasonable","Very Strong","5'6""","125 lbs","-","-",55,98,5,8,12,10,12,3,4,5,1,4,8,6,6,12,12,6,6,8,4,11,15,13,1,8,3,5,4,10,12,12,5,4,15,12,10,1,11,18,12,10,9,12,12,1,6,6,11,11,7,2,3,3,3,1,1,3,3,3,2,3
"4588",2000166011,"Confidence Senwelo","4/8/2002 (21 years old)","M/AM (C)","BDF XI","Botswanan Premier Division","BOT","No","2/1/2022","6/30/2025","$0","Right","Reasonable","Very Strong","5'11""","156 lbs","-","-",62,98,5,5,7,8,13,5,5,7,1,4,8,3,7,10,11,6,6,7,6,12,9,12,6,7,7,6,13,7,12,11,6,6,10,10,7,3,14,19,10,9,11,11,5,13,5,6,11,13,17,3,3,3,3,1,2,1,3,2,4,1
"4589",2000092122,"Tebogo Kopelang","4/24/2002 (21 years old)","D (C)","Security Systems","Botswanan Premier Division","BOT","No","2/12/2021","6/30/2025","$0","Right","Reasonable","Very Strong","6'3""","147 lbs","-","-",72,97,4,3,2,1,7,1,7,2,3,13,5,2,13,6,15,8,9,7,6,13,5,5,5,6,10,6,3,7,10,10,7,14,15,8,8,7,13,13,11,10,12,8,6,10,5,6,10,11,12,1,1,3,2,2,2,2,1,1,1,2
"4590",2000016787,"Jawad Rezai","8/21/2001 (21 years old)","M (R), AM (RC)","Hume City","National Premier Leagues - Victoria","AFG","No","6/1/2023","9/30/2023","$0","Right","Reasonable","Very Strong","5'8""","127 lbs","38","13",72,95,6,5,14,11,13,7,7,9,3,7,11,8,6,10,7,11,8,9,15,9,11,12,8,11,8,8,7,9,11,9,9,6,11,14,8,5,12,9,9,10,8,5,7,13,5,8,10,13,18,3,2,1,1,3,1,1,2,2,2,1
"4591",2000242033,"Odirile Lekoba","1/9/2002 (21 years old)","M/AM (R)","Security Systems","Botswanan Premier Division","BOT","No","1/1/2023","6/30/2025","$0","Right","Reasonable","Very Strong","5'10""","158 lbs","-","-",75,97,7,12,13,12,8,6,6,8,6,6,11,3,5,13,11,8,7,5,7,13,12,12,6,10,6,7,7,12,12,10,7,3,8,9,9,4,11,14,12,8,14,9,9,10,13,3,12,10,11,2,3,1,1,3,1,2,1,1,1,2
"4592",13204810,"Simisani Mathumo","11/11/1991 (31 years old)","D (C)","Township Rollers","Botswanan Premier Division","BOT","No","6/30/2021","6/30/2024","$20K - $200K","Right Only","Weak","Very Strong","6'0""","176 lbs","11","-",95,97,3,4,8,5,7,1,15,5,3,11,10,3,13,9,11,14,10,8,13,15,10,5,13,9,14,9,8,6,11,12,10,12,11,11,11,7,14,17,10,11,12,12,8,9,5,6,12,13,15,2,1,3,3,1,3,2,3,3,1,1
"4593",2000313553,"Thabang Aphiri","8/3/2003 (19 years old)","AM (RLC)","Jwaneng Galaxy","Botswanan Premier Division","BOT","No","7/1/2021","6/30/2025","$0","Right","Fairly Strong","Very Strong","5'10""","154 lbs","-","-",71,96,7,10,10,9,12,7,6,9,4,7,11,6,9,7,10,6,1,9,5,7,5,9,5,8,7,8,9,13,12,12,4,7,15,11,9,5,14,16,12,10,11,13,10,3,10,2,11,10,18,1,3,3,3,3,1,2,2,3,4,1
"4594",2000311826,"Richard Lithemba","1/14/2007 (16 years old)","AM (RLC)","Sua Flamingoes","Botswanan Premier Division","BOT","No","7/1/2022","6/30/2026","$0","Right","Reasonable","Very Strong","5'5""","116 lbs","-","-",51,96,5,5,12,8,11,5,5,3,3,4,10,1,7,13,11,8,5,5,4,5,4,13,10,8,6,7,7,12,12,8,2,4,13,11,7,1,13,12,13,10,10,13,7,7,8,3,8,11,19,3,1,2,2,2,1,2,2,1,1,3
"4595",65028596,"Thato Kebue","5/29/1997 (26 years old)","D (RLC)","Orapa Utd","Botswanan Premier Division","BOT","No","7/1/2022","6/30/2025","$0 - $110K","Left","Very Strong","Reasonable","6'2""","163 lbs","29","-",84,95,6,11,3,1,8,7,6,5,5,12,9,2,14,8,10,9,9,9,6,10,15,5,10,7,12,8,8,9,14,13,9,9,12,12,14,5,15,13,12,12,11,11,12,12,15,1,8,10,8,1,1,3,2,3,1,3,1,1,1,2
"4596",13201630,"Thatayaone Kgamanyane","1/30/1996 (27 years old)","M/AM (C)","Gaborone Utd","Botswanan Premier Division","BOT","No","1/10/2019","6/30/2024","$22K - $210K","Right","Reasonable","Very Strong","5'10""","156 lbs","10","1",89,95,6,5,9,11,8,4,7,8,1,6,14,4,9,12,7,9,1,9,8,8,5,11,8,8,9,7,12,12,14,14,8,6,14,14,14,7,13,19,11,13,11,11,13,9,9,7,15,9,10,1,1,2,1,3,1,2,2,2,2,3
"4597",2000250392,"Otsile Tsapoga","11/26/2001 (21 years old)","AM (RLC)","Sua Flamingoes","Botswanan Premier Division","BOT","No","7/1/2021","6/30/2025","$0","Right","Reasonable","Very Strong","5'3""","123 lbs","-","-",58,95,3,7,8,9,13,3,5,7,1,5,7,2,5,9,9,8,4,3,6,12,15,9,4,5,6,7,8,11,13,13,6,1,11,11,7,1,10,15,10,13,12,13,5,5,13,5,14,9,14,2,1,2,2,3,3,3,1,1,2,1
"4598",13187115,"Mothusi Cooper","7/19/1997 (25 years old)","M/AM (C)","Gaborone Utd","Botswanan Premier Division","BOT","No","7/1/2022","6/30/2024","$3.5K - $35K","Right Only","Weak","Very Strong","5'7""","145 lbs","3","-",87,95,7,7,5,9,14,7,3,9,1,8,14,2,8,14,9,10,8,8,6,7,10,13,8,8,8,7,14,12,14,14,8,6,8,14,14,7,12,19,10,12,13,11,8,12,15,2,8,8,10,1,2,2,1,2,2,1,1,3,1,1
"4599",13227282,"Baokeditswe Talane","2/18/2000 (23 years old)","AM (C), ST (C)","Orapa Utd","Botswanan Premier Division","BOT","No","7/1/2022","6/30/2025","$0","Right","Reasonable","Very Strong","6'1""","165 lbs","-","-",78,95,2,2,6,13,12,6,8,6,1,6,12,9,7,11,5,9,5,9,7,7,7,11,10,10,7,3,6,8,13,13,7,9,14,13,12,5,11,14,10,12,11,12,10,10,13,5,10,9,16,3,1,3,1,3,2,2,3,2,2,3
"4600",2000250287,"Nico Babutsi","3/16/2002 (21 years old)","D (LC)","Township Rollers","Botswanan Premier Division","BOT","No","8/4/2022","6/30/2025","$0","Left","Very Strong","Reasonable","6'0""","165 lbs","-","-",74,95,6,10,7,2,9,3,9,5,4,12,4,1,11,8,15,11,8,7,11,14,15,5,5,6,8,8,3,9,14,12,9,7,13,13,8,7,11,19,12,12,13,10,8,10,10,6,7,13,13,1,1,1,1,2,1,1,3,3,1,2
"4601",2000283359,"Ramin Aamdi","1/1/2007 (16 years old)","M/AM (R)","Basel","Swiss Super League","AFG","No","7/22/2021","6/30/2026","$5K - $50K","Right","Weak","Very Strong","5'7""","125 lbs","-","-",58,93,6,11,8,10,14,6,3,7,6,3,11,2,6,11,15,6,7,6,4,10,5,10,1,4,7,7,6,8,10,13,7,6,14,14,6,4,12,10,13,12,12,10,9,13,8,8,20,9,16,3,2,3,1,1,2,3,3,1,3,1
"4602",2000166043,"Tlamelo Kolagano","8/2/2001 (21 years old)","D/WB (L), DM","Orapa Utd","Botswanan Premier Division","BOT","No","1/1/2021","6/30/2025","$0","Left","Very Strong","Fairly Strong","5'11""","156 lbs","-","-",74,95,5,8,7,1,9,4,6,7,5,7,11,4,8,6,15,5,8,7,7,13,10,5,10,7,8,8,8,8,12,13,8,10,12,13,8,6,13,20,12,12,14,13,6,17,8,1,13,10,20,3,1,1,1,4,3,4,3,3,3,1
"4603",2000092164,"Anderson Makolontwana","7/21/2001 (21 years old)","M/AM (C)","Extension Gunners","Botswanan Lower Divisions","BOT","No","7/1/2019","6/30/2024","$0","Right","Fairly Strong","Very Strong","5'7""","130 lbs","-","-",74,95,6,6,8,12,13,5,3,13,2,8,9,6,10,13,11,6,8,6,5,12,6,15,9,5,8,7,13,12,12,10,7,5,10,11,8,1,14,17,11,9,12,11,11,4,10,7,10,9,7,3,1,2,2,2,2,4,3,3,3,2
"4604",13217538,"Ryan Brown","7/30/2000 (22 years old)","GK","Jwaneng Galaxy","Botswanan Premier Division","BOT","No","7/1/2019","6/30/2025","$0","Right","Reasonable","Very Strong","6'4""","178 lbs","-","-",74,95,3,3,2,3,4,6,1,1,3,1,9,1,1,1,5,10,14,7,6,13,5,3,2,2,12,7,6,6,9,10,7,11,14,11,4,5,11,11,13,11,10,10,10,9,14,1,10,9,14,11,6,13,5,9,6,11,9,10,7,13
"4605",2000092315,"Kevin Bulala","3/20/2000 (23 years old)","M (L), AM (LC)","Sua Flamingoes","Botswanan Premier Division","BOT","No","1/18/2023","6/30/2025","$0","Left","Very Strong","Reasonable","5'7""","121 lbs","-","-",74,95,6,9,13,7,13,6,6,7,5,6,5,6,7,10,12,8,8,7,7,7,13,10,2,13,6,8,8,12,13,13,8,4,11,13,11,1,13,18,14,11,9,11,6,1,13,1,11,10,7,1,2,3,1,2,1,3,2,2,4,2
"4606",2000088918,"Tshepo Maikano","7/11/1988 (34 years old)","D/WB (R)","Gaborone Utd","Botswanan Premier Division","BOT","No","6/14/2021","6/30/2024","$0 - $12K","Right","Reasonable","Very Strong","5'3""","119 lbs","7","-",87,95,6,8,7,7,10,8,9,9,9,11,8,4,13,11,9,9,7,11,14,13,17,9,6,9,11,10,10,11,12,13,10,5,17,12,13,1,11,17,12,10,12,10,13,11,7,3,11,13,19,3,3,2,2,2,2,2,2,4,3,3
"4607",2000088917,"Tlhalefo Molebatsi","10/22/1994 (28 years old)","AM (R), ST (C)","Township Rollers","Botswanan Premier Division","BOT","No","7/1/2019","6/30/2025","$65K - $200K","Right","Reasonable","Very Strong","5'5""","125 lbs","-","-",88,95,7,10,9,14,13,7,12,8,4,6,11,6,2,12,12,7,8,8,8,14,9,11,3,13,8,7,9,9,14,14,3,5,13,13,11,1,12,12,11,9,10,10,7,5,9,7,10,12,7,1,3,2,1,2,1,1,1,1,3,3
"4608",2000313498,"Ernest Ngwaga","12/19/2000 (22 years old)","AM (RLC)","Morupule Wanderers","Botswanan Premier Division","BOT","No","7/1/2022","6/30/2024","$0","Right","Fairly Strong","Very Strong","5'10""","149 lbs","-","-",75,95,7,10,13,11,6,6,4,7,1,5,10,4,6,8,15,9,6,6,7,13,2,12,1,12,7,7,9,9,13,12,7,8,13,13,6,4,16,13,9,10,9,12,14,2,12,4,12,11,14,2,2,3,4,1,2,2,1,3,3,3
"4609",13146376,"Lebogang Ditsile","4/20/1996 (27 years old)","M/AM (C)","Gaborone Utd","Botswanan Premier Division","BOT","No","6/1/2021","6/30/2025","$14K - $140K","Right","Fairly Strong","Very Strong","6'1""","163 lbs","4","-",88,95,5,7,9,9,9,7,8,9,2,8,6,5,9,13,13,7,6,6,8,14,15,15,9,13,9,8,6,9,14,12,6,8,13,14,14,5,10,20,9,11,13,11,7,4,7,7,12,10,7,4,3,1,1,3,2,3,1,3,4,3
"4610",23493806,"Ilhan Fandi","11/8/2002 (20 years old)","AM (RC), ST (C)","KMSK Deinze","Belgian Challenger Pro League","SIN","No","1/1/2023","6/30/2024","$150K - $1.5M","Left","Very Strong","Fairly Strong","6'0""","160 lbs","51","28",101,117,9,11,11,15,11,9,12,9,9,7,12,7,5,12,8,9,7,9,10,11,2,13,12,10,10,10,12,11,12,11,10,12,6,10,11,7,12,10,14,12,13,10,13,8,10,8,12,10,10,3,4,1,2,3,2,2,1,3,2,2
"4611",23359300,"Ikhsan Fandi","4/9/1999 (24 years old)","AM (RL), ST (C)","BG Pathum Utd","Thai League","SIN","No","1/1/2022","5/31/2024","$50K - $500K","Right Only","Weak","Very Strong","6'0""","178 lbs","135","34",104,115,9,10,12,14,10,8,13,11,5,5,11,10,5,11,10,14,10,13,7,12,6,12,5,14,7,11,9,10,12,12,10,13,12,12,12,13,14,10,10,10,13,9,8,7,12,5,12,13,13,4,1,1,3,3,1,3,3,4,1,1
"4612",2000109911,"Mohammad Tamim","10/7/2005 (17 years old)","M (L), AM (RL), ST (C)","Vejle","3F Superliga","AFG","Yes","6/13/2022","6/30/2024","$14K - $130K","Right","Fairly Strong","Very Strong","6'0""","154 lbs","-","-",76,113,12,11,14,11,12,11,7,10,3,3,11,9,2,15,6,11,7,8,6,8,8,17,4,13,3,4,10,4,11,11,7,10,11,11,6,5,10,8,7,9,13,11,6,14,8,11,7,9,12,3,1,3,1,2,3,2,2,2,2,1
"4613",15085266,"Zelfy Nazary","1/1/1995 (28 years old)","M (C)","St. Albans Saints","National Premier Leagues - Victoria","AFG","No","1/1/2022","9/30/2023","$0 - $24K","Right","Fairly Strong","Very Strong","5'5""","125 lbs","85","18",83,93,7,6,3,5,10,7,7,13,1,9,10,7,7,5,10,8,2,8,5,12,7,5,9,13,8,8,11,13,14,14,8,5,11,14,13,1,11,14,9,14,13,12,8,17,8,7,9,12,18,2,1,3,2,2,1,1,1,2,2,1
"4614",23083845,"Safuwan Baharudin","9/22/1991 (31 years old)","D (C), DM","N. Sembilan","Malaysian Super League","SIN","No","2/22/2023","11/30/2024","Not for Sale","Right","Reasonable","Very Strong","5'11""","149 lbs","256","44",81,110,5,4,1,7,12,7,12,8,4,12,6,3,12,8,12,10,9,8,9,11,18,5,7,6,14,4,6,9,10,8,8,10,12,10,7,12,15,16,12,10,12,10,10,10,12,2,13,10,20,4,2,3,3,1,3,3,1,2,3,3
"4615",23222901,"Irfan Fandi","8/13/1997 (25 years old)","D (C), DM","BG Pathum Utd","Thai League","SIN","No","11/27/2018","5/31/2026","$275K - $800K","Right","Weak","Very Strong","6'2""","165 lbs","135","17",100,107,5,5,10,8,9,5,13,8,6,13,9,10,12,7,10,14,8,11,13,12,16,12,5,5,13,10,6,11,12,10,8,13,12,11,11,11,13,14,15,16,13,15,7,12,7,5,13,15,13,3,1,2,1,4,1,1,3,1,3,2
"4616",2000025507,"Harry Birtwistle","12/1/2003 (19 years old)","D/WB (R)","Wolves","English Premier Division","SIN","No","10/28/2021","6/30/2024","$12K - $120K","Right","Reasonable","Very Strong","5'4""","121 lbs","-","-",75,104,4,9,12,6,4,1,7,7,7,8,8,1,14,7,10,9,8,9,8,5,9,7,7,5,8,13,8,13,16,14,10,3,13,15,9,1,8,16,13,12,13,11,8,7,11,1,10,12,10,4,2,2,2,1,2,4,2,3,2,1
"4617",23418788,"Ryhan Stewart","2/15/2000 (23 years old)","D/M (RC)","BG Pathum Utd","Thai League","SIN","No","6/1/2023","6/30/2024","$45K - $475K","Right","Reasonable","Very Strong","6'0""","174 lbs","80","6",89,104,3,8,9,4,11,3,9,5,6,12,7,6,12,9,12,11,12,10,10,11,6,5,5,5,11,13,8,12,12,10,12,10,11,11,12,11,12,20,11,12,9,10,11,3,9,8,11,10,10,2,1,1,1,2,1,3,3,3,3,3
"4618",45035461,"Song Ui-Young","11/8/1993 (29 years old)","M/AM (C), ST (C)","Nong Bua Pitchaya","Thai League Two","SIN","No","1/15/2023","6/30/2024","$140K - $425K","Right","Reasonable","Very Strong","5'10""","171 lbs","219","62",83,96,4,6,11,13,10,6,7,9,4,7,11,4,2,10,12,11,6,9,6,11,16,9,1,12,9,8,10,9,14,14,8,6,14,14,5,6,9,13,11,16,11,15,5,8,7,3,14,11,7,2,3,1,1,2,2,2,4,2,2,2
"4619",7801003,"Hassan Sunny","4/2/1984 (39 years old)","GK","Albirex (S)","Singaporean Premier League","SIN","No","12/16/2022","11/30/2024","Not for Sale","Left","Very Strong","Strong","6'0""","176 lbs","468","-",82,90,2,3,3,3,5,7,4,3,1,3,6,3,3,3,5,10,13,8,9,10,7,3,9,2,10,4,3,7,11,13,7,7,16,7,5,7,11,13,14,12,10,11,9,11,12,4,7,13,10,7,11,12,16,9,11,13,5,8,7,9
"4620",1005180,"Khairul Amri","3/15/1985 (38 years old)","ST (C)","Tanjong Pagar","Singaporean Premier League","SIN","No","1/1/2023","11/30/2024","$0 - $9K","Right","Fairly Strong","Very Strong","5'8""","145 lbs","366","147",59,89,9,10,12,11,11,11,3,4,1,4,11,8,3,12,9,6,8,8,8,7,11,15,7,10,6,10,12,8,10,6,6,3,13,10,6,6,8,9,8,10,13,12,12,14,7,7,13,15,16,2,1,2,3,3,1,3,2,1,1,1
"4621",23493802,"Abdul Rasaq Akeem","6/16/2001 (21 years old)","ST (C)","LC Sailors","Singaporean Premier League","SIN","No","1/10/2023","11/30/2025","$18K - $180K","Right","Weak","Very Strong","5'9""","154 lbs","57","20",65,89,9,7,9,12,10,9,6,11,4,5,9,6,7,9,9,9,7,10,8,9,7,9,11,10,5,9,7,8,9,10,9,10,15,10,7,9,11,19,11,10,9,11,5,11,12,4,19,12,8,1,2,2,4,1,3,3,2,3,2,2
"4622",23029462,"Hariss Harun","11/19/1990 (32 years old)","D (C), DM, M (C)","LC Sailors","Singaporean Premier League","SIN","No","1/1/2023","11/30/2024","$0 - $65K","Right","Weak","Very Strong","5'10""","163 lbs","347","27",74,88,6,9,8,8,10,9,9,9,4,11,10,6,10,8,13,9,10,8,7,11,13,11,13,10,11,10,8,11,9,8,10,9,13,9,10,10,11,8,10,15,10,11,11,11,5,5,14,11,7,1,3,2,2,3,2,1,2,3,3,2
"4623",23036415,"Izwan Mahbud","7/14/1990 (32 years old)","GK","LC Sailors","Singaporean Premier League","SIN","No","1/1/2023","11/30/2024","$2.5K - $26K","Right","Reasonable","Very Strong","6'0""","189 lbs","256","-",67,85,1,3,2,2,3,4,1,3,3,1,7,1,2,2,7,9,11,6,7,9,12,2,14,3,7,6,5,5,9,14,8,10,14,8,4,8,9,17,12,10,11,10,5,6,5,2,18,12,14,3,7,12,5,8,9,12,6,8,8,10
"4624",2000210510,"Yahyie Shirzai","10/1/2005 (17 years old)","D (C)","HB Køge","NordicBet Liga","AFG","Yes","1/1/2022","6/30/2024","$0 - $60K","Right Only","Weak","Very Strong","5'7""","127 lbs","2","-",63,91,4,3,1,1,7,1,14,2,1,7,7,4,13,5,11,12,6,6,8,14,2,5,1,2,14,6,5,7,9,12,7,5,12,14,4,1,10,16,11,12,11,9,9,1,9,8,8,10,20,1,3,2,1,1,2,3,2,2,3,1
"4625",23419145,"Farhan Zulkifli","11/10/2002 (20 years old)","D/WB/AM (L)","Hougang Utd","Singaporean Premier League","SIN","No","1/1/2023","11/30/2025","$45K - $130K","Left","Very Strong","Weak","5'4""","121 lbs","70","3",63,85,8,11,7,9,7,5,2,2,1,6,7,2,6,10,14,7,7,6,7,13,8,13,9,4,6,6,7,7,13,13,6,1,11,13,7,1,11,16,10,10,12,12,6,10,7,2,16,11,9,4,1,3,1,4,1,1,3,1,2,3
"4626",23222841,"Adam Swandi","1/12/1996 (27 years old)","M/AM (C)","LC Sailors","Singaporean Premier League","SIN","No","1/1/2023","11/30/2024","$45K - $130K","Right","Reasonable","Very Strong","5'7""","138 lbs","160","22",69,83,9,6,10,6,11,9,7,9,4,3,8,7,6,12,7,11,7,11,9,10,9,11,8,8,6,9,10,9,10,13,6,7,8,10,11,6,12,13,11,12,12,13,10,16,7,5,7,12,9,2,3,3,2,1,3,2,1,3,1,2
"4627",23083853,"Shakir Hamzah","10/10/1992 (30 years old)","D (LC), WB (L)","Tanjong Pagar","Singaporean Premier League","SIN","No","1/1/2023","11/30/2024","$40K - $120K","Left","Very Strong","Fairly Strong","5'10""","134 lbs","234","20",67,82,1,7,5,3,7,1,12,1,1,10,5,2,11,6,12,12,12,7,7,10,7,5,2,5,11,6,2,8,12,7,6,11,15,11,12,11,7,15,8,12,11,9,13,11,13,1,15,11,16,3,2,3,3,4,2,2,3,1,3,2
"4628",23139375,"M. Anumanthan","7/14/1994 (28 years old)","DM, M (C)","LC Sailors","Singaporean Premier League","SIN","No","1/1/2023","11/30/2024","$5K - $50K","Right","Reasonable","Very Strong","5'11""","171 lbs","213","7",72,82,9,6,5,6,10,10,8,11,7,12,8,6,12,7,13,10,8,10,7,10,11,5,15,8,10,11,8,11,11,8,12,10,15,12,11,11,14,11,10,12,8,12,13,15,11,2,20,10,12,2,2,2,3,3,2,2,1,1,2,2
"4629",23083855,"Zulfahmi Arifin","10/5/1991 (31 years old)","D (C), DM, M/AM (C)","Hougang Utd","Singaporean Premier League","SIN","No","1/1/2023","11/30/2024","$3K - $30K","Right","Reasonable","Very Strong","5'10""","165 lbs","227","9",68,81,4,5,3,9,8,5,8,7,3,7,10,4,13,7,5,8,8,6,8,10,14,9,6,8,12,9,10,13,9,10,8,6,10,8,12,8,10,18,11,14,12,14,10,8,5,4,17,11,13,1,3,1,2,1,3,2,3,2,1,1
"4630",23112043,"Faris Ramli","8/24/1992 (30 years old)","AM (RL)","Tampines","Singaporean Premier League","SIN","No","1/18/2023","11/30/2024","$6K - $55K","Right","Fairly Strong","Very Strong","5'6""","130 lbs","268","81",74,81,8,13,14,11,10,7,6,5,6,2,7,12,2,10,8,9,8,7,6,9,11,13,10,10,6,8,7,6,11,11,6,3,13,12,11,3,12,12,12,11,9,13,12,3,5,7,5,10,12,1,1,4,1,1,1,3,4,2,4,1
"4631",23419142,"Ryaan Sanizal","5/31/2002 (21 years old)","D (C)","Tampines","Singaporean Premier League","SIN","No","1/1/2023","11/30/2025","$16K - $160K","Right","Fairly Strong","Very Strong","5'9""","160 lbs","69","5",66,81,7,5,7,8,8,5,11,6,5,13,6,4,11,6,13,10,11,9,7,10,9,4,4,4,9,8,4,9,10,8,9,11,10,10,8,9,12,13,11,14,11,10,7,11,9,7,10,10,13,3,1,1,1,3,3,3,3,3,2,2
"4632",23359746,"Saifullah Akbar","1/31/1999 (24 years old)","M (C), AM (RC)","Tampines","Singaporean Premier League","SIN","No","1/7/2023","11/30/2025","$12K - $120K","Right","Weak","Very Strong","5'5""","125 lbs","103","12",64,81,8,6,9,6,9,8,7,8,3,5,7,5,5,7,13,8,8,8,6,5,11,8,10,12,7,9,8,11,13,12,6,2,12,12,8,4,11,10,11,11,12,11,13,10,11,3,10,13,7,1,2,3,2,3,3,3,2,1,3,2
"4633",23112022,"Sahil Suhaimi","7/8/1992 (30 years old)","AM (LC), ST (C)","Hougang Utd","Singaporean Premier League","SIN","No","1/1/2023","11/30/2024","$0 - $90K","Right","Reasonable","Very Strong","5'6""","149 lbs","184","35",64,81,5,7,10,11,7,5,7,5,5,5,10,5,6,11,12,6,3,4,9,11,5,11,6,10,4,7,3,11,13,13,13,1,8,13,8,1,7,15,11,11,10,12,5,9,5,3,8,10,20,3,1,2,3,2,1,1,2,3,1,1
"4634",23447960,"Joel Chew","2/9/2000 (23 years old)","M (C), AM (LC)","Tampines","Singaporean Premier League","SIN","No","1/1/2023","12/31/2027","$14K - $130K","Right","Fairly Strong","Very Strong","5'6""","134 lbs","112","7",66,80,10,8,12,6,12,9,4,8,4,6,12,7,4,13,7,11,7,12,6,10,7,13,7,7,3,6,12,9,9,11,7,5,12,8,7,2,15,15,9,12,11,10,13,4,9,3,9,9,19,2,3,2,1,2,1,1,1,2,1,2
"4635",2000105329,"Hassan Rahmani","3/15/1996 (27 years old)","DM, M (C)","Stovner","Norwegian Fourth Division Oslo 2","AFG","Yes","5/27/2021","-","$0","Right","Weak","Very Strong","5'10""","163 lbs","112","4",53,91,8,8,7,6,10,8,8,10,7,10,12,7,10,11,12,11,7,11,8,9,7,11,11,7,9,7,10,6,6,8,8,8,7,7,5,9,11,12,9,10,10,7,12,17,14,11,10,5,10,2,3,2,3,2,1,1,1,3,4,4
"4636",23359794,"Shah Shahiran","11/14/1999 (23 years old)","M (C)","Tampines","Singaporean Premier League","SIN","No","2/10/2023","11/30/2025","$18K - $180K","Right Only","Weak","Very Strong","5'8""","125 lbs","145","8",67,80,9,8,9,7,12,10,4,7,4,7,12,6,7,12,8,11,7,11,9,14,9,9,8,10,9,10,12,10,10,9,8,7,12,9,10,4,9,7,8,10,13,8,12,15,5,5,10,9,10,3,1,2,3,1,2,2,3,2,2,3
"4637",23419134,"Nur Adam Abdullah","4/13/2001 (22 years old)","D/WB (L)","LC Sailors","Singaporean Premier League","SIN","No","1/1/2023","11/30/2025","$20K - $210K","Left Only","Very Strong","Weak","5'6""","141 lbs","89","-",67,80,6,9,10,4,9,3,8,8,2,9,8,1,11,10,15,8,9,8,7,11,11,8,8,11,9,9,6,9,12,12,8,7,9,13,10,5,17,14,12,12,10,10,10,5,13,1,9,13,12,2,2,2,2,3,1,2,2,2,1,3
"4638",23392307,"Glenn Kweh","3/26/2000 (23 years old)","AM (L)","Tampines","Singaporean Premier League","SIN","No","1/7/2023","11/30/2025","$6K - $55K","Left","Very Strong","Weak","5'8""","154 lbs","71","6",67,80,4,5,11,11,11,6,7,5,5,5,8,7,4,10,7,9,6,9,5,9,9,8,13,11,5,9,4,8,13,10,9,6,6,13,7,8,13,18,9,12,10,11,12,12,5,8,12,9,10,2,2,2,4,2,4,1,3,3,2,3
"4639",2000058989,"Khairin Nadim Rahim","5/8/2004 (19 years old)","ST (C)","LC Sailors","Singaporean Premier League","SIN","No","1/1/2023","11/30/2025","$60K - $180K","Right","Weak","Very Strong","5'7""","132 lbs","49","7",52,80,7,6,9,11,10,7,13,6,6,3,7,6,5,9,11,8,7,10,6,5,7,10,13,11,3,7,5,6,11,12,6,5,7,10,11,3,8,17,10,13,11,11,8,1,6,1,9,10,19,3,3,1,1,2,3,1,1,2,1,1
"4640",23034869,"Shahfiq Ghani","3/17/1992 (31 years old)","ST (C)","Geylang Int.","Singaporean Premier League","SIN","No","2/27/2023","11/30/2024","$16K - $50K","Right","Weak","Very Strong","5'9""","154 lbs","190","34",51,79,6,6,4,14,13,6,11,7,2,5,6,6,5,8,10,7,1,14,6,14,12,8,13,8,7,6,8,8,6,11,6,5,14,8,7,4,9,15,13,11,10,10,13,11,6,5,18,12,14,2,3,2,2,1,3,2,3,2,1,1
"4641",23200240,"Anders Aplin","6/21/1991 (31 years old)","D (RC)","Hougang Utd","Singaporean Premier League","SIN","No","1/1/2023","11/30/2024","$0 - $10K","Right","Weak","Very Strong","5'11""","158 lbs","132","6",50,79,2,6,2,5,6,1,9,2,1,12,5,1,12,3,10,7,8,6,5,13,15,5,11,2,13,5,3,5,10,9,6,5,12,8,4,5,12,16,11,13,10,12,12,18,10,1,13,10,20,3,2,1,1,3,2,2,1,3,3,2
"4642",23083879,"Nazrul Nazari","2/11/1991 (32 years old)","D/M (R)","Hougang Utd","Singaporean Premier League","SIN","No","1/1/2023","11/30/2024","$2.5K - $26K","Right","Reasonable","Very Strong","5'5""","121 lbs","272","18",71,79,8,12,8,9,8,8,8,7,8,9,8,4,12,12,9,11,5,7,9,13,7,5,11,9,10,9,8,10,12,13,7,5,18,14,6,2,11,17,14,10,8,12,9,7,6,4,7,11,12,1,1,3,1,1,2,2,2,3,1,1
"4643",1046493,"Shahdan Sulaiman","8/9/1988 (34 years old)","D (C), DM, M (C)","Hougang Utd","Singaporean Premier League","SIN","No","1/27/2023","11/30/2024","$4.5K - $14K","Right","Reasonable","Very Strong","5'10""","167 lbs","357","56",70,78,6,8,8,7,13,8,9,9,4,9,10,3,12,11,7,11,9,9,10,9,16,9,13,11,10,9,11,13,8,8,7,5,7,6,7,8,9,20,13,9,12,10,5,12,8,1,13,12,7,3,1,3,2,2,1,1,4,3,3,2
"4644",23051961,"Gabriel Quak","12/22/1990 (32 years old)","M (RC), AM (RLC)","Hougang Utd","Singaporean Premier League","SIN","No","1/18/2023","11/30/2024","$28K - $85K","Left","Very Strong","Reasonable","5'10""","143 lbs","281","61",70,78,4,9,10,8,11,7,5,6,7,7,13,1,6,8,11,9,7,8,8,13,10,12,7,11,7,8,8,11,12,10,8,8,10,13,6,5,10,13,10,10,8,11,9,13,7,8,13,9,20,2,1,4,1,2,2,1,3,3,1,1
"4645",23222967,"Hami Syahin","11/16/1998 (24 years old)","DM, M (C)","LC Sailors","Singaporean Premier League","SIN","No","1/1/2023","11/30/2025","$4.5K - $45K","Right","Reasonable","Very Strong","5'5""","132 lbs","158","16",69,78,7,7,10,6,13,4,5,8,7,7,12,9,7,13,11,11,4,10,7,10,12,13,10,10,7,10,12,10,11,10,7,4,12,10,9,3,12,19,12,10,10,8,10,12,17,2,9,10,11,1,3,4,2,3,1,3,2,3,4,4
"4646",2000094499,"Jaweed Muradi","9/16/2002 (20 years old)","M/AM (L)","Para Hills","South Australia - State League 1","AFG","No","1/1/2020","6/30/2024","$0","Left","Very Strong","Reasonable","5'9""","145 lbs","26","6",54,90,6,11,9,8,8,4,1,6,5,5,9,6,2,9,12,8,7,7,6,13,8,9,11,5,4,7,4,11,12,12,6,6,14,9,6,3,10,18,12,9,9,10,6,9,13,2,11,13,19,3,3,1,3,2,3,3,1,3,3,1
"4647",23222954,"Zulqarnaen Suzliman","3/29/1998 (25 years old)","D/WB (R)","LC Sailors","Singaporean Premier League","SIN","No","1/1/2023","11/30/2024","$0 - $120K","Right","Reasonable","Very Strong","5'9""","149 lbs","124","8",67,78,4,9,8,7,8,1,8,3,3,9,8,2,11,10,11,9,7,9,9,8,3,6,15,8,10,9,6,9,13,8,9,7,14,12,9,7,10,12,14,10,12,9,9,14,6,8,15,10,18,1,3,4,1,1,3,3,3,3,3,3
"4648",1046401,"Irwan Shah","11/2/1988 (34 years old)","D/WB/M/AM (L)","Hougang Utd","Singaporean Premier League","SIN","No","1/19/2023","11/30/2024","$4K - $12K","Left","Very Strong","Reasonable","5'7""","136 lbs","347","12",63,77,6,9,5,9,9,7,6,5,4,8,14,7,4,9,10,8,8,9,9,13,4,7,13,8,9,6,9,9,8,11,4,5,13,10,12,7,13,20,12,11,10,11,7,8,8,8,10,9,19,1,3,2,3,1,1,2,1,3,2,3
"4649",23055906,"Yasir Hanapi","6/21/1989 (33 years old)","M/AM (C)","Tampines","Singaporean Premier League","SIN","No","1/1/2023","11/30/2024","$0 - $26K","Right Only","Very Weak","Very Strong","5'7""","149 lbs","336","44",66,77,9,9,8,9,8,9,7,7,5,7,8,5,7,9,6,10,7,10,7,10,9,13,13,13,7,9,9,9,12,9,7,5,14,10,14,7,14,19,13,12,13,9,5,3,14,3,5,13,7,3,1,2,2,3,1,1,1,2,3,2
"4650",23419040,"Daniel Goh","8/13/1999 (23 years old)","AM (RL)","Balestier","Singaporean Premier League","SIN","No","5/2/2022","11/30/2025","$14K - $130K","Right","Reasonable","Very Strong","5'8""","127 lbs","84","16",66,76,6,11,9,10,12,5,2,6,4,5,6,3,5,10,7,9,5,7,6,11,13,8,12,12,5,7,9,12,11,9,6,4,14,10,12,3,11,13,12,12,11,11,6,7,7,1,9,12,8,4,1,2,2,1,1,3,2,4,2,2
"4651",23320374,"Syed Firdaus Syed Hassan","5/30/1998 (25 years old)","DM, M (C)","Tampines","Singaporean Premier League","SIN","No","2/6/2022","11/30/2024","$14K - $150K","Right Only","Weak","Very Strong","5'8""","143 lbs","106","2",65,76,3,7,8,8,9,6,8,9,3,7,14,4,7,6,10,7,6,9,10,13,9,5,6,5,7,9,12,11,8,10,9,7,16,9,14,6,7,14,11,10,10,10,13,13,11,8,20,11,14,3,2,2,3,3,1,1,1,1,3,1
"4652",23277485,"Joshua Pereira","10/10/1997 (25 years old)","D (C), DM, M (C)","Geylang Int.","Singaporean Premier League","SIN","No","12/20/2022","11/30/2024","$50K - $150K","Right","Reasonable","Very Strong","5'10""","158 lbs","129","8",66,76,2,4,7,7,6,4,7,6,3,11,9,3,13,7,5,9,7,8,8,9,8,5,7,5,9,7,9,12,13,14,7,5,8,14,14,7,12,14,9,12,10,9,6,13,7,6,11,12,14,3,3,1,1,2,3,2,1,3,1,3
"4653",23139424,"Christopher van Huizen","11/28/1992 (30 years old)","D (L), WB/AM (RL)","LC Sailors","Singaporean Premier League","SIN","Yes","1/20/2023","11/30/2024","$0 - $90K","Right","Strong","Very Strong","5'7""","141 lbs","158","8",67,76,10,12,9,8,9,8,4,8,2,6,12,2,4,9,8,8,5,6,6,8,11,12,5,8,4,8,7,10,11,10,6,5,14,11,10,6,12,20,11,13,11,10,9,6,13,1,12,11,18,2,3,1,1,2,2,1,1,2,1,2
"4654",23200226,"Shawal Anuar","4/29/1991 (32 years old)","AM (RL)","LC Sailors","Singaporean Premier League","SIN","No","1/1/2023","11/30/2024","$0 - $85K","Right","Fairly Strong","Very Strong","5'6""","127 lbs","176","49",72,75,9,13,11,9,9,8,10,8,6,3,9,7,4,10,9,9,6,10,7,8,9,11,8,9,5,9,7,8,13,12,7,4,12,13,8,4,12,13,11,13,11,10,8,7,9,5,11,13,20,3,3,2,2,2,2,3,3,1,2,2
"4655",23222811,"Amirul Adli","1/13/1996 (27 years old)","D (C), DM","Geylang Int.","Singaporean Premier League","SIN","No","2/20/2023","11/30/2024","$5K - $50K","Right","Reasonable","Very Strong","5'10""","160 lbs","214","8",67,75,4,5,4,3,5,5,7,6,2,13,6,1,12,7,14,6,4,5,11,11,3,5,11,5,9,7,7,11,8,11,6,8,8,13,13,6,13,10,11,12,13,12,13,10,8,8,8,11,15,1,4,4,3,1,3,2,2,1,4,1
"4656",23139459,"Amy Recha","5/13/1992 (31 years old)","AM (RL), ST (C)","Hougang Utd","Singaporean Premier League","SIN","No","1/1/2023","11/30/2024","$4K - $40K","Right","Reasonable","Very Strong","5'7""","132 lbs","219","46",68,75,7,5,12,13,13,6,12,7,6,7,7,3,5,11,5,8,5,6,7,12,15,9,4,11,7,8,9,9,13,9,8,3,12,11,8,5,9,20,11,10,8,11,10,5,10,2,12,11,17,2,3,3,2,3,3,2,1,3,3,3
"4657",33070664,"Mosawer Ahadi","3/8/2000 (23 years old)","WB (R), M/AM (RL), ST (C)","HIFK","Finnish First Division","AFG","Yes","12/7/2022","11/15/2023","$18K - $190K","Left","Very Strong","Reasonable","5'9""","141 lbs","97","9",80,90,6,6,9,8,9,6,8,6,8,4,8,7,7,11,11,7,8,7,7,7,8,6,13,11,9,11,7,11,12,13,10,7,9,12,9,6,11,14,7,7,5,10,8,11,11,5,7,14,12,2,1,3,2,4,1,2,4,3,3,1
"4658",23448105,"Naqiuddin Eunos","12/1/1997 (25 years old)","D/WB/M (L), AM (RL)","Tanjong Pagar","Singaporean Premier League","SIN","No","1/1/2023","11/30/2024","$45K - $130K","Right","Reasonable","Very Strong","5'9""","156 lbs","88","2",63,75,5,8,11,8,7,4,1,2,1,5,10,3,6,7,14,4,4,5,6,7,8,12,2,10,5,5,6,6,12,12,5,4,6,12,11,7,12,20,9,12,11,9,14,10,10,8,15,12,18,2,3,2,2,2,2,3,2,3,2,3
"4659",23359799,"Amirul Haikal","10/11/1999 (23 years old)","D/WB/AM (L)","Tampines","Singaporean Premier League","SIN","No","1/1/2023","11/30/2025","$4.5K - $45K","Left","Very Strong","Reasonable","5'4""","132 lbs","105","6",60,75,6,9,3,10,8,5,1,3,6,8,8,1,8,9,12,8,7,8,7,11,15,10,8,10,8,7,5,8,14,14,7,3,9,14,5,4,12,20,11,12,10,11,10,6,5,8,8,11,20,1,3,1,2,1,3,4,2,1,2,3
"4660",1046505,"Zaiful Nizam","7/24/1987 (35 years old)","GK","Hougang Utd","Singaporean Premier League","SIN","No","1/17/2023","11/30/2024","$6K - $18K","Right","Weak","Very Strong","5'9""","160 lbs","330","-",59,75,10,2,2,1,1,14,1,11,1,1,7,1,3,1,9,7,9,6,6,12,14,13,12,2,9,5,4,10,8,14,5,5,10,3,4,9,10,18,11,8,10,9,6,12,5,6,14,12,16,4,11,9,10,7,11,9,13,9,8,7
"4661",23359805,"Irfan Najeeb","7/31/1999 (23 years old)","D (RC)","Tampines","Singaporean Premier League","SIN","No","1/1/2023","11/30/2025","$50K - $150K","Right Only","Weak","Very Strong","5'10""","154 lbs","142","5",65,75,8,7,8,4,10,3,9,6,8,11,8,4,11,8,9,11,9,10,8,10,2,8,9,6,11,9,6,7,10,11,10,9,10,10,10,9,11,11,13,12,12,13,11,4,5,5,8,13,9,2,2,1,3,2,2,3,3,3,2,2
"4662",1046437,"Firdaus Kasman","1/24/1988 (35 years old)","DM, M (C)","Tampines","Singaporean Premier League","SIN","No","1/1/2023","11/30/2024","$0","Right","Weak","Very Strong","5'7""","145 lbs","271","7",53,75,6,7,7,5,11,6,6,8,3,8,7,3,13,9,6,9,7,6,7,14,13,5,14,8,9,7,7,12,7,7,5,6,12,7,7,6,12,15,8,12,11,11,6,7,12,8,10,9,10,1,1,3,4,3,2,4,1,3,4,1
"4663",23222869,"Lionel Tan","6/5/1997 (26 years old)","D (C)","LC Sailors","Singaporean Premier League","SIN","No","1/18/2023","11/30/2024","$12K - $40K","Right Only","Weak","Very Strong","6'0""","163 lbs","132","6",65,75,5,3,4,3,6,2,11,4,6,11,5,7,11,6,11,10,11,9,8,10,9,4,11,4,11,8,4,7,10,7,11,13,12,11,10,11,14,20,11,12,10,11,10,9,5,1,9,11,14,4,3,3,1,3,1,2,1,1,3,1
"4664",23222837,"Iqram Rifqi Yazid","2/25/1996 (27 years old)","D/WB (L), AM (RL)","Balestier","Singaporean Premier League","SIN","No","1/6/2023","11/30/2024","$26K - $80K","Left","Very Strong","Reasonable","5'5""","125 lbs","86","4",54,74,4,8,7,4,11,2,1,4,4,5,8,1,6,6,6,4,6,6,5,10,1,12,5,9,6,6,6,7,12,12,6,1,14,12,11,1,11,17,11,8,11,12,5,10,11,4,9,8,10,1,3,1,2,1,2,3,1,3,3,3
"4665",23277290,"Taufik Suparno","10/31/1995 (27 years old)","AM (RL), ST (C)","Tampines","Singaporean Premier League","SIN","No","1/1/2023","11/30/2024","$12K - $130K","Right","Reasonable","Very Strong","5'5""","141 lbs","139","32",66,74,7,7,7,10,9,7,10,6,7,3,7,5,4,9,13,10,9,10,8,9,11,11,7,9,5,8,7,10,11,12,6,2,15,11,14,6,9,6,11,12,13,10,13,4,13,3,11,13,15,2,2,1,2,2,3,2,3,2,2,1
"4666",43373698,"Edoardo Colombo","1/24/2001 (22 years old)","GK","Cavese","Italian Serie D Grp. G","SMR","Yes","7/7/2022","6/30/2026","$0","Right Only","Very Weak","Very Strong","6'1""","169 lbs","101","-",89,115,2,1,2,1,8,5,8,3,3,3,8,3,2,9,12,10,12,11,11,7,15,8,8,5,11,7,8,13,11,13,13,14,13,9,11,10,10,8,9,13,12,10,2,11,5,5,12,15,12,10,12,15,9,13,10,11,7,9,10,11
"4667",60028967,"Filippo Fabbri","1/7/2002 (21 years old)","D (RC), WB (R)","Olbia","Italian Serie C/B","SMR","Yes","7/6/2022","6/30/2024","$14K - $140K","Right","Weak","Very Strong","6'1""","174 lbs","65","1",94,115,4,10,5,6,11,6,12,6,7,11,8,5,12,10,13,11,12,9,12,10,10,6,7,8,11,10,8,13,12,12,13,12,14,12,12,11,12,10,11,10,11,10,5,14,8,4,14,12,8,2,1,4,2,1,3,2,2,1,2,3
"4668",33064507,"Fareed Sadat","11/10/1998 (24 years old)","AM (RC), ST (C)","Nakhon Si Utd","Thai League Two","AFG","Yes","1/5/2023","6/30/2024","$0","Right","Reasonable","Very Strong","5'11""","171 lbs","130","32",78,89,8,11,11,8,8,8,10,9,8,8,14,7,3,10,13,10,7,8,8,9,12,8,13,7,9,8,7,8,13,7,8,9,12,13,11,10,10,17,9,11,12,8,10,7,11,3,12,13,18,2,2,3,1,2,1,2,3,3,1,2
"4669",60027854,"Nicola Nanni","5/2/2000 (23 years old)","ST (C)","Olbia","Italian Serie C/B","SMR","Yes","10/5/2022","6/30/2024","$40K - $400K","Right Only","Weak","Very Strong","6'3""","194 lbs","82","6",96,111,7,9,9,11,11,8,14,9,7,7,9,9,9,8,13,11,13,11,11,11,13,12,7,14,9,13,9,10,10,10,14,14,13,11,12,15,9,11,10,10,11,10,7,7,14,5,10,10,8,1,1,3,2,3,1,3,2,1,1,2
"4670",833976,"Roberto Di Maio","9/21/1982 (40 years old)","D (C)","Cosmos","San Marino League","SMR","Yes","6/8/2022","6/30/2024","$0","Left Only","Very Strong","Weak","6'2""","182 lbs","578","58",65,105,4,5,4,6,6,4,12,6,6,11,7,3,10,6,13,8,10,7,11,10,14,5,13,8,11,9,6,8,6,6,9,14,11,6,6,12,10,7,7,12,12,11,5,12,9,10,13,11,10,3,2,1,3,1,2,1,1,1,3,2
"4671",2000269006,"Lyes Hoël","4/12/2007 (16 years old)","GK","US Thionville Lusitanos","French National 3 - Group I","SMR","Yes","6/12/2023","6/30/2024","$0 - $26K","Right","Fairly Strong","Very Strong","6'3""","165 lbs","-","-",61,105,4,1,1,1,3,8,1,3,2,1,10,3,1,3,5,4,15,2,9,13,10,3,4,3,9,6,5,4,6,9,6,14,11,6,1,5,8,15,7,10,11,11,13,7,6,7,8,11,20,10,6,12,5,6,13,12,5,8,6,10
"4672",8800539,"Elia Benedettini","6/22/1995 (27 years old)","GK","Cailungo","San Marino League","SMR","No","7/11/2022","6/30/2024","$0","Right Only","Weak","Very Strong","6'2""","176 lbs","87","-",85,101,5,3,2,1,7,8,1,2,1,2,8,1,2,6,9,9,13,10,11,9,13,7,12,7,12,10,7,8,7,8,14,14,14,8,11,16,9,12,14,9,9,10,11,13,6,2,13,14,10,11,11,13,13,11,9,11,11,10,9,12
"4673",60023431,"Filippo Berardi","5/18/1997 (26 years old)","M (R), AM (RL), ST (C)","Sammaurese","Italian Serie D Grp. D","SMR","Yes","1/23/2023","6/30/2024","$4K - $40K","Left Only","Very Strong","Weak","5'9""","154 lbs","119","10",79,96,10,11,12,10,10,11,8,11,5,6,13,11,6,13,9,9,5,8,9,9,12,14,10,12,7,7,11,7,11,12,10,8,11,10,11,8,10,11,11,12,11,12,14,10,6,7,13,12,11,2,3,1,1,4,3,3,1,2,3,3
"4674",1405484,"Mirko Palazzi","3/21/1987 (36 years old)","D (LC)","Cosmos","San Marino League","SMR","Yes","7/11/2022","6/30/2024","$0","Right","Reasonable","Very Strong","6'0""","165 lbs","335","29",60,91,3,6,8,8,7,5,8,7,7,10,9,8,10,10,12,9,10,9,10,9,12,9,15,10,10,12,9,12,7,9,11,9,12,8,9,8,19,12,14,17,11,16,8,15,11,3,14,7,11,3,2,2,2,1,3,1,1,1,3,1
"4675",60028962,"Lorenzo Capicchioni","1/19/2002 (21 years old)","M (RC)","Cosmos","San Marino League","SMR","No","2/10/2022","6/30/2026","$0","Right Only","Weak","Very Strong","5'8""","154 lbs","23","2",54,75,5,8,9,6,9,6,8,9,7,8,11,7,8,7,11,10,4,7,10,10,8,7,5,9,11,11,8,6,10,9,8,10,7,11,10,9,14,6,9,13,11,11,5,15,14,1,8,13,10,3,2,4,3,1,1,1,2,1,3,3
"4676",43000794,"Matteo Vitaioli","10/27/1989 (33 years old)","AM (RL), ST (C)","La Fiorita","San Marino League","SMR","No","7/13/2022","6/30/2024","$0 - $4.5K","Right Only","Weak","Very Strong","6'2""","163 lbs","182","47",62,75,8,9,11,9,9,13,7,10,3,3,8,11,4,10,8,8,7,9,9,8,15,11,15,11,6,12,9,9,9,11,8,7,14,8,8,6,14,13,11,13,12,11,8,12,7,3,13,15,17,2,2,2,3,1,3,1,3,3,1,1
"4677",43373700,"Andrea Magi","2/3/2001 (22 years old)","D (C)","Diegaro","Italian Eccellenza Emilia-Romagna Grp.B","SMR","Yes","9/8/2021","6/30/2023","$0","Left Only","Very Strong","Weak","5'11""","163 lbs","12","-",56,75,5,6,5,5,8,7,9,6,7,8,9,6,8,5,8,11,9,8,9,11,15,8,11,7,11,11,7,9,9,7,8,11,14,10,8,7,8,18,8,17,13,10,2,11,7,5,15,10,15,2,2,3,3,1,1,3,3,2,2,2
"4678",43373711,"Alessandro Tosi","4/28/2001 (22 years old)","D (LC), WB/M (L)","Victor San Marino","Italian Serie D Grp. D","SMR","No","7/29/2022","6/30/2025","$1K - $8K","Left","Very Strong","Reasonable","5'9""","156 lbs","24","-",55,75,5,8,8,5,7,5,6,7,6,8,8,7,8,7,7,7,10,8,10,8,7,10,6,10,10,9,8,10,9,10,7,8,10,10,11,7,15,12,11,10,9,9,5,13,6,4,13,12,8,3,2,1,4,3,2,3,3,1,3,1
"4679",16155608,"Rahman Jawadi","1/10/1999 (24 years old)","AM (LC), ST (C)","FC Wacker Innsbruck","Austrian Tyrol League","AFG","No","2/6/2023","6/30/2024","$0 - $18K","Right","Reasonable","Very Strong","5'7""","147 lbs","142","30",71,88,4,7,9,13,13,6,9,5,1,5,9,1,1,11,9,9,8,9,4,12,11,11,12,13,5,7,5,8,13,13,6,4,15,13,7,1,9,19,10,12,11,10,11,12,13,3,8,10,9,3,1,1,3,3,2,3,2,3,4,2
"4680",1401703,"Aldo Junior Simoncini","8/30/1986 (36 years old)","GK","Cosmos","San Marino League","SMR","No","6/30/2022","6/30/2024","$0","Left Only","Very Strong","Very Weak","6'1""","167 lbs","289","-",52,71,3,2,3,3,4,1,4,1,2,3,4,1,2,5,12,8,11,8,9,8,10,3,12,3,8,5,5,6,6,11,7,11,11,6,7,7,1,16,14,14,8,9,7,12,12,3,13,5,7,8,13,13,12,8,5,11,12,7,11,10
"4681",43619639,"Dante Carlos Rossi","7/12/1987 (35 years old)","D (C)","Tropical Coriano","Italian Eccellenza Emilia-Romagna Grp.B","SMR","No","6/30/2022","6/30/2024","$0 - $1.5K","Left Only","Very Strong","Weak","5'11""","180 lbs","27","1",61,70,4,6,5,5,5,5,9,5,5,12,7,7,12,5,15,12,13,8,11,7,15,7,14,10,10,8,4,11,7,8,11,9,12,8,11,12,14,8,13,13,11,8,11,12,14,3,11,6,13,2,2,3,1,3,3,2,2,4,3,3
"4682",60009447,"Mattia Stefanelli","3/12/1993 (30 years old)","ST (C)","Pennarossa","San Marino League","SMR","No","7/25/2019","6/30/2024","$0","Right Only","Weak","Very Strong","5'11""","163 lbs","103","48",51,67,6,6,6,9,7,6,13,6,5,5,9,7,6,8,7,8,11,9,8,8,14,6,10,7,7,11,7,12,8,6,12,12,5,8,9,13,4,11,9,11,10,10,15,11,8,2,12,8,17,2,1,1,2,3,2,3,2,1,2,1
"4683",2000087437,"Simone Santi","5/3/2004 (19 years old)","M (LC), AM (L)","San Marino Academy","San Marino League","SMR","No","6/13/2022","6/30/2024","$3K - $9K","Right","Fairly Strong","Very Strong","5'9""","152 lbs","4","-",54,61,8,7,9,6,10,9,4,12,4,5,9,3,7,10,14,8,6,7,8,8,8,9,10,9,6,7,11,9,10,11,7,6,13,8,8,6,11,17,12,11,8,10,10,10,13,1,19,10,19,3,2,1,3,3,2,2,1,1,3,1
"4684",60031148,"Davide Aluigi","3/3/2002 (21 years old)","GK","Lama","Italian Eccellenza Umbria","SMR","Yes","12/13/2022","6/30/2023","$0","Right Only","Very Weak","Very Strong","5'11""","165 lbs","25","-",50,61,3,3,2,3,6,2,4,3,1,1,6,3,2,6,7,9,10,7,8,9,10,3,6,2,10,8,8,7,10,11,10,9,11,8,8,8,8,9,8,14,10,13,5,8,4,1,6,10,16,7,10,10,11,11,8,9,5,9,7,6
"4685",43096752,"Fabio Ramon Tomassini","2/5/1996 (27 years old)","M (R), AM (RL), ST (C)","Pietracuta","Italian Eccellenza Emilia-Romagna Grp.B","SMR","No","6/15/2020","6/30/2024","$0 - $30K","Right Only","Weak","Very Strong","5'8""","141 lbs","101","14",54,60,9,9,11,8,10,6,5,7,5,4,8,6,6,10,7,8,8,8,9,7,14,9,7,10,6,8,9,9,9,12,7,6,14,8,9,5,10,16,8,13,13,12,6,1,5,3,9,12,18,2,2,1,1,2,2,3,2,1,1,2
"4686",2000057533,"Lorenzo Lazzari","6/6/2003 (20 years old)","DM, M/AM (C)","Victor San Marino","Italian Serie D Grp. D","SMR","No","7/29/2022","6/30/2025","$6K - $20K","Right Only","Weak","Very Strong","5'7""","138 lbs","-","-",50,54,6,7,8,7,10,8,5,6,5,8,10,5,10,9,11,10,9,8,8,9,11,6,5,10,8,9,9,11,8,10,7,6,11,9,10,6,8,14,11,12,10,9,11,9,10,1,11,11,17,1,2,3,2,3,2,2,1,3,2,2
"4687",43617291,"Davide Fabbri","4/11/2003 (20 years old)","GK","Pietracuta","Italian Eccellenza Emilia-Romagna Grp.B","SMR","Yes","1/20/2023","6/30/2023","$0","Right Only","Weak","Very Strong","6'6""","171 lbs","1","-",51,52,3,3,3,1,6,7,5,3,3,2,5,1,3,5,5,8,8,7,8,9,8,6,6,2,9,7,8,6,8,9,10,14,13,8,6,7,9,11,11,9,10,11,4,12,8,2,10,12,19,9,8,11,12,11,10,9,5,7,8,12
"4688",2000101005,"Pietro Amici","1/27/2004 (19 years old)","GK","San Marino Academy","San Marino League","SMR","No","6/13/2022","6/30/2029","$1.5K - $5K","Left","Very Strong","Reasonable","6'3""","178 lbs","-","-",50,50,3,2,1,2,1,6,1,3,2,1,5,1,2,2,12,7,13,2,7,12,17,1,1,3,6,5,4,4,9,6,5,10,12,5,1,5,10,18,9,10,9,10,8,12,10,8,10,11,18,7,8,12,9,6,6,12,5,3,5,12
"4689",28059949,"Tim Chow","1/18/1994 (29 years old)","M (C)","CD Rongcheng","Chinese Super League","TPE","No","1/1/2022","1/31/2026","$1.2M - $2.6M","Right","Fairly Strong","Very Strong","5'11""","160 lbs","165","11",104,115,10,9,12,8,11,10,9,11,5,9,12,5,12,12,11,10,13,11,11,11,13,8,8,13,10,16,10,16,10,11,11,8,13,12,15,10,12,9,9,10,9,11,4,11,3,3,15,11,14,3,2,1,1,4,3,2,1,3,2,1
"4690",2000108518,"Mohammad Reza Rezaie","3/13/2001 (22 years old)","D (RL)","ASK Mannersdorf","Austrian 2. County League East (NÖ)","AFG","No","7/8/2022","6/30/2024","$0 - $5K","Left","Very Strong","Reasonable","5'11""","160 lbs","80","3",70,88,5,11,7,1,11,1,7,8,6,8,7,8,13,9,5,9,9,9,12,8,15,7,7,7,11,9,9,9,15,10,9,11,13,12,11,6,12,16,9,10,13,9,7,7,6,5,14,10,7,3,1,3,3,2,3,3,2,2,1,4
"4691",2000011900,"Miguel Sandberg","8/5/2002 (20 years old)","M (L), AM (C), ST (C)","Västerås SK","Swedish First Division Elite","TPE","Yes","12/31/2021","12/31/2024","$0 - $45K","Right Only","Weak","Very Strong","6'0""","149 lbs","30","1",81,112,7,8,11,10,10,7,7,9,5,6,10,7,6,10,8,10,11,10,11,10,11,9,7,10,7,11,9,12,12,11,9,10,12,12,12,9,11,12,12,12,12,10,10,9,6,2,10,10,16,3,3,3,2,3,2,3,3,3,2,3
"4692",66037307,"Wang Gun-Myung","7/4/1993 (29 years old)","D/WB (R)","QD Hainiu","Chinese Super League","TPE","No","7/2/2022","12/31/2024","$5K - $50K","Right","Weak","Very Strong","5'11""","149 lbs","88","6",81,95,5,10,10,9,11,3,9,2,4,10,10,5,15,11,12,11,6,11,10,10,11,8,9,10,10,15,10,12,11,12,12,12,12,12,11,6,12,11,11,9,11,9,6,11,8,4,10,11,12,1,1,3,1,3,2,2,3,1,2,4
"4693",23020963,"Chen Po-liang","2/11/1988 (35 years old)","M/AM (C)","QD West Coast","Chinese National First Division","TPE","No","1/1/2023","12/31/2024","$500 - $2.5K","Right","Reasonable","Very Strong","5'11""","165 lbs","261","29",70,84,9,8,10,8,9,9,7,8,4,6,10,7,6,10,10,11,10,11,9,13,13,9,13,12,7,12,10,11,10,10,10,8,11,10,7,9,11,14,11,11,11,8,8,12,7,3,11,11,9,2,1,1,1,2,2,3,3,2,3,3
"4694",28116909,"Will Donkin","12/26/2000 (22 years old)","M (LC), AM (L)","Shenzhen","Chinese Super League","TPE","No","5/31/2022","12/31/2026","$4K - $12K","Right","Reasonable","Very Strong","5'11""","147 lbs","42","6",64,83,6,8,11,7,14,6,4,8,3,7,6,1,6,12,5,8,7,3,8,13,11,9,14,13,7,7,10,11,11,6,12,10,15,11,7,4,12,11,10,11,10,11,12,11,6,6,13,10,9,1,2,1,2,4,2,2,2,4,1,3
"4695",23168528,"Wen Chi-hao","3/25/1993 (30 years old)","DM, M (C), ST (C)","Taipower","Chinese Taipei Football Premier League","TPE","No","1/1/2022","12/31/2023","$0 - $60K","Left","Very Strong","Strong","5'7""","138 lbs","194","21",64,82,7,7,6,8,8,8,5,7,4,6,8,3,6,6,12,9,12,10,8,8,13,9,11,11,8,7,5,10,11,13,11,6,10,12,9,6,14,11,12,14,8,13,15,12,10,2,8,11,10,1,2,3,1,1,2,3,1,1,2,1
"4696",23034948,"Chen Hao-wei","4/30/1992 (31 years old)","M (LC), AM (RLC)","Taichung Futuro","Chinese Taipei Football Premier League","TPE","No","12/11/2020","12/31/2023","$0 - $35K","Right","Weak","Very Strong","5'7""","132 lbs","130","17",59,77,8,7,7,7,10,8,2,7,4,3,7,10,3,8,7,8,8,9,5,8,12,12,9,7,6,8,5,10,12,12,8,5,14,12,9,6,12,14,14,11,7,11,14,6,7,4,6,12,10,3,2,3,2,2,1,3,3,3,1,3
"4697",67071601,"Yaki","4/21/1989 (34 years old)","D (C), DM","NJ City","Chinese National First Division","TPE","Yes","4/5/2023","12/31/2023","$2K - $6K","Right","Reasonable","Very Strong","6'0""","167 lbs","154","6",75,75,1,3,8,5,8,4,12,4,4,12,11,4,12,10,11,9,12,9,10,8,18,8,6,7,12,8,8,9,10,11,10,11,13,9,9,11,10,13,12,12,13,11,9,11,7,6,10,11,8,1,1,3,4,1,3,1,1,2,2,4
"4698",23168501,"Onur Doğan","9/8/1987 (35 years old)","ST (C)","Taichung Futuro","Chinese Taipei Football Premier League","TPE","No","1/1/2021","12/31/2023","$1.5K - $5K","Right","Reasonable","Very Strong","6'1""","174 lbs","78","14",61,75,6,7,10,9,13,6,8,7,3,6,10,3,2,8,12,7,6,10,7,14,11,7,5,12,7,7,5,12,10,6,10,10,17,8,10,6,11,11,11,11,7,11,12,8,11,2,5,10,8,1,2,2,3,1,4,3,2,3,2,3
"4699",23168526,"Wang Ruei","8/10/1993 (29 years old)","D (C)","Taichung Futuro","Chinese Taipei Football Premier League","TPE","No","5/31/2020","12/31/2023","$0 - $30K","Right","Weak","Very Strong","5'11""","174 lbs","22","2",55,66,2,1,1,1,2,1,12,1,1,12,3,1,11,1,7,8,7,4,7,12,9,5,8,4,9,4,3,5,12,12,5,7,13,12,10,4,14,20,11,13,10,10,5,14,5,6,12,11,17,3,3,3,2,3,1,1,1,3,1,3
"4700",2000294070,"Zeng Zi-hao","10/19/1997 (25 years old)","DM, M (C)","Taichung Futuro","Chinese Taipei Football Premier League","TPE","No","1/1/2021","12/31/2023","$0 - $40K","Right","Reasonable","Very Strong","5'9""","152 lbs","6","-",57,61,5,6,4,4,6,5,4,5,3,7,5,2,7,10,12,10,7,4,7,12,3,5,8,7,8,7,6,10,13,13,6,3,5,13,10,5,10,17,12,12,10,8,9,9,9,8,12,11,19,2,3,3,2,3,4,1,2,1,3,2
"4701",2000104998,"Ali Jan Noorzai","1/1/2005 (18 years old)","M (C)","SV Allerheiligen","Austrian Regional League Central","AFG","No","7/15/2022","6/30/2026","$0","Right","Fairly Strong","Very Strong","6'0""","154 lbs","27","2",57,88,5,2,3,2,13,5,5,8,4,10,13,1,5,8,11,7,5,5,3,12,3,5,6,8,4,6,10,10,11,11,6,9,10,13,10,3,7,17,12,13,11,10,8,10,11,7,8,12,12,1,1,1,3,3,3,1,2,3,3,1
"4702",2000290108,"Chang Chun-chieh","6/8/2000 (23 years old)","ST (C)","Ming Chuan Univ.","Chinese Taipei Football Premier League","TPE","No","8/1/2022","-","$0","Right","Reasonable","Very Strong","5'9""","149 lbs","16","2",54,60,7,8,11,9,13,7,9,8,6,5,6,3,4,8,9,7,6,11,7,11,14,12,4,11,7,7,6,9,8,12,8,7,10,12,8,5,9,19,9,9,11,12,6,12,15,8,11,11,9,1,2,2,1,2,1,1,3,2,2,3
"4703",23168511,"Chen Ting-yang","7/6/1991 (31 years old)","D (C)","Taichung Futuro","Chinese Taipei Football Premier League","TPE","No","5/31/2019","12/31/2024","$1.5K - $16K","Right","Weak","Very Strong","5'9""","141 lbs","35","4",53,53,6,2,2,5,8,1,9,4,3,10,4,2,13,6,13,10,9,10,8,10,5,5,10,6,10,8,8,9,8,6,9,8,10,5,7,6,11,12,11,12,11,13,6,9,15,4,9,12,18,2,2,2,2,2,2,1,3,3,2,2
"4704",2000097770,"Hsieh Peng-lung","11/13/1998 (24 years old)","D (C)","Ming Chuan Univ.","Chinese Taipei Football Premier League","TPE","No","1/1/2019","-","$0","Right Only","Weak","Very Strong","6'4""","180 lbs","26","1",51,53,4,2,1,1,7,1,9,2,1,9,6,1,13,4,12,12,7,7,6,7,9,5,13,5,6,6,4,7,11,11,7,12,15,12,12,8,12,19,15,13,10,12,13,12,8,6,7,12,12,2,1,2,3,1,3,4,2,3,1,2
"4705",2000250232,"Joseph Loro","7/7/2004 (18 years old)","D (C), DM, M (C)","Munuki","South Sudanese Lower Divisions","SSD","No","1/1/2022","6/30/2024","$0","Right","Reasonable","Very Strong","6'6""","180 lbs","-","-",85,115,2,4,7,6,10,5,15,9,3,7,11,5,13,13,13,8,8,9,5,12,18,5,10,8,8,8,11,12,14,13,9,17,10,13,11,5,11,10,11,13,13,11,5,10,6,8,12,9,10,2,1,1,3,4,2,2,1,4,2,4
"4706",12093064,"Dani Lual","11/29/2002 (20 years old)","AM (R), ST (C)","Vyškov","-","SSD","No","2/13/2022","6/30/2024","$16K - $170K","Right","Reasonable","Very Strong","6'2""","158 lbs","56","27",70,109,3,7,10,13,12,6,6,8,6,6,10,8,2,11,5,8,8,10,6,8,13,11,9,11,6,7,4,4,13,12,13,12,7,13,5,4,11,19,9,11,12,11,11,7,13,5,11,10,16,2,2,2,3,4,2,3,2,1,1,3
"4707",2000082503,"Machop Chol","11/14/1998 (24 years old)","AM (RL)","Atlanta United","Major League Soccer","SSD","No","1/19/2021","12/31/2023","$26K - $275K","Right","Weak","Very Strong","6'2""","174 lbs","100","14",96,107,7,9,12,9,10,5,12,7,6,8,10,12,8,11,8,8,12,9,8,8,13,10,10,10,7,11,8,13,13,13,8,15,14,16,10,7,15,20,14,11,13,11,9,11,3,7,7,10,17,1,3,1,3,1,3,3,1,1,3,3
"4708",2000066434,"Paul Pal","2/12/2000 (23 years old)","D (C), DM","Ulsan Citizen FC","Korean K3 League","SSD","No","1/1/2021","12/31/2025","$0","Right","Fairly Strong","Very Strong","6'7""","174 lbs","-","-",60,105,1,3,1,1,2,4,10,5,1,12,4,1,12,5,8,5,7,5,3,12,5,5,3,4,12,4,3,6,9,6,5,18,13,7,9,8,13,19,13,12,9,12,11,7,6,2,10,13,11,1,1,3,1,3,3,2,2,1,3,3
"4709",2000301562,"Tito Mayor","10/22/2004 (18 years old)","AM (R), ST (C)","AS Ali Sabieh","Djiboutian Premier Division","SSD","No","6/12/2023","6/30/2024","$0","Right","Fairly Strong","Very Strong","5'10""","149 lbs","-","-",60,104,6,11,13,13,6,3,8,4,2,4,7,4,4,10,5,3,5,5,6,11,6,12,11,9,6,6,5,7,13,10,6,7,12,10,12,4,8,10,11,10,13,11,10,9,12,6,9,10,8,2,2,3,1,1,4,3,3,2,3,1
"4710",2000232330,"Joseph Dhata","9/5/2002 (20 years old)","D/WB (R)","NEC FC","Uganda Premier League","SSD","No","6/12/2023","6/30/2025","$0","Right","Strong","Very Strong","5'11""","163 lbs","-","-",70,102,5,13,8,5,10,4,9,6,8,10,9,2,12,10,14,8,10,9,9,11,14,5,10,7,8,9,9,9,12,8,4,11,12,11,6,8,16,17,11,9,9,12,7,18,8,3,8,13,20,3,3,2,1,3,3,2,2,1,1,1
"4711",15048350,"Kenny Athiu","8/5/1992 (30 years old)","ST (C)","Heidelberg Utd","National Premier Leagues - Victoria","SSD","No","2/10/2023","9/30/2023","$18K - $190K","Right","Reasonable","Very Strong","6'7""","200 lbs","170","80",91,101,3,8,11,12,12,9,13,9,1,1,8,11,2,9,6,8,8,9,8,6,9,14,2,11,6,7,4,8,12,8,10,20,9,14,14,15,12,19,13,12,12,13,11,14,3,6,5,14,17,1,2,3,3,1,2,3,3,4,2,3
"4712",37058062,"Omid Popalzay","1/25/1996 (27 years old)","DM, M (C), AM (RLC)","Ariana FC","Swedish First Division South","AFG","Yes","3/31/2023","11/30/2023","$0","Right","Weak","Very Strong","5'7""","143 lbs","130","14",67,88,11,10,7,8,8,11,7,11,6,8,8,8,8,11,7,8,8,7,8,8,10,8,7,8,9,9,8,9,10,10,8,7,13,11,11,8,6,10,10,10,10,7,10,9,7,5,9,10,11,3,1,1,4,2,1,2,2,1,2,1
"4713",13225601,"Tito Okello","1/7/1996 (27 years old)","AM (C), ST (C)","Paykan","Persian Gulf Premier League","SSD","No","4/25/2022","6/30/2026","$275K - $850K","Right","Reasonable","Very Strong","5'9""","156 lbs","60","23",100,100,6,8,12,14,12,3,8,10,2,8,10,6,6,12,5,8,3,11,9,11,3,11,3,12,9,8,8,10,14,14,9,8,9,14,14,8,9,11,13,13,12,12,13,1,6,3,10,10,14,1,1,1,1,2,2,1,2,1,3,3
"4714",2000213048,"Juma Genaro","2/28/1982 (41 years old)","GK","Hay Al-Wadi","Sudanese Premier League","SSD","No","1/2/2020","6/30/2024","$0","Right","Reasonable","Very Strong","6'1""","167 lbs","25","-",80,100,5,1,1,1,4,9,1,2,2,3,6,2,3,6,11,11,10,6,11,12,12,3,14,1,10,9,8,8,5,15,5,14,13,5,5,5,11,12,12,10,11,10,10,6,12,1,8,11,11,10,14,5,13,8,14,15,5,12,9,15
"4715",12093113,"Jackson Dwang","6/24/2002 (20 years old)","M (C)","Posta Rangers","Kenyan Premier Division","SSD","No","7/1/2019","6/30/2025","$0","Right","Fairly Strong","Very Strong","5'11""","158 lbs","-","-",77,100,7,6,6,4,14,3,7,8,2,12,14,1,8,13,5,11,8,10,8,10,7,6,8,11,9,8,14,11,12,12,8,7,15,10,6,7,11,14,13,12,8,12,7,11,10,1,10,12,14,1,3,3,1,2,1,1,2,1,1,3
"4716",2000066436,"Martin Sawi","9/16/1999 (23 years old)","AM (C), ST (C)","Ulsan Citizen FC","Korean K3 League","SSD","No","1/1/2021","12/31/2025","$0 - $24K","Right","Fairly Strong","Very Strong","5'10""","165 lbs","-","-",65,100,5,5,9,12,8,5,13,5,1,2,10,5,1,6,14,7,7,13,6,8,12,11,5,11,6,6,9,7,13,13,6,3,12,13,8,4,11,11,10,10,11,14,6,5,10,2,10,11,10,2,1,1,1,1,1,1,3,2,1,3
"4717",13231506,"William Akio","7/23/1998 (24 years old)","AM (RL), ST (C)","Raith Rovers","cinch Championship","SSD","No","1/28/2023","5/31/2024","$0","Right Only","Weak","Very Strong","5'11""","163 lbs","93","26",90,100,6,8,13,8,10,5,10,5,7,6,9,7,5,7,10,7,8,7,8,13,14,7,9,11,7,8,9,13,14,14,7,9,14,14,11,13,11,15,10,14,11,12,9,10,12,6,11,9,14,3,2,2,1,3,3,3,4,1,1,1
"4718",2000213893,"Samuel Malish","10/29/2002 (20 years old)","D (C)","Kator","South Sudanese Lower Divisions","SSD","No","1/1/2020","6/30/2024","$0","Right","Reasonable","Very Strong","6'3""","174 lbs","-","-",72,98,2,2,1,4,8,1,10,5,5,13,5,1,13,7,14,10,8,5,6,13,14,5,1,6,10,6,3,7,13,9,2,12,12,10,12,5,13,19,11,11,12,10,6,18,6,2,12,13,19,2,3,3,2,2,2,3,1,1,3,2
"4719",2000250229,"Jacob Koal","4/26/2004 (19 years old)","D/WB (L)","Sofapaka","Kenyan Premier Division","SSD","No","7/1/2022","6/30/2025","$12K - $35K","Left","Very Strong","Weak","6'0""","160 lbs","-","-",53,98,5,10,6,4,9,1,4,4,5,8,8,3,14,6,6,9,7,6,5,9,3,8,9,7,8,7,8,8,14,14,7,10,11,14,6,5,11,18,10,15,11,10,14,10,10,1,10,9,18,3,1,3,1,3,4,1,1,1,2,4
"4720",2000018535,"Ajak Riak","12/10/2000 (22 years old)","ST (C)","South Melbourne","National Premier Leagues - Victoria","SSD","No","11/27/2022","9/30/2023","$0","Right","Fairly Strong","Very Strong","6'1""","165 lbs","64","31",81,97,5,7,6,8,10,8,15,8,8,6,6,4,6,6,12,14,10,8,7,13,6,13,7,5,9,8,7,9,11,11,13,11,15,14,7,11,10,17,11,11,11,11,10,12,11,4,16,9,9,1,1,3,1,2,3,4,1,3,2,1
"4721",2000015988,"Kur Kur","2/20/2000 (23 years old)","M (C), AM (LC)","Brisbane Roar (NPL)","National Premier Leagues - Queensland","SSD","No","6/1/2023","9/30/2023","$0 - $55K","Left","Very Strong","Weak","6'2""","174 lbs","50","12",81,97,7,9,9,10,12,7,7,9,7,5,10,4,9,9,8,8,4,7,9,14,12,7,9,10,7,9,11,12,11,11,9,14,12,11,9,10,15,11,10,10,12,12,14,1,5,2,15,8,11,4,2,3,1,3,1,1,3,3,3,2
"4722",2000213892,"William Gama","12/14/2002 (20 years old)","DM, M (C)","Onduparaka","Ugandan Big League","SSD","No","7/1/2022","6/30/2024","$0","Right","Reasonable","Very Strong","6'5""","189 lbs","-","-",68,96,6,5,6,8,12,6,6,10,4,8,11,5,8,9,7,8,7,8,8,9,13,5,9,6,10,8,13,12,11,9,8,14,11,12,7,9,10,20,9,10,11,10,9,8,8,2,11,10,12,3,3,3,3,1,3,3,2,2,2,3
"4723",2000214408,"Reza Hosseini","11/8/2006 (16 years old)","M (C)","HSV","Bundesliga 2","AFG","No","11/8/2021","6/30/2025","$45K - $450K","Right","Weak","Very Strong","5'11""","149 lbs","-","-",66,111,6,3,4,3,14,6,4,9,5,9,10,2,7,14,14,7,5,5,7,13,13,8,3,7,10,8,8,13,10,9,7,10,11,8,8,6,13,13,9,12,12,13,13,16,12,3,7,13,9,2,2,1,2,3,1,2,1,3,1,1
"4724",2000245652,"Riyaz Khalili","2/8/2006 (17 years old)","M (R)","Nürnberg","Bundesliga 2","AFG","No","7/1/2022","6/30/2024","$0 - $100K","Right","Reasonable","Very Strong","5'4""","143 lbs","-","-",62,88,9,11,10,4,11,6,6,4,5,3,9,2,4,12,13,7,5,14,7,11,15,6,3,7,4,7,7,10,11,12,6,1,15,14,7,1,12,14,11,11,9,12,9,1,13,6,11,12,13,1,2,3,3,3,4,2,3,1,3,2
"4725",2000250226,"Nikson Sarfino","3/4/2003 (20 years old)","D (C)","Al-Merreikh Juba","South Sudanese Lower Divisions","SSD","No","7/1/2022","6/30/2024","$0","Right","Strong","Very Strong","6'4""","180 lbs","-","-",52,96,1,1,1,1,5,1,12,1,1,12,5,1,10,4,7,10,7,5,7,12,11,5,8,3,7,4,4,3,6,7,5,13,10,10,6,6,12,11,12,12,11,8,12,1,9,4,6,11,16,1,3,2,3,2,1,1,3,1,1,3
"4726",12087285,"David Majak","10/10/2000 (22 years old)","ST (C)","Tusker FC","Kenyan Premier Division","SSD","No","3/29/2019","6/30/2023","$0","Right Only","Weak","Very Strong","6'4""","171 lbs","22","8",80,95,4,5,8,8,8,5,12,7,4,4,4,6,6,8,9,7,9,8,9,8,12,7,5,12,5,10,6,10,11,10,11,17,15,13,12,11,4,10,10,10,10,10,7,1,8,5,11,11,12,2,3,1,2,3,2,2,1,2,1,3
"4727",2000250230,"Felix Abishai","6/6/2004 (19 years old)","ST (C)","Amarat Utd","South Sudanese Lower Divisions","SSD","No","7/2/2021","6/30/2024","$0","Right","Weak","Very Strong","6'0""","160 lbs","-","-",59,95,5,4,13,13,12,5,12,6,1,3,6,3,1,7,7,9,5,4,6,9,8,7,1,11,5,5,6,6,13,10,6,9,12,10,7,4,8,17,13,12,12,11,7,6,10,2,18,14,11,1,1,4,2,1,2,3,3,3,4,3
"4728",13219855,"John Kuol","11/9/1999 (23 years old)","D (C)","Mathare Utd","Kenyan Second Division","SSD","No","1/2/2023","6/30/2024","$1.5K - $14K","Right","Fairly Strong","Very Strong","6'6""","160 lbs","21","1",78,95,2,4,1,1,4,2,10,3,3,13,7,4,12,3,15,10,9,6,7,13,7,6,2,4,10,6,3,7,13,11,7,12,15,12,8,7,13,17,11,12,12,10,10,2,10,2,15,13,12,3,3,1,2,3,3,1,2,3,3,3
"4729",2000213898,"Vitali Paulino","5/11/2002 (21 years old)","M/AM (C)","Rainbow (SSD)","South Sudanese Lower Divisions","SSD","No","1/1/2021","6/30/2024","$0","Right","Fairly Strong","Very Strong","5'8""","145 lbs","-","-",58,93,2,6,9,9,13,5,2,6,4,5,11,5,6,8,15,7,7,10,6,9,3,8,5,7,5,7,10,10,13,9,6,4,11,9,5,3,13,20,11,12,11,10,10,11,12,8,10,9,8,1,1,2,3,2,3,2,1,2,4,2
"4730",88025202,"Manyumow Achol","12/10/1999 (23 years old)","M (RL), AM (RLC)","Auda","Optibet Virsliga","SSD","No","3/1/2022","11/30/2025","$20K - $200K","Right Only","Weak","Very Strong","6'3""","176 lbs","100","16",77,93,7,8,10,8,9,10,6,9,8,7,8,9,7,10,10,12,8,8,10,10,13,10,8,8,11,11,10,12,13,8,7,8,12,13,9,6,13,11,12,11,11,11,7,10,7,1,9,12,9,1,1,2,1,1,3,3,2,2,1,2
"4731",13232594,"Ezra Elly Bida","5/2/1999 (24 years old)","AM (RLC)","Onduparaka","Ugandan Big League","SSD","No","1/31/2023","6/30/2024","$0","Right","Reasonable","Very Strong","5'4""","121 lbs","-","-",73,90,6,8,10,11,6,4,6,6,3,3,10,6,8,11,12,7,3,7,6,12,10,11,12,11,5,7,10,9,13,13,7,2,14,13,12,1,11,16,9,10,10,13,12,8,6,2,10,11,10,3,3,1,2,1,1,1,2,3,1,2
"4732",15075088,"Maker Maker","7/1/1999 (23 years old)","DM, M (C)","Dandenong Thunder","National Premier Leagues - Victoria","SSD","No","6/1/2023","9/30/2023","$0","Right","Reasonable","Very Strong","6'4""","182 lbs","50","8",65,90,5,3,5,7,14,6,7,8,5,8,12,3,14,10,11,7,6,8,8,10,16,5,11,7,12,8,10,11,10,7,2,15,10,9,6,7,13,12,11,11,11,10,12,1,5,5,18,13,12,3,2,3,2,1,1,3,3,2,1,3
"4733",13159167,"Dominic Aboi","1/1/1991 (32 years old)","AM (C), ST (C)","Al-Ahli Khartoum","Sudanese Premier League","SSD","No","7/1/2020","6/30/2024","$0","Right","Fairly Strong","Very Strong","5'10""","156 lbs","-","-",90,90,8,9,12,13,12,8,11,8,6,8,8,5,3,11,5,12,4,8,8,13,13,10,12,13,6,8,10,10,12,10,8,9,15,8,10,7,11,17,10,12,10,11,12,4,12,7,11,12,18,3,2,1,3,4,3,2,1,1,2,1
"4734",13196470,"Rashid Toha","10/9/1997 (25 years old)","D (C)","Arua Hill SC","Uganda Premier League","SSD","No","7/1/2021","6/30/2025","$0","Right","Reasonable","Very Strong","6'1""","167 lbs","-","-",81,90,3,1,1,1,7,5,11,3,2,13,6,1,13,3,10,8,8,7,13,13,6,5,8,3,13,6,5,7,13,13,7,9,16,13,4,9,15,13,10,12,11,10,5,5,8,3,10,12,10,2,1,1,3,1,1,1,3,3,3,3
"4735",16285713,"Taufee Skandari","4/2/1999 (24 years old)","M (RL), AM (C)","B36","Faroese Premier League","AFG","No","2/3/2023","11/30/2023","$0","Left Only","Very Strong","Weak","5'9""","154 lbs","75","17",81,87,6,7,11,9,12,8,7,11,3,7,10,6,6,12,7,7,11,11,9,8,7,13,13,11,5,8,7,9,13,14,12,8,10,12,13,8,8,12,9,10,12,10,9,17,15,2,20,10,10,3,3,3,3,3,2,1,1,3,2,3
"4736",2000229377,"Zarik Bolo","11/14/1999 (23 years old)","M (C)","Al-Ittifaq","UAE Second Division","SSD","No","7/1/2022","-","$0","Right","Fairly Strong","Very Strong","6'2""","176 lbs","-","-",66,89,2,2,5,7,10,4,6,10,1,8,10,4,9,9,8,5,1,5,6,13,8,5,9,7,10,7,12,12,13,11,7,12,9,12,8,7,11,20,12,11,11,11,12,16,5,4,20,10,8,1,2,1,2,3,4,3,1,1,2,1
"4737",15071025,"Jackson Morgan","8/18/1998 (24 years old)","D (R), DM, M (C)","Bentleigh Greens","National Premier Leagues - Victoria","SSD","No","11/15/2022","9/30/2023","$0","Right","Reasonable","Very Strong","5'11""","149 lbs","104","3",72,89,2,6,10,6,11,6,15,7,3,9,12,8,9,11,5,7,10,7,7,8,9,9,1,8,9,6,9,8,11,14,15,12,15,11,12,10,16,9,11,7,9,3,14,5,13,18,8,13,11,2,1,4,1,1,2,2,2,2,2,1
"4738",2000257739,"Jacob Addis","7/4/2005 (17 years old)","D/WB/M (L)","Sofapaka","Kenyan Premier Division","SSD","No","7/1/2022","6/30/2025","$1K - $9K","Left","Very Strong","Reasonable","5'7""","134 lbs","-","-",55,88,8,11,7,6,11,6,2,4,2,6,8,2,12,8,11,4,7,3,7,9,8,5,3,7,7,7,7,8,14,14,7,4,13,14,5,4,10,20,10,12,10,12,5,17,5,2,10,12,19,2,1,3,3,2,2,2,2,3,2,1
"4739",15065253,"Denis Yongule","8/17/1998 (24 years old)","M (L), AM (RLC)","Brunswick Juventus","National Premier Leagues - Victoria 2","SSD","No","6/1/2022","9/30/2023","$0","Right","Reasonable","Very Strong","5'11""","143 lbs","61","6",66,88,5,9,4,8,11,5,5,7,5,2,11,3,2,10,7,7,7,8,7,10,9,10,6,13,4,7,5,12,13,13,7,8,8,13,9,8,14,10,12,11,10,8,8,10,7,4,10,9,10,2,3,2,1,1,2,3,4,3,1,1
"4740",2000248123,"Philip Taban","9/16/2002 (20 years old)","M/AM (R), ST (C)","UPDF","Uganda Premier League","SSD","No","7/1/2022","6/30/2025","$0","Right","Reasonable","Very Strong","5'5""","125 lbs","-","-",56,88,4,8,12,10,8,5,6,6,5,5,13,3,4,11,6,8,2,6,6,10,4,11,6,6,5,6,8,7,13,13,6,2,13,13,4,1,10,20,11,10,13,13,14,6,7,5,16,12,7,1,2,4,3,2,1,1,3,2,2,3
"4741",2000213894,"Joseph Malish","7/27/2002 (20 years old)","M (C)","Al-Merreikh Omdurman","Sudanese Premier League","SSD","No","1/20/2023","6/30/2026","$0","Right","Reasonable","Very Strong","5'7""","134 lbs","-","-",64,88,4,2,5,7,11,6,6,7,2,8,13,1,13,8,12,6,7,8,7,12,4,7,6,8,5,7,8,5,13,13,4,7,13,13,7,2,12,20,12,12,10,10,10,9,5,2,8,11,13,1,4,3,1,1,1,4,3,1,3,1
"4742",2000166396,"John Kuol","9/24/1994 (28 years old)","AM (RL)","Dandenong City","National Premier Leagues - Victoria 2","SSD","No","2/3/2022","9/30/2023","$0","Right","Reasonable","Very Strong","5'10""","149 lbs","-","-",68,88,3,8,8,9,8,5,5,4,5,5,9,4,6,13,13,6,5,7,6,8,12,12,10,9,4,4,4,8,13,13,6,6,15,11,13,3,11,14,10,11,10,12,10,10,13,5,11,10,12,2,1,1,3,3,1,1,4,1,1,1
"4743",2000302517,"Paul Jawa","7/15/2004 (18 years old)","ST (C)","Rainbow (SSD)","South Sudanese Lower Divisions","SSD","No","7/1/2022","6/30/2024","$0","Right","Fairly Strong","Very Strong","5'10""","149 lbs","-","-",53,88,2,5,12,12,7,4,12,5,1,1,5,6,1,8,12,5,5,12,3,7,4,9,9,12,1,4,1,5,12,12,5,8,13,12,10,4,10,13,11,11,9,10,9,5,5,3,17,13,8,4,3,1,2,2,2,1,2,3,3,3
"4744",2000123305,"Ramadan John","3/13/2000 (23 years old)","GK","Malakia","South Sudanese Lower Divisions","SSD","No","6/15/2020","6/30/2024","$0","Right","Reasonable","Very Strong","6'6""","187 lbs","-","-",70,87,2,3,1,3,1,6,1,1,3,2,10,3,3,1,15,8,15,5,12,13,12,2,8,2,7,6,6,5,10,7,7,12,12,11,4,7,12,16,11,10,10,13,10,8,7,8,20,11,10,8,11,9,6,6,9,12,5,8,10,13
"4745",2000302611,"Emmanuel Sebit","11/22/2004 (18 years old)","D (L)","Al-Merreikh Juba","South Sudanese Lower Divisions","SSD","No","6/12/2023","6/30/2024","$0","Left","Very Strong","Reasonable","5'9""","149 lbs","-","-",50,87,5,10,1,1,10,1,4,2,5,7,6,1,8,6,14,5,8,4,7,10,4,5,2,1,7,6,5,7,11,13,6,3,8,13,12,4,11,20,9,11,10,10,10,5,5,1,14,11,16,2,3,1,1,4,1,2,1,1,2,1
"4746",2000291907,"Said Hossaini","1/1/2007 (16 years old)","ST (C)","LASK","Austrian Premier Division","AFG","No","7/30/2021","6/30/2026","$5K - $55K","Right","Reasonable","Very Strong","6'0""","145 lbs","-","-",55,87,5,4,12,13,10,5,12,6,1,3,3,5,4,5,11,7,4,7,2,9,2,8,10,13,4,5,6,6,13,11,6,13,13,11,6,3,9,13,10,12,12,12,13,1,7,5,13,12,17,2,1,2,3,3,2,1,2,3,1,1
"4747",2000253867,"Thomas Feni","12/20/2004 (18 years old)","M (C)","Amarat Utd","South Sudanese Lower Divisions","SSD","No","1/1/2022","6/30/2024","$0","Right","Reasonable","Very Strong","6'3""","169 lbs","-","-",51,86,3,5,4,3,13,6,5,6,2,7,14,1,9,14,12,5,2,5,6,13,7,7,1,5,7,7,8,11,8,10,1,12,14,11,6,4,12,10,9,11,9,12,5,13,8,2,10,8,13,3,3,2,2,2,4,2,3,1,2,2
"4748",2000250228,"Lumumba Brown","11/15/2005 (17 years old)","AM (RLC)","Calvary","Ugandan Big League","SSD","No","7/1/2022","6/30/2024","$0","Right","Reasonable","Very Strong","5'4""","116 lbs","-","-",50,86,6,7,6,11,12,6,5,4,2,3,11,1,4,10,12,4,1,6,4,6,11,11,10,12,5,7,6,12,13,10,7,4,11,13,7,1,13,13,13,9,10,11,11,8,9,1,9,10,7,2,3,3,2,1,2,3,1,3,3,1
"4749",2000253869,"Peter Aparer","2/5/2006 (17 years old)","AM (L), ST (C)","KCCA","Uganda Premier League","SSD","No","7/1/2021","6/30/2024","$0","Left","Very Strong","Fairly Strong","6'4""","171 lbs","-","-",62,86,6,9,11,11,13,5,11,7,2,5,10,5,4,10,5,7,5,5,3,7,6,10,9,3,6,6,6,7,12,9,6,13,6,12,6,5,8,11,12,11,12,12,15,5,10,3,7,12,16,3,3,2,1,3,3,3,1,1,3,1
"4750",2000247182,"Emmanuel Loki","11/14/2000 (22 years old)","M (R), AM (RL)","Bright Stars","Uganda Premier League","SSD","No","7/1/2020","6/30/2025","$0","Right","Reasonable","Very Strong","6'3""","171 lbs","-","-",70,85,3,7,12,11,14,6,7,8,7,7,11,3,8,11,15,9,1,5,8,8,10,10,11,13,7,8,10,9,12,11,8,14,17,11,7,7,14,12,12,9,13,12,9,5,11,3,10,11,8,1,2,1,2,3,2,1,1,4,3,3
"4751",2000249581,"Godwill Sabio","11/28/1999 (23 years old)","GK","Kator","South Sudanese Lower Divisions","SSD","No","7/23/2019","6/30/2024","$0","Right Only","Very Weak","Very Strong","6'2""","160 lbs","-","-",65,85,4,1,3,1,1,6,1,3,3,1,7,3,2,2,5,8,10,9,7,13,6,1,13,2,6,6,5,4,10,10,4,13,16,10,1,2,11,14,11,11,9,10,13,8,6,6,8,11,17,9,8,13,14,8,9,9,5,10,11,13
"4752",2000213039,"Adut Makoi","8/7/2002 (20 years old)","D (C)","Zalan","South Sudanese Premier Division","SSD","No","1/1/2021","6/30/2024","$0","Right","Reasonable","Very Strong","6'2""","171 lbs","-","-",55,85,3,5,3,4,8,4,10,2,3,13,7,4,9,6,15,9,8,6,7,12,7,5,6,3,9,6,5,7,8,10,7,12,15,7,6,6,12,20,13,8,9,10,11,14,5,3,11,11,9,3,2,2,2,3,3,3,2,3,2,1
"4753",15078723,"Yagoub Mustafa","2/28/1999 (24 years old)","M (L), AM (RL)","Hume City","National Premier Leagues - Victoria","SSD","No","9/24/2022","6/30/2024","$500 - $7K","Right","Weak","Very Strong","5'7""","143 lbs","80","12",75,85,9,9,12,7,9,7,4,6,7,5,10,7,3,9,13,12,8,10,12,10,8,12,2,7,8,6,7,7,13,14,9,9,13,11,10,7,8,12,9,10,10,11,8,7,5,3,5,11,7,2,1,4,3,3,1,2,1,3,1,3
"4754",2000123318,"David Omot Sebit","10/28/1998 (24 years old)","D/WB (L)","Al-Merreikh Juba","South Sudanese Lower Divisions","SSD","No","1/1/2021","6/30/2024","$0","Left","Very Strong","Fairly Strong","5'11""","156 lbs","-","-",75,85,3,10,5,1,8,1,7,1,5,8,7,6,13,8,10,8,9,5,5,13,12,5,12,6,7,7,7,7,13,13,7,7,13,13,12,6,10,17,10,12,9,11,9,14,6,6,12,10,11,1,1,2,1,3,3,3,3,3,1,2
"4755",2000212519,"Akot Wiir","5/17/1998 (25 years old)","ST (C)","Zalan","South Sudanese Premier Division","SSD","No","1/1/2021","6/30/2024","$0","Right","Strong","Very Strong","5'10""","158 lbs","-","-",70,85,2,4,10,12,12,4,12,5,3,1,7,9,3,12,5,12,4,10,1,6,16,14,1,9,6,5,5,3,12,12,6,5,15,12,8,8,11,13,13,11,13,11,11,12,7,5,14,9,7,1,1,1,2,2,4,4,3,1,3,4
"4756",2000214361,"Dominic Angelo","4/14/2000 (23 years old)","D/WB (L), DM","Munuki","South Sudanese Lower Divisions","SSD","No","6/15/2020","6/30/2024","$0","Left","Very Strong","Weak","5'3""","119 lbs","-","-",68,85,6,11,4,4,9,7,6,7,6,9,11,4,11,9,14,10,6,7,5,8,8,5,2,7,10,8,9,9,14,14,7,2,14,15,5,1,12,18,10,11,12,9,9,6,10,1,8,13,19,2,1,3,3,3,4,3,1,1,3,1
"4757",213375,"Faisal Sakhizada","6/15/1990 (32 years old)","D (LC)","Kingston City","National Premier Leagues - Victoria 2","AFG","No","6/14/2021","9/30/2023","$0","Left Only","Very Strong","Weak","6'3""","191 lbs","141","11",72,87,4,9,10,3,9,5,11,2,1,12,10,3,12,7,14,11,13,11,6,12,5,5,12,4,14,7,3,8,9,6,8,15,9,7,5,12,9,13,13,10,11,10,15,6,10,1,10,12,9,3,2,1,3,1,1,1,2,2,2,3
"4758",2000123315,"Stephen Lujang","10/10/1999 (23 years old)","M/AM (C)","Onduparaka","Ugandan Big League","SSD","No","7/1/2022","6/30/2024","$0","Right","Fairly Strong","Very Strong","5'7""","160 lbs","-","-",65,85,6,2,8,11,12,6,3,8,1,6,13,4,7,7,7,8,7,5,4,10,9,15,3,8,6,7,12,8,12,11,7,3,5,8,7,11,14,17,10,12,11,8,14,4,9,7,12,9,8,1,4,3,1,1,2,4,3,2,1,1
"4759",2000301071,"Julius Debbo","5/20/2001 (22 years old)","D (RL), WB (L)","Busoga Utd","Uganda Premier League","SSD","No","6/12/2023","6/30/2025","$0","Left","Very Strong","Fairly Strong","5'9""","152 lbs","-","-",65,85,8,12,5,5,13,4,6,5,4,9,9,7,11,9,9,10,8,9,8,9,5,5,12,8,6,9,7,9,13,10,4,7,9,9,7,5,9,17,9,10,10,11,10,1,6,8,11,8,13,4,3,3,1,3,1,2,3,3,4,1
"4760",2000123310,"Munyang Ilemu","1/7/2000 (23 years old)","M/AM (R)","Atlabara","South Sudanese Lower Divisions","SSD","No","7/1/2021","6/30/2024","$0","Right","Reasonable","Very Strong","5'9""","149 lbs","-","-",63,85,4,9,10,7,10,3,4,7,5,5,11,4,4,8,10,4,6,6,7,12,12,8,6,8,5,3,4,8,13,10,2,4,9,12,13,3,18,11,13,13,12,12,10,5,8,1,12,11,11,2,1,2,2,1,4,1,1,1,1,1
"4761",29162734,"Tommy Semmy","9/30/1994 (28 years old)","AM (RL), ST (C)","Altona Magic","National Premier Leagues - Victoria","PNG","No","12/5/2022","9/30/2023","$18K - $170K","Right Only","Weak","Very Strong","5'10""","216 lbs","72","30",91,112,7,7,9,10,9,10,8,11,10,5,7,10,6,9,13,8,17,7,8,6,18,14,11,8,4,11,7,9,16,11,10,11,16,16,12,16,12,18,12,16,9,11,5,12,8,4,6,14,19,1,2,2,1,3,1,1,3,1,1,2
"4762",91181837,"Alwin Komolong","11/2/1994 (28 years old)","D (C), DM","Lae City","Papua New Guinean National Soccer League","PNG","Yes","1/1/2020","12/31/2024","$5K - $14K","Right Only","Weak","Very Strong","6'0""","176 lbs","13","-",80,90,4,6,1,1,8,6,12,4,1,13,5,1,13,7,5,7,9,7,8,13,14,5,11,6,11,6,7,8,12,10,11,10,13,8,12,13,10,14,15,14,14,12,10,12,12,6,11,12,6,1,3,3,2,1,1,1,2,1,3,3
"4763",29162727,"Raymond Gunemba","6/4/1986 (37 years old)","ST (C)","Lae City Dwellers","Papua New Guinean National Soccer League","PNG","No","12/31/2022","12/31/2024","$0","Left Only","Very Strong","Weak","5'10""","191 lbs","25","7",67,88,10,6,8,11,11,8,10,6,7,6,9,2,3,11,9,10,4,12,11,9,11,11,12,11,8,10,10,12,10,10,13,8,8,11,11,11,8,11,12,12,11,12,6,9,11,3,10,10,16,2,1,1,3,3,1,1,3,2,2,1
"4764",37061966,"Jamie Woodlock","5/27/1998 (25 years old)","WB/M/AM (RL)","Cambridge","New Zealand NRFL Conference","PNG","No","12/31/2020","-","$0","Right","Weak","Very Strong","6'2""","167 lbs","2","-",59,86,5,9,8,5,7,5,4,3,5,9,10,5,4,12,10,8,3,6,5,7,10,15,1,10,5,3,5,7,13,9,6,7,12,13,8,4,10,10,12,11,11,11,7,9,7,19,9,11,20,3,3,2,1,1,3,1,2,3,3,3
"4765",29162718,"Valentine Nelson","4/12/1987 (36 years old)","D (C)","Lae City Dwellers","Papua New Guinean National Soccer League","PNG","No","6/14/2021","12/31/2024","$0","Right","Fairly Strong","Very Strong","6'2""","205 lbs","-","-",63,82,4,1,2,1,7,3,14,6,1,8,7,1,6,6,9,9,8,7,9,14,18,5,9,6,14,6,4,7,7,8,7,14,8,6,9,6,7,16,9,14,11,10,5,10,6,2,14,12,19,3,2,2,1,1,2,3,1,3,1,2
"4766",29162725,"Daniel Joe","5/29/1990 (33 years old)","D/WB (R)","Hekari Utd","Papua New Guinean National Soccer League","PNG","No","6/14/2021","12/31/2024","Not for Sale","Right Only","Very Weak","Very Strong","5'6""","149 lbs","-","-",60,81,7,13,2,3,9,3,7,5,7,9,8,12,14,5,13,12,7,7,9,10,12,8,12,12,12,8,5,11,11,11,8,1,12,12,9,2,9,10,11,11,11,12,6,8,6,2,10,12,14,1,1,1,2,1,2,1,3,1,2,1
"4767",15076555,"Nigel Dabinyaba","10/26/1992 (30 years old)","AM (RL), ST (C)","Lae City Dwellers","Papua New Guinean National Soccer League","PNG","No","12/31/2022","12/31/2024","$0 - $2K","Right","Reasonable","Very Strong","6'0""","196 lbs","24","5",72,80,6,7,10,9,9,7,8,9,8,3,8,7,3,11,5,9,11,10,9,10,12,11,10,11,7,11,7,11,13,10,9,9,10,12,9,10,11,16,11,12,11,11,9,15,11,6,13,12,12,2,3,4,3,2,3,4,3,1,3,1
"4768",15064475,"Nashir Hussainy","10/12/1998 (24 years old)","AM (RL)","Springvale White Eagles","Victorian State League 1 South-East","AFG","No","3/5/2023","9/30/2023","$0","Right","Reasonable","Very Strong","5'9""","147 lbs","48","18",74,85,6,13,11,11,12,4,7,9,2,7,11,7,7,10,15,10,7,8,8,5,4,13,11,9,7,8,9,7,13,11,5,9,15,11,14,4,13,16,10,11,13,9,13,12,7,6,10,11,15,1,1,3,2,2,3,2,3,2,2,1
"4769",88028475,"Basil Jofari","1/15/1994 (29 years old)","AM (C), ST (C)","Gulf Komara","Papua New Guinean National Soccer League","PNG","No","12/31/2021","12/31/2024","$0","Right","Reasonable","Very Strong","6'2""","174 lbs","-","-",59,79,5,6,5,7,9,5,4,7,5,5,6,3,6,11,10,8,5,9,6,12,14,11,11,5,3,6,3,7,13,11,6,8,11,13,12,6,12,13,13,13,11,12,11,8,8,8,10,8,20,3,3,2,2,1,2,3,1,1,3,2
"4770",88025910,"Emmanuel Simon","12/25/1992 (30 years old)","DM, M (C)","Lae City","Papua New Guinean National Soccer League","PNG","No","1/1/2020","12/31/2024","$0 - $4K","Right","Reasonable","Very Strong","5'7""","152 lbs","14","8",68,77,10,10,8,10,11,10,5,10,10,5,12,9,6,11,8,9,9,10,12,12,10,9,15,10,10,9,12,11,9,9,8,6,7,10,7,8,6,20,11,12,11,12,8,12,5,4,20,12,15,2,3,1,1,1,3,3,1,1,3,1
"4771",88025909,"Jacob Sabua","8/25/1994 (28 years old)","M/AM (C)","Lae City","Papua New Guinean National Soccer League","PNG","No","6/15/2020","12/31/2024","$1.5K - $4K","Right","Reasonable","Very Strong","5'11""","154 lbs","-","-",61,75,5,1,5,9,13,5,1,5,1,6,11,4,4,13,10,7,5,5,4,11,13,14,7,6,7,6,8,11,13,13,6,8,13,13,12,3,13,16,12,14,11,11,5,13,7,7,18,11,20,1,2,3,3,1,2,3,2,2,1,2
"4772",88021857,"Andrew Storer","1/14/1996 (27 years old)","D (C)","Cashmere Tech","New Zealand Southern League","PNG","No","12/31/2020","-","$0","Right Only","Weak","Very Strong","6'5""","233 lbs","46","3",71,75,3,3,4,3,5,1,13,5,5,11,6,1,13,6,15,9,14,8,8,6,4,2,12,9,11,9,5,10,7,7,6,13,11,7,11,14,11,17,10,11,10,12,6,12,9,1,12,10,12,2,4,3,1,3,3,3,2,2,3,2
"4773",88028978,"Gregory Togubai","3/22/1998 (25 years old)","DM, M (C)","POM Strikers","Papua New Guinean National Soccer League","PNG","No","12/31/2020","12/31/2024","$0 - $10K","Right","Weak","Very Strong","5'10""","147 lbs","-","-",61,75,5,5,7,6,8,5,3,8,1,2,10,2,5,9,13,8,5,8,7,7,3,5,7,6,6,7,9,9,13,13,7,3,13,13,11,7,9,11,14,12,12,12,13,13,10,5,14,8,8,3,3,3,3,2,1,2,1,3,3,3
"4774",147810,"Michael Foster","9/5/1985 (37 years old)","M (C)","POM Strikers","Papua New Guinean National Soccer League","PNG","No","12/31/2022","12/31/2024","$0","Right","Weak","Very Strong","5'10""","158 lbs","-","-",65,73,7,6,5,9,14,8,8,10,2,10,11,3,9,10,7,9,7,11,6,10,10,6,6,8,9,9,10,11,10,10,9,10,14,7,10,6,9,14,13,12,11,11,12,14,10,5,20,11,17,2,3,2,2,2,1,1,2,3,1,3
"4775",88024415,"Felix Komolong","3/6/1997 (26 years old)","D (C), DM","Lae City","Papua New Guinean National Soccer League","PNG","Yes","1/1/2020","12/31/2024","$0 - $2K","Right Only","Weak","Very Strong","6'1""","178 lbs","16","-",71,73,5,8,5,5,8,7,10,5,9,10,9,4,9,7,10,7,11,10,8,8,16,7,9,6,10,9,9,9,11,10,13,10,12,12,12,12,7,18,12,13,9,10,7,8,6,8,11,12,12,1,3,2,1,3,3,1,2,1,2,2
"4776",2000031115,"Sylvester Wanim","5/5/2000 (23 years old)","DM","POM Strikers","Papua New Guinean National Soccer League","PNG","No","12/31/2020","12/31/2025","$0","Right","Reasonable","Very Strong","5'10""","152 lbs","-","-",51,70,2,4,2,5,10,4,1,6,2,10,7,5,12,8,5,10,7,6,7,7,4,5,13,5,10,6,7,11,13,13,6,6,13,12,7,4,14,20,8,9,13,12,12,4,10,7,10,9,8,4,4,1,2,2,4,1,1,2,2,3
"4777",88028469,"Yagi Yasasa","8/17/2000 (22 years old)","M/AM (C)","Hekari Utd","Papua New Guinean National Soccer League","PNG","No","9/13/2021","12/31/2025","$0","Right","Reasonable","Very Strong","5'3""","127 lbs","-","-",64,70,11,5,9,6,10,7,2,3,8,2,11,5,2,10,7,10,7,9,11,12,14,11,15,11,9,9,12,13,9,9,4,4,5,8,8,3,8,10,13,12,12,12,10,12,7,7,7,11,14,4,3,1,1,1,2,2,1,1,1,2
"4778",2000012292,"Riggie Togubai","4/5/2000 (23 years old)","ST (C)","Gulf Komara","Papua New Guinean National Soccer League","PNG","No","12/31/2020","12/31/2025","$0","Right","Reasonable","Very Strong","6'2""","169 lbs","-","-",58,70,5,1,13,13,10,5,6,4,4,5,7,9,1,8,13,9,6,9,6,11,12,8,11,13,6,5,5,7,13,9,6,12,12,10,4,5,12,13,12,10,13,11,8,12,8,1,7,9,14,1,2,2,2,3,3,2,2,2,4,1
"4779",2000066105,"Kanischka Taher","4/4/1991 (32 years old)","DM, M/AM (C)","Arnoldsweiler","German Lower Division","AFG","Yes","7/1/2021","6/30/2023","$0","Left Only","Very Strong","Weak","6'0""","165 lbs","298","37",81,85,7,8,7,11,14,6,8,8,4,8,14,4,11,10,15,11,9,10,8,15,8,13,11,9,11,9,7,13,8,9,9,12,15,9,14,6,13,20,12,10,10,10,6,11,13,1,15,10,8,1,2,1,2,2,3,2,2,3,3,3
"4780",88028499,"Ati Kepo","1/15/1996 (27 years old)","ST (C)","Hekari Utd","Papua New Guinean National Soccer League","PNG","No","1/1/2020","12/31/2024","$0","Right","Fairly Strong","Very Strong","6'0""","174 lbs","-","-",64,70,5,5,9,13,6,5,7,5,1,5,6,8,1,10,5,8,4,11,4,6,13,10,11,11,6,5,4,7,13,13,6,7,13,13,12,7,7,10,10,13,11,12,11,5,7,5,8,10,9,3,2,2,1,3,3,3,2,3,1,2
"4781",2000247705,"Pala Paul","7/25/1999 (23 years old)","AM (LC)","POM Strikers","Papua New Guinean National Soccer League","PNG","No","12/31/2022","12/31/2025","$0","Left","Very Strong","Reasonable","6'5""","182 lbs","-","-",58,69,4,5,9,6,8,4,4,5,5,2,8,3,6,9,6,6,7,5,5,9,18,9,11,9,6,7,6,11,13,9,4,13,8,12,6,6,10,13,12,9,11,11,9,11,10,2,19,12,17,3,4,4,3,1,1,4,3,2,1,2
"4782",88028981,"Freeman Giwi","7/7/2000 (22 years old)","D (C)","Madang FC","Papua New Guinean National Soccer League","PNG","No","6/15/2020","12/31/2025","$0","Right","Fairly Strong","Very Strong","6'0""","154 lbs","-","-",60,69,1,1,1,2,6,1,9,4,2,9,6,1,8,5,10,13,8,6,4,13,18,5,9,3,13,5,3,6,9,13,6,7,18,10,5,8,10,17,10,11,11,9,5,1,10,7,10,11,16,1,1,1,1,3,1,3,1,1,2,1
"4783",2000012759,"Godfrey Haro","6/30/1998 (24 years old)","D (L)","Hekari Utd","Papua New Guinean National Soccer League","PNG","No","1/1/2022","12/31/2025","$0","Left","Very Strong","Fairly Strong","5'9""","143 lbs","-","-",62,68,4,4,6,4,8,2,3,5,5,7,6,2,9,7,7,7,7,7,12,11,16,5,7,5,7,7,6,7,13,13,7,4,17,13,8,3,7,14,9,11,13,12,9,8,6,3,7,10,15,1,1,3,2,2,3,1,3,3,1,3
"4784",88025913,"Philip Steven","1/19/1995 (28 years old)","D (LC)","Lae City","Papua New Guinean National Soccer League","PNG","No","7/1/2022","12/31/2024","$0","Left","Very Strong","Reasonable","6'1""","169 lbs","-","-",62,68,5,9,6,2,7,3,8,1,4,7,8,4,13,6,15,8,8,7,8,13,12,5,4,5,7,7,4,8,10,13,7,14,12,13,13,6,11,16,10,10,10,11,6,9,9,4,11,13,11,3,3,2,2,2,2,3,4,1,3,3
"4785",88028537,"Eliud Fugre","3/15/1989 (34 years old)","AM (C)","Lae City","Papua New Guinean National Soccer League","PNG","No","9/14/2021","12/31/2024","$0","Left","Very Strong","Strong","5'11""","167 lbs","-","-",60,68,10,10,7,8,8,10,6,4,1,6,10,4,5,10,5,8,7,9,5,11,13,8,15,10,7,7,8,8,9,8,7,8,6,9,9,6,7,12,12,10,12,9,11,12,7,1,10,10,9,1,1,2,2,1,1,1,2,1,2,2
"4786",88028504,"Ishmael Pole","1/25/1993 (30 years old)","GK","Lae City Dwellers","Papua New Guinean National Soccer League","PNG","No","12/31/2022","12/31/2024","$0","Right","Fairly Strong","Very Strong","5'9""","154 lbs","-","-",64,68,2,1,3,3,1,6,1,1,3,3,8,1,3,1,9,9,10,7,8,14,6,1,6,1,9,7,6,6,12,10,7,5,14,8,5,5,11,12,12,12,10,11,7,13,7,5,15,12,14,8,11,14,5,7,7,9,5,8,8,8
"4787",2000271935,"Santo Manu","7/25/2002 (20 years old)","ST (C)","Gulf Komara","Papua New Guinean National Soccer League","PNG","No","6/13/2022","12/31/2025","$0","Left","Very Strong","Reasonable","5'9""","149 lbs","-","-",52,67,4,4,11,11,11,4,9,4,3,4,4,6,1,6,9,6,3,12,4,7,14,7,9,12,1,4,3,5,12,12,1,3,10,12,3,5,11,13,11,9,10,11,13,15,8,4,20,13,10,2,3,1,3,2,2,1,1,1,3,1
"4788",88029604,"Giwi Simon","7/3/1997 (25 years old)","AM (RC), ST (C)","Morobe Wawens","Papua New Guinean National Soccer League","PNG","No","12/31/2020","12/31/2024","$0","Right","Reasonable","Very Strong","5'9""","145 lbs","-","-",50,67,4,6,9,4,11,4,6,3,2,3,7,1,2,6,5,4,6,5,5,10,4,12,5,8,5,5,2,6,11,12,2,3,14,12,11,3,9,13,10,11,12,12,13,9,14,2,10,11,11,4,2,3,2,3,3,1,1,2,2,1
"4789",88029579,"Solomon Rani","5/22/2002 (21 years old)","M/AM (C)","Hekari Utd","Papua New Guinean National Soccer League","PNG","No","1/1/2020","12/31/2025","$0","Right","Strong","Very Strong","5'4""","130 lbs","-","-",58,66,5,4,7,6,7,4,5,3,2,6,12,3,6,8,6,8,4,7,5,13,15,8,2,8,2,7,13,12,8,10,6,1,13,7,12,1,14,14,8,11,9,11,12,2,10,3,10,10,15,2,3,3,2,4,3,2,3,3,3,3
"4790",92019104,"Abassin Alikhil","4/19/1991 (32 years old)","D/WB (R), DM, M (RC)","Eintracht Frankfurt","Bundesliga","AFG","Yes","7/1/2022","6/30/2024","$0","Right","Reasonable","Very Strong","5'10""","145 lbs","308","19",79,85,6,11,7,5,7,6,5,7,11,12,11,7,11,9,13,9,12,10,9,8,9,12,9,10,7,11,12,9,12,13,8,9,11,12,11,9,9,10,9,10,11,15,12,7,11,11,8,13,12,3,3,2,4,3,1,3,3,3,3,3
"4791",88028525,"Mathew David","8/17/1994 (28 years old)","AM (R), ST (C)","POM Strikers","Papua New Guinean National Soccer League","PNG","No","7/1/2022","12/31/2024","$0","Right","Reasonable","Very Strong","5'7""","141 lbs","-","-",60,66,5,9,7,9,7,5,5,5,1,3,7,5,1,8,13,9,7,9,9,8,18,12,13,10,6,8,9,7,11,12,4,4,6,12,7,4,9,13,13,11,10,12,12,7,13,7,9,10,9,3,3,2,1,3,1,2,1,3,2,3
"4792",88029646,"Russel Chris","8/10/1998 (24 years old)","GK","Hekari Utd","Papua New Guinean National Soccer League","PNG","No","9/17/2021","12/31/2025","$0","Right","Reasonable","Very Strong","6'2""","174 lbs","-","-",60,66,2,1,1,2,3,4,1,2,3,2,9,2,1,3,11,9,9,7,9,7,15,1,3,1,10,7,6,6,14,11,7,9,14,10,2,7,8,13,11,11,9,12,12,1,7,3,20,11,9,6,9,10,8,10,10,8,5,9,9,9
"4793",88025908,"Obert Bika","5/11/1993 (30 years old)","AM (RC)","Lae City","Papua New Guinean National Soccer League","PNG","No","6/14/2021","12/31/2024","$0","Right","Reasonable","Very Strong","5'11""","149 lbs","-","-",60,66,5,6,6,5,10,5,5,3,5,3,7,2,7,9,12,7,3,7,6,9,6,9,6,12,6,6,9,11,13,13,6,9,16,13,11,3,14,15,11,11,13,14,10,6,10,6,11,11,13,1,1,2,3,3,2,1,1,1,2,3
"4794",88028529,"Peter Dabinyaba Jr","3/28/1997 (26 years old)","D (R)","Hekari Utd","Papua New Guinean National Soccer League","PNG","No","1/1/2021","12/31/2024","$0","Right","Reasonable","Very Strong","5'11""","158 lbs","-","-",59,66,5,9,1,1,8,1,7,4,5,8,7,1,8,5,10,8,6,7,7,9,7,5,13,6,6,7,4,7,14,14,7,7,12,14,12,6,11,10,13,9,10,10,14,6,14,5,9,10,17,3,2,4,1,2,2,2,4,3,2,3
"4795",88029650,"Bernard Purari","5/10/1997 (26 years old)","AM (R), ST (C)","Morobe Wawens","Papua New Guinean National Soccer League","PNG","No","12/31/2020","12/31/2024","$0","Right","Reasonable","Very Strong","5'9""","145 lbs","-","-",54,65,3,6,8,9,9,5,6,3,1,5,9,3,1,5,5,8,4,10,5,10,15,5,13,10,5,5,4,7,13,13,6,6,15,13,12,5,9,13,10,11,11,12,11,9,11,3,17,10,12,3,1,2,2,2,3,2,2,1,3,2
"4796",29162733,"Patrick Aisa","7/6/1994 (28 years old)","AM (R), ST (C)","Gulf Komara","Papua New Guinean National Soccer League","PNG","No","7/1/2021","12/31/2024","$1.5K - $4K","Right Only","Weak","Very Strong","5'10""","154 lbs","8","-",61,65,6,6,10,7,10,7,4,7,8,2,6,7,3,10,7,11,8,7,9,6,10,10,12,16,6,8,7,10,12,13,11,5,11,12,11,5,10,12,10,9,11,10,14,9,13,3,15,10,8,1,2,1,2,2,3,2,2,4,1,2
"4797",88028983,"Jason Wadunah","1/25/2003 (20 years old)","AM (C)","Madang FC","Papua New Guinean National Soccer League","PNG","No","6/13/2022","12/31/2025","$0","Left","Very Strong","Fairly Strong","5'10""","145 lbs","-","-",59,65,5,6,6,9,8,5,5,5,1,4,8,5,4,9,6,3,3,6,6,8,7,13,10,7,2,7,8,10,13,13,6,6,5,13,5,3,16,18,13,12,10,8,12,9,12,6,8,10,17,1,4,1,1,1,1,1,3,2,1,1
"4798",88029620,"Rupa Emil","6/5/1997 (26 years old)","AM (LC)","Gulf Komara","Papua New Guinean National Soccer League","PNG","No","1/1/2020","12/31/2024","$0","Left","Very Strong","Weak","5'9""","149 lbs","-","-",58,65,1,5,6,8,7,4,4,4,4,5,7,2,4,9,6,9,2,7,5,11,6,9,7,11,6,6,5,7,13,13,6,7,11,13,12,6,19,20,13,13,11,11,13,4,8,3,10,10,20,2,2,2,1,3,1,2,2,3,2,2
"4799",88028478,"Eaka Philemon","10/8/1998 (24 years old)","M/AM (R)","POM Strikers","Papua New Guinean National Soccer League","PNG","No","12/31/2021","12/31/2025","$0","Right","Reasonable","Very Strong","5'10""","154 lbs","-","-",56,65,6,11,9,5,11,4,5,5,4,4,7,5,2,8,5,6,3,9,5,8,4,9,6,8,2,5,3,6,12,12,6,7,9,12,9,2,10,12,8,10,10,11,5,12,12,5,6,11,10,3,1,3,1,2,2,1,2,1,2,3
"4800",2000031108,"Randall Passam","4/26/2000 (23 years old)","AM (RL)","POM Strikers","Papua New Guinean National Soccer League","PNG","No","12/31/2020","12/31/2025","$0","Left","Very Strong","Weak","5'4""","123 lbs","-","-",52,65,6,8,10,9,11,4,6,7,1,3,10,3,4,6,6,6,7,6,7,8,4,6,12,9,6,8,6,12,13,11,4,1,11,10,8,1,11,11,9,11,9,8,13,10,8,2,9,15,7,3,2,3,2,2,2,1,3,3,3,3
"4801",18115039,"Farokh Obaidi","1/14/2003 (20 years old)","DM, M (RLC), AM (R)","Lierse K","Belgian Challenger Pro League","AFG","Yes","7/1/2020","6/30/2024","$4K - $40K","Left Only","Very Strong","Weak","5'9""","143 lbs","-","-",75,85,7,6,8,9,9,7,7,5,2,8,14,5,12,12,15,9,3,8,8,14,3,11,2,7,9,12,10,11,12,9,5,8,13,12,9,5,13,19,9,11,15,8,11,15,7,5,10,11,19,3,1,2,2,2,2,3,3,3,3,3
"4802",2000013838,"Winston Somasi","3/10/1997 (26 years old)","AM (L)","Morobe Wawens","Papua New Guinean National Soccer League","PNG","No","1/1/2020","12/31/2024","$0","Left","Very Strong","Reasonable","5'7""","132 lbs","-","-",54,65,5,8,4,6,7,5,1,6,5,5,11,5,1,8,9,7,7,7,6,7,4,8,9,8,5,6,5,4,13,13,6,4,15,13,9,1,12,10,14,11,11,11,11,11,11,1,9,13,8,3,3,1,1,2,2,2,1,3,2,3
"4803",88028511,"Moses Joe","7/21/2002 (20 years old)","D (C)","Hekari Utd","Papua New Guinean National Soccer League","PNG","No","1/1/2020","12/31/2025","$0","Right","Reasonable","Very Strong","6'0""","158 lbs","-","-",55,65,1,4,2,1,5,1,11,1,1,13,6,3,12,4,10,6,8,5,8,13,4,5,10,5,13,5,5,6,10,9,6,6,12,9,8,3,14,10,12,13,8,11,7,3,11,2,9,11,16,1,3,2,3,3,3,2,1,3,2,3
"4804",88029649,"Ilai Ilarova","2/20/1994 (29 years old)","GK","POM Strikers","Papua New Guinean National Soccer League","PNG","No","12/31/2021","12/31/2024","$0","Right","Reasonable","Very Strong","6'5""","178 lbs","-","-",54,65,3,3,1,3,1,6,1,3,1,1,6,3,3,3,15,12,8,6,9,9,14,2,5,3,12,6,5,5,10,10,6,14,18,12,5,5,9,10,12,10,10,11,13,2,7,2,11,13,16,3,13,5,5,8,9,13,5,7,8,13
"4805",88028482,"Gabby Yanum","2/5/1997 (26 years old)","D (LC)","Lae City","Papua New Guinean National Soccer League","PNG","No","1/1/2022","12/31/2024","$0","Left","Very Strong","Reasonable","6'0""","163 lbs","-","-",55,65,3,8,5,3,6,5,4,2,5,7,7,1,12,7,10,8,7,5,4,13,14,5,14,5,9,6,3,7,13,13,6,6,11,13,7,5,14,17,11,11,10,10,8,6,11,1,11,13,20,2,3,2,1,3,2,1,3,3,2,1
"4806",88028534,"Alex Kamen","8/26/1993 (29 years old)","AM (L), ST (C)","Lae City","Papua New Guinean National Soccer League","PNG","No","12/31/2020","12/31/2024","$0","Left","Very Strong","Reasonable","6'0""","165 lbs","-","-",58,65,3,8,13,10,7,3,10,5,5,4,8,3,1,5,5,7,3,10,6,11,7,5,9,9,4,5,7,7,13,10,6,9,10,11,12,5,10,14,10,14,13,10,5,10,8,4,15,11,17,2,1,3,3,2,2,1,4,1,1,2
"4807",29162724,"Koriak Upaiga","6/13/1987 (35 years old)","D/WB (L), ST (C)","United Highlands FC","-","PNG","No","6/14/2021","12/31/2023","$0","Left Only","Very Strong","Weak","5'8""","160 lbs","-","-",58,65,4,9,5,9,11,6,8,4,6,7,8,2,8,6,5,8,12,8,8,14,15,5,5,7,5,11,5,12,10,9,4,4,15,8,9,5,9,20,10,12,8,11,5,13,15,5,8,8,17,3,2,2,3,2,3,3,1,2,3,1
"4808",88029645,"Kenneth Arah","10/23/1990 (32 years old)","AM (C)","Gulf Komara","Papua New Guinean National Soccer League","PNG","No","1/1/2020","12/31/2024","Not for Sale","Right","Reasonable","Very Strong","5'10""","156 lbs","-","-",54,65,5,2,3,8,10,6,4,7,3,7,11,5,7,13,8,9,7,8,4,13,5,12,13,9,8,7,14,12,7,9,6,9,7,8,11,4,16,20,11,11,9,9,5,9,5,8,12,10,14,2,2,3,4,1,1,3,1,1,1,2
"4809",88028508,"Joseph Joe","6/14/2000 (22 years old)","AM (L), ST (C)","Hekari Utd","Papua New Guinean National Soccer League","PNG","No","1/1/2020","12/31/2025","$0","Left","Very Strong","Reasonable","5'10""","152 lbs","-","-",57,64,5,10,5,11,12,5,4,1,5,5,6,2,5,9,7,3,4,11,6,7,15,9,9,6,5,6,5,7,13,13,6,4,11,13,10,5,10,20,11,11,12,13,8,8,11,6,15,12,11,2,1,1,2,2,1,2,2,3,1,3
"4810",88028541,"Joshua Oscar","10/3/1990 (32 years old)","D/WB/M/AM (L)","Lae City","Papua New Guinean National Soccer League","PNG","No","1/1/2020","12/31/2024","$0","Left","Very Strong","Reasonable","6'0""","163 lbs","-","-",54,63,6,11,4,8,7,6,6,4,6,7,6,5,8,5,12,10,7,8,8,9,17,6,5,13,8,7,8,8,8,9,7,10,12,7,12,4,13,18,11,12,12,10,11,1,6,1,14,11,13,2,3,1,2,2,3,2,1,2,1,1
"4811",88029569,"Vanya Malagian","10/10/1991 (31 years old)","ST (C)","Madang FC","Papua New Guinean National Soccer League","PNG","No","6/14/2021","12/31/2024","$0","Right","Reasonable","Very Strong","6'0""","154 lbs","-","-",50,62,5,4,8,13,13,5,13,4,1,5,6,7,1,10,12,8,4,10,5,8,11,10,8,12,6,5,3,6,7,6,6,10,11,6,3,7,9,15,13,11,13,11,6,7,14,5,12,10,7,2,2,4,4,2,4,3,3,1,2,3
"4812",37065878,"Najim Haidary","12/26/1999 (23 years old)","D (LC), WB (L)","Ariana FC","Swedish First Division South","AFG","Yes","2/1/2023","12/31/2023","$0","Left Only","Very Strong","Weak","6'1""","169 lbs","25","-",71,85,8,10,9,6,9,8,6,7,7,8,9,8,10,10,11,9,10,9,10,10,11,9,8,9,9,9,10,9,11,11,8,11,12,12,11,8,12,10,10,10,10,10,5,1,8,5,11,11,12,3,2,1,1,1,2,1,2,4,3,2
"4813",88025967,"Stahl Gubag","7/17/1999 (23 years old)","AM (L)","Lae City","Papua New Guinean National Soccer League","PNG","No","7/25/2020","12/31/2025","$0","Left","Very Strong","Reasonable","5'6""","138 lbs","5","1",55,62,5,9,9,8,9,7,7,6,7,5,8,4,9,9,7,9,5,11,10,5,10,6,5,10,8,9,9,8,10,10,8,6,8,12,8,6,7,19,9,10,14,11,5,10,9,4,10,12,15,1,3,3,2,2,1,2,3,3,1,3
"4814",88025911,"Clement Willis","1/21/1993 (30 years old)","D/WB (L)","POM Strikers","Papua New Guinean National Soccer League","PNG","No","6/1/2023","12/31/2024","$0","Left Only","Very Strong","Weak","5'10""","158 lbs","-","-",54,62,4,8,6,1,8,2,7,3,6,8,7,1,8,6,14,8,8,5,6,7,6,7,10,6,10,7,7,7,14,14,7,9,13,14,12,7,11,14,11,9,8,10,5,5,7,6,9,10,9,1,4,2,2,2,3,3,3,2,1,2
"4815",88028510,"Kolu Kepo","6/15/1993 (29 years old)","AM (R), ST (C)","Hekari Utd","Papua New Guinean National Soccer League","PNG","No","1/1/2020","12/31/2024","$0","Right","Reasonable","Very Strong","5'10""","169 lbs","-","-",60,62,7,10,7,6,7,9,10,9,6,8,8,7,5,4,7,11,8,4,3,3,2,13,6,11,9,9,7,11,13,12,10,7,13,13,10,10,9,19,9,10,10,12,7,8,13,8,11,8,19,3,1,3,1,1,2,3,2,1,2,1
"4816",15024964,"Brian Kaltak","9/30/1993 (29 years old)","D (C)","CC Mariners","Isuzu UTE A-League","VAN","No","1/11/2023","6/30/2025","$100K - $1M","Right Only","Weak","Very Strong","5'11""","185 lbs","108","11",102,114,4,7,9,8,11,10,15,8,11,10,10,9,12,11,13,10,17,11,8,9,18,9,13,6,11,14,10,16,13,11,10,12,13,14,12,15,12,9,11,16,10,9,11,8,5,2,12,12,17,2,2,3,2,3,2,1,2,3,1,1
"4817",15020330,"Mitch Cooper","9/18/1994 (28 years old)","M/AM (C)","Hume City","National Premier Leagues - Victoria","VAN","No","2/14/2021","6/30/2024","$0 - $85K","Right Only","Weak","Very Strong","5'5""","138 lbs","167","38",83,98,5,9,12,5,13,8,7,3,1,8,12,6,7,12,6,9,7,12,10,11,11,13,11,12,7,11,12,12,12,11,9,5,8,12,12,6,9,11,11,11,11,10,18,11,6,14,13,12,12,3,3,1,1,3,2,1,3,1,3,2
"4818",15086041,"Jared Clark","1/21/1998 (25 years old)","D (C), DM, M (C)","FK Beograd","National Premier Leagues - South Australia","VAN","No","11/6/2022","9/30/2023","$0","Right","Weak","Very Strong","6'4""","189 lbs","81","2",68,86,5,6,1,7,7,7,8,6,4,9,9,5,12,4,15,9,8,10,9,9,12,5,11,8,9,8,6,9,6,7,8,17,7,9,9,9,9,13,13,14,12,13,12,1,14,2,8,12,18,2,4,3,3,1,1,2,3,2,2,3
"4819",30052494,"John Alick","4/25/1991 (32 years old)","DM, M (C)","Solomon Warriors","Solomon Islands S-League","VAN","No","6/14/2021","12/31/2024","Not for Sale","Right Only","Weak","Very Strong","6'0""","176 lbs","78","10",69,86,7,7,6,6,10,3,2,4,6,12,11,3,12,10,7,11,11,9,10,11,12,5,12,9,11,8,10,11,9,9,12,11,12,9,10,12,9,10,10,13,12,9,10,15,7,1,10,13,20,1,3,1,1,1,2,3,1,1,3,3
"4820",88003826,"Seule Soromon","8/14/1984 (38 years old)","M/AM (R), ST (C)","Douglas Villa","New Zealand Capital Division Two","VAN","No","6/14/2021","-","$0","Left Only","Very Strong","Weak","5'9""","154 lbs","62","31",56,81,8,12,8,10,11,8,9,8,6,5,11,10,3,11,5,8,2,9,8,12,4,10,6,12,8,8,9,9,8,10,7,8,8,8,6,9,10,15,10,12,10,10,13,5,5,1,7,12,14,1,3,3,3,1,1,3,2,2,3,3
"4821",30053153,"John Well Wohale","7/9/1997 (25 years old)","M/AM (C)","Ifira BB","Vanuatuan Port Vila Premier Division","VAN","No","7/1/2021","6/30/2025","$0","Right","Reasonable","Very Strong","6'1""","163 lbs","-","-",64,80,4,5,6,6,7,2,5,8,3,5,6,5,5,7,6,9,7,7,7,13,3,7,3,7,6,7,7,10,13,13,6,7,12,13,8,3,14,19,12,10,11,9,10,7,10,5,13,12,10,2,3,2,3,3,2,1,3,1,1,1
"4822",88023474,"Kensi Tangis","1/20/1990 (33 years old)","ST (C)","ABM Galaxy","Vanuatuan Port Vila Premier Division","VAN","No","1/2/2020","6/30/2024","$0","Right","Reasonable","Very Strong","6'1""","180 lbs","13","23",70,79,8,6,8,13,12,8,12,7,5,7,9,12,1,10,8,9,7,11,9,9,5,8,10,10,9,9,9,9,9,8,9,9,10,9,9,11,11,16,11,13,10,11,10,15,8,8,10,10,18,4,3,1,1,3,1,1,2,3,3,2
"4823",93077865,"Saber Azizi","1/13/1996 (27 years old)","D (R), DM, M (C)","Ariana FC","Swedish First Division South","AFG","Yes","1/2/2022","11/30/2023","$0","Right","Weak","Very Strong","5'8""","145 lbs","163","28",63,85,7,8,8,8,10,7,7,9,6,7,9,8,8,10,12,7,8,7,8,8,8,7,7,9,8,8,9,8,12,11,8,7,14,12,11,8,9,10,10,10,12,10,5,7,8,5,9,8,7,2,1,1,2,2,2,2,1,2,1,4
"4824",88024855,"Bong Kalo","1/18/1997 (26 years old)","M/AM (C)","ABM Galaxy","Vanuatuan Port Vila Premier Division","VAN","No","6/12/2023","6/30/2025","$0 - $1.5K","Right","Reasonable","Very Strong","5'7""","147 lbs","8","1",71,75,10,10,12,9,10,12,3,6,6,3,11,12,3,12,8,10,4,11,10,11,6,7,8,13,6,12,12,11,11,10,8,5,6,11,10,6,9,18,13,14,10,11,10,10,4,8,12,11,11,1,1,3,1,2,3,3,2,1,2,2
"4825",88027978,"Jacky Ruben","11/10/1996 (26 years old)","M (C)","North Efate Utd","Vanuatuan Port Vila Premier Division","VAN","No","6/1/2021","6/30/2024","$0","Right","Reasonable","Very Strong","5'11""","156 lbs","-","-",63,75,2,5,6,8,7,4,5,8,9,5,10,4,6,11,5,11,3,10,9,6,10,5,8,10,6,8,9,8,14,10,8,7,12,13,12,6,18,10,11,10,10,13,13,8,7,4,10,12,15,1,2,3,4,2,2,1,3,1,3,2
"4826",30052352,"Tony Kaltack","3/4/1996 (27 years old)","ST (C)","Yatel","Vanuatuan Port Vila Premier Division","VAN","No","1/2/2022","6/30/2025","$0","Right","Reasonable","Very Strong","5'9""","163 lbs","14","19",69,75,1,2,5,13,10,5,12,6,1,6,8,3,1,6,7,13,2,13,10,11,8,13,10,13,7,6,7,7,10,9,12,9,13,9,9,12,9,11,12,8,10,12,5,8,12,2,10,10,13,2,4,2,2,3,3,2,1,1,2,3
"4827",88027874,"Micah Tommy","1/21/1999 (24 years old)","AM (R), ST (C)","Launceston City","National Premier Leagues - Tasmania","VAN","No","6/18/2022","6/30/2024","$0 - $6K","Right","Reasonable","Very Strong","6'1""","167 lbs","4","2",65,75,5,8,9,12,11,3,9,9,3,5,4,6,1,7,13,8,6,9,7,8,9,7,9,11,5,2,5,7,13,13,7,9,10,13,6,5,9,16,12,10,11,12,8,3,13,7,12,10,12,3,1,3,1,3,1,2,3,2,2,3
"4828",88026056,"Selwyn Vatu","6/13/1998 (24 years old)","D (LC)","ABM Galaxy","Vanuatuan Port Vila Premier Division","VAN","No","1/2/2020","6/30/2025","$0","Left","Very Strong","Reasonable","5'8""","149 lbs","-","-",64,75,4,7,7,6,9,3,7,7,7,10,10,4,10,8,10,10,9,7,10,15,12,5,14,5,10,10,3,10,10,10,8,3,11,11,7,7,8,14,13,8,10,10,7,10,13,2,9,11,8,3,2,2,3,1,1,3,2,2,3,2
"4829",30053161,"Claude Aru","4/25/1997 (26 years old)","DM, M (C)","North Efate Utd","Vanuatuan Port Vila Premier Division","VAN","No","1/2/2023","6/30/2024","$0","Right","Reasonable","Very Strong","5'9""","158 lbs","1","1",66,74,3,3,8,7,10,3,8,3,10,9,12,8,9,11,6,10,12,10,10,11,5,5,12,10,10,12,10,10,11,10,9,6,10,11,10,10,10,11,13,11,12,11,11,8,13,7,8,13,18,1,1,2,2,3,2,3,2,1,2,1
"4830",88026055,"Jason Thomas","1/20/1997 (26 years old)","D (C)","Erakor GS","Vanuatuan Port Vila Premier Division","VAN","No","1/2/2023","6/30/2025","$0","Right Only","Weak","Very Strong","6'1""","178 lbs","6","1",63,73,3,4,5,5,9,4,11,5,11,9,9,5,11,9,10,9,11,9,10,9,6,5,11,9,9,10,9,10,8,7,12,11,12,7,9,10,8,16,10,9,11,11,6,9,4,6,7,9,17,1,2,2,3,1,3,3,1,2,1,1
"4831",30053131,"Alex Saniel","11/8/1996 (26 years old)","AM (R), ST (C)","Suva","Fijian Premier League","VAN","No","6/1/2023","12/31/2024","$0","Right","Reasonable","Very Strong","6'1""","163 lbs","49","27",62,73,4,7,11,9,7,4,5,5,1,2,7,5,1,9,10,8,6,5,5,10,13,10,6,7,3,5,6,7,12,12,5,11,14,12,12,4,8,18,10,13,10,10,14,2,8,1,9,13,7,1,2,3,3,1,1,1,3,1,1,1
"4832",30054847,"Armando Ravo","12/12/2002 (20 years old)","M/AM (R)","Malampa","Luganville Premier Division","VAN","No","7/1/2019","6/30/2024","$0","Right","Reasonable","Very Strong","6'1""","158 lbs","-","-",57,72,4,9,6,10,13,3,3,7,2,5,5,2,4,11,8,9,4,5,6,7,13,11,10,9,5,6,9,10,10,9,6,7,15,13,5,3,13,14,12,9,11,11,14,4,5,5,14,12,8,2,3,3,2,1,2,1,1,1,3,4
"4833",2000036631,"Nicholas King","4/14/2004 (19 years old)","D (C)","Mauriki","Vanuatuan Port Vila First Division","VAN","No","7/1/2019","6/30/2024","$0","Right","Weak","Very Strong","6'4""","178 lbs","-","-",56,72,4,1,3,1,5,1,10,1,2,13,6,1,12,1,5,6,8,6,4,13,13,5,12,4,12,5,1,6,7,9,6,14,15,9,4,7,9,15,10,9,11,14,5,13,10,1,8,10,10,2,4,1,2,2,1,2,3,2,2,2
"4834",2000225740,"Milad Amirzade","1/1/2006 (17 years old)","M (C)","Lugano","Swiss Super League","AFG","No","7/1/2021","6/30/2025","$22K - $230K","Right","Reasonable","Very Strong","5'9""","145 lbs","-","-",68,109,5,3,1,5,11,6,5,6,5,8,13,4,9,10,8,7,7,7,4,9,4,5,6,5,4,7,13,11,13,13,6,4,9,14,7,6,14,10,11,9,9,11,7,11,6,2,12,11,18,2,3,2,1,3,2,3,3,2,3,4
"4835",2000309174,"Abdul Khalil Salari","5/8/2007 (16 years old)","ST (C)","Sion","Swiss Challenge League","AFG","No","7/1/2022","6/30/2026","$0 - $90K","Right","Reasonable","Very Strong","5'9""","136 lbs","-","-",52,85,4,1,8,12,12,4,8,5,4,2,5,3,1,9,12,6,4,7,5,10,4,10,8,12,5,4,5,5,12,10,5,4,16,11,7,5,9,11,10,10,13,11,9,12,12,1,14,11,9,3,1,1,1,1,3,4,1,4,3,1
"4836",30053230,"Godine Tenene","5/3/1998 (25 years old)","M (R), AM (RC)","Ifira BB","Vanuatuan Port Vila Premier Division","VAN","No","1/2/2020","6/30/2025","$0","Right","Reasonable","Very Strong","5'5""","130 lbs","-","-",66,71,5,10,7,9,7,5,1,5,5,5,6,5,5,8,5,8,7,5,7,7,12,10,10,8,6,7,6,7,13,13,7,1,6,13,9,1,16,13,12,14,11,10,13,10,8,5,8,11,7,3,3,3,3,3,1,2,3,3,1,3
"4837",2000036518,"Alphonse Lency","3/21/1996 (27 years old)","D (C)","Ifira BB","Vanuatuan Port Vila Premier Division","VAN","No","7/1/2018","6/30/2025","$0","Right","Reasonable","Very Strong","5'11""","160 lbs","-","-",60,70,3,1,1,2,6,1,6,5,4,7,2,1,13,5,11,11,8,6,6,13,12,5,7,3,9,5,1,6,13,13,6,6,12,13,9,8,12,15,12,13,11,11,9,5,15,3,18,10,10,2,3,1,3,3,4,2,3,3,1,2
"4838",2000036526,"Frank Ruben","10/7/1996 (26 years old)","M (C)","Ifira BB","Vanuatuan Port Vila Premier Division","VAN","No","6/1/2022","6/30/2025","$0","Right","Reasonable","Very Strong","6'1""","165 lbs","-","-",58,70,4,1,3,6,9,5,1,5,1,7,7,3,7,10,15,4,2,6,7,10,5,5,9,7,4,7,11,11,13,13,6,7,13,13,13,5,7,17,12,9,10,13,13,9,5,7,17,12,10,2,1,2,2,3,2,3,2,2,2,1
"4839",2000036583,"Kenry Arsen","4/9/2002 (21 years old)","ST (C)","Erakor GS","Vanuatuan Port Vila Premier Division","VAN","No","7/1/2019","6/30/2025","$0","Right","Reasonable","Very Strong","5'5""","125 lbs","-","-",50,70,2,1,7,13,4,4,13,6,1,4,6,4,4,9,13,13,6,8,6,13,1,9,12,7,5,5,6,6,13,13,6,1,18,13,8,1,11,15,14,10,8,13,9,7,7,8,18,10,7,1,1,3,2,1,2,2,1,2,1,3
"4840",30052510,"Barry Mansale","11/1/1995 (27 years old)","DM, M (C)","Yatel","Vanuatuan Port Vila Premier Division","VAN","No","7/1/2021","6/30/2024","$0","Right","Reasonable","Very Strong","6'3""","176 lbs","-","-",64,70,5,1,3,6,9,5,6,5,4,6,11,1,10,9,12,10,7,6,6,13,9,6,1,6,12,7,9,11,13,12,6,13,12,12,6,6,11,12,12,9,12,11,6,12,11,6,12,14,11,4,3,1,1,1,2,3,2,1,2,2
"4841",2000036591,"Anthony Peli","11/11/1999 (23 years old)","ST (C)","ABM Galaxy","Vanuatuan Port Vila Premier Division","VAN","No","6/1/2022","6/30/2025","$0","Right","Reasonable","Very Strong","5'10""","156 lbs","-","-",50,70,5,6,8,10,13,5,6,6,2,5,6,5,1,9,13,13,1,6,3,7,12,9,10,9,4,5,5,7,13,12,2,4,10,13,5,6,10,15,10,11,10,13,13,11,10,7,13,11,8,1,1,1,1,1,1,1,1,3,2,1
"4842",2000036541,"Junior Felix","3/17/1997 (26 years old)","D (C)","North Efate Utd","Vanuatuan Port Vila Premier Division","VAN","No","9/1/2021","6/30/2024","$0","Right","Reasonable","Very Strong","6'0""","167 lbs","-","-",61,70,2,1,3,1,6,1,9,1,1,7,2,2,13,1,7,9,5,6,10,13,4,5,3,5,11,5,5,7,11,10,6,8,13,11,12,8,12,17,12,12,11,12,7,3,5,8,14,10,16,1,2,1,3,1,3,2,2,1,3,2
"4843",2000036546,"Lency Philip","6/8/1997 (26 years old)","D/WB (L)","Gawler Eagles","South Australia - State League 2","VAN","No","6/1/2023","9/30/2023","$0","Left","Very Strong","Reasonable","5'7""","143 lbs","-","-",61,70,3,7,2,1,7,1,5,4,5,8,4,1,10,7,5,6,6,4,11,11,13,10,11,6,7,7,4,7,14,11,7,5,13,13,12,5,8,16,14,11,11,11,7,11,10,1,11,11,18,2,3,3,2,1,3,1,3,3,3,1
"4844",2000036536,"Jesse Kalopong","1/1/1998 (25 years old)","D (R)","Yatel","Vanuatuan Port Vila Premier Division","VAN","No","1/2/2022","6/30/2025","$0","Either","Very Strong","Very Strong","5'10""","152 lbs","-","-",60,70,3,5,4,4,7,1,6,1,3,7,3,3,6,5,12,7,8,6,9,9,18,6,7,3,9,6,5,7,13,13,2,8,10,13,12,5,9,19,12,9,9,12,8,5,13,7,9,12,18,3,2,2,2,3,2,4,3,3,4,3
"4845",2000037523,"John Thomas","4/19/1996 (27 years old)","AM (C)","Ifira BB","Vanuatuan Port Vila Premier Division","VAN","No","6/1/2021","6/30/2025","$0","Right","Fairly Strong","Very Strong","5'7""","134 lbs","-","-",57,70,5,7,13,9,6,5,1,4,5,2,6,1,6,9,6,5,5,7,6,9,12,9,5,7,6,5,7,7,13,12,4,1,15,12,12,1,10,18,12,14,7,12,13,1,6,4,5,10,9,1,1,2,2,1,1,2,3,2,3,3
"4846",27098529,"Arfan Habibi","3/29/1997 (26 years old)","DM, M (C)","Ariana FC","Swedish First Division South","AFG","Yes","6/7/2021","11/30/2024","$8K - $24K","Right","Reasonable","Very Strong","5'8""","149 lbs","133","13",75,85,12,11,9,7,11,12,5,7,5,7,12,11,7,11,12,8,11,10,8,8,11,8,12,8,6,11,12,10,11,11,9,7,7,11,11,9,13,9,9,8,9,9,5,2,6,5,12,9,12,1,2,1,3,3,3,1,1,2,4,3
"4847",30053241,"Jeffery Bob","7/1/1992 (30 years old)","M (C)","Tafea","Vanuatuan Port Vila Premier Division","VAN","No","1/2/2020","6/30/2025","$0","Right Only","Weak","Very Strong","6'0""","169 lbs","-","-",63,70,4,6,8,7,12,8,5,7,8,9,12,5,10,10,6,8,10,8,7,15,6,5,11,10,8,9,10,10,9,9,7,10,8,10,8,7,10,19,12,11,10,10,15,12,12,7,17,9,11,3,3,2,1,2,3,1,3,2,4,3
"4848",30053079,"Andre Batick","4/28/1993 (30 years old)","ST (C)","Malampa","Luganville Premier Division","VAN","No","6/12/2023","6/30/2024","$0","Right","Reasonable","Very Strong","6'0""","171 lbs","-","-",63,70,5,4,6,13,13,5,6,5,1,5,3,4,2,9,10,8,7,7,6,11,8,13,4,9,3,5,4,7,13,13,4,6,10,13,12,10,12,13,12,13,13,9,14,1,6,8,10,10,12,3,3,1,3,1,2,3,2,2,2,2
"4849",30053245,"Tasso Jeffrey","8/12/1998 (24 years old)","D (C), DM","Gawler Eagles","South Australia - State League 2","VAN","No","6/1/2023","9/30/2023","$0","Right","Reasonable","Very Strong","5'8""","145 lbs","-","-",62,70,3,3,3,1,5,5,9,6,1,10,5,1,11,2,9,10,7,6,10,13,6,5,6,5,13,5,4,7,9,12,6,4,13,12,8,6,9,16,12,13,12,10,9,11,7,3,8,10,19,3,2,3,3,1,1,3,1,1,2,3
"4850",30053244,"Loic Boulet","11/29/1998 (24 years old)","D (RC)","Ifira BB","Vanuatuan Port Vila Premier Division","VAN","No","7/1/2019","6/30/2025","$0","Right","Reasonable","Very Strong","5'8""","154 lbs","-","-",61,70,3,8,5,4,7,1,7,3,2,10,7,6,12,2,13,9,8,4,9,14,12,5,3,6,12,6,2,7,13,12,7,3,9,12,11,8,11,14,12,12,12,11,8,10,14,3,4,13,10,2,3,3,4,2,4,1,3,4,1,3
"4851",2000036524,"Edwin Bai","12/21/1995 (27 years old)","AM (RC)","Malampa","Luganville Premier Division","VAN","No","1/2/2023","6/30/2024","$0","Right","Reasonable","Very Strong","5'10""","149 lbs","-","-",63,70,4,8,8,8,12,2,2,7,5,4,4,1,5,11,7,6,6,4,4,13,17,14,8,7,3,6,6,7,13,13,6,5,9,13,12,3,11,15,10,12,11,11,7,2,10,1,15,11,17,2,2,2,3,3,1,3,1,4,1,3
"4852",2000036566,"Tonly Kalotang","5/19/1997 (26 years old)","ST (C)","Ifira BB","Vanuatuan Port Vila Premier Division","VAN","No","7/1/2019","6/30/2025","$0","Left","Very Strong","Reasonable","5'9""","149 lbs","-","-",61,69,5,4,10,8,13,5,11,3,4,1,6,4,1,8,14,7,4,9,6,11,10,14,6,10,6,5,7,7,13,13,6,7,10,13,12,4,8,16,10,11,9,12,5,8,12,4,12,8,20,1,3,1,2,1,1,1,3,3,3,2
"4853",2000036517,"Allista Kalip","7/28/1989 (33 years old)","ST (C)","Yatel","Vanuatuan Port Vila Premier Division","VAN","No","7/1/2021","6/30/2024","$0","Right","Reasonable","Very Strong","6'0""","165 lbs","-","-",59,69,5,3,10,14,13,6,8,7,1,6,5,6,2,8,11,10,6,8,7,10,16,8,13,10,7,6,6,8,10,7,6,11,12,8,12,6,12,14,10,10,12,10,9,5,5,1,13,11,14,1,3,1,2,2,2,3,1,1,2,1
"4854",88026054,"Jonathan Spokeyjack","11/13/1998 (24 years old)","D/WB/M/AM (L)","Ifira BB","Vanuatuan Port Vila Premier Division","VAN","No","1/2/2020","6/30/2025","$0","Left","Very Strong","Reasonable","5'5""","136 lbs","-","-",62,69,2,7,7,4,7,2,2,2,2,7,8,7,7,7,15,9,8,9,9,6,4,5,10,7,6,8,3,9,11,11,6,3,9,12,10,5,9,11,11,10,12,10,5,8,8,2,7,11,8,3,2,1,4,3,2,3,3,3,3,1
"4855",30052367,"Jayson Timatua","12/27/1998 (24 years old)","M/AM (R)","ABM Galaxy","Vanuatuan Port Vila Premier Division","VAN","No","9/1/2021","6/30/2025","$0","Right","Reasonable","Very Strong","5'9""","149 lbs","-","-",64,69,2,6,4,9,8,5,4,4,5,4,6,2,4,8,12,7,7,8,5,7,3,8,13,10,5,7,5,11,13,13,6,7,8,13,9,3,13,20,11,13,9,11,10,9,7,4,15,9,20,2,3,1,2,1,2,1,1,3,1,3
"4856",2000057104,"Kerry Iawak","3/16/1996 (27 years old)","D/WB/M/AM (L)","Ifira BB","Vanuatuan Port Vila Premier Division","VAN","No","6/15/2020","6/30/2025","$0","Left","Very Strong","Reasonable","5'9""","149 lbs","-","-",60,69,4,7,7,9,9,5,3,4,1,3,9,1,7,5,5,6,5,7,7,9,8,6,6,12,7,6,4,7,13,13,6,6,8,13,11,3,14,11,11,10,12,13,6,4,10,6,8,9,20,1,2,1,2,1,3,3,1,2,2,1
"4857",53162602,"Mehdi Rasoli","11/28/2000 (22 years old)","D/AM (RL)","Elverum","Norwegian Third Division Group 2","AFG","Yes","3/15/2023","12/31/2025","$0","Left Only","Very Strong","Weak","5'9""","149 lbs","67","3",76,84,9,9,13,8,13,11,3,9,7,8,11,10,8,13,11,10,11,6,6,8,9,15,7,10,8,8,11,9,10,10,10,7,15,9,9,8,11,12,12,11,12,12,11,8,10,9,9,11,13,2,3,2,3,1,1,2,3,3,3,1
"4858",2000264665,"Lee Taiwia","12/23/1995 (27 years old)","DM, M (C)","Ifira BB","Vanuatuan Port Vila Premier Division","VAN","No","6/15/2020","6/30/2025","$0","Right","Reasonable","Very Strong","5'11""","163 lbs","-","-",60,69,5,4,1,6,13,5,5,3,2,7,4,1,13,9,9,8,4,4,7,9,8,5,4,6,10,7,7,12,13,13,6,10,10,13,7,8,12,19,12,13,11,10,11,1,13,5,12,12,15,1,2,1,3,2,1,2,1,3,1,3
"4859",2000179267,"Andreas Duch","10/12/1998 (24 years old)","GK","Ifira BB","Vanuatuan Port Vila Premier Division","VAN","No","7/1/2021","6/30/2025","$0","Left","Very Strong","Reasonable","6'5""","182 lbs","-","-",60,68,3,1,1,1,1,6,1,2,3,3,6,1,2,3,9,10,11,6,13,13,11,2,5,1,8,6,5,5,8,6,6,13,11,12,5,6,10,14,11,11,12,11,11,10,6,5,8,9,19,4,12,9,5,10,6,9,5,11,11,10
"4860",2000275738,"Chichirua Kano","7/15/2001 (21 years old)","AM (C), ST (C)","Ifira BB","Vanuatuan Port Vila Premier Division","VAN","No","6/13/2022","6/30/2025","$0","Right","Reasonable","Very Strong","6'1""","165 lbs","-","-",50,68,3,3,6,12,9,5,4,4,1,4,7,2,2,10,9,6,7,8,6,7,6,11,9,8,6,5,8,7,13,13,6,7,13,13,6,6,9,20,12,11,11,13,12,10,14,5,17,9,20,1,3,3,2,3,1,3,2,2,1,3
"4861",30054848,"Bethuel Ollie","8/19/1997 (25 years old)","AM (R)","North Efate Utd","Vanuatuan Port Vila Premier Division","VAN","No","6/1/2022","6/30/2024","$0","Right","Fairly Strong","Very Strong","6'1""","167 lbs","-","-",56,68,5,5,7,8,7,5,5,3,5,4,8,2,1,9,11,7,7,7,7,8,8,10,9,7,5,7,5,7,12,13,7,7,14,13,12,6,13,18,11,11,11,11,8,15,7,8,8,12,15,2,2,1,4,3,1,2,3,3,2,2
"4862",30054804,"Brendon Tankon","7/24/2003 (19 years old)","GK","Teouma Academy","Vanuatuan Port Vila Second Division","VAN","No","6/13/2022","6/30/2024","$0","Right","Strong","Very Strong","6'5""","178 lbs","-","-",50,68,2,3,2,1,3,5,1,2,1,2,6,3,3,2,5,4,7,3,8,13,16,3,11,2,9,6,5,4,11,6,6,14,16,11,1,6,9,11,15,8,11,11,9,11,9,7,10,12,14,6,9,13,13,7,7,7,5,6,10,13
"4863",2000036606,"Noah Roger","2/18/1995 (28 years old)","AM (R)","Tafea","Vanuatuan Port Vila Premier Division","VAN","No","7/1/2020","6/30/2025","$0","Right","Reasonable","Very Strong","6'0""","156 lbs","-","-",54,68,3,8,6,6,11,4,4,2,1,3,9,1,4,7,11,8,1,6,2,11,12,8,6,10,2,6,5,10,12,12,5,9,14,12,11,3,10,15,10,8,13,9,14,12,11,3,16,10,12,1,1,2,2,2,3,3,3,1,2,2
"4864",88025888,"Azariah Soromon","3/1/1999 (24 years old)","ST (C)","Suva","Fijian Premier League","VAN","No","12/31/2020","12/31/2025","$0","Right","Fairly Strong","Very Strong","5'8""","147 lbs","55","22",65,67,5,2,10,9,8,5,13,6,3,5,6,4,2,9,12,7,7,8,6,7,16,11,9,13,4,5,3,6,12,13,6,6,11,13,7,7,7,18,12,10,13,12,10,6,5,5,9,9,17,2,3,2,3,1,1,2,1,2,1,3
"4865",30052369,"Serge Daniel","2/16/1991 (32 years old)","GK","Erakor GS","Vanuatuan Port Vila Premier Division","VAN","No","6/14/2021","6/30/2025","Not for Sale","Right","Reasonable","Very Strong","6'0""","160 lbs","-","-",53,67,2,3,2,3,1,5,1,2,3,3,10,2,1,2,10,10,12,7,7,14,11,1,10,1,8,7,6,6,9,7,2,6,18,8,4,5,7,19,13,12,11,12,15,10,11,8,9,9,18,6,13,13,11,8,7,6,5,12,8,9
"4866",2000036525,"Frederick Massing","9/11/1998 (24 years old)","M (C)","Ifira BB","Vanuatuan Port Vila Premier Division","VAN","No","1/1/2021","6/30/2025","$0","Right","Weak","Very Strong","5'10""","156 lbs","-","-",52,67,1,5,2,6,12,1,1,6,1,6,11,2,4,7,9,7,4,5,3,10,12,8,6,6,4,6,13,11,13,11,6,6,15,12,13,6,10,15,12,11,12,10,5,9,14,2,8,11,9,3,1,3,1,2,1,1,2,1,2,1
"4867",30053263,"Ignace Iamak","3/25/1990 (33 years old)","D (LC)","ABM Galaxy","Vanuatuan Port Vila Premier Division","VAN","No","7/1/2019","6/30/2024","$0","Right","Weak","Very Strong","5'11""","158 lbs","-","-",57,67,1,4,1,1,7,4,7,6,1,14,4,1,12,4,5,8,5,6,7,11,8,5,8,6,13,6,2,7,9,9,7,9,15,9,7,7,13,14,13,13,11,8,10,9,8,1,12,10,17,3,2,1,1,1,1,2,2,1,3,3
"4868",91019336,"Zubayr Amiri","5/2/1990 (33 years old)","M (R), AM (RL), ST (C)","Eintracht Frankfurt","Bundesliga","AFG","Yes","7/1/2022","6/30/2024","$0","Right","Reasonable","Very Strong","6'1""","176 lbs","301","60",84,84,11,10,10,9,10,12,9,8,8,9,11,9,10,11,11,11,9,10,7,8,7,9,8,12,11,9,11,11,12,10,10,10,13,12,10,10,10,17,11,9,10,13,5,8,10,8,8,11,7,1,2,1,3,2,3,2,1,3,2,2
"4869",30053036,"Gordshem Dona","6/7/1997 (26 years old)","D (RLC)","ABM Galaxy","Vanuatuan Port Vila Premier Division","VAN","No","11/1/2020","6/30/2025","$0","Right","Reasonable","Very Strong","5'11""","160 lbs","-","-",59,66,3,7,1,1,7,1,9,1,2,9,6,2,9,5,9,7,8,6,5,8,12,5,11,5,9,5,1,6,13,13,6,9,12,13,11,6,13,11,10,12,8,11,5,1,9,3,10,12,8,2,3,1,3,2,2,1,1,3,4,1
"4870",2000067310,"Karl Wanemut","2/23/2001 (22 years old)","AM (RL)","Erakor GS","Vanuatuan Port Vila Premier Division","VAN","No","7/1/2019","6/30/2025","$0","Right","Reasonable","Very Strong","6'0""","156 lbs","-","-",53,66,6,9,5,7,6,5,1,1,2,5,8,1,1,8,13,4,7,7,4,13,11,8,9,13,5,6,5,7,13,10,6,7,12,13,4,3,13,17,13,13,8,13,5,15,7,2,16,11,8,3,2,3,3,3,3,1,1,1,2,3
"4871",30053940,"Michel Coulon","12/3/1995 (27 years old)","D (LC), DM","Yatel","Vanuatuan Port Vila Premier Division","VAN","No","6/1/2022","6/30/2025","$0","Right","Reasonable","Very Strong","5'8""","154 lbs","-","-",61,66,7,9,7,7,9,8,8,4,7,11,10,4,11,8,7,8,7,10,8,9,5,5,8,8,8,9,8,10,10,10,9,9,10,10,9,8,10,13,12,12,11,13,9,11,8,5,7,10,20,2,1,3,2,3,2,3,1,2,2,2
"4872",23365449,"Nguyen Hoang Duc","1/11/1998 (25 years old)","M (C), AM (RC)","Viettel FC","V.League One","VIE","No","6/15/2020","12/31/2024","$190K - $550K","Left","Very Strong","Fairly Strong","6'0""","163 lbs","95","24",93,113,8,8,12,8,13,10,9,10,1,5,14,8,7,12,8,11,9,11,9,11,15,14,6,8,6,10,14,9,11,10,10,11,10,10,12,9,14,17,16,11,14,12,8,10,6,6,12,10,8,1,3,2,1,3,3,2,2,2,2,1
"4873",23303678,"Nguyen Quang Hai","4/12/1997 (26 years old)","M (C), AM (LC)","Pau FC","Ligue 2 BKT","VIE","No","7/1/2022","6/30/2025","$0","Left","Very Strong","Reasonable","5'6""","143 lbs","152","36",93,110,11,9,13,11,13,13,5,12,4,6,13,10,5,14,8,10,10,10,10,12,14,13,6,10,6,11,13,10,11,12,11,5,10,11,13,6,12,12,14,12,13,8,5,12,6,9,12,12,10,2,1,3,1,2,1,2,1,1,1,1
"4874",23339415,"Nguyen Tien Linh","10/20/1997 (25 years old)","ST (C)","Binh Duong","V.League One","VIE","No","6/15/2020","12/31/2024","$22K - $220K","Right","Fairly Strong","Very Strong","5'10""","158 lbs","130","50",88,106,3,4,10,14,11,2,11,8,3,3,7,9,5,12,8,10,9,12,9,10,13,9,4,13,4,11,7,8,12,11,12,9,11,11,11,10,7,12,15,11,14,10,9,8,3,11,10,12,8,3,3,1,3,1,3,1,1,1,2,1
"4875",23401153,"Doan Van Hau","4/19/1999 (24 years old)","D (LC)","CA Ha Noi","V.League One","VIE","No","1/9/2023","12/31/2025","$150K - $450K","Left","Very Strong","Reasonable","6'1""","180 lbs","67","8",90,106,3,8,8,4,9,7,14,3,5,13,10,5,14,9,15,10,11,11,11,11,15,6,4,3,12,9,4,9,10,10,11,12,16,10,11,13,11,10,16,11,14,8,3,14,14,4,12,13,7,1,2,1,1,1,1,1,2,3,3,3
"4876",23458989,"Ho Tan Tai","11/6/1997 (25 years old)","D (RC), WB (R)","CA Ha Noi","V.League One","VIE","No","1/16/2023","12/31/2024","$120K - $375K","Right","Fairly Strong","Very Strong","5'11""","158 lbs","116","13",84,103,8,12,11,8,10,4,7,7,8,10,9,8,11,11,7,10,9,12,10,10,14,9,7,7,10,11,9,13,11,11,9,10,10,12,12,8,14,16,15,11,15,11,5,9,7,7,11,12,9,3,1,2,2,3,2,2,2,2,4,1
"4877",23339420,"Phan Van Duc","4/11/1996 (27 years old)","M (L), AM (LC)","CA Ha Noi","V.League One","VIE","No","11/28/2022","12/31/2024","$28K - $275K","Left","Very Strong","Fairly Strong","5'7""","141 lbs","104","28",81,103,6,9,11,8,11,4,4,8,4,6,10,8,5,11,8,10,6,11,10,10,10,12,6,13,4,9,11,10,12,13,8,6,9,12,8,6,9,13,14,11,13,11,13,12,5,7,12,11,8,1,2,4,2,3,1,3,1,2,2,4
"4878",23462796,"Pham Tuan Hai","5/19/1998 (25 years old)","AM (C), ST (C)","Ha Noi FC","V.League One","VIE","No","12/11/2021","12/31/2024","$50K - $500K","Right","Weak","Very Strong","5'8""","149 lbs","90","35",84,101,3,6,11,12,11,4,9,7,3,4,8,7,5,12,8,12,10,13,8,11,12,11,8,12,6,8,8,14,12,12,11,7,12,12,12,8,11,9,12,11,10,8,7,10,6,7,8,11,8,1,1,1,2,1,2,4,3,1,3,3
"4879",16173634,"Masieh Kukcha","12/20/1999 (23 years old)","M/AM (L)","SC Leopoldsdorf/M.","Austrian Region-League North/Northwest (NÖ)","AFG","No","7/14/2022","6/30/2023","$0","Left Only","Very Strong","Weak","5'9""","132 lbs","113","10",61,84,7,10,10,6,9,5,4,1,5,4,7,2,5,5,9,6,4,9,6,13,9,12,1,7,4,6,8,11,13,12,2,8,11,13,10,3,18,11,10,8,13,10,10,5,10,5,17,13,11,2,2,3,3,3,2,3,3,2,3,1
"4880",2000247336,"Le Dinh Long Vu","5/27/2006 (17 years old)","M/AM (R)","SLNA","Vietnamese Third Division Group A","VIE","No","6/13/2022","12/31/2025","$40K - $400K","Left","Very Strong","Reasonable","5'7""","132 lbs","-","-",60,100,7,11,10,9,11,5,1,6,5,3,9,3,2,8,6,4,7,5,4,11,5,10,1,6,5,6,6,7,13,13,6,1,9,13,7,2,11,14,12,10,11,12,7,10,12,8,8,11,19,1,2,2,2,3,1,1,1,3,2,3
"4881",23303645,"Nguyen Van Toan","4/12/1996 (27 years old)","AM (R), ST (C)","Seoul E-Land","Hana 1Q K LEAGUE 2","VIE","No","1/4/2023","12/31/2023","$0","Right","Reasonable","Very Strong","5'7""","136 lbs","191","46",84,99,5,7,13,9,11,5,6,8,4,4,10,10,5,12,8,10,8,11,9,10,14,12,7,13,5,10,8,13,13,13,9,6,9,13,10,6,11,15,18,11,15,13,6,13,5,4,10,9,10,1,3,3,1,1,2,1,3,4,1,1
"4882",97208382,"Le Van Do","8/7/2001 (21 years old)","WB (R), M (RC)","CA Ha Noi","V.League One","VIE","No","1/9/2023","12/31/2025","$35K - $350K","Left","Very Strong","Reasonable","5'8""","143 lbs","39","7",66,99,7,11,9,5,11,7,6,7,4,8,8,5,8,11,7,8,7,8,9,8,12,8,4,6,9,10,9,12,11,13,10,8,11,12,7,5,11,10,9,10,9,9,6,6,6,7,9,6,8,2,2,2,1,1,3,1,3,4,4,2
"4883",23299484,"Do Hung Dung","9/8/1993 (29 years old)","M (C)","Ha Noi FC","V.League One","VIE","No","6/15/2020","12/31/2024","$45K - $425K","Right","Reasonable","Very Strong","5'7""","145 lbs","160","19",89,98,11,9,12,7,12,6,5,7,2,4,13,8,10,14,8,11,10,11,12,11,12,12,6,8,8,13,12,12,11,11,12,7,12,10,13,8,15,14,17,11,15,13,8,9,6,2,14,12,8,1,1,3,2,2,3,1,1,1,2,1
"4884",97205123,"Nguyen Van Tung","6/2/2001 (22 years old)","AM (C), ST (C)","Ha Noi FC","V.League One","VIE","No","1/1/2019","12/31/2025","$10K - $100K","Right","Weak","Very Strong","5'10""","154 lbs","19","1",61,97,4,6,7,11,9,2,11,6,3,2,6,8,5,10,8,8,11,11,7,9,11,10,4,11,6,7,7,9,11,8,11,11,12,11,9,9,9,10,11,7,12,11,5,8,6,6,9,8,7,3,1,2,2,3,1,3,1,3,1,3
"4885",23303751,"Nguyen Thanh Chung","9/8/1997 (25 years old)","D (C)","Ha Noi FC","V.League One","VIE","No","6/15/2020","11/30/2025","$12K - $120K","Right","Reasonable","Very Strong","5'11""","154 lbs","123","9",82,97,1,3,6,6,8,1,13,6,8,12,10,6,13,7,11,10,13,11,8,11,12,8,10,6,12,8,9,11,9,9,11,11,10,9,10,11,10,15,14,11,15,15,9,9,8,5,8,10,8,2,2,2,3,4,4,2,3,2,1,3
"4886",23303624,"Do Duy Manh","9/29/1996 (26 years old)","D (C), DM","Ha Noi FC","V.League One","VIE","No","6/15/2020","12/31/2024","$35K - $325K","Right","Reasonable","Very Strong","5'11""","154 lbs","137","7",82,97,2,3,8,4,8,3,12,6,6,13,11,4,13,8,13,9,13,11,9,11,12,4,9,2,12,8,6,10,9,10,11,10,10,9,11,10,14,15,17,9,14,18,11,9,12,5,10,13,9,2,2,1,2,1,2,3,1,1,2,3
"4887",2000213870,"Nguyen Thanh Nhan","7/28/2003 (19 years old)","AM (RL), ST (C)","PVF Cong An Nhan Dan","V.League Two","VIE","No","1/1/2022","12/31/2024","$22K - $230K","Left","Very Strong","Reasonable","5'8""","152 lbs","33","20",57,97,2,6,13,12,11,4,7,4,1,5,9,4,5,7,12,5,6,2,5,12,9,11,12,3,3,5,6,7,12,10,1,5,12,10,12,2,10,14,12,12,10,9,6,4,8,5,9,13,12,1,3,2,1,3,1,3,2,3,2,2
"4888",23296841,"Dang Van Lam","8/13/1993 (29 years old)","GK","Binh Dinh","V.League One","VIE","No","8/16/2022","11/30/2025","$130K - $400K","Left","Very Strong","Weak","6'2""","191 lbs","175","-",86,96,3,4,3,2,7,3,5,4,5,2,8,4,5,7,11,11,11,8,11,11,15,4,6,2,12,8,4,2,9,10,7,12,13,9,7,10,6,15,13,9,12,7,9,14,6,11,14,15,8,11,7,13,9,12,8,13,6,12,11,10
"4889",23462805,"Bui Hoang Viet Anh","1/1/1999 (24 years old)","D (C)","Ha Noi FC","V.League One","VIE","No","12/5/2019","12/31/2025","$110K - $325K","Right Only","Weak","Very Strong","5'11""","169 lbs","68","7",80,96,1,3,8,3,7,2,13,3,3,11,10,4,13,9,13,10,12,10,9,11,13,3,4,4,12,7,3,10,11,11,11,13,12,9,11,11,16,16,12,11,14,15,6,11,9,6,12,11,8,4,2,4,1,3,4,2,2,1,1,1
"4890",2000104634,"Mohsen Anwari","1/1/2005 (18 years old)","M (R)","FCM Traiskirchen","Austrian Regional League East","AFG","No","1/2/2022","6/30/2026","$0","Right","Weak","Very Strong","5'9""","147 lbs","38","8",57,83,6,9,12,3,9,5,3,7,6,5,9,3,7,12,9,5,3,8,7,7,14,8,2,6,5,7,9,10,12,14,7,7,8,14,5,4,13,19,10,13,13,11,7,9,8,1,17,11,10,3,1,4,1,3,1,2,1,2,3,1
"4891",23296792,"Nguyen Cong Phuong","1/21/1995 (28 years old)","AM (LC), ST (C)","Yokohama FC","J1 League","VIE","No","1/2/2023","1/31/2026","$75K - $750K","Right","Reasonable","Very Strong","5'6""","143 lbs","136","43",94,96,7,8,14,8,10,11,6,4,9,3,11,10,4,11,13,8,7,9,8,9,12,13,7,11,5,7,10,11,13,12,7,5,11,12,11,8,12,13,13,11,11,8,4,12,7,14,9,12,9,3,2,3,3,2,2,1,2,1,3,2
"4892",2000214431,"Ho Van Cuong","1/15/2003 (20 years old)","D/WB (R)","SLNA","Vietnamese Third Division Group A","VIE","No","1/1/2022","12/31/2025","$12K - $120K","Right","Weak","Very Strong","5'6""","138 lbs","28","-",60,96,7,11,10,7,11,6,6,6,3,6,11,6,8,11,7,9,7,8,7,10,12,11,6,5,9,10,8,12,10,12,8,5,11,11,9,6,12,11,10,7,8,6,6,9,6,6,9,11,8,3,1,1,3,3,1,2,3,2,1,2
"4893",2000212813,"Nguyen Van Truong","9/10/2003 (19 years old)","M/AM (RLC)","Ha Noi FC","Vietnamese Third Division Group A","VIE","No","1/1/2022","12/31/2025","$95K - $275K","Right","Fairly Strong","Very Strong","5'11""","160 lbs","9","-",54,95,6,7,11,8,11,6,9,9,3,8,10,7,6,12,6,6,4,6,4,7,12,12,3,11,3,6,8,8,9,11,8,11,12,9,6,6,12,13,12,8,10,11,6,9,8,7,10,10,8,2,1,3,2,1,3,2,1,3,2,2
"4894",2000214434,"Nguyen Thai Son","7/13/2003 (19 years old)","M (C)","Thanh Hoa","V.League One","VIE","No","1/1/2022","12/31/2025","$35K - $350K","Right","Reasonable","Very Strong","5'7""","134 lbs","19","2",62,95,8,6,9,5,9,4,7,6,4,9,12,4,10,11,6,9,8,8,7,8,14,7,12,6,11,10,6,11,11,12,12,6,13,10,11,8,12,10,8,7,13,12,7,12,6,7,10,9,8,1,2,2,1,1,2,1,3,1,4,2
"4895",23303646,"Vu Van Thanh","4/14/1996 (27 years old)","D/WB (L)","CA Ha Noi","V.League One","VIE","No","1/9/2023","12/31/2024","$35K - $325K","Right","Fairly Strong","Very Strong","5'8""","147 lbs","177","29",84,94,4,11,10,5,7,3,6,6,7,9,10,9,11,11,9,10,10,10,9,11,11,8,4,7,10,9,8,13,12,12,10,8,10,12,13,8,13,10,12,10,12,12,8,11,4,7,11,13,8,2,4,1,1,2,2,2,3,1,1,1
"4896",2000214447,"Khuat Van Khang","5/11/2003 (20 years old)","AM (RL), ST (C)","Viettel FC","Vietnamese Third Division Group A","VIE","No","1/1/2022","12/31/2025","$12K - $120K","Left","Very Strong","Fairly Strong","5'7""","138 lbs","9","-",62,93,7,9,10,6,11,5,4,7,2,5,11,5,7,12,6,11,8,8,9,8,14,12,4,7,6,6,10,10,10,12,8,7,12,11,6,4,12,10,11,8,12,9,7,9,6,6,11,9,8,2,3,1,3,2,3,2,3,2,3,1
"4897",23303642,"Nguyen Tuan Anh","5/16/1995 (28 years old)","M (C)","Gia Lai","V.League One","VIE","No","6/15/2020","12/31/2024","$40K - $375K","Right","Reasonable","Very Strong","5'9""","149 lbs","117","4",81,93,10,8,12,8,12,9,7,10,4,6,13,10,9,14,6,11,9,12,11,11,13,12,11,8,11,11,12,11,8,8,11,8,8,8,10,7,10,17,17,11,12,11,8,10,5,5,10,10,10,2,3,1,1,3,2,2,1,1,1,1
"4898",23302366,"Bui Tien Dung","10/2/1995 (27 years old)","D (C)","Viettel FC","V.League One","VIE","No","6/15/2020","12/31/2024","$35K - $375K","Right","Fairly Strong","Very Strong","5'8""","154 lbs","113","10",81,93,3,5,5,4,6,2,11,6,7,10,9,8,13,6,10,11,12,11,12,11,11,6,12,9,12,9,8,10,10,10,11,7,10,9,11,10,8,10,14,11,10,8,4,11,9,10,11,11,8,1,1,2,2,1,4,2,1,3,3,3
"4899",97208328,"Nguyen Thanh Binh","11/2/2000 (22 years old)","D (LC)","Viettel FC","V.League One","VIE","No","1/1/2019","12/31/2025","$35K - $375K","Left","Very Strong","Fairly Strong","5'11""","171 lbs","80","2",76,90,3,3,4,4,6,3,13,5,6,10,7,3,14,8,11,8,9,11,7,11,14,4,10,4,12,5,6,8,10,10,12,11,12,9,10,11,9,14,12,10,13,11,8,12,6,9,10,10,8,3,3,3,3,1,3,2,2,1,3,1
"4900",2000030106,"Hoang Xuan Tan","2/22/2001 (22 years old)","M (RLC)","Nam Dinh","V.League One","VIE","No","1/1/2020","12/31/2025","$26K - $275K","Left Only","Very Strong","Weak","5'9""","145 lbs","44","1",60,88,3,12,10,6,9,3,4,6,7,11,9,3,8,10,12,9,8,9,8,10,9,9,4,8,9,8,9,11,11,12,8,9,8,12,10,4,14,10,11,8,10,9,6,9,11,6,9,8,7,2,1,1,3,3,3,3,3,1,2,1
"4901",2000103030,"Murtaza Abrahmi","1/1/2006 (17 years old)","ST (C)","AKA St. Pölten NÖ","Austrian Youth Academy League","AFG","No","7/15/2022","6/30/2025","$0","Right","Reasonable","Very Strong","5'7""","145 lbs","2","-",61,83,5,2,8,13,10,3,13,2,1,2,2,6,1,10,13,11,4,3,2,9,12,10,5,12,1,5,1,6,13,13,6,5,12,13,10,2,7,17,11,11,11,12,6,12,11,7,7,12,10,1,3,1,2,3,3,3,2,3,2,3
"4902",2000214425,"Tran Nam Hai","2/5/2004 (19 years old)","M/AM (C)","SLNA","Vietnamese Third Division Group A","VIE","No","1/1/2022","12/31/2025","$110K - $325K","Right","Weak","Very Strong","6'0""","165 lbs","17","1",58,88,8,8,11,7,11,7,5,7,2,5,11,6,4,11,8,8,6,10,9,8,11,10,7,9,5,8,10,10,11,11,8,10,10,11,8,5,9,8,9,6,9,12,8,10,6,5,12,8,8,2,1,2,2,1,2,1,2,2,3,2
"4903",2000163256,"Pham Dinh Duy","4/2/2002 (21 years old)","M/AM (R), ST (C)","Da Nang","V.League One","VIE","No","1/1/2022","12/31/2025","$40K - $400K","Right","Reasonable","Very Strong","5'9""","154 lbs","35","4",63,88,4,6,9,10,11,3,6,3,3,4,6,6,5,11,9,10,8,10,6,8,13,12,4,11,6,8,6,12,11,12,10,9,11,11,9,8,10,10,12,10,11,10,8,11,9,7,11,12,8,2,2,3,2,3,2,2,1,2,3,3
"4904",23357001,"Bui Tien Dung","11/23/1998 (24 years old)","DM, M (C)","CA Ha Noi","V.League One","VIE","No","1/4/2023","12/31/2025","$75K - $230K","Right","Reasonable","Very Strong","5'11""","169 lbs","135","2",73,88,6,5,8,4,9,4,9,9,8,10,10,8,12,9,12,8,11,10,20,11,12,6,8,4,12,6,8,11,9,8,10,8,10,8,11,9,11,13,15,10,12,11,5,10,6,9,8,12,8,2,3,2,2,3,3,4,2,2,1,1
"4905",2000244310,"Nguyen Quoc Viet","5/4/2003 (20 years old)","AM (RL), ST (C)","Gia Lai","V.League One","VIE","No","1/1/2023","12/31/2025","$30K - $300K","Right","Weak","Very Strong","5'8""","138 lbs","13","1",59,87,4,6,13,8,11,6,6,5,2,3,8,4,5,12,6,7,5,8,7,9,12,10,5,11,3,6,7,8,12,12,8,7,11,11,7,4,10,9,12,7,8,11,6,8,5,8,10,11,8,1,1,2,4,1,1,2,1,1,2,1
"4906",23292091,"Que Ngoc Hai","5/15/1993 (30 years old)","D (RC)","SLNA","V.League One","VIE","No","1/13/2022","12/31/2025","$14K - $130K","Right","Fairly Strong","Very Strong","5'11""","158 lbs","212","15",82,87,2,3,6,3,8,3,13,4,4,12,9,12,14,10,14,10,11,11,8,12,12,4,13,3,12,5,6,8,9,8,10,10,11,8,9,10,10,6,10,11,14,9,2,11,10,12,13,13,10,3,2,2,3,1,1,1,1,1,3,3
"4907",23303740,"Pham Xuan Manh","2/9/1996 (27 years old)","D/WB (R)","SLNA","V.League One","VIE","No","6/15/2020","12/31/2024","$28K - $275K","Right","Fairly Strong","Very Strong","5'9""","149 lbs","127","8",77,87,5,9,10,6,9,5,7,8,5,10,11,5,11,9,8,8,9,8,10,10,10,8,5,5,10,8,9,12,11,11,8,8,9,11,12,9,12,14,15,11,12,9,10,10,4,10,12,8,8,2,2,2,3,3,1,3,1,2,1,3
"4908",23365436,"Nguyen Duc Chien","8/24/1998 (24 years old)","D (C), DM","Viettel FC","V.League One","VIE","No","6/15/2020","12/31/2025","$24K - $240K","Right","Fairly Strong","Very Strong","5'11""","169 lbs","74","10",72,87,2,4,6,6,6,2,11,6,10,11,7,10,13,6,11,10,11,9,10,8,12,5,8,8,11,6,5,10,8,11,10,11,10,8,12,11,4,11,13,10,13,11,1,10,9,7,11,11,8,3,3,3,1,2,2,1,1,2,2,1
"4909",23357003,"Ha Duc Chinh","9/22/1997 (25 years old)","AM (RL), ST (C)","Binh Dinh","V.League One","VIE","No","11/14/2021","12/31/2024","$7K - $75K","Right","Reasonable","Very Strong","5'9""","163 lbs","141","26",73,86,4,6,9,9,11,4,13,6,3,5,9,11,8,11,8,10,9,11,9,9,10,10,3,11,4,9,9,10,11,11,11,7,10,10,11,9,8,14,14,10,8,10,8,9,4,12,8,12,8,3,3,1,1,2,3,3,1,2,1,3
"4910",2000214429,"Dinh Xuan Tien","1/10/2003 (20 years old)","M (R), AM (RLC)","SLNA","Vietnamese Third Division Group A","VIE","No","1/1/2022","12/31/2025","$120K - $350K","Right","Weak","Very Strong","5'7""","143 lbs","33","4",63,86,8,9,11,8,12,5,6,4,3,4,8,9,6,11,10,8,6,6,7,7,12,11,6,9,4,8,8,10,11,13,9,6,12,11,8,7,12,10,8,7,10,9,6,9,8,7,9,8,8,1,1,3,1,1,3,1,3,3,2,3
"4911",97203555,"Tran Bao Toan","7/14/2000 (22 years old)","M/AM (RL)","Gia Lai","V.League One","VIE","No","1/1/2019","12/31/2025","$12K - $120K","Right","Fairly Strong","Very Strong","5'7""","138 lbs","65","-",65,86,5,7,10,5,9,4,5,8,2,7,10,8,9,11,6,9,8,8,8,8,10,9,4,6,9,9,9,10,11,10,10,6,8,11,12,8,10,9,10,8,6,12,5,6,5,6,9,8,7,2,2,1,2,3,1,1,1,3,2,3
"4912",2000131402,"Belal Ahmadi","10/7/2002 (20 years old)","M/AM (C), ST (C)","Harksheide","German Div. Hamburg","AFG","Yes","7/1/2022","6/30/2023","$0","Right","Reasonable","Very Strong","6'0""","163 lbs","48","-",57,83,4,4,14,12,8,6,8,6,2,6,12,5,7,13,12,6,6,13,7,7,8,12,3,11,8,6,13,8,10,12,7,6,10,11,5,4,9,20,9,13,12,9,5,9,12,3,9,9,14,2,1,1,1,4,3,2,2,2,1,1
"4913",97203598,"Mai Xuan Quyet","4/1/1999 (24 years old)","M/AM (R), ST (C)","Nam Dinh","V.League One","VIE","No","2/1/2019","12/31/2024","$26K - $250K","Right","Fairly Strong","Very Strong","5'7""","149 lbs","84","6",69,86,4,9,12,7,10,5,4,8,5,4,9,6,4,11,7,9,7,8,7,9,12,11,6,11,5,9,10,11,11,12,9,6,8,11,8,5,7,13,12,11,10,14,3,5,3,8,7,11,8,2,1,2,4,2,1,2,1,1,3,2
"4914",23462862,"Nguyen Xuan Kien","1/4/2000 (23 years old)","D (C)","Viettel FC","V.League One","VIE","No","1/1/2019","12/31/2025","$18K - $180K","Left","Very Strong","Weak","5'7""","145 lbs","47","2",63,86,3,3,5,4,6,4,12,6,7,11,6,3,12,8,10,7,8,6,7,11,11,6,8,5,12,4,6,7,11,9,10,7,13,11,11,9,10,12,13,10,12,10,8,9,8,8,9,11,6,2,1,1,2,3,3,1,3,2,1,2
"4915",23303685,"Tran Van Kien","5/13/1996 (27 years old)","D (R)","Ha Noi FC","V.League One","VIE","No","6/15/2020","12/31/2024","$75K - $230K","Right","Reasonable","Very Strong","5'6""","138 lbs","152","4",77,85,4,12,10,5,8,2,7,6,9,9,10,8,11,8,10,11,11,10,10,10,11,7,8,11,11,10,9,12,11,12,11,5,10,11,11,8,10,10,15,11,11,13,6,8,9,4,9,8,8,1,1,4,3,2,2,3,1,3,2,1
"4916",23462803,"Ly Cong Hoang Anh","9/1/1999 (23 years old)","M/AM (C)","Binh Dinh","V.League One","VIE","No","1/8/2022","12/31/2024","$9K - $90K","Right","Reasonable","Very Strong","5'5""","154 lbs","68","6",71,85,12,8,9,6,11,7,7,7,4,7,12,4,8,11,11,9,10,11,10,11,12,11,5,6,9,11,9,10,10,9,11,8,12,10,11,9,14,12,14,11,11,10,6,8,8,4,12,10,8,3,3,3,1,1,3,1,4,1,1,1
"4917",23303720,"Trieu Viet Hung","1/19/1997 (26 years old)","DM, M (C)","Hai Phong","V.League One","VIE","No","11/20/2022","11/30/2024","$16K - $160K","Right","Reasonable","Very Strong","5'7""","143 lbs","115","14",70,85,6,7,7,6,9,4,8,9,6,10,10,6,12,9,10,10,10,11,9,10,9,7,6,7,12,11,8,12,9,10,11,6,11,9,11,8,11,11,13,10,10,9,4,9,5,4,9,9,8,2,3,1,2,3,3,2,1,2,3,4
"4918",2000213673,"Nguyen Duc Viet","1/1/2004 (19 years old)","M (C), AM (RC)","Gia Lai","V.League One","VIE","No","1/1/2022","12/31/2025","$95K - $300K","Right Only","Weak","Very Strong","5'9""","154 lbs","14","-",54,85,4,6,8,5,8,6,8,8,4,7,11,7,10,10,11,7,9,7,8,8,8,6,10,5,8,9,6,10,10,10,11,9,12,11,12,7,13,9,9,7,8,10,6,9,8,4,10,9,5,3,1,1,1,2,2,2,1,2,2,2
"4919",2000244345,"Ryan Ha","8/24/1997 (25 years old)","M/AM (C), ST (C)","Khanh Hoa","V.League One","VIE","Yes","12/25/2022","12/31/2024","$85K - $275K","Right","Weak","Very Strong","6'0""","185 lbs","17","2",71,85,6,11,12,10,11,7,6,6,2,5,11,8,6,12,8,8,6,8,7,8,11,11,6,7,6,7,10,10,12,11,7,10,12,12,9,6,11,8,11,7,10,8,9,8,7,7,8,11,8,3,2,3,3,1,1,2,1,3,2,2
"4920",97208332,"Tran Danh Trung","10/3/2000 (22 years old)","ST (C)","Viettel FC","V.League One","VIE","No","1/1/2019","12/31/2025","$30K - $300K","Right","Reasonable","Very Strong","5'9""","167 lbs","30","1",60,84,3,5,10,10,10,3,9,6,4,3,8,8,6,11,9,7,6,10,8,8,8,11,4,12,6,8,8,10,11,12,9,7,8,11,8,7,8,9,9,8,7,8,6,6,5,9,9,5,7,2,3,1,2,4,1,3,3,3,2,2
"4921",2000214424,"Nguyen Van Viet","7/12/2002 (20 years old)","GK","SLNA","Vietnamese Third Division Group A","VIE","No","1/1/2022","12/31/2025","$24K - $250K","Right Only","Weak","Very Strong","5'11""","154 lbs","8","-",56,84,1,2,3,2,6,1,4,2,4,1,6,3,2,8,9,8,7,9,8,7,12,4,6,3,9,5,6,6,8,12,7,11,9,8,8,7,6,11,9,7,11,12,7,9,6,6,11,10,8,8,6,12,11,12,7,11,8,10,9,10
"4922",85072783,"Lê Michel","2/12/1993 (30 years old)","D (C)","Azzurri GE","Swiss Lower Division","VIE","Yes","2/13/2023","-","$0","Right Only","Weak","Very Strong","6'1""","176 lbs","79","8",73,84,2,7,5,4,9,9,10,6,1,9,8,2,10,5,11,10,12,10,8,15,13,5,7,7,10,7,8,8,8,9,10,10,12,8,9,10,14,15,15,14,11,14,8,5,11,5,11,12,9,2,3,2,4,2,2,2,1,1,1,2
"4923",47014920,"Ruslan Mingazow","11/23/1991 (31 years old)","M (RL), AM (RLC)","Kitchee","Hong Kong Premier League","TKM","No","1/1/2023","6/30/2025","Not for Sale","Right","Strong","Very Strong","5'9""","138 lbs","261","80",98,119,11,10,11,11,12,12,6,10,9,4,12,12,5,12,7,12,4,12,8,9,13,14,7,12,7,9,12,10,12,11,11,6,12,12,11,9,17,7,6,13,15,12,9,12,11,8,10,11,15,3,3,2,1,3,1,2,1,2,1,2
"4924",2000212816,"Nguyen Duc Anh","5/16/2003 (20 years old)","D (LC)","Ha Noi FC","Vietnamese Third Division Group A","VIE","No","1/1/2022","12/31/2025","$26K - $275K","Right Only","Weak","Very Strong","5'9""","154 lbs","6","-",50,84,1,7,6,2,6,1,9,4,6,11,8,3,13,3,9,10,12,9,7,7,12,3,8,3,11,5,3,6,9,11,12,7,11,11,7,6,3,11,10,8,7,9,3,6,4,6,8,8,7,2,3,2,3,3,1,2,1,1,3,1
"4925",2000090531,"Hoang Van Toan","4/1/2001 (22 years old)","DM, M (C)","CA Ha Noi","V.League One","VIE","No","1/1/2021","12/31/2025","$10K - $95K","Right","Reasonable","Very Strong","5'9""","154 lbs","30","1",62,84,7,6,6,5,11,6,6,5,3,7,12,6,6,11,4,11,7,9,8,8,13,7,12,5,8,11,8,9,10,12,11,9,14,10,12,8,8,12,12,12,10,11,8,8,4,6,11,8,8,3,1,2,3,1,3,2,1,2,2,3
"4926",97203596,"Doan Thanh Truong","11/3/2000 (22 years old)","WB/M (R)","Nam Dinh","V.League One","VIE","No","2/1/2019","12/31/2025","$28K - $275K","Right","Reasonable","Very Strong","5'7""","134 lbs","64","3",54,84,3,11,10,6,9,3,4,6,3,5,7,3,6,10,7,6,4,9,4,9,9,7,4,9,4,9,9,10,11,12,8,6,9,11,8,5,10,9,9,10,13,15,5,5,6,7,9,9,8,1,1,2,1,1,3,1,2,1,2,2
"4927",37049838,"Jort van der Sande","1/25/1996 (27 years old)","AM (RLC), ST (C)","NAC Breda","Keuken Kampioen Divisie","BOE","Yes","7/1/2022","6/30/2024","$0","Right","Weak","Very Strong","6'0""","169 lbs","214","54",107,111,6,8,11,9,10,10,13,12,7,5,12,13,4,12,13,11,13,8,9,11,7,7,13,11,5,14,12,15,12,11,14,13,12,12,13,14,13,20,10,10,10,11,7,7,12,4,15,10,15,1,3,3,1,3,3,2,2,4,3,2
"4928",37088233,"Quincy Hoeve","4/3/2003 (20 years old)","ST (C)","FC Volendam","Eredivisie","BOE","Yes","8/1/2022","-","$0","Right","Reasonable","Very Strong","6'3""","189 lbs","32","4",82,105,7,4,10,10,10,7,12,7,2,5,8,6,1,12,11,12,6,8,8,11,9,11,6,14,7,7,6,8,12,12,8,13,15,11,7,7,9,10,13,12,11,10,9,5,14,7,9,12,12,2,3,2,1,2,1,3,1,1,3,1
"4929",78045893,"Jhojan Martínez","8/14/1989 (33 years old)","ST (C)","SV Vitesse","Bonaire Kampionato","BOE","No","1/2/2021","-","$0","Left","Very Strong","Weak","6'3""","171 lbs","11","1",60,103,5,2,11,10,13,5,13,6,5,5,3,6,1,12,10,7,4,7,6,8,10,10,10,11,6,5,6,6,10,8,6,9,11,10,11,4,10,18,11,9,13,11,11,10,8,4,18,11,12,3,2,3,3,1,2,2,3,3,3,1
"4930",2000312629,"Denyor Cicilia","3/29/2007 (16 years old)","GK","N.E.C. Nijmegen","Eredivisie","BOE","Yes","6/12/2023","6/30/2027","$160K - $475K","Right","Reasonable","Very Strong","6'1""","149 lbs","-","-",60,96,5,1,1,3,1,7,1,1,2,3,9,2,2,3,10,5,8,2,9,12,14,2,8,3,7,5,4,4,10,12,5,6,17,10,1,3,6,17,9,10,12,10,5,9,5,7,6,10,14,5,5,12,7,5,12,12,5,5,9,11
"4931",2000290579,"Milan Blanken","5/30/2007 (16 years old)","M (C)","SV Uruguay","Bonaire Kampionato","BOE","No","6/1/2022","12/31/2025","$0","Right","Weak","Very Strong","5'9""","134 lbs","-","-",56,94,6,2,2,7,10,3,5,7,2,6,9,3,7,6,15,6,1,8,4,7,6,5,9,6,7,7,14,4,14,13,7,9,13,13,5,6,9,18,11,10,10,13,9,3,10,3,7,11,13,1,2,1,3,1,1,1,1,1,3,3
"4932",37050857,"Liandro Martis","11/13/1995 (27 years old)","M (L), AM (RL)","Spartak Varna","Bulgarian Second League","BOE","No","6/8/2022","6/30/2024","$30K - $90K","Left","Very Strong","Reasonable","5'9""","141 lbs","71","6",84,94,9,8,12,7,11,9,6,10,9,7,10,8,5,13,8,7,6,6,7,6,10,10,3,8,6,7,8,8,16,12,9,7,12,13,9,7,16,14,9,12,10,10,10,12,15,6,9,12,13,2,2,1,3,1,2,1,1,3,2,1
"4933",82089739,"Jursten Trinidad","12/26/2000 (22 years old)","M (R), AM (RL), ST (C)","SV Vespo","Bonaire Kampionato","BOE","No","7/1/2019","12/31/2023","$0","Right","Reasonable","Very Strong","5'10""","132 lbs","-","-",70,90,6,11,11,11,9,4,8,7,6,6,10,1,7,12,6,9,8,5,7,6,5,12,7,10,6,7,5,8,12,13,7,6,15,13,5,5,11,10,11,10,11,12,9,9,5,1,10,11,19,1,4,1,2,2,1,3,1,2,3,3
"4934",2000270957,"Denis Titov","1/17/2006 (17 years old)","AM (LC)","Rostov","Russian Premier League","TKM","No","1/1/2023","6/30/2024","$85K - $250K","Right","Fairly Strong","Very Strong","5'7""","130 lbs","-","-",52,115,4,7,10,5,12,3,4,6,1,4,9,2,3,11,13,5,4,9,2,8,16,14,8,10,4,6,9,7,12,10,6,3,11,12,4,1,11,15,12,10,13,11,9,7,7,6,7,14,19,4,3,2,2,2,3,2,3,3,1,3
"4935",82089734,"Marnix Eustachia","8/8/2001 (21 years old)","M/AM (LC)","Real Rincon","Bonaire Kampionato","BOE","No","6/13/2022","12/31/2023","$0","Left","Very Strong","Reasonable","5'6""","136 lbs","-","-",67,90,5,7,8,11,13,6,5,8,5,6,8,4,6,14,9,7,2,7,7,14,11,13,9,5,7,7,8,6,11,12,7,1,6,12,8,1,12,19,12,10,9,13,12,11,7,8,12,12,11,1,3,1,3,1,1,2,2,3,2,2
"4936",2000290575,"Raemian Janga","7/4/2006 (16 years old)","M/AM (C)","Real Rincon","Bonaire Kampionato","BOE","No","1/1/2023","12/31/2025","$0","Right","Reasonable","Very Strong","6'0""","149 lbs","-","-",51,86,6,5,9,13,8,1,7,9,6,5,7,4,9,7,9,5,7,7,4,11,11,12,2,7,4,8,5,13,12,11,8,10,10,9,11,5,10,14,10,11,11,9,11,10,9,4,6,12,20,1,2,3,1,2,1,2,3,2,1,2
"4937",82089775,"Aquino Cecilia","3/24/2002 (21 years old)","M/AM (L)","Atlétiko","Bonaire Kampionato","BOE","No","7/1/2018","-","$0","Left","Very Strong","Reasonable","5'11""","156 lbs","-","-",58,85,8,12,7,12,13,6,6,6,6,4,9,3,4,9,5,4,7,6,7,9,17,8,1,5,6,7,7,12,7,13,7,7,11,12,9,4,15,13,11,10,9,11,11,15,5,2,9,10,8,3,1,3,4,1,3,1,1,2,1,3
"4938",82089430,"Jamison Sint Jago","3/27/2002 (21 years old)","D (C)","SV Vespo","Bonaire Kampionato","BOE","No","7/1/2021","12/31/2023","$0","Right Only","Weak","Very Strong","6'4""","182 lbs","-","-",65,85,2,2,1,3,3,1,9,3,1,14,7,4,10,1,14,8,8,7,8,14,2,5,6,5,14,6,2,7,9,9,7,15,8,7,12,5,12,19,13,13,12,12,10,20,12,5,15,11,15,2,1,3,1,4,3,3,2,3,1,3
"4939",82089697,"Ayrton Cicilia","3/2/2001 (22 years old)","M/AM (C), ST (C)","Real Rincon","Bonaire Kampionato","BOE","No","9/1/2021","12/31/2023","$0","Right","Weak","Very Strong","6'2""","171 lbs","28","11",68,85,6,2,13,14,14,6,7,8,3,5,10,7,5,9,11,7,6,6,4,5,2,12,6,10,8,7,8,8,13,12,7,8,15,11,5,6,10,17,12,11,11,10,8,9,14,7,11,15,9,1,2,1,3,1,2,2,4,3,1,1
"4940",2000290584,"Freadyen Michiel","6/16/2006 (16 years old)","ST (C)","Real Rincon","Bonaire Kampionato","BOE","No","1/1/2023","12/31/2025","$0","Right","Reasonable","Very Strong","6'1""","147 lbs","-","-",51,82,4,6,7,13,13,5,13,5,1,1,6,3,1,10,5,8,7,4,6,6,18,10,2,6,4,5,6,6,13,13,6,7,16,13,5,5,9,17,12,12,12,11,14,9,7,4,12,10,12,1,1,1,3,2,2,3,3,2,3,2
"4941",2000252864,"Amir Winklaar","2/21/2006 (17 years old)","D (C)","Real Rincon","Bonaire Kampionato","BOE","No","6/13/2022","12/31/2024","$0","Right","Fairly Strong","Very Strong","6'0""","158 lbs","-","-",52,82,1,3,1,1,4,1,11,4,1,12,5,1,11,1,13,11,5,3,4,12,6,5,10,3,12,4,4,5,7,11,5,7,12,11,3,6,11,15,9,11,10,10,11,3,9,8,6,11,11,3,3,2,3,1,1,3,1,2,1,3
"4942",2000088598,"Marshelon Pourier","12/6/2002 (20 years old)","D (RL), WB (R)","Be Quick 1887","Dutch Vierde Divisie D","BOE","Yes","7/1/2019","-","$0","Right","Weak","Very Strong","6'5""","189 lbs","2","-",59,80,4,8,6,4,8,2,8,5,6,8,7,5,12,8,9,8,8,5,8,10,17,9,9,5,7,7,2,7,12,10,7,17,12,8,12,9,14,11,11,10,10,9,15,10,5,4,10,10,11,3,3,1,3,4,2,2,1,2,1,2
"4943",82075734,"Guillermo Montero","1/12/1997 (26 years old)","ST (C)","Dakota","Aruban Division di Honor","BOE","Yes","6/12/2023","-","$0","Left Only","Very Strong","Weak","5'11""","158 lbs","33","15",55,80,1,1,7,12,11,2,12,3,3,2,1,7,1,7,14,11,7,12,5,9,18,8,13,12,5,4,3,6,12,12,5,5,5,12,11,4,12,19,11,10,11,12,15,7,11,3,9,12,8,1,2,1,1,2,2,3,2,1,1,3
"4944",2000148312,"Jonathan Libania","5/8/2001 (22 years old)","M (L)","SV Victory Boys","Kampionato Liga MCB - Promé Division","BOE","No","7/1/2021","-","$0","Left","Very Strong","Reasonable","5'5""","125 lbs","-","-",53,80,7,11,12,3,8,6,6,7,2,6,8,1,7,11,5,8,6,7,7,9,15,5,11,7,6,8,9,12,12,10,7,4,15,11,7,1,11,15,10,11,11,14,5,11,8,8,12,11,12,3,2,1,1,3,1,1,2,1,3,1
"4945",2000116109,"Alireza Karimi","8/25/2001 (21 years old)","DM, M (C)","Union Innsbruck","Austrian Tyrol League","AFG","No","7/1/2021","6/30/2023","$0","Right","Strong","Very Strong","5'3""","121 lbs","57","12",69,107,5,4,2,7,9,2,6,13,3,10,9,6,11,11,15,9,7,6,8,14,6,5,2,7,10,7,11,12,14,11,7,1,15,12,8,1,11,15,11,10,11,11,11,9,12,3,17,10,19,3,3,1,2,2,3,3,2,3,3,2
"4946",58030929,"Wahyt Orazsähedow","1/26/1992 (31 years old)","AM (R), ST (C)","Altyn Asyr","Turkmenistani Higher League","TKM","No","3/1/2023","12/31/2023","$3K - $9K","Right","Weak","Very Strong","6'2""","180 lbs","66","9",84,110,7,6,10,10,9,9,8,7,5,9,10,3,9,13,5,11,5,12,10,9,11,10,4,12,8,9,4,11,12,12,9,11,7,11,12,9,9,14,10,10,11,10,10,7,5,3,8,12,7,2,1,2,3,1,3,3,1,3,2,3
"4947",82075639,"Yurick Seinpaal","11/12/1995 (27 years old)","M (R), AM (RL), ST (C)","Flamingo","Bonaire Kampionato","BOE","Yes","1/1/2022","-","$0","Right","Reasonable","Very Strong","5'10""","149 lbs","24","29",70,80,5,7,12,11,11,11,7,6,5,4,7,7,1,10,9,9,7,9,6,9,14,12,1,10,5,6,4,7,12,12,6,2,13,12,12,5,11,19,9,7,13,10,8,19,6,8,12,9,8,2,2,1,3,1,1,1,3,3,1,3
"4948",59045417,"Ahmet Ataýew","9/19/1990 (32 years old)","DM, M (C)","Altyn Asyr","Turkmenistani Higher League","TKM","No","1/1/2020","12/31/2023","$4K - $12K","Right","Weak","Very Strong","6'1""","174 lbs","63","5",95,110,9,9,5,8,14,9,9,10,5,11,14,8,10,9,14,12,10,9,9,11,7,5,13,11,14,10,12,14,10,8,7,11,13,8,10,9,11,19,12,8,12,14,12,7,10,1,9,11,16,2,3,2,1,2,2,2,2,3,2,2
"4949",59021779,"Arslanmyrat Amanow","3/28/1990 (33 years old)","M (C), AM (RLC), ST (C)","Arkadag","Turkmenistani Higher League","TKM","No","1/1/2023","12/31/2024","Not for Sale","Right","Reasonable","Very Strong","5'9""","156 lbs","176","21",95,109,9,12,8,9,11,9,8,9,8,9,13,3,9,10,9,11,6,11,8,15,11,8,12,10,10,10,9,11,12,12,10,8,7,11,13,13,12,18,12,11,11,12,14,15,6,6,10,12,7,2,3,1,3,3,3,3,3,1,3,2
"4950",59145072,"Mirza Beknazarow","5/15/2000 (23 years old)","M (L)","Shukura","Georgian National League","TKM","No","2/7/2023","12/31/2024","$0","Left","Very Strong","Reasonable","6'1""","167 lbs","25","-",75,108,7,12,9,8,11,7,5,7,4,7,6,3,4,10,9,10,4,7,8,9,14,8,13,7,4,8,9,13,14,13,8,8,9,12,12,5,15,10,13,12,13,11,14,14,9,4,10,10,10,1,2,3,1,1,4,3,3,3,3,1
"4951",2000035169,"Rasul Çaryýew","9/30/1999 (23 years old)","GK","Arkadag","Turkmenistani Higher League","TKM","No","4/1/2023","12/31/2025","$4K - $12K","Right","Reasonable","Very Strong","6'4""","176 lbs","26","-",75,108,2,3,1,1,1,5,1,3,2,3,8,1,3,1,9,7,11,7,8,13,8,1,9,2,11,7,6,5,11,16,7,13,13,9,1,6,9,17,9,10,10,9,8,8,9,5,11,10,10,7,9,13,5,4,12,8,5,8,12,10
"4952",2000034932,"Şamämmet Hydyrow","1/20/2001 (22 years old)","AM (L), ST (C)","Köpetdag FK","Turkmenistani Higher League","TKM","No","1/1/2022","12/31/2024","$0 - $26K","Right","Reasonable","Very Strong","5'6""","134 lbs","9","1",72,108,9,9,12,14,11,13,9,8,1,7,10,6,4,10,5,6,6,11,8,14,15,12,3,12,8,7,7,8,13,9,11,1,11,11,13,2,14,13,10,12,10,10,6,3,12,6,20,10,14,2,2,3,3,3,3,1,3,2,2,1
"4953",59045421,"Elman Tagaýew","6/2/1989 (34 years old)","M (R), AM (RC)","Ahal","Turkmenistani Higher League","TKM","No","3/1/2020","12/31/2023","$0","Left","Very Strong","Weak","5'7""","141 lbs","76","22",85,108,8,11,10,12,13,8,8,14,8,7,8,9,4,9,5,10,5,11,8,13,11,13,10,15,8,9,12,14,12,8,9,6,5,11,10,7,12,19,13,9,9,12,7,9,6,6,10,8,7,1,2,3,1,1,1,2,3,2,1,1
"4954",59134677,"Wezirgeldi Ylýasow","1/18/1992 (31 years old)","M/AM (C)","Nebitçi","Turkmenistani Higher League","TKM","No","3/1/2023","12/31/2024","Not for Sale","Right","Fairly Strong","Very Strong","5'9""","152 lbs","20","-",82,106,7,6,8,9,14,3,7,10,2,8,14,4,10,11,5,9,5,9,6,13,16,11,12,9,9,8,14,13,9,7,8,7,14,8,10,6,16,16,11,11,13,11,9,12,5,2,10,12,13,1,2,2,2,3,2,2,1,4,2,2
"4955",2000250774,"Teymur Çaryýew","11/26/2000 (22 years old)","WB (R), DM, M (RC), AM (C)","Abdysh-Ata","Kyrgyzstani High League","TKM","No","3/4/2023","12/31/2023","$0 - $28K","Right","Weak","Very Strong","5'10""","154 lbs","-","-",85,105,8,10,5,10,10,8,6,10,6,11,9,6,14,8,15,12,15,10,6,8,15,12,13,10,10,14,8,14,10,14,9,8,12,15,9,7,15,20,13,15,10,10,5,9,6,5,15,12,13,3,2,3,3,1,2,3,1,3,1,1
"4956",59145105,"Döwletyar Berdiýew","5/5/1998 (25 years old)","GK","Köpetdag FK","Turkmenistani Higher League","TKM","No","3/1/2023","12/31/2024","$0","Right","Fairly Strong","Very Strong","6'2""","169 lbs","2","-",68,104,3,2,2,2,3,4,1,2,3,2,5,1,2,3,5,6,15,5,12,12,7,3,1,2,4,5,4,4,9,9,5,9,12,9,4,3,11,17,12,12,9,10,13,8,6,2,10,10,12,4,6,12,5,7,5,12,5,10,9,12
"4957",72049268,"Adam Najem","1/19/1995 (28 years old)","M/AM (C)","Bhayangkara","Indonesian League One","AFG","No","7/11/2022","5/31/2024","$14K - $140K","Right","Reasonable","Very Strong","5'8""","152 lbs","109","13",92,105,12,10,10,9,10,10,8,11,4,6,12,13,7,12,7,11,10,9,10,10,9,10,8,11,7,12,11,12,12,13,10,7,14,11,12,8,16,20,12,12,11,5,10,17,6,5,9,11,9,2,1,1,2,2,1,2,1,3,2,3
"4958",2000270131,"Adrien Ebersbach","9/20/2006 (16 years old)","M (C)","FC Rapid","Romanian First League","TKM","Yes","7/1/2022","6/30/2026","$22K - $220K","Right","Reasonable","Very Strong","5'7""","121 lbs","-","-",57,102,6,4,6,6,13,6,6,13,2,9,14,4,7,8,15,5,1,5,5,11,12,7,11,8,5,7,9,10,13,9,7,2,14,13,5,4,9,14,11,11,11,8,12,8,8,8,12,12,12,2,3,2,4,3,3,2,3,1,2,3
"4959",59044989,"Şöhrat Söyünow","3/8/1992 (31 years old)","D (C)","Ahal","Turkmenistani Higher League","TKM","No","11/30/2020","12/31/2023","$3K - $10K","Right","Reasonable","Very Strong","6'0""","143 lbs","28","-",83,101,5,4,3,2,10,1,11,5,8,16,7,1,13,7,5,12,10,10,14,12,9,5,13,6,10,9,5,10,9,8,10,9,12,8,10,10,10,14,11,10,12,13,6,14,15,4,10,13,19,3,1,3,3,2,2,3,1,3,2,1
"4960",2000046803,"Wepa Jumaýew","12/18/2000 (22 years old)","D (RC)","Energetik-BGU","Belarusian Highest League","TKM","No","3/16/2023","11/30/2023","$2.5K - $24K","Right","Reasonable","Very Strong","6'0""","167 lbs","64","3",82,100,4,6,6,4,10,8,6,12,6,10,10,8,12,10,8,9,8,8,8,10,5,8,8,6,12,12,8,12,12,12,12,6,12,12,12,12,8,13,10,10,10,11,8,7,8,7,6,12,16,1,3,2,1,3,3,2,3,3,2,1
"4961",59145068,"Batyr Babaýew","8/21/1991 (31 years old)","GK","Altyn Asyr","Turkmenistani Higher League","TKM","No","12/31/2021","12/31/2024","Not for Sale","Right","Reasonable","Very Strong","6'0""","174 lbs","25","-",83,99,3,2,2,3,1,6,1,3,2,2,10,1,1,4,11,11,15,9,8,7,11,3,8,3,10,9,8,8,11,11,9,10,14,10,6,10,10,14,10,10,9,13,12,6,7,4,13,11,17,8,9,14,5,14,14,11,5,10,11,13
"4962",2000211745,"Nurmyrat Rozyýew","2/17/2001 (22 years old)","M/AM (C)","Altyn Asyr","Turkmenistani Higher League","TKM","No","6/15/2020","12/31/2023","$6K - $20K","Right","Fairly Strong","Very Strong","6'2""","167 lbs","-","-",68,99,6,2,8,8,12,6,6,14,5,3,8,1,3,8,9,9,5,5,7,13,4,7,12,12,8,7,13,6,12,11,7,8,16,14,5,6,11,15,8,12,10,11,10,6,8,3,13,12,16,3,2,1,1,1,1,1,3,2,3,3
"4963",59145103,"Begenç Akmämmedow","6/1/1998 (25 years old)","M/AM (L)","Arkadag","Turkmenistani Higher League","TKM","No","3/1/2023","12/31/2024","$1K - $10K","Left","Very Strong","Fairly Strong","5'7""","138 lbs","31","11",82,98,6,9,12,12,13,6,4,4,4,6,9,3,5,13,8,6,8,8,7,11,13,13,12,13,6,7,8,8,12,11,7,6,16,11,12,3,13,10,12,10,12,12,8,11,11,8,11,14,11,2,2,3,1,3,1,3,2,2,3,3
"4964",58104546,"Selim Nurmyradow","3/22/1996 (27 years old)","AM (RL), ST (C)","Altyn Asyr","Turkmenistani Higher League","TKM","No","2/13/2023","12/31/2023","$0 - $18K","Right","Fairly Strong","Very Strong","5'11""","154 lbs","33","4",88,97,6,9,13,8,13,6,4,7,4,6,8,2,6,9,5,9,6,10,7,12,7,9,4,11,6,6,4,8,13,13,7,6,8,13,13,6,9,12,13,12,12,12,6,19,13,8,10,11,11,3,3,1,3,3,1,3,3,3,4,3
"4965",59059996,"Furkad Tursunow","2/5/1991 (32 years old)","D (L)","Ahal","Turkmenistani Higher League","TKM","No","3/1/2023","12/31/2023","$0 - $5K","Left","Very Strong","Weak","6'1""","171 lbs","21","1",74,97,5,8,6,7,11,1,9,3,7,10,8,7,15,8,13,11,10,6,13,10,4,8,6,7,14,9,8,9,12,11,9,10,12,9,7,7,11,18,12,12,11,11,7,3,8,7,14,9,12,2,2,3,1,1,1,2,2,3,2,3
"4966",59130373,"Altymyrat Annadurdyýew","4/13/1993 (30 years old)","AM (L), ST (C)","Arkadag","Turkmenistani Higher League","TKM","No","3/1/2023","12/31/2024","$14K - $45K","Left","Very Strong","Reasonable","5'9""","147 lbs","25","35",91,96,7,11,9,13,8,7,11,7,1,7,10,10,2,7,8,9,3,13,8,11,12,10,4,13,8,7,7,9,13,13,8,7,14,13,13,5,11,11,10,11,13,11,5,4,10,2,10,11,9,1,4,1,1,1,1,3,1,4,3,2
"4967",59145101,"Bagtyýar Gürgenow","2/27/1998 (25 years old)","D (R)","Köpetdag FK","Turkmenistani Higher League","TKM","No","1/1/2022","12/31/2023","$0","Right","Reasonable","Very Strong","5'9""","147 lbs","9","-",80,95,3,10,1,7,8,1,8,7,6,8,9,3,12,8,5,9,9,6,11,13,12,6,9,7,9,8,6,8,14,14,8,4,18,14,13,8,16,12,11,11,11,12,5,3,10,8,19,13,8,2,3,2,3,4,1,1,3,2,3,3
"4968",29141400,"Maziar Kouhyar","9/30/1997 (25 years old)","AM (RLC)","York","Vanarama National League","AFG","No","1/27/2023","6/30/2025","$18K - $180K","Right","Fairly Strong","Very Strong","5'11""","187 lbs","91","8",80,105,11,11,12,5,12,10,5,8,5,5,11,9,4,12,9,8,13,10,7,7,18,11,7,10,5,13,11,13,11,11,13,9,14,11,10,8,12,15,12,15,9,11,11,10,7,8,12,16,18,3,1,4,2,2,4,1,2,1,4,2
"4969",2000035377,"Alibek Abdyrahmanow","6/5/1990 (33 years old)","M/AM (R)","Ahal","Turkmenistani Higher League","TKM","No","6/12/2023","12/31/2023","$0","Right","Reasonable","Very Strong","5'9""","145 lbs","27","8",75,95,9,13,8,10,14,7,6,6,1,4,9,6,6,13,15,10,5,6,4,13,11,14,4,11,7,8,8,13,11,9,8,4,16,9,11,5,14,14,10,11,11,10,10,1,6,5,10,12,18,2,2,2,3,2,1,1,2,2,2,2
"4970",59045015,"Amir Gurbany","10/24/1987 (35 years old)","M (LC), AM (L)","Ahal","Turkmenistani Higher League","TKM","No","1/1/2020","12/31/2023","$0","Left","Very Strong","Reasonable","5'10""","169 lbs","25","21",83,95,7,11,7,12,8,8,8,7,5,7,10,9,6,11,7,11,8,12,9,10,16,14,7,15,8,9,8,14,11,11,9,9,6,11,11,11,10,20,11,12,10,10,7,8,8,4,12,10,9,2,2,1,2,1,2,2,1,2,2,2
"4971",59091972,"Nurýagdy Muhammedow","1/29/1984 (39 years old)","AM (C), ST (C)","Ahal","Turkmenistani Higher League","TKM","No","1/1/2021","12/31/2024","Not for Sale","Left","Very Strong","Fairly Strong","5'10""","158 lbs","22","4",75,95,6,9,7,15,13,8,13,9,5,8,8,10,6,11,9,7,7,12,8,9,4,9,9,15,9,8,11,10,7,7,7,6,12,7,7,7,12,19,12,12,12,11,9,11,10,1,10,11,15,1,2,2,3,2,1,1,1,3,1,1
"4972",2000035073,"Hydyr Ýakubow","5/23/1991 (32 years old)","ST (C)","Şagadam","Turkmenistani Higher League","TKM","No","1/1/2019","12/31/2023","$1.5K - $5K","Right","Reasonable","Very Strong","5'8""","152 lbs","27","3",71,94,7,5,6,14,14,7,11,8,5,7,7,10,5,13,9,14,3,10,8,13,4,12,8,12,7,7,6,8,7,12,8,6,7,10,13,6,8,14,13,11,11,9,8,1,5,7,12,10,11,1,3,3,3,1,3,4,2,1,1,1
"4973",59071402,"Gurbangeldi Batyrow","7/28/1988 (34 years old)","WB (L)","Nebitçi","Turkmenistani Higher League","TKM","No","3/1/2023","12/31/2024","Not for Sale","Left","Very Strong","Reasonable","5'11""","165 lbs","22","1",81,94,8,11,6,7,16,5,5,8,9,10,12,3,9,16,7,9,7,9,7,13,16,5,8,10,9,10,7,10,12,10,10,10,10,9,10,7,13,11,9,11,12,11,11,3,13,2,9,9,10,1,2,2,1,3,3,1,3,3,1,1
"4974",59130943,"Myrat Annaýew","5/6/1993 (30 years old)","M/AM (C)","Altyn Asyr","Turkmenistani Higher League","TKM","No","1/1/2019","12/31/2023","$500 - $3.5K","Right","Weak","Very Strong","6'1""","160 lbs","20","3",78,94,5,4,8,13,13,6,7,8,1,7,7,1,5,8,11,10,8,4,5,12,19,8,10,10,8,6,8,8,13,13,7,10,13,13,10,4,13,14,10,12,11,11,13,10,5,4,20,11,20,3,3,3,3,4,1,2,2,1,2,1
"4975",59071610,"Mekan Saparow","4/22/1994 (29 years old)","D (C)","Arkadag","Turkmenistani Higher League","TKM","No","3/1/2023","12/31/2024","$0 - $40K","Right","Fairly Strong","Very Strong","5'11""","165 lbs","24","2",89,93,5,3,1,4,7,1,14,4,1,8,3,4,13,2,10,11,9,8,8,14,11,5,10,7,13,7,3,8,14,14,8,6,13,14,13,10,8,20,11,13,11,10,6,12,7,5,13,11,14,3,3,2,1,3,2,1,1,2,2,1
"4976",59145088,"Güýçmyrat Annagulyýew","6/10/1996 (27 years old)","D (C)","Arkadag","Turkmenistani Higher League","TKM","No","3/1/2023","12/31/2024","$0 - $28K","Right","Reasonable","Very Strong","6'2""","169 lbs","23","1",83,93,5,2,2,1,8,7,9,1,1,14,6,3,11,6,15,12,9,7,8,9,16,5,8,7,14,7,2,8,14,10,8,14,11,11,9,10,14,16,10,12,14,13,7,11,10,6,20,8,16,3,3,3,3,1,1,4,4,3,1,2
"4977",59145071,"Yhlas Säpärmammedow","2/25/1997 (26 years old)","D (L)","Arkadag","Turkmenistani Higher League","TKM","No","3/1/2023","12/31/2024","$500 - $7K","Left","Very Strong","Reasonable","5'7""","134 lbs","26","4",76,93,7,9,5,6,7,2,7,6,7,9,8,3,11,8,10,9,7,8,11,11,17,5,11,5,9,8,6,8,14,14,7,3,14,14,8,3,12,16,12,11,11,13,10,15,9,6,17,13,9,1,1,2,1,3,2,1,1,1,2,3
"4978",59044985,"Serdar Annaorazow","6/29/1990 (32 years old)","D/WB (R)","Altyn Asyr","Turkmenistani Higher League","TKM","No","2/13/2023","12/31/2023","$1.5K - $5K","Right","Reasonable","Very Strong","6'0""","167 lbs","26","-",81,92,7,15,4,9,11,4,8,6,5,12,10,3,13,11,5,12,10,10,9,16,12,10,13,9,11,10,8,10,10,10,10,8,15,9,10,7,14,17,9,10,8,13,10,13,9,1,12,12,8,2,2,2,3,3,4,2,2,3,1,1
"4979",29129409,"Noor Husin","3/3/1997 (26 years old)","M/AM (C)","Southend","Vanarama National League","AFG","No","1/21/2022","6/30/2024","$24K - $70K","Right","Weak","Very Strong","5'10""","154 lbs","139","12",79,105,7,8,10,9,10,8,7,10,6,9,10,10,12,9,11,10,11,7,7,11,11,12,4,9,8,14,10,12,10,12,12,10,11,11,13,10,9,12,11,12,13,12,6,6,6,8,11,9,9,4,3,2,2,3,2,2,1,3,2,1
"4980",59130374,"Mihail Titow","10/18/1997 (25 years old)","ST (C)","Arkadag","Turkmenistani Higher League","TKM","No","3/1/2023","12/31/2024","$0 - $24K","Right","Reasonable","Very Strong","5'10""","167 lbs","27","21",76,92,6,4,7,13,11,3,13,7,1,5,2,5,5,9,5,9,6,12,5,11,12,11,12,12,4,6,7,7,13,13,7,3,12,13,11,12,11,16,12,11,12,9,14,5,15,5,19,9,7,2,1,3,1,2,2,3,3,4,1,2
"4981",2000035172,"Serdarmyrat Baýramow","12/14/1989 (33 years old)","D/WB (L)","Köpetdag FK","Turkmenistani Higher League","TKM","No","1/1/2019","12/31/2023","$0","Left","Very Strong","Reasonable","5'10""","163 lbs","26","3",70,91,5,11,5,3,9,3,8,5,5,10,9,6,11,8,7,10,9,9,10,11,4,5,7,9,9,9,9,9,13,11,6,5,14,11,10,12,16,16,9,10,12,11,13,15,13,8,17,7,18,1,2,2,3,3,1,3,3,3,2,2
"4982",59145070,"Gurbanguly Aşyrow","2/20/1993 (30 years old)","WB (L)","Ahal","Turkmenistani Higher League","TKM","No","6/14/2021","12/31/2023","$0 - $14K","Left","Very Strong","Fairly Strong","6'2""","169 lbs","37","2",86,91,6,11,8,7,10,4,7,4,6,7,8,4,6,11,6,7,7,6,14,12,15,8,8,7,8,8,6,9,14,14,5,12,15,13,13,7,17,12,12,11,12,11,11,1,5,4,11,10,16,4,3,2,4,2,1,3,3,1,1,1
"4983",59024619,"Mämmedaly Garadanow","3/17/1982 (41 years old)","ST (C)","Energetik Türkm.","Turkmenistani Higher League","TKM","No","1/1/2021","12/31/2024","Not for Sale","Right","Fairly Strong","Very Strong","6'1""","154 lbs","40","176",55,91,6,3,5,11,13,7,10,7,5,6,8,2,1,15,11,14,8,10,8,12,5,13,12,10,8,7,8,8,5,5,5,9,13,5,5,5,11,14,13,8,10,13,10,9,8,2,8,12,9,3,2,3,1,3,1,3,2,2,2,3
"4984",2000073041,"Döwran Hojamämmedow","7/3/1998 (24 years old)","DM, M (C)","Ahal","Turkmenistani Higher League","TKM","No","3/1/2022","12/31/2024","$5K - $16K","Right","Reasonable","Very Strong","5'7""","143 lbs","12","1",70,90,6,6,5,6,11,3,6,5,1,7,11,1,9,12,11,9,8,8,4,13,6,5,13,7,11,7,9,11,13,13,7,4,11,13,7,7,11,11,12,11,9,13,15,9,7,5,9,9,12,1,1,3,1,3,1,1,1,3,4,2
"4985",59029721,"Guwanç Abylow","3/30/1988 (35 years old)","D (R), M (RL)","Şagadam","Turkmenistani Higher League","TKM","No","3/1/2023","12/31/2023","$0","Right","Reasonable","Very Strong","5'11""","163 lbs","44","8",81,90,11,14,11,7,11,9,5,6,9,10,10,2,10,12,13,11,5,8,11,10,12,5,12,10,10,10,11,11,9,10,10,11,9,10,12,9,12,15,9,13,12,10,10,10,9,8,17,13,12,1,2,3,4,2,2,1,2,1,1,3
"4986",59060111,"Didar Durdyýew","7/16/1993 (29 years old)","AM (RLC), ST (C)","Arkadag","Turkmenistani Higher League","TKM","No","3/1/2023","12/31/2024","$0","Right","Reasonable","Very Strong","5'9""","149 lbs","20","14",80,90,5,6,13,13,10,6,9,8,1,5,7,10,4,12,9,7,7,13,6,13,16,12,9,12,7,7,7,8,13,13,7,5,10,13,9,5,12,14,11,13,8,10,9,7,8,1,10,10,14,1,2,2,1,1,1,3,1,1,3,3
"4987",59066288,"Zafar Babajanow","2/9/1987 (36 years old)","D (C)","Merw","Turkmenistani Higher League","TKM","No","2/16/2023","12/31/2023","$0","Right","Reasonable","Very Strong","5'11""","160 lbs","32","2",82,90,6,4,6,6,9,1,15,6,2,14,7,3,14,5,15,9,9,9,9,15,11,7,3,8,10,8,8,9,10,9,9,10,12,10,7,7,10,20,11,12,10,12,6,9,10,4,10,10,12,2,3,3,3,4,1,1,1,1,2,2
"4988",2000314533,"Söhbet Durdyýew","6/23/2003 (19 years old)","ST (C)","Köpetdag FK","Turkmenistani Higher League","TKM","No","3/1/2022","12/31/2024","$6K - $20K","Right","Strong","Very Strong","5'9""","154 lbs","-","-",65,89,5,5,13,13,12,5,13,5,2,1,5,8,2,10,5,11,6,11,3,10,16,10,11,3,4,5,1,5,12,12,6,7,5,13,3,6,8,19,12,11,11,9,7,14,7,8,8,12,11,2,3,1,3,3,3,3,3,2,3,1
"4989",59071589,"Myrat Ýakşiýew","1/12/1992 (31 years old)","AM (RL), ST (C)","Neftchi Kochkor-Ata","Kyrgyzstani High League","TKM","No","3/20/2023","12/31/2023","$0","Right","Reasonable","Very Strong","5'10""","154 lbs","25","11",86,89,7,11,11,12,10,4,10,9,6,8,11,8,9,13,5,12,3,12,6,15,9,11,6,10,8,9,9,10,12,8,9,6,16,9,13,6,10,12,12,12,13,10,6,5,10,3,12,14,14,1,1,2,3,2,3,1,2,1,2,3
"4990",93108980,"Suleman Zurmati","6/1/2000 (23 years old)","DM, M/AM (C)","FC Trollhättan","Swedish First Division South","AFG","Yes","1/30/2023","11/30/2025","$0 - $65K","Right","Weak","Very Strong","6'0""","156 lbs","142","7",83,105,8,9,7,7,9,7,8,8,7,9,9,7,10,10,13,11,12,10,10,10,11,8,10,11,10,13,11,13,11,10,13,11,12,12,12,12,8,10,12,12,12,10,8,11,11,7,11,11,16,1,4,3,3,3,3,1,1,3,3,4
"4991",59134670,"Hoşgeldi Hojowow","2/28/1996 (27 years old)","D (R)","Altyn Asyr","Turkmenistani Higher League","TKM","No","2/13/2023","12/31/2023","$0 - $14K","Right","Reasonable","Very Strong","5'10""","156 lbs","34","2",86,89,6,11,9,3,11,4,10,7,8,11,12,8,15,10,5,14,10,8,11,10,14,10,11,8,10,10,8,14,11,12,10,10,12,13,9,6,11,11,11,10,12,13,13,9,5,7,9,11,7,2,2,2,2,3,2,2,3,3,3,1
"4992",2000039331,"Atageldi Geldiýew","8/24/1992 (30 years old)","D (C), DM, M (C)","Aşgabat","Turkmenistani Higher League","TKM","No","1/1/2020","12/31/2025","$0","Right","Reasonable","Very Strong","5'7""","136 lbs","28","-",76,89,6,2,5,7,6,7,9,9,7,11,8,5,12,9,15,9,8,9,10,11,13,5,11,8,11,8,9,13,14,14,8,2,18,14,9,5,13,16,10,13,11,9,5,1,5,2,12,9,20,3,1,1,2,2,2,2,2,4,3,2
"4993",2000211747,"Ruslan Täjiýew","7/8/2000 (22 years old)","D (C)","Altyn Asyr","Turkmenistani Higher League","TKM","No","6/15/2020","12/31/2023","$500 - $5K","Right","Reasonable","Very Strong","6'4""","187 lbs","-","-",65,88,2,2,4,5,6,1,11,3,3,12,7,2,10,1,15,9,8,6,5,13,16,5,8,5,9,5,4,4,11,8,6,13,7,7,4,6,15,16,12,10,13,10,8,13,5,5,10,10,8,3,2,3,3,3,2,3,1,1,1,1
"4994",59130363,"Akmämmet Metdäýew","7/23/1998 (24 years old)","ST (C)","Nebitçi","Turkmenistani Higher League","TKM","No","6/15/2020","12/31/2025","$500 - $2.5K","Right","Weak","Very Strong","5'9""","145 lbs","23","1",58,88,5,4,7,13,9,5,13,4,2,5,6,2,1,6,9,9,4,5,5,12,11,8,6,10,6,5,6,7,13,13,6,8,15,13,12,5,7,17,11,12,12,10,10,11,7,8,5,10,18,3,3,2,3,1,3,3,2,1,1,2
"4995",59130371,"Mekan Aşyrow","11/12/1995 (27 years old)","D (C), DM, M (C)","Şagadam","Turkmenistani Higher League","TKM","No","3/1/2023","12/31/2023","$0 - $2.5K","Right","Weak","Very Strong","6'3""","182 lbs","8","-",70,88,5,3,7,5,8,7,9,4,7,9,6,5,8,8,8,8,8,9,7,11,4,5,4,8,10,8,6,12,14,10,8,14,6,12,11,8,12,20,12,12,10,12,6,13,8,7,10,11,7,2,1,3,1,2,2,3,2,2,2,1
"4996",59130372,"Resul Hojaýew","1/7/1997 (26 years old)","DM, M (C)","Arkadag","Turkmenistani Higher League","TKM","No","3/1/2023","12/31/2024","$0 - $35K","Right","Fairly Strong","Very Strong","5'9""","145 lbs","38","7",84,87,6,5,4,5,9,6,6,8,1,11,13,2,13,13,10,10,8,8,7,8,5,5,4,5,8,7,12,12,13,13,7,6,13,13,13,5,14,12,11,12,10,10,11,9,7,6,12,11,11,3,4,1,3,2,4,3,1,1,3,2
"4997",59145121,"Sergeý Kuznesow","3/22/1985 (38 years old)","GK","Şagadam","Turkmenistani Higher League","TKM","No","1/1/2020","12/31/2024","Not for Sale","Right","Fairly Strong","Very Strong","6'4""","176 lbs","5","-",69,86,3,1,3,1,4,4,1,2,2,3,9,3,1,4,12,8,15,5,9,11,11,2,13,2,13,7,6,5,7,15,6,12,17,6,1,6,10,11,10,11,12,11,7,16,5,2,11,12,15,8,14,7,10,9,11,10,5,6,11,8
"4998",59128527,"Yhlas Magtymow","4/20/1992 (31 years old)","M (C)","Şagadam","Turkmenistani Higher League","TKM","No","1/1/2019","12/31/2023","$500 - $3K","Right","Reasonable","Very Strong","5'10""","156 lbs","28","17",77,86,7,7,3,5,8,5,7,8,2,11,14,3,7,13,10,10,6,9,7,14,4,11,10,10,10,7,10,12,9,8,8,6,12,10,11,5,15,14,13,9,11,13,11,4,9,1,12,12,13,3,1,1,1,2,1,3,1,1,3,1
"4999",2000214600,"Rustam Kamolov","6/4/2007 (16 years old)","ST (C)","Istiqlol","Tajikistani High League","TJK","No","1/1/2022","12/31/2025","$0 - $26K","Right","Weak","Very Strong","6'1""","154 lbs","2","-",50,119,5,5,13,7,7,4,7,10,1,4,13,4,4,11,11,5,2,7,6,5,7,11,8,8,2,5,7,9,12,11,13,13,8,8,8,4,8,10,11,15,12,10,5,7,5,7,13,9,19,2,3,3,1,3,2,2,1,3,2,2
"5000",59130383,"Ekhson Pandzhshanbe","5/12/1999 (24 years old)","M/AM (C)","Istiqlol","Tajikistani High League","TJK","No","2/9/2023","12/31/2023","$1K - $12K","Right","Strong","Very Strong","5'8""","143 lbs","112","15",100,118,7,7,9,10,10,7,1,9,3,7,13,6,5,12,15,6,9,9,9,13,13,12,9,7,6,8,13,12,13,13,8,3,11,13,13,5,16,11,11,13,14,12,9,15,8,4,14,10,16,3,1,4,2,1,3,1,3,4,3,2
"5001",82089445,"Jurven Koffy","9/28/1998 (24 years old)","M/AM (C)","Flamingo","Bonaire Kampionato","BOE","No","6/15/2020","-","$0","Right","Weak","Very Strong","6'6""","189 lbs","-","-",65,78,5,5,7,9,8,5,5,13,1,6,6,1,4,13,13,6,2,9,6,9,12,13,4,10,7,6,13,11,13,10,4,14,14,10,13,8,9,15,9,11,10,11,11,9,12,8,7,11,9,2,1,3,2,3,4,3,1,1,2,4
"5002",2000230500,"Rogyaer Michiel","9/12/1999 (23 years old)","DM, M (C)","Flamingo","Bonaire Kampionato","BOE","No","7/1/2022","-","$0","Right","Reasonable","Very Strong","5'8""","149 lbs","-","-",60,70,6,3,4,7,7,6,6,9,5,8,14,3,9,7,12,8,7,7,8,13,11,5,12,8,8,7,8,10,14,10,7,3,7,10,5,5,9,20,8,11,9,10,15,14,13,2,10,12,18,1,1,2,1,3,4,3,2,1,2,4
"5003",2000191527,"Sivasakthi Narayanan","6/9/2001 (22 years old)","ST (C)","Bengaluru","Indian National Division","IND","No","7/1/2021","6/30/2025","$3.5K - $35K","Right","Reasonable","Very Strong","5'5""","134 lbs","32","6",59,77,6,5,5,8,7,7,7,5,3,7,6,3,2,6,6,9,8,10,8,11,18,12,1,14,8,8,7,14,11,14,4,6,14,12,11,6,12,11,11,10,11,15,9,11,13,5,8,10,14,3,1,3,1,3,3,2,1,1,1,1
"5004",40030270,"Suresh Singh","8/7/2000 (22 years old)","DM, M (C)","Bengaluru","Indian National Division","IND","No","5/30/2023","5/31/2028","$0 - $110K","Right","Fairly Strong","Very Strong","5'11""","147 lbs","66","1",64,77,8,7,4,3,7,10,6,6,1,8,6,1,5,7,11,12,9,7,8,8,17,5,9,4,7,13,15,18,12,12,4,6,12,11,12,5,6,20,12,16,13,11,7,10,10,5,9,12,10,1,3,3,1,4,1,2,3,2,2,3
"5005",40023979,"Bipin Singh","3/10/1995 (28 years old)","AM (RL)","Mumbai","Indian National Division","IND","No","4/19/2021","5/31/2025","$3.5K - $35K","Right","Reasonable","Very Strong","5'8""","143 lbs","131","24",76,76,9,7,4,3,16,8,3,8,8,9,5,6,9,16,12,12,4,9,9,5,14,11,4,5,9,11,4,16,12,14,10,5,12,12,10,4,2,16,10,10,9,8,11,8,5,1,7,10,8,3,2,2,3,1,3,2,1,1,1,1
"5006",2000040793,"Aryaman Trehan","3/14/1998 (25 years old)","D (R)","Águias do Moradal","Portuguese Castelo Branco First Division","IND","No","7/1/2022","-","$0","Right Only","Weak","Very Strong","5'8""","136 lbs","63","1",59,76,6,9,8,5,10,5,7,6,10,8,8,7,10,9,11,8,11,8,7,8,12,6,4,9,7,11,6,10,12,12,8,6,10,11,11,8,9,12,9,12,9,12,13,15,11,1,12,12,12,3,2,1,2,3,2,2,1,3,1,1
"5007",40035915,"Narender Gahlot","4/24/2001 (22 years old)","D (C)","Odisha","Indian National Division","IND","No","6/9/2022","5/31/2025","$3.5K - $35K","Left","Very Strong","Reasonable","6'0""","174 lbs","63","-",54,75,3,3,2,2,6,5,8,7,7,7,7,9,8,6,5,9,7,7,4,8,7,3,4,2,8,12,7,16,11,9,7,7,12,12,12,11,6,20,11,12,13,12,7,11,7,1,8,11,13,3,2,1,4,3,2,3,3,3,2,1
"5008",40037929,"Hormipam Ruivah","1/25/2001 (22 years old)","D (C)","Kerala","Indian National Division","IND","No","5/21/2023","5/31/2027","$35K - $100K","Right","Fairly Strong","Very Strong","5'11""","165 lbs","62","-",55,75,7,3,6,7,8,2,7,8,2,14,8,3,8,3,7,8,9,9,10,5,18,4,14,2,7,10,5,15,12,8,9,7,12,12,11,9,13,13,11,12,8,10,11,9,5,8,11,11,13,1,1,3,3,3,1,1,3,3,2,4
"5009",40029887,"Ashique Kuruniyan","6/14/1997 (25 years old)","WB/M/AM (L)","Kolkata","Indian National Division","IND","No","6/20/2022","5/31/2027","$1K - $12K","Left","Very Strong","Fairly Strong","5'10""","154 lbs","83","5",68,75,7,7,11,5,6,10,6,5,6,3,6,11,3,10,4,7,6,5,7,7,6,18,3,7,3,8,10,11,14,12,9,8,11,13,12,8,12,15,8,10,10,13,7,11,5,1,10,15,16,1,3,3,1,3,2,1,3,1,1,3
"5010",40035811,"Roshan Singh","1/2/1999 (24 years old)","D/WB (L)","Bengaluru","Indian National Division","IND","No","6/10/2022","5/31/2026","$3K - $28K","Left","Very Strong","Fairly Strong","5'8""","149 lbs","55","6",68,75,6,8,4,4,10,7,5,5,7,7,6,3,6,5,5,5,8,9,10,9,15,15,6,7,5,9,5,14,11,12,8,4,14,12,11,6,9,19,11,11,11,11,5,19,5,5,8,12,9,3,3,1,2,1,3,1,3,4,2,3
"5011",40030287,"Prabhsukhan Singh Gill","1/2/2001 (22 years old)","GK","Kerala","Indian National Division","IND","No","9/9/2020","6/30/2024","$18K - $180K","Left Only","Very Strong","Very Weak","6'0""","154 lbs","70","-",50,75,3,1,2,1,3,6,3,2,1,2,5,1,2,2,14,10,8,7,9,9,17,3,14,2,7,9,8,8,13,7,9,7,11,12,6,7,11,10,13,10,12,9,9,9,6,7,18,12,14,8,11,8,12,10,7,9,7,11,6,7
"5012",40011979,"Rahul Bheke","12/6/1990 (32 years old)","D (RC), WB (R)","Mumbai","Indian National Division","IND","No","6/3/2023","5/31/2024","$1K - $12K","Right","Fairly Strong","Very Strong","5'10""","165 lbs","202","7",69,75,4,4,3,2,6,11,7,4,18,10,5,12,9,6,5,4,9,10,9,5,16,9,12,6,10,13,6,15,11,11,6,6,10,11,13,8,18,11,13,12,9,11,6,11,9,1,10,14,18,3,3,1,3,3,3,2,3,1,1,3
"5013",2000230507,"Levi Renjaan","6/3/1997 (26 years old)","D/WB/M/AM (L)","Real Rincon","Bonaire Kampionato","BOE","Yes","7/1/2021","12/31/2024","$0","Left","Very Strong","Reasonable","5'10""","156 lbs","-","-",60,70,6,7,5,6,7,6,6,4,6,5,10,3,8,9,7,8,7,8,8,8,16,13,3,8,8,7,6,8,14,11,7,8,9,12,12,4,12,20,12,13,8,11,15,1,10,1,11,10,15,2,3,2,2,3,2,1,3,1,1,2
"5014",2000200546,"Shaliyanth Modugula","10/6/1998 (24 years old)","AM (R)","SV Kuchl","Austrian Salzburg League","IND","No","1/1/2023","6/30/2024","$0","Right Only","Weak","Very Strong","5'8""","149 lbs","17","3",63,74,4,6,7,6,7,4,7,5,5,1,10,1,3,8,8,5,2,7,6,8,10,10,9,8,5,6,7,8,13,13,6,4,9,13,13,7,13,17,11,10,13,10,9,9,5,2,9,10,15,2,2,1,3,3,2,2,1,1,3,1
"5015",40011292,"Amrinder Singh","5/27/1993 (30 years old)","GK","Odisha","Indian National Division","IND","No","5/11/2023","5/31/2026","$0 - $85K","Right","Reasonable","Very Strong","6'1""","176 lbs","204","-",74,74,5,3,2,3,7,7,2,2,2,1,6,3,2,9,14,8,9,11,12,6,14,1,14,2,10,11,10,10,9,11,11,14,12,10,10,12,10,14,11,16,14,15,8,7,8,1,8,14,18,7,12,12,12,9,9,9,5,12,9,10
"5016",40029043,"Manvir Singh","11/6/1995 (27 years old)","M/AM (R), ST (C)","Kolkata","Indian National Division","IND","No","5/27/2022","5/31/2027","$1K - $8K","Right","Reasonable","Very Strong","6'2""","171 lbs","127","20",62,73,6,6,6,10,5,7,10,5,4,6,9,11,6,8,7,5,12,9,7,10,7,8,5,11,5,12,8,15,10,9,7,10,12,11,14,14,5,19,12,11,9,10,7,10,14,6,9,11,12,4,1,1,1,2,1,3,3,2,1,1
"5017",2000110069,"Vedaant Nag","10/27/1996 (26 years old)","D/WB/M/AM (R)","USK Anif","Austrian Salzburg League","IND","No","7/27/2021","6/30/2024","$0","Right Only","Weak","Very Strong","6'1""","160 lbs","37","-",65,73,7,9,7,9,7,5,5,2,5,6,10,5,7,7,15,9,7,6,7,13,4,14,6,7,7,7,7,7,13,11,7,12,9,13,8,3,12,17,11,12,10,13,5,12,9,8,6,11,8,3,2,2,2,3,3,2,3,1,3,1
"5018",40037045,"Naorem Mahesh Singh","3/1/1999 (24 years old)","M/AM (L), ST (C)","Bengal","Indian National Division","IND","No","8/3/2022","5/31/2024","$28K - $85K","Left","Very Strong","Fairly Strong","5'9""","130 lbs","67","10",66,72,8,7,5,8,5,6,5,9,6,7,8,5,6,5,6,5,6,5,9,5,14,12,12,8,6,9,6,14,13,14,9,8,8,13,8,5,11,18,11,10,11,13,14,12,8,2,10,10,20,1,3,3,3,1,2,3,3,1,1,1
"5019",2000220024,"Brian Ellens","11/13/2000 (22 years old)","ST (C)","Valadares Gaia","Portugal Championship - Group B","IND","No","7/1/2022","6/30/2023","$0","Right Only","Weak","Very Strong","5'8""","145 lbs","20","12",50,70,4,1,13,13,10,5,12,5,1,4,5,2,3,5,7,9,4,5,2,9,15,5,14,13,6,5,5,6,13,12,6,1,7,13,5,3,8,19,7,10,11,11,12,5,8,1,10,13,16,3,1,3,2,1,1,1,1,1,1,3
"5020",43124959,"Taljinder Singh","2/14/1996 (27 years old)","AM (R)","Todi","Italian Promozione Umbria Grp.B","IND","Yes","6/15/2020","-","$0","Right","Reasonable","Very Strong","5'11""","154 lbs","-","-",50,70,5,10,11,6,10,3,5,4,2,4,6,2,2,7,8,7,1,5,4,7,10,11,10,9,4,5,1,6,12,12,5,7,11,12,8,3,11,13,9,11,11,12,11,3,6,1,13,9,12,2,3,1,2,1,1,2,2,3,1,1
"5021",40030278,"Dheeraj Singh","7/4/2000 (22 years old)","GK","Goa","Indian National Division","IND","No","1/15/2021","5/31/2024","$0 - $14K","Right","Reasonable","Very Strong","5'11""","154 lbs","63","-",52,70,2,1,1,3,1,4,3,3,2,1,4,3,2,6,13,6,11,7,9,11,18,3,3,2,8,7,8,8,6,13,9,9,12,7,12,6,9,18,11,12,9,8,11,9,9,8,8,11,11,12,6,9,11,10,7,8,3,12,11,6
"5022",40038032,"Himanshu Jangra","7/21/2004 (18 years old)","ST (C)","DFC","Indian National Football League","IND","No","6/12/2021","5/31/2026","$0 - $110K","Right","Reasonable","Very Strong","6'2""","167 lbs","22","2",50,69,3,6,7,10,6,8,6,8,3,8,5,6,5,8,7,8,7,7,6,8,11,8,4,10,6,9,5,14,10,9,11,7,11,11,7,8,5,12,13,11,8,8,8,2,10,4,8,12,13,1,1,1,1,2,2,1,3,1,2,2
"5023",40030720,"Mehtab Singh","6/5/1998 (25 years old)","D (C)","Mumbai","Indian National Division","IND","No","6/12/2023","5/31/2026","$0 - $60K","Right","Reasonable","Very Strong","5'11""","160 lbs","68","3",65,69,7,5,3,3,5,6,9,7,8,9,9,9,7,6,7,9,8,6,7,9,7,4,6,5,8,13,6,15,11,9,9,9,9,13,10,10,8,14,12,12,9,11,10,6,10,3,5,10,17,2,1,2,3,2,1,4,3,1,3,2
"5024",90051254,"Ivanny Calvenhoven","1/4/1991 (32 years old)","M (RL), AM (R)","Centro Dominguito","Kampionato Liga MCB - Promé Division","BOE","No","6/14/2021","6/30/2024","$0 - $12K","Right","Fairly Strong","Very Strong","5'6""","136 lbs","-","-",65,70,6,11,9,7,11,6,6,3,6,6,9,3,6,9,9,10,7,6,8,9,8,13,13,9,4,8,5,13,11,12,5,1,9,11,8,3,13,13,11,10,11,9,5,5,5,6,8,10,13,2,1,2,3,2,2,2,2,4,4,4
"5025",40035642,"Nandha Kumar Sekar","12/20/1995 (27 years old)","M/AM (RL)","Bengal","Indian National Division","IND","No","6/10/2023","5/31/2026","$0 - $60K","Right","Fairly Strong","Very Strong","5'8""","143 lbs","88","12",58,69,4,6,11,5,6,6,6,6,5,5,7,3,7,5,10,6,3,7,7,6,5,11,3,7,4,8,6,15,11,12,7,4,11,13,12,6,9,13,11,12,12,12,7,10,5,2,13,11,9,3,2,1,4,2,2,3,2,3,3,2
"5026",40027273,"Subhasish Bose","8/18/1995 (27 years old)","D (LC), WB (L)","Kolkata","Indian National Division","IND","No","5/31/2020","5/31/2025","$7K - $20K","Left","Very Strong","Reasonable","6'0""","169 lbs","138","5",57,68,2,2,1,1,3,4,9,6,8,10,4,10,6,2,12,9,11,7,9,9,12,4,5,2,7,11,3,14,9,10,7,11,11,10,11,11,5,11,10,10,11,12,9,9,11,4,11,11,13,2,1,1,1,2,4,2,2,4,2,1
"5027",40036767,"Ritwik Das","12/14/1996 (26 years old)","M/AM (R)","Jamshedpur","Indian National Division","IND","No","10/26/2021","5/31/2024","$1.5K - $16K","Right","Reasonable","Very Strong","5'10""","156 lbs","65","14",50,68,8,6,7,3,4,6,5,5,6,3,7,3,7,6,4,6,9,6,5,6,16,13,4,6,4,10,7,13,11,10,9,6,11,11,10,6,14,20,12,11,10,10,14,10,6,4,5,9,17,3,3,3,1,3,1,3,2,3,2,3
"5028",40035521,"Mohammed Yasir","4/14/1998 (25 years old)","M (L), AM (RLC)","Hyderabad","Indian National Division","IND","No","2/17/2020","5/31/2025","$26K - $80K","Left Only","Very Strong","Weak","5'7""","149 lbs","77","6",65,67,8,7,5,4,7,9,6,8,9,9,8,4,6,8,9,6,8,8,10,5,17,8,12,16,9,10,6,16,13,13,10,7,16,13,11,9,12,16,10,11,13,10,12,9,12,1,8,10,11,3,3,3,3,1,1,2,1,1,2,2
"5029",40022828,"Pritam Kotal","9/8/1993 (29 years old)","D (RC), WB (R)","Kolkata","Indian National Division","IND","No","1/1/2019","6/30/2024","$0","Right","Reasonable","Very Strong","5'8""","163 lbs","226","8",59,66,4,4,3,2,5,4,5,4,9,5,8,12,7,6,7,6,8,4,3,5,14,9,12,4,9,12,5,16,12,10,8,8,10,14,11,8,8,14,14,14,14,15,7,7,7,3,7,10,8,3,2,1,2,3,2,3,3,1,3,3
"5030",40007654,"Rowllin Borges","6/5/1992 (31 years old)","DM, M (C)","Goa","Indian National Division","IND","No","6/5/2021","5/31/2024","$0 - $55K","Right","Reasonable","Very Strong","6'0""","158 lbs","161","12",65,66,6,4,3,5,7,7,11,7,5,6,9,13,5,7,7,8,7,7,12,9,16,2,5,4,8,12,6,17,10,12,9,9,11,12,12,8,10,15,10,11,13,18,7,11,12,3,12,11,11,4,3,1,1,3,1,1,2,3,3,2
"5031",40029598,"Chinglensana Singh","11/23/1996 (26 years old)","D (C)","Hyderabad","Indian National Division","IND","No","8/5/2021","5/31/2025","$0 - $85K","Right","Weak","Very Strong","6'1""","176 lbs","116","4",65,66,4,6,5,3,7,3,9,6,4,8,13,8,6,11,11,12,10,7,10,10,8,7,13,7,9,12,8,15,12,12,12,11,12,12,13,10,7,10,9,9,11,12,6,15,9,3,6,10,9,2,3,1,1,3,3,2,1,3,2,2
"5032",40029009,"Nikhil Poojary","9/3/1995 (27 years old)","D/WB/M/AM (R)","Hyderabad","Indian National Division","IND","No","2/17/2023","5/31/2026","$20K - $65K","Right","Reasonable","Very Strong","5'10""","141 lbs","91","2",60,65,7,4,3,3,5,6,3,6,3,2,4,10,2,5,7,7,5,6,9,12,7,9,13,7,4,11,11,16,11,9,7,4,11,13,11,9,13,20,10,12,10,12,7,3,8,4,11,12,19,1,3,2,2,3,3,1,1,2,2,2
"5033",2000224989,"Shlok Kaul","3/21/2005 (18 years old)","M/AM (C)","Etoile Carouge","Swiss Promotion League","IND","No","9/16/2021","6/30/2024","$3.5K - $10K","Right Only","Weak","Very Strong","5'8""","143 lbs","-","-",54,65,5,5,7,10,7,5,6,5,1,5,8,1,6,8,14,5,7,4,4,10,7,13,1,5,6,6,10,10,14,14,7,8,7,14,6,4,10,20,8,10,12,10,5,7,6,1,9,11,15,2,3,2,3,2,2,1,3,3,1,2
"5034",40036916,"Gurmeet Singh","12/3/1999 (23 years old)","GK","Hyderabad","Indian National Division","IND","No","7/30/2021","5/31/2024","$0 - $65K","Right","Weak","Very Strong","6'0""","176 lbs","24","-",50,65,2,3,1,3,1,6,1,3,1,1,8,3,3,3,9,7,9,6,12,7,11,2,12,3,9,6,3,5,11,8,5,9,13,13,1,11,11,18,13,10,13,13,6,9,15,6,18,9,14,3,5,7,7,9,6,7,5,6,11,9
"5035",2000252863,"Jurneth Clara","8/6/2002 (20 years old)","M/AM (R)","SV Uruguay","Bonaire Kampionato","BOE","No","1/1/2021","12/31/2023","$0","Left","Very Strong","Weak","5'9""","147 lbs","-","-",51,70,4,8,12,7,9,4,1,3,1,2,6,1,5,6,5,8,4,2,5,9,5,10,12,7,4,5,5,8,12,12,5,7,7,12,5,2,11,20,9,11,11,12,10,4,7,4,9,11,12,2,2,3,1,2,2,2,2,1,2,2
"5036",40026221,"Vishal Kaith","7/22/1996 (26 years old)","GK","Kolkata","Indian National Division","IND","No","7/8/2022","5/31/2025","$6K - $18K","Right","Reasonable","Very Strong","6'2""","171 lbs","128","-",61,65,3,2,2,2,5,5,2,2,3,1,5,3,3,8,11,10,10,8,7,8,17,2,5,2,8,10,9,9,7,9,9,12,11,7,6,10,7,10,11,11,13,9,10,8,9,6,4,12,7,6,6,12,11,8,9,9,5,8,11,10
"5037",40035831,"Asish Rai","1/27/1999 (24 years old)","D/WB (R)","Kolkata","Indian National Division","IND","No","6/20/2022","5/31/2025","$10K - $100K","Right Only","Very Weak","Very Strong","5'9""","147 lbs","99","1",63,65,6,5,4,3,6,8,6,6,7,8,5,9,9,7,5,8,6,6,8,8,15,11,5,7,7,12,7,17,13,12,8,5,14,13,12,5,11,17,13,13,9,9,7,8,7,7,10,11,14,3,3,1,2,2,1,1,1,1,3,3
"5038",2000047383,"Ishan Pandita","5/26/1998 (25 years old)","AM (RL), ST (C)","Jamshedpur","Indian National Division","IND","No","8/31/2021","6/30/2024","$2K - $18K","Right","Weak","Very Strong","6'0""","171 lbs","45","9",55,65,5,4,5,8,7,5,8,7,5,8,7,2,4,6,5,9,8,7,8,6,6,6,2,8,9,9,7,11,10,7,9,8,12,11,12,12,10,12,9,12,11,12,14,9,13,6,19,12,18,1,2,3,2,1,3,1,1,3,2,1
"5039",30052374,"Raphael Lea'i","9/9/2003 (19 years old)","AM (RL), ST (C)","Velež Mostar","Bosnian Premier League","SOL","No","1/29/2023","6/30/2024","$20K - $190K","Left","Very Strong","Fairly Strong","5'7""","130 lbs","59","85",85,110,6,6,13,9,8,6,4,8,7,4,7,8,4,10,7,12,6,7,9,8,6,11,5,11,7,8,9,6,14,13,9,6,9,14,6,5,11,11,9,7,10,11,12,6,11,7,11,8,7,3,2,3,3,3,3,3,2,3,2,2
"5040",88023472,"Micah Lea'alafa","6/1/1991 (32 years old)","M/AM (R), ST (C)","FK Beograd","National Premier Leagues - South Australia","SOL","No","2/22/2023","9/30/2023","$0 - $30K","Right","Weak","Very Strong","5'6""","143 lbs","93","36",85,95,6,8,14,8,12,7,5,8,2,3,7,8,6,12,11,8,9,7,6,9,14,12,6,11,9,8,9,6,15,13,7,7,10,14,10,8,7,15,10,12,12,13,4,4,5,3,6,13,11,1,1,1,1,2,1,2,1,3,3,2
"5041",15005750,"Henry Fa'arodo","10/5/1982 (40 years old)","M/AM (RC)","Franklin United","New Zealand NRFL Conference","SOL","No","1/4/2022","-","$0","Right Only","Weak","Very Strong","5'8""","154 lbs","212","62",63,90,5,10,12,11,11,4,9,8,1,2,9,7,5,12,7,12,3,7,8,7,10,12,6,12,7,9,10,12,10,13,14,8,10,10,10,4,12,12,12,8,7,8,5,8,10,4,11,10,17,3,3,1,2,1,1,1,2,3,1,1
"5042",2000034047,"Ben Fox","7/6/2001 (21 years old)","M/AM (C)","Marist","Solomon Islands S-League","SOL","No","1/1/2019","12/31/2025","$0","Left","Very Strong","Reasonable","5'5""","127 lbs","65","2",65,86,9,3,7,7,8,9,1,4,1,7,13,1,6,13,6,8,3,8,6,9,14,13,11,7,7,7,11,12,13,13,6,4,9,13,7,1,9,13,11,11,8,14,11,18,15,4,5,12,15,2,2,1,2,1,2,2,1,2,3,1
"5043",2000067713,"Alden Suri","4/7/2004 (19 years old)","AM (RL), ST (C)","Petone","New Zealand Central League","SOL","No","6/13/2022","-","$0","Right Only","Weak","Very Strong","5'6""","136 lbs","-","-",56,84,6,6,11,6,8,5,3,7,6,7,6,8,4,9,11,4,12,5,4,4,9,13,7,5,3,6,5,11,14,13,15,6,10,12,6,4,7,19,10,12,13,12,5,7,8,7,10,13,19,2,4,1,2,3,2,1,3,3,2,1
"5044",2000034090,"Javin Wae","11/17/2002 (20 years old)","D (C), DM","Manukau United","New Zealand Northern League","SOL","No","6/12/2023","-","$0","Right","Reasonable","Very Strong","6'2""","182 lbs","87","17",67,83,5,2,4,6,6,9,6,4,1,9,9,10,10,8,7,9,11,8,9,9,13,5,11,7,10,9,9,11,7,8,9,14,8,9,9,10,13,11,11,11,11,9,8,6,8,7,8,14,17,3,3,1,2,1,1,1,2,2,2,3
"5045",88021809,"Joses Nawo","5/3/1988 (35 years old)","AM (R), ST (C)","KOSSA","Solomon Islands S-League","SOL","No","4/30/2021","12/31/2024","$0","Left","Very Strong","Weak","5'7""","145 lbs","84","69",68,81,7,10,12,16,13,7,10,7,8,8,13,8,4,11,13,8,6,10,9,13,15,9,13,11,8,9,9,10,11,9,6,7,10,7,7,4,11,16,11,10,10,8,7,4,13,3,19,13,19,2,3,3,2,4,1,1,1,2,2,1
"5046",82089123,"Alberseeto Cecilia","11/19/1996 (26 years old)","GK","SV Vespo","Bonaire Kampionato","BOE","No","6/15/2020","12/31/2023","$0","Right","Weak","Very Strong","6'4""","178 lbs","-","-",57,70,4,3,3,2,1,6,1,1,1,1,8,1,3,2,14,8,8,4,6,12,11,1,9,1,8,5,4,4,11,12,5,11,12,8,4,3,8,10,13,11,12,10,8,10,5,3,9,10,11,5,6,12,8,7,5,12,11,5,7,12
"5047",2000030220,"Ali Mekawir","7/27/2000 (22 years old)","AM (R), ST (C)","TFA","UAE Third Division","SOL","No","9/1/2022","-","$0","Right","Reasonable","Very Strong","6'0""","165 lbs","53","16",71,80,3,6,13,8,13,6,8,7,6,5,10,5,1,8,14,9,3,11,6,7,12,13,6,12,6,7,6,8,13,8,7,9,11,13,11,6,13,17,12,12,15,11,7,4,10,8,13,13,19,1,2,2,1,2,3,3,4,1,1,1
"5048",2000064256,"Don Keana","9/9/2000 (22 years old)","M/AM (C)","Waneagu","Solomon Islands S-League","SOL","No","6/1/2023","12/31/2024","$0","Right","Reasonable","Very Strong","5'7""","134 lbs","33","1",69,79,4,5,8,9,9,6,3,8,3,8,11,4,5,10,9,10,3,6,8,9,6,9,12,8,8,8,9,11,14,12,7,6,11,13,6,5,15,19,10,10,10,10,10,14,11,5,19,12,15,1,3,3,2,1,1,1,1,1,1,3
"5049",88020689,"Gagame Feni","8/21/1992 (30 years old)","AM (L), ST (C)","KOSSA","Solomon Islands S-League","SOL","No","4/30/2021","12/31/2024","$1.5K - $4.5K","Right Only","Weak","Very Strong","5'7""","143 lbs","135","102",73,79,6,9,8,7,13,7,8,6,7,4,7,4,6,10,7,11,8,10,10,10,4,12,1,12,6,10,8,10,12,12,8,6,14,13,10,6,12,14,9,11,14,12,14,8,5,3,10,7,12,3,2,3,3,2,4,1,4,1,2,2
"5050",2000116203,"Edward Osifelo","9/12/1997 (25 years old)","DM, M (C)","Marist","Solomon Islands S-League","SOL","No","1/1/2021","12/31/2024","$0","Right","Reasonable","Very Strong","6'0""","169 lbs","39","2",56,79,5,1,4,4,13,5,5,12,1,7,11,1,11,12,8,6,7,6,7,4,11,6,10,7,8,7,4,12,13,10,6,6,11,11,13,9,13,13,13,10,12,11,7,8,5,3,11,12,19,1,3,1,3,4,3,2,3,3,4,1
"5051",2000034102,"William Komasi","6/10/2000 (23 years old)","DM, M (C)","Central Coast (SOL)","Solomon Islands S-League","SOL","No","12/31/2022","12/31/2025","$0 - $4K","Right","Reasonable","Very Strong","5'10""","163 lbs","69","8",73,78,7,7,3,6,13,10,6,9,5,10,10,3,10,8,10,10,8,9,9,14,13,5,13,8,9,8,9,7,14,14,8,4,7,14,6,7,11,12,11,12,13,11,13,3,11,5,12,9,15,1,2,1,3,1,3,1,2,2,1,2
"5052",2000034048,"Bobby Leslie","4/3/2000 (23 years old)","AM (R), ST (C)","Waneagu","Solomon Islands S-League","SOL","No","4/30/2021","12/31/2024","$0","Right","Reasonable","Very Strong","5'9""","154 lbs","77","48",70,77,4,9,13,13,10,6,13,5,2,2,7,5,5,6,11,9,5,8,4,10,16,7,1,12,7,6,8,8,13,11,7,6,10,11,6,6,10,15,10,11,11,12,7,11,13,8,9,11,18,1,3,3,3,3,1,2,1,3,1,1
"5053",2000033131,"David Supa","12/21/2000 (22 years old)","D (LC)","Central Coast (SOL)","Solomon Islands S-League","SOL","No","7/1/2022","12/31/2025","$0","Left","Very Strong","Reasonable","6'3""","176 lbs","86","5",62,77,5,8,5,3,5,3,8,2,4,13,7,4,9,7,9,7,7,7,7,14,13,5,14,6,7,7,3,7,9,8,7,16,12,11,7,6,11,12,11,9,8,10,12,9,9,5,12,11,20,1,1,1,3,2,4,3,1,1,3,3
"5054",2000038333,"Prince Tahunipue","1/13/1995 (28 years old)","D/WB (L)","Central Coast (SOL)","Solomon Islands S-League","SOL","No","6/1/2023","12/31/2024","$0","Left","Very Strong","Reasonable","5'10""","167 lbs","65","7",69,75,10,10,2,4,7,3,7,3,6,6,8,1,12,7,10,6,8,5,12,10,11,5,13,6,7,7,7,7,14,14,7,6,10,14,9,12,13,13,9,10,12,12,11,11,5,7,15,10,10,1,2,2,1,2,2,3,1,2,2,3
"5055",88027887,"Dennis Ifunaoa","11/9/1991 (31 years old)","AM (RL)","Solomon Warriors","Solomon Islands S-League","SOL","No","7/2/2019","12/31/2024","Not for Sale","Left","Very Strong","Reasonable","5'10""","156 lbs","73","36",65,75,7,10,6,10,10,2,5,7,6,6,9,6,5,10,8,8,6,9,10,9,10,8,12,10,7,8,7,10,10,8,8,6,10,10,15,5,11,16,11,12,8,11,12,10,5,4,16,10,12,1,1,1,2,1,3,1,1,1,2,3
"5056",2000033927,"Molis Junior Gagame","9/14/1999 (23 years old)","M (C)","KOSSA","Solomon Islands S-League","SOL","No","7/1/2022","12/31/2025","$0","Right","Fairly Strong","Very Strong","5'8""","145 lbs","78","2",67,75,6,4,3,6,14,6,6,9,1,8,14,4,5,13,12,8,7,8,6,14,16,5,5,7,5,7,7,11,11,13,7,2,9,13,6,4,10,14,11,9,12,9,5,17,9,4,8,9,18,1,3,1,2,3,3,1,1,4,3,3
"5057",82089762,"Giovanie Makaai","11/10/1988 (34 years old)","ST (C)","Flamingo","Bonaire Kampionato","BOE","No","7/1/2018","-","$0","Right","Reasonable","Very Strong","6'1""","176 lbs","-","-",68,68,5,2,5,14,13,6,11,6,2,6,7,8,3,11,5,12,6,10,6,12,15,10,4,14,7,6,6,7,7,10,2,11,5,11,11,8,9,13,9,10,11,12,14,11,7,6,10,12,10,2,3,1,2,3,1,2,1,4,1,3
"5058",2000067704,"Junior Petua","12/30/2003 (19 years old)","GK","Honiara City","Solomon Islands S-League","SOL","No","1/1/2020","12/31/2025","$0","Right","Reasonable","Very Strong","6'1""","167 lbs","45","-",63,75,2,3,1,2,3,3,4,1,3,2,11,3,1,5,5,8,10,8,9,9,15,1,14,3,11,10,9,9,11,11,10,16,8,14,6,7,9,18,11,13,11,11,15,16,5,3,8,10,13,9,10,11,3,9,10,11,10,6,6,6
"5059",30052799,"Aengari Gagame","4/15/2000 (23 years old)","D (RL)","Solomon Warriors","Solomon Islands S-League","SOL","No","6/15/2020","12/31/2025","$0","Right","Reasonable","Very Strong","5'9""","149 lbs","63","5",68,75,6,9,4,2,6,1,7,4,6,8,3,2,12,3,13,10,8,7,12,14,1,8,6,5,10,7,5,7,14,14,7,9,9,14,7,6,14,13,10,10,12,11,14,3,6,5,10,13,20,4,1,3,2,2,1,1,3,1,3,2
"5060",2000116210,"Norman Ngafu","7/16/1997 (25 years old)","AM (LC)","Marist","Solomon Islands S-League","SOL","No","1/1/2021","12/31/2024","$0","Right","Reasonable","Very Strong","5'9""","145 lbs","26","6",67,75,6,8,13,6,8,6,6,8,2,6,9,5,6,5,14,10,5,7,4,12,13,8,3,10,7,7,9,8,14,14,7,6,12,14,7,4,10,11,12,10,10,12,5,5,11,3,9,8,16,2,3,2,3,2,2,1,3,1,2,3
"5061",88000784,"Haddis Aengari","10/23/1988 (34 years old)","D (RC)","Solomon Warriors","Solomon Islands S-League","SOL","No","6/14/2021","12/31/2024","$0","Right","Reasonable","Very Strong","6'1""","169 lbs","77","9",61,75,5,9,6,1,8,1,11,5,5,10,7,5,13,5,5,8,8,7,9,12,15,5,11,6,8,7,6,8,7,10,8,15,16,9,12,6,11,17,13,11,12,9,5,6,10,8,12,11,13,4,3,4,1,1,1,3,2,3,3,4
"5062",30052667,"Leon Kofana","6/22/2002 (20 years old)","D (C)","Henderson Eels","Solomon Islands S-League","SOL","No","11/17/2019","12/31/2025","$0","Right","Fairly Strong","Very Strong","6'2""","169 lbs","57","1",65,74,1,5,1,3,7,1,6,3,1,10,6,2,10,2,13,13,5,7,9,12,3,5,8,6,14,6,6,7,10,11,7,11,13,10,4,5,8,17,10,7,13,11,12,8,9,2,10,10,20,2,2,3,2,1,1,1,2,4,4,3
"5063",88025897,"Michael Boso","9/3/1991 (31 years old)","D (C)","Palmerston North Marist","New Zealand Central Federation League","SOL","No","2/1/2019","-","$0","Right","Reasonable","Very Strong","5'11""","174 lbs","50","5",65,74,2,1,2,3,4,2,11,3,3,10,5,2,11,5,12,8,12,8,8,8,11,5,11,8,8,9,7,12,10,12,12,10,5,11,9,11,3,17,9,11,10,9,9,14,8,6,20,11,18,2,1,1,2,4,1,2,3,3,3,2
"5064",2000090202,"Jaygray Sipakana","12/27/1992 (30 years old)","AM (R), ST (C)","Solomon Warriors","Solomon Islands S-League","SOL","No","12/31/2022","12/31/2024","$0","Right","Fairly Strong","Very Strong","6'0""","165 lbs","28","18",67,73,5,5,6,11,13,5,2,7,5,3,10,2,4,9,11,10,2,5,5,9,13,12,8,6,5,6,5,7,13,13,7,9,12,13,6,7,10,19,14,13,9,12,12,15,11,5,20,14,11,3,2,3,2,2,3,2,3,3,3,2
"5065",30052790,"Junior David","9/22/2001 (21 years old)","D/WB (R)","Central Coast (SOL)","Solomon Islands S-League","SOL","No","6/1/2023","12/31/2025","$0","Right","Reasonable","Very Strong","5'10""","143 lbs","41","-",68,73,6,10,4,5,11,10,9,6,8,6,9,4,12,6,10,10,11,9,10,14,14,5,9,11,6,9,9,12,9,9,12,8,8,10,7,11,12,19,9,9,12,11,12,6,6,4,11,12,10,1,1,3,2,2,3,2,2,2,1,1
"5066",30052844,"Alvin Hou","9/18/1996 (26 years old)","AM (RL)","Solomon Warriors","Solomon Islands S-League","SOL","No","6/12/2023","12/31/2024","$0","Left Only","Very Strong","Very Weak","5'7""","136 lbs","57","17",67,72,4,8,12,8,9,5,5,6,4,5,11,4,6,8,7,6,7,6,4,12,4,9,3,10,3,6,8,7,13,13,6,3,10,13,11,1,12,18,11,13,11,11,9,8,13,5,10,12,12,2,2,3,1,1,2,2,2,2,1,1
"5067",2000300155,"Davidson Otai","10/18/1988 (34 years old)","D (C)","Juniper","Solomon Islands S-League","SOL","No","6/12/2023","-","$0","Right","Reasonable","Very Strong","5'11""","154 lbs","-","-",57,72,2,1,2,2,6,1,11,5,1,12,6,2,13,5,8,13,5,6,7,13,7,5,4,5,9,5,5,6,7,9,6,10,10,8,10,3,15,15,11,10,10,14,8,7,8,5,8,11,15,4,2,3,1,3,1,4,3,2,1,1
"5068",2000308149,"Daymerick Casper","11/8/2000 (22 years old)","M (C)","Young Boys (BON)","Bonaire Kampionato","BOE","Yes","7/1/2022","-","$0","Right","Reasonable","Very Strong","5'11""","158 lbs","-","-",59,68,3,5,2,4,8,6,4,5,1,10,14,3,6,11,13,10,5,6,5,10,6,5,13,7,11,8,8,12,11,12,7,9,12,10,7,5,12,10,11,8,10,12,13,1,15,8,12,11,11,3,1,2,2,2,3,2,1,2,4,4
"5069",88006498,"Andrew Abba","11/25/1989 (33 years old)","M/AM (RL)","Takapuna","New Zealand Northern League","SOL","No","1/6/2020","-","$0","Right Only","Weak","Very Strong","5'3""","125 lbs","105","29",62,72,6,8,11,8,14,7,2,8,7,3,12,7,7,10,14,9,4,9,5,6,7,11,5,12,5,9,7,10,13,12,8,5,7,12,6,4,9,16,10,11,11,10,9,16,6,7,11,11,9,3,3,2,2,3,4,2,1,2,3,3
"5070",2000067823,"Calvin Ohasio","4/5/2000 (23 years old)","D (RL)","Marist","Solomon Islands S-League","SOL","No","12/31/2022","12/31/2025","$0","Left","Very Strong","Reasonable","5'10""","152 lbs","28","3",66,72,5,9,5,4,8,1,7,6,5,8,4,5,11,6,7,8,8,5,6,8,10,5,2,5,6,8,7,15,14,13,7,6,12,14,11,6,11,14,9,9,13,10,9,8,15,2,7,10,8,2,3,2,3,3,3,2,1,1,1,1
"5071",30052909,"Adrian Mara","8/1/1998 (24 years old)","ST (C)","Henderson Eels","Solomon Islands S-League","SOL","No","4/30/2021","12/31/2025","$0","Right","Fairly Strong","Very Strong","5'10""","163 lbs","84","46",59,72,5,2,11,10,9,5,8,7,1,5,7,2,1,6,5,7,7,11,5,11,17,14,12,10,4,5,4,7,12,11,11,8,9,12,10,8,10,12,11,13,14,10,5,7,7,6,11,10,17,1,2,3,2,3,1,3,1,2,3,3
"5072",2000245886,"John Alo","9/16/2003 (19 years old)","M/AM (C), ST (C)","Sosa (SOL)","Solomon Islands S-League","SOL","No","12/31/2022","12/31/2023","$0","Right","Weak","Very Strong","5'11""","158 lbs","7","-",55,72,6,3,8,7,14,6,7,7,2,7,8,4,8,9,10,4,4,6,5,14,12,8,8,8,3,7,9,7,12,10,7,8,11,10,8,5,8,16,11,13,10,12,10,7,8,6,7,10,8,3,2,3,2,3,1,3,3,3,4,3
"5073",30052751,"Boni Pride","9/10/1995 (27 years old)","D (RC)","Logan Roos","Football Queensland Premier League 6 - Metro","SOL","No","1/1/2022","-","$0","Right","Fairly Strong","Very Strong","5'11""","158 lbs","72","11",62,72,1,4,1,2,6,1,9,2,2,8,6,4,8,5,12,8,7,6,5,13,8,5,11,4,12,5,1,6,13,13,6,9,11,13,10,5,12,15,11,9,9,9,11,16,8,3,8,12,18,2,1,1,2,2,4,1,3,3,2,2
"5074",2000034101,"Philip Ropa","10/21/2002 (20 years old)","M/AM (R)","Waneagu","Solomon Islands S-League","SOL","No","5/13/2021","12/31/2025","$0","Right","Reasonable","Very Strong","6'1""","165 lbs","59","10",62,71,6,9,6,9,12,5,5,6,5,2,8,3,2,10,9,3,4,5,6,5,4,10,12,8,3,7,5,11,13,13,6,11,12,13,6,4,13,19,10,8,10,10,8,2,12,3,10,9,14,2,2,3,3,2,1,2,2,2,1,3
"5075",2000034035,"Martin Saleimanu","8/17/1984 (38 years old)","D (RC)","Sosa (SOL)","Solomon Islands S-League","SOL","No","12/31/2022","12/31/2023","$0","Right","Weak","Very Strong","6'0""","167 lbs","63","2",54,71,6,9,7,7,8,3,8,5,4,11,9,5,7,5,8,8,8,9,8,15,4,5,2,7,11,8,5,9,8,8,7,11,15,6,8,6,14,14,12,12,11,11,5,8,11,4,20,9,8,1,3,2,2,3,3,3,1,4,2,3
"5076",2000032380,"Ian Kalu","7/16/1999 (23 years old)","D/WB (L)","Napier City Rovers","New Zealand Central League","SOL","No","2/20/2023","-","$0","Left","Very Strong","Weak","5'11""","152 lbs","48","5",66,71,4,7,4,4,8,1,7,5,1,11,7,1,11,6,5,9,8,7,9,8,8,6,11,6,11,7,7,7,14,14,7,7,14,14,4,5,12,12,10,13,10,11,9,12,9,7,9,9,9,3,2,3,3,1,1,1,1,3,3,3
"5077",2000271257,"John Orobulu","6/24/1999 (23 years old)","ST (C)","Southern Utd (SOL)","Solomon Islands S-League","SOL","No","6/15/2020","12/31/2023","$0","Right","Weak","Very Strong","5'11""","165 lbs","-","-",63,70,4,4,11,11,7,6,7,7,1,2,7,6,1,11,5,11,5,12,7,11,5,11,10,10,7,6,6,8,10,9,7,9,12,11,10,10,8,14,9,11,12,8,9,13,7,3,18,13,10,1,1,3,2,2,1,3,2,2,3,2
"5078",2000245270,"Micheal Laulae","5/20/2002 (21 years old)","GK","Henderson Eels","Solomon Islands S-League","SOL","No","1/1/2022","12/31/2025","$0","Right","Reasonable","Very Strong","6'1""","167 lbs","18","-",54,70,1,3,3,3,1,4,1,3,2,2,9,3,3,1,15,12,12,5,6,12,4,3,3,2,5,6,1,4,6,13,6,9,9,6,1,3,9,10,10,12,10,12,5,9,8,8,20,11,10,7,10,13,6,7,8,11,5,7,11,7
"5079",82089118,"Jurven Clara","1/21/1999 (24 years old)","GK","SV Uruguay","Bonaire Kampionato","BOE","Yes","6/15/2020","12/31/2023","$0","Right","Weak","Very Strong","6'5""","185 lbs","-","-",58,66,1,1,1,2,4,5,1,3,2,2,7,2,1,1,5,8,15,4,8,11,10,2,4,3,9,6,5,5,11,13,6,14,15,9,5,8,8,19,11,11,13,11,6,12,5,2,13,12,15,6,9,8,9,6,11,9,5,7,11,8
"5080",2000300156,"Philip Feni","11/19/1999 (23 years old)","M/AM (C)","Juniper","Solomon Islands S-League","SOL","No","6/12/2023","-","$0","Right","Reasonable","Very Strong","5'10""","152 lbs","-","-",58,70,5,6,8,11,12,1,2,8,2,7,10,6,6,10,13,10,4,12,7,9,5,11,12,8,8,7,6,8,10,11,7,5,15,12,8,5,16,12,10,9,11,9,5,7,6,8,15,11,8,3,3,3,1,3,3,1,2,1,2,2
"5081",2000300158,"Sammy Mae","12/10/2002 (20 years old)","D (L)","Juniper","Solomon Islands S-League","SOL","No","6/12/2023","-","$0","Left","Very Strong","Reasonable","6'0""","167 lbs","-","-",55,70,5,12,6,1,11,4,6,6,7,4,8,1,10,9,11,8,9,5,9,12,12,10,8,7,11,8,8,8,13,10,3,10,10,11,5,6,12,20,10,10,11,11,9,2,11,4,10,11,19,3,1,2,1,2,1,2,2,3,3,3
"5082",88025968,"Andrew Rarangia","6/1/1994 (29 years old)","D (C)","KOSSA","Solomon Islands S-League","SOL","No","7/1/2018","12/31/2024","$0","Right","Reasonable","Very Strong","6'0""","165 lbs","70","1",60,70,3,3,2,1,6,1,9,3,1,12,6,2,13,4,14,5,8,6,9,11,13,5,10,5,8,5,1,4,13,9,6,9,14,12,9,8,9,16,11,11,14,11,5,9,11,7,12,10,9,1,1,1,1,3,3,3,3,2,1,1
"5083",2000034065,"Mathew Fagono","7/6/2000 (22 years old)","M (R), AM (RL)","Honiara City","Solomon Islands S-League","SOL","No","7/1/2022","12/31/2025","$0","Right","Reasonable","Very Strong","6'2""","165 lbs","69","18",63,70,4,10,6,7,10,2,2,4,5,5,12,5,4,6,6,4,7,6,6,7,17,7,8,11,5,6,7,7,13,13,6,7,15,13,6,4,14,13,11,11,10,13,10,12,9,5,20,11,12,2,3,3,3,2,3,3,2,1,2,3
"5084",88027868,"Darold Kakasi","2/7/1999 (24 years old)","AM (RL)","Ba","Fijian Premier League","SOL","No","7/1/2022","12/31/2025","$0","Right","Reasonable","Very Strong","6'2""","171 lbs","71","15",60,69,7,5,10,7,6,8,8,8,8,5,9,7,5,6,8,12,7,10,7,6,6,7,13,9,9,9,9,8,10,12,7,16,10,14,12,6,12,17,10,11,10,11,14,17,13,5,11,11,9,1,2,1,1,2,3,3,1,2,1,1
"5085",2000036490,"Alford Kanahanimae","10/1/2002 (20 years old)","DM, M (C)","Henderson Eels","Solomon Islands S-League","SOL","No","7/1/2022","12/31/2025","$0","Right","Reasonable","Very Strong","6'0""","158 lbs","70","8",63,69,3,5,5,7,6,1,6,8,6,8,7,2,11,5,15,6,5,8,8,14,6,5,11,7,9,5,6,9,14,14,7,6,14,14,5,5,12,19,11,13,13,12,5,8,12,5,20,11,20,1,2,1,2,2,2,2,3,1,1,3
"5086",2000116264,"Coleman Wasi","5/20/1989 (34 years old)","M (C), AM (RC)","Laugu","Solomon Islands S-League","SOL","No","7/1/2022","12/31/2024","$0","Right","Fairly Strong","Very Strong","5'8""","147 lbs","43","15",60,69,6,5,9,8,9,6,6,4,6,5,9,3,7,6,10,8,6,7,6,11,16,5,7,13,7,8,12,13,8,11,3,4,8,10,8,4,10,10,15,9,10,13,11,13,7,5,9,13,20,3,3,2,1,2,3,1,1,2,2,2
"5087",2000300152,"Christia'an Ohasio","4/4/2000 (23 years old)","D (RC)","Marist","Solomon Islands S-League","SOL","No","7/1/2022","12/31/2025","$0","Right","Reasonable","Very Strong","6'3""","171 lbs","12","3",61,69,3,8,6,1,5,6,5,1,2,10,7,6,7,4,15,7,7,7,8,11,2,5,10,6,11,7,6,8,14,11,8,15,16,12,8,7,13,16,11,11,12,12,11,2,8,6,7,11,11,2,1,2,2,3,2,1,4,2,1,1
"5088",30052759,"Allen Peter","9/11/1995 (27 years old)","D (C)","Solomon Warriors","Solomon Islands S-League","SOL","No","7/1/2022","12/31/2024","$0","Right","Weak","Very Strong","6'4""","178 lbs","68","6",61,68,3,2,1,6,6,2,6,6,1,10,7,1,9,7,11,8,8,7,10,9,8,5,11,5,10,6,7,8,14,11,7,15,15,13,5,9,13,12,10,10,12,8,12,14,15,4,14,11,18,2,1,1,1,2,2,1,2,3,1,2
"5089",2000034029,"Stanton Alick","5/25/1998 (25 years old)","D (RC)","Central Coast (SOL)","Solomon Islands S-League","SOL","No","7/1/2022","12/31/2024","$0","Right","Reasonable","Very Strong","6'4""","176 lbs","62","3",63,68,1,5,3,1,7,1,5,1,2,8,6,2,13,3,10,7,8,6,7,12,12,5,11,5,13,5,1,7,13,12,6,12,16,13,12,6,12,15,14,11,11,11,12,14,11,1,7,12,13,3,2,1,1,2,3,1,2,3,3,2
"5090",82075609,"Naygel Coffie","7/26/1996 (26 years old)","M/AM (RC)","SV Estrellas","Bonaire Kampionato","BOE","Yes","7/1/2022","12/31/2023","$0","Right","Reasonable","Very Strong","6'0""","163 lbs","-","-",60,66,5,7,8,5,7,5,3,4,5,5,7,1,3,8,10,9,2,4,6,12,13,8,13,9,6,6,9,7,13,11,6,8,14,11,12,5,14,12,10,11,11,12,11,2,14,4,10,12,8,3,4,2,2,2,2,1,3,4,3,3
"5091",2000116571,"Clifford Fafale","2/4/1993 (30 years old)","AM (C), ST (C)","Central Coast (SOL)","Solomon Islands S-League","SOL","No","7/1/2022","12/31/2024","$0","Right","Reasonable","Very Strong","5'10""","163 lbs","46","19",55,68,4,3,10,12,11,4,8,2,1,1,6,4,1,7,9,6,6,6,2,6,15,8,13,10,5,4,6,7,12,12,5,2,13,12,11,12,12,11,11,9,10,10,12,11,5,1,18,11,19,2,2,2,2,1,1,2,2,2,2,2
"5092",29162737,"Atkin Kaua","1/4/1996 (27 years old)","M (C), AM (RC)","Laugu","Solomon Islands S-League","SOL","No","6/12/2023","12/31/2024","$1.5K - $4K","Right Only","Weak","Very Strong","5'9""","149 lbs","83","21",66,68,8,7,9,8,9,3,6,7,6,6,7,5,6,9,5,6,6,6,7,6,13,7,4,7,7,11,7,10,12,12,10,8,12,11,14,5,6,20,10,10,11,11,12,3,7,8,12,14,8,3,3,1,3,1,1,3,1,2,1,2
"5093",30052713,"Timothy Maearasia","9/16/1998 (24 years old)","GK","Solomon Warriors","Solomon Islands S-League","SOL","No","6/15/2020","12/31/2025","$0","Right","Reasonable","Very Strong","6'4""","182 lbs","62","-",65,68,2,1,3,2,5,4,1,2,2,1,7,1,2,1,5,9,10,6,6,13,16,1,6,3,7,6,5,5,12,15,6,13,12,10,5,7,7,10,10,15,11,12,11,2,7,3,9,12,13,5,11,10,11,6,9,10,5,6,5,13
"5094",28015705,"Mohammed Saeid","12/24/1990 (32 years old)","M/AM (LC), ST (C)","Trelleborgs FF","Swedish First Division Elite","ERI","Yes","8/11/2021","12/31/2023","$26K - $80K","Left Only","Very Strong","Weak","5'7""","138 lbs","327","34",94,109,8,8,11,9,12,8,7,9,2,9,12,13,10,12,9,10,7,11,11,11,11,9,6,12,11,13,12,11,12,12,12,5,10,12,13,7,18,10,10,10,10,7,5,7,9,10,12,10,12,4,3,2,4,3,1,4,1,1,2,3
"5095",12093162,"Ali Suleiman","1/1/2000 (23 years old)","ST (C)","Hawassa","Ethiopian Premier Division","ERI","No","7/1/2022","6/30/2026","$0 - $35K","Right","Reasonable","Very Strong","6'2""","174 lbs","55","12",86,105,6,6,13,13,13,4,13,6,4,5,7,4,1,11,10,9,8,6,7,7,3,14,5,13,7,6,7,7,13,13,5,13,10,13,7,8,11,20,15,11,13,9,12,6,7,1,9,10,11,3,2,2,3,1,2,3,2,3,1,1
"5096",23328628,"Ahmed Abdoh","1/25/1996 (27 years old)","ST (C)","Al-Shabab","Saudi Professional League","ERI","No","7/1/2022","6/30/2025","$0","Right","Reasonable","Very Strong","5'9""","141 lbs","78","11",95,105,6,5,13,13,13,7,12,6,5,5,8,7,3,10,15,10,7,13,8,9,6,12,13,11,6,4,6,8,13,13,7,7,15,13,13,7,13,20,13,11,9,9,15,2,5,8,14,12,17,3,1,3,1,3,3,3,3,3,3,4
"5097",12093158,"Robel Teklemichael","7/14/2000 (22 years old)","D (C), DM","Ethiopian Coffee","Ethiopian Premier Division","ERI","No","4/1/2021","6/30/2024","$0 - $60K","Right","Reasonable","Very Strong","5'11""","156 lbs","49","8",84,105,7,8,6,7,9,8,10,10,2,10,11,7,9,11,5,10,9,13,10,15,15,5,13,8,15,6,9,10,10,9,15,9,14,9,10,5,14,20,11,13,9,11,9,5,9,3,11,11,17,1,2,3,3,2,3,2,2,2,3,2
"5098",91201950,"Filimon Gerezgiher","7/4/2000 (22 years old)","M (RL), AM (L)","Freiberg","German Regional Division Southwest","ERI","Yes","1/16/2023","6/30/2024","$0 - $70K","Left Only","Very Strong","Weak","6'0""","158 lbs","75","19",79,100,8,11,9,11,8,7,7,8,7,7,9,4,8,13,12,6,6,11,8,12,4,12,1,13,7,8,6,11,14,14,8,8,13,14,6,5,14,14,11,9,10,10,5,5,11,1,11,12,7,1,3,1,2,1,1,2,3,1,3,3
"5099",93087478,"Abiel Sequar","1/3/1999 (24 years old)","D (C), DM, M (C)","Täby FK","Swedish First Division North","ERI","Yes","2/1/2023","12/31/2023","$0 - $14K","Right","Weak","Very Strong","5'11""","145 lbs","96","3",76,100,7,10,7,5,10,7,8,7,7,9,10,7,9,10,9,11,8,8,9,9,9,9,9,10,10,11,10,11,11,11,9,8,12,12,12,9,10,12,12,12,10,10,5,2,8,5,12,9,18,3,2,3,1,3,3,3,1,3,2,1
"5100",91138847,"Joel Gerezgiher","10/9/1995 (27 years old)","M (LC), AM (C)","Homburg","German Regional Division Southwest","ERI","Yes","7/1/2022","6/30/2023","$0","Right Only","Weak","Very Strong","5'9""","169 lbs","103","14",94,99,15,14,13,11,15,14,7,12,8,7,14,12,7,15,9,11,7,11,9,10,10,15,5,13,7,13,16,10,12,14,7,6,6,10,8,6,16,15,12,13,11,11,13,10,5,6,10,12,8,4,2,3,2,1,3,1,2,2,2,3
"5101",82075571,"Rachid Trenindad","7/6/1994 (28 years old)","D/WB/M (L)","SV Vespo","Bonaire Kampionato","BOE","Yes","6/15/2020","12/31/2023","$0","Left","Very Strong","Reasonable","5'8""","143 lbs","-","-",63,65,7,10,7,3,5,6,4,6,4,8,8,1,5,8,5,7,2,7,5,11,11,8,5,7,7,7,6,8,14,14,7,4,12,12,11,5,11,11,12,11,9,10,9,2,9,1,10,11,16,1,1,1,4,1,3,3,2,3,4,3
"5102",2000050579,"Nahom Tesfom","1/3/2004 (19 years old)","M (C)","Grasshoppers","Swiss First League Classic Group 3","ERI","Yes","6/13/2022","6/30/2025","$8K - $85K","Right","Reasonable","Very Strong","5'11""","156 lbs","20","2",77,98,7,6,5,6,10,7,7,6,1,9,14,1,13,14,14,9,4,7,4,13,15,6,10,10,9,13,7,13,12,8,14,10,15,10,8,7,9,12,9,9,9,11,10,13,8,2,11,14,16,3,3,4,3,3,1,1,1,3,2,1
"5103",2000202351,"Seme Yohannes","12/26/2005 (17 years old)","M/AM (R)","Concordia BS","Swiss First League Classic Group 2","ERI","No","7/1/2022","6/30/2024","$500 - $3.5K","Right","Fairly Strong","Very Strong","5'10""","152 lbs","-","-",58,95,6,11,9,13,8,5,1,3,1,3,8,3,6,13,14,4,7,10,6,7,9,13,6,5,4,6,8,10,13,11,4,9,5,9,6,4,10,20,13,14,10,10,10,14,12,6,8,13,14,4,2,1,2,1,1,4,1,3,3,3
"5104",2000167946,"Natnael Berhe","6/1/2001 (22 years old)","DM, M (C)","Jimma Aba Jifar","Ethiopian Higher League Group C","ERI","No","12/2/2022","6/30/2024","$0 - $9K","Right","Reasonable","Very Strong","5'7""","136 lbs","-","-",63,87,5,3,4,6,10,5,5,7,1,7,9,2,13,8,8,7,5,7,7,13,16,5,3,7,10,7,11,11,11,13,6,5,10,12,6,1,13,10,10,11,12,11,13,8,8,8,20,11,18,3,2,1,2,1,3,1,1,4,1,4
"5105",2000064494,"Alex Ybrah","1/18/2004 (19 years old)","D (RL)","Vaduz","Swiss Challenge League","ERI","No","7/5/2021","6/30/2024","$0 - $50K","Left","Very Strong","Reasonable","6'1""","163 lbs","16","1",52,87,4,11,6,4,4,2,7,4,6,6,8,1,6,8,11,5,8,6,4,10,16,8,10,5,5,7,7,8,10,14,3,14,15,13,13,6,10,17,11,11,9,11,5,7,14,7,17,11,7,2,2,2,4,2,2,4,2,2,3,1
"5106",2000110082,"Ezana Kahsay","11/16/1994 (28 years old)","ST (C)","Bałtyk Gdynia","Polish Fourth Division","ERI","No","2/28/2023","6/30/2024","$0 - $30K","Right","Reasonable","Very Strong","6'2""","178 lbs","104","37",79,85,6,7,9,12,9,8,7,10,8,6,8,10,5,8,12,13,11,10,12,11,12,13,10,14,5,7,8,9,12,10,5,13,7,11,9,8,12,11,10,11,13,8,14,10,10,6,14,13,18,2,3,1,2,3,4,3,4,1,2,3
"5107",2000073577,"Jemal Kassa","9/23/1997 (25 years old)","M (R), AM (RL), ST (C)","Hünfeld","German Div. Hessia","ERI","Yes","7/6/2022","6/30/2024","$30K - $90K","Right Only","Weak","Very Strong","5'7""","119 lbs","136","23",76,85,6,10,13,8,13,6,7,5,3,6,9,3,5,8,12,9,6,6,7,9,11,12,11,10,6,7,7,8,13,13,7,4,9,13,12,1,11,17,11,10,9,11,13,10,9,1,11,10,13,1,2,2,1,3,2,1,2,1,3,3
"5108",2000306109,"Sirak Samson Bein","8/7/2007 (15 years old)","D (C)","Lausanne","Swiss Super League","ERI","No","6/12/2023","6/30/2027","$50K - $150K","Right","Reasonable","Very Strong","6'0""","147 lbs","-","-",54,83,1,1,2,4,6,1,7,5,4,13,6,3,10,3,8,6,8,5,5,13,14,5,7,1,11,5,4,6,11,7,6,11,13,6,3,6,6,17,11,11,10,13,5,5,6,8,9,14,16,1,2,2,2,2,3,1,1,1,1,1
"5109",37063415,"Medhanie Redie","9/9/1993 (29 years old)","M (C)","Unitas","Dutch Derde Divisie B","ERI","Yes","7/1/2019","-","$0","Right","Fairly Strong","Very Strong","5'8""","158 lbs","110","18",74,80,5,3,2,7,10,4,3,8,2,9,9,1,10,13,14,10,6,6,7,9,8,5,13,9,7,7,13,12,13,13,7,5,6,13,11,11,11,19,9,9,9,10,5,7,5,3,12,10,12,3,3,2,1,1,1,2,3,2,2,1
"5110",93089746,"Christoffer Forsell","2/19/1994 (29 years old)","M (LC), AM (RL), ST (C)","Rågsveds IF","Swedish Second Division South Svealand","ERI","Yes","1/12/2022","12/31/2023","$0","Left Only","Very Strong","Weak","5'9""","147 lbs","130","7",55,80,7,8,8,7,8,6,5,5,5,6,8,6,5,9,10,7,8,6,7,7,8,11,6,8,7,7,8,8,11,10,8,6,12,11,11,8,8,9,9,9,12,8,8,16,9,6,9,8,14,1,2,1,3,3,3,1,2,1,3,2
"5111",2000312451,"Simone Mekonen","2/11/2005 (18 years old)","M (C)","Wangen bei Olten","Swiss Lower Division","ERI","No","3/14/2023","-","$0","Left","Very Strong","Reasonable","5'11""","154 lbs","-","-",59,77,5,2,3,6,13,5,5,13,1,6,13,3,3,13,13,7,2,5,6,13,7,7,1,3,3,7,3,11,11,13,6,8,13,13,12,5,10,16,11,12,11,10,8,15,7,4,8,10,7,3,1,2,2,2,3,3,2,1,1,1
"5112",37042225,"Berry Sonnenschein","2/12/1994 (29 years old)","D (L)","SV Vitesse","Bonaire Kampionato","BOE","Yes","12/31/2021","-","$0","Left","Very Strong","Reasonable","6'1""","163 lbs","22","1",60,77,3,8,4,1,8,1,2,4,6,10,6,3,9,6,6,8,8,7,7,13,2,7,6,6,8,7,3,8,13,11,7,12,16,12,13,6,9,15,11,11,12,11,6,16,9,2,11,11,13,1,2,3,2,3,2,2,3,2,2,1
"5113",37064448,"Tom Homburg","1/4/1988 (35 years old)","M/AM (R)","SV Uruguay","Bonaire Kampionato","BOE","Yes","6/14/2021","-","$0","Right","Reasonable","Very Strong","5'10""","154 lbs","-","-",54,65,7,9,8,11,8,7,7,7,7,7,7,4,4,9,14,9,4,7,7,13,6,7,11,11,7,9,5,13,8,9,8,7,14,9,11,5,9,19,10,13,11,11,7,9,8,8,7,9,15,1,2,3,3,1,2,3,3,3,1,2
"5114",98065314,"Yaël Yohans","4/26/2000 (23 years old)","ST (C)","La Tour/Le Pâquier","Swiss Second League Interregio Gr 1","ERI","No","1/15/2023","6/30/2024","$0","Left","Very Strong","Reasonable","6'0""","160 lbs","56","18",64,75,5,7,13,9,8,6,11,7,2,7,8,4,3,12,10,8,7,6,5,8,5,11,14,11,7,7,3,8,14,11,4,6,8,13,11,4,8,18,11,12,10,11,8,3,11,2,7,10,20,3,1,1,2,3,2,3,4,3,3,3
"5115",2000251339,"Yafet Kbrom","10/22/2006 (16 years old)","M (R)","Südostschweiz","Swiss Lower Division","ERI","No","7/1/2022","6/30/2026","$1K - $9K","Right","Weak","Very Strong","5'11""","145 lbs","-","-",58,75,8,11,10,7,11,6,5,7,6,6,11,3,6,10,13,6,6,4,3,9,12,5,5,6,4,7,6,11,14,12,4,6,8,14,6,4,6,14,14,14,13,14,12,9,5,3,19,13,7,1,1,4,2,3,1,1,1,3,2,3
"5116",2000211084,"Kamal Taha","7/1/2001 (21 years old)","D (C), DM, M (C)","Al-Jazira Al-Hamra","UAE First Division","ERI","No","6/1/2022","6/30/2025","$0 - $75K","Right","Reasonable","Very Strong","5'10""","154 lbs","21","-",60,74,5,1,2,7,11,6,6,6,1,8,9,4,9,7,14,6,5,8,6,14,15,5,3,7,6,7,10,12,11,13,7,7,12,11,7,6,11,18,10,12,8,10,8,9,6,2,9,12,17,1,2,1,1,3,1,1,2,2,4,3
"5117",2000072626,"Yafet Ghebrezgabiher","2/20/2001 (22 years old)","M (C), AM (RC)","Gran IL","Norwegian Fourth Division Indre Østland 1","ERI","Yes","8/26/2021","-","$0","Right Only","Weak","Very Strong","5'8""","134 lbs","26","2",62,73,3,6,8,7,7,4,6,7,2,8,8,3,6,8,12,7,16,5,5,7,10,17,4,8,8,10,8,15,13,10,3,7,11,14,14,4,12,12,8,10,10,8,8,8,13,8,10,10,10,1,2,4,2,2,3,4,1,2,2,1
"5118",12093154,"Kibrom Solomon","9/10/2000 (22 years old)","GK","Denden","Eritrean Premier Division","ERI","No","1/1/2019","-","$0","Right","Reasonable","Very Strong","6'2""","156 lbs","-","-",55,72,3,3,1,1,1,6,1,3,3,2,11,3,3,1,5,5,11,5,9,8,11,3,2,2,7,5,4,4,11,11,5,7,14,9,4,3,10,20,12,11,11,11,8,5,14,5,13,11,15,8,9,10,5,4,9,12,5,6,11,12
"5119",2000235002,"Natnaël Téga","2/12/1991 (32 years old)","ST (C)","Waldgirmes","German Div. Hessia","ERI","Yes","7/1/2022","6/30/2024","$0","Right Only","Weak","Very Strong","6'3""","176 lbs","231","91",62,72,2,3,5,14,13,6,14,4,2,5,6,3,6,12,8,6,6,6,6,9,1,11,3,14,6,5,6,7,12,11,5,11,11,11,6,7,8,11,10,12,9,9,13,2,5,8,7,10,7,1,1,4,3,2,3,2,3,2,2,1
"5120",216445,"Hermon Tekleab","12/3/1993 (29 years old)","M/AM (C)","SteDoCo","Dutch Derde Divisie B","ERI","Yes","6/30/2022","-","$0","Right","Fairly Strong","Very Strong","5'7""","152 lbs","65","9",59,71,4,1,3,9,7,4,2,6,1,5,6,4,6,11,13,6,3,5,5,11,5,12,4,6,4,5,9,6,12,12,5,1,11,12,10,10,13,20,10,11,10,12,6,10,13,3,15,13,19,2,3,2,2,4,2,3,4,3,2,1
"5121",12093159,"Michael Habte","8/21/2000 (22 years old)","DM, M (C)","Adulis Club","Eritrean Premier Division","ERI","No","1/1/2019","-","$0","Right","Reasonable","Very Strong","5'7""","136 lbs","1","-",57,70,5,6,2,4,9,6,3,8,1,8,8,1,9,9,13,11,7,7,6,14,16,5,7,7,7,8,8,11,9,13,7,2,14,12,6,3,16,12,12,13,12,9,13,1,10,3,14,11,18,3,3,3,3,2,4,3,1,3,2,2
"5122",13109515,"Yohannes Tilahun","10/16/1993 (29 years old)","M (C)","Unitas","Dutch Derde Divisie B","ERI","No","7/1/2019","-","$0","Right","Reasonable","Very Strong","5'10""","152 lbs","55","-",62,70,4,4,4,5,12,4,3,9,1,8,12,1,6,8,13,7,4,5,3,12,5,9,2,5,6,6,8,11,12,12,5,5,15,12,12,4,12,20,12,10,13,9,14,15,12,2,18,13,15,2,4,3,2,3,4,3,2,1,2,1
"5123",29178760,"Yonas Solomon","6/21/1994 (28 years old)","D (LC), WB (L)","Ethio Electric","Ethiopian Higher League","ERI","No","1/24/2023","6/30/2024","$0 - $4.5K","Left","Very Strong","Reasonable","5'9""","147 lbs","8","-",65,70,3,5,6,1,9,1,7,5,5,9,7,2,8,7,15,9,8,7,7,11,9,5,13,5,7,6,6,7,13,13,6,4,12,13,12,5,9,13,10,12,12,12,10,10,5,8,12,10,19,3,3,3,2,1,1,2,2,2,2,2
"5124",2000230497,"Jonas Lafeber","11/8/1995 (27 years old)","GK","Real Rincon","Bonaire Kampionato","BOE","Yes","7/1/2021","12/31/2023","$0","Right","Strong","Very Strong","6'4""","191 lbs","-","-",62,65,3,1,2,3,1,6,1,1,3,2,7,2,1,3,12,11,11,6,8,6,2,2,14,2,10,6,5,5,11,7,4,10,12,11,5,5,10,18,12,11,13,13,12,8,10,6,9,10,19,4,10,10,13,10,4,13,5,11,5,13
"5125",2000133836,"Semon Alem","1/1/2005 (18 years old)","D (L)","Sion","Swiss First League Classic Group 1","ERI","No","7/1/2020","6/30/2024","$0 - $22K","Left","Very Strong","Reasonable","5'11""","165 lbs","-","-",52,67,6,10,1,4,9,1,8,6,3,8,7,1,14,8,14,8,3,8,11,14,4,6,7,7,7,8,6,8,11,7,8,11,10,7,8,7,11,19,12,10,12,11,14,5,15,5,13,11,7,1,2,1,1,1,3,4,1,2,2,2
"5126",12093155,"Nahom Awet","10/11/2000 (22 years old)","D (R)","Red Sea","Eritrean Premier Division","ERI","No","1/1/2019","-","$0","Right","Reasonable","Very Strong","5'9""","147 lbs","-","-",50,65,3,7,5,5,9,1,7,1,4,12,7,3,11,7,9,9,8,7,6,9,7,5,10,6,8,7,3,7,14,13,6,4,11,13,4,5,13,16,9,11,10,12,5,6,9,1,13,12,16,3,3,3,1,1,3,2,2,2,1,2
"5127",2000306061,"Lamek Nigru","4/9/2007 (16 years old)","AM (RL), ST (C)","Südostschweiz","Swiss Lower Division","ERI","No","6/13/2022","6/30/2026","$9K - $26K","Right","Reasonable","Very Strong","6'0""","154 lbs","-","-",57,61,6,9,6,13,9,4,10,6,3,3,12,4,3,9,11,4,3,6,1,10,14,10,5,5,5,5,6,7,13,9,6,8,8,13,7,6,5,13,8,12,11,12,9,11,6,8,6,13,17,3,1,2,1,1,3,1,3,3,1,2
"5128",12093156,"Isaias Abraham","6/9/2000 (23 years old)","D (C)","Red Sea","Eritrean Premier Division","ERI","No","1/1/2019","-","$0","Right","Reasonable","Very Strong","5'11""","152 lbs","-","-",54,61,1,1,1,2,4,1,8,1,1,9,2,1,7,1,9,10,8,2,7,12,5,5,13,2,12,4,1,5,12,12,5,4,16,12,6,5,9,14,12,14,10,12,13,6,5,3,12,9,11,1,1,2,3,2,1,1,3,1,2,3
"5129",2000092964,"Deven Gibxawi","9/3/2000 (22 years old)","ST (C)","Red Sea","Eritrean Premier Division","ERI","No","1/1/2019","12/31/2023","$0","Right","Fairly Strong","Very Strong","5'9""","147 lbs","-","-",50,60,4,2,6,10,9,4,12,5,1,4,3,2,1,8,8,6,5,10,5,8,10,9,11,11,5,4,3,5,12,11,5,7,12,7,9,2,11,10,12,12,15,12,10,6,5,5,18,9,12,1,2,3,3,2,2,2,1,2,2,1
"5130",2000039513,"Mo Kibrom","10/9/1992 (30 years old)","D (C)","Unitas","Dutch Derde Divisie B","ERI","Yes","6/14/2021","-","$0","Right Only","Weak","Very Strong","6'4""","191 lbs","26","1",53,60,1,1,1,1,2,1,11,1,1,11,1,1,7,1,7,11,7,4,5,11,4,5,5,2,11,3,3,5,10,11,4,13,10,9,10,11,9,16,9,14,12,11,12,10,5,5,9,11,12,1,1,1,3,2,2,2,2,2,4,3
"5131",13109526,"Daniël Alexander","6/20/1994 (28 years old)","M/AM (L)","Unitas","Dutch Derde Divisie B","ERI","No","6/15/2020","-","$0","Left","Very Strong","Reasonable","6'2""","167 lbs","53","2",50,60,5,8,6,8,6,4,1,5,4,4,10,5,5,9,14,7,2,7,5,10,13,10,3,10,2,6,5,11,12,12,5,9,8,12,6,3,10,12,13,8,12,13,7,13,6,2,10,11,18,1,1,3,4,2,2,1,3,1,4,1
"5132",2000092961,"Ablelom Teklezghi","9/1/1996 (26 years old)","M (C)","Red Sea","Eritrean Premier Division","ERI","No","6/15/2020","-","$0","Right","Reasonable","Very Strong","6'1""","160 lbs","-","-",50,60,3,1,2,2,10,5,5,5,1,12,12,2,7,11,15,9,4,4,6,9,9,5,5,8,7,6,7,9,13,13,6,13,13,13,10,4,9,16,10,9,11,11,13,1,11,5,8,13,15,1,2,3,2,1,2,2,1,4,2,3
"5133",53124073,"Nabil Wahhab-Rabbi","5/7/1994 (29 years old)","D/WB (R), M (C)","Østsiden","Norwegian Fourth Division Østfold","ERI","No","1/1/2019","-","$0","Right Only","Very Weak","Very Strong","5'7""","125 lbs","20","3",60,60,9,9,10,7,10,3,3,5,10,6,7,3,9,10,12,10,13,3,5,6,3,17,6,11,7,9,7,13,12,11,3,6,7,13,12,6,15,11,10,13,10,11,7,5,13,1,8,10,9,1,1,2,3,2,1,1,1,1,1,1
"5134",8750608,"Robel Kidane","12/18/1994 (28 years old)","M/AM (L)","Denden","Eritrean Premier Division","ERI","No","6/15/2020","-","$0","Left","Very Strong","Weak","5'9""","145 lbs","-","-",55,60,4,9,8,9,11,4,4,5,4,3,9,2,1,6,13,5,4,4,4,8,9,7,12,7,4,6,5,11,12,12,5,6,15,12,10,3,9,20,10,11,10,13,9,7,12,6,11,12,18,2,2,1,2,3,1,3,3,1,2,2
"5135",2000178180,"Jamrick Sint Jago","10/14/2003 (19 years old)","D (C)","Real Rincon","Bonaire Kampionato","BOE","No","6/13/2022","12/31/2024","$0","Right","Weak","Very Strong","6'3""","174 lbs","-","-",55,65,2,1,3,2,6,1,13,6,1,12,3,1,11,5,10,12,8,5,6,12,18,5,8,5,11,6,1,7,7,11,7,12,14,10,8,6,10,12,9,13,11,10,6,9,10,5,14,12,12,2,1,2,2,3,2,1,2,1,2,3
"5136",2000245273,"Abel Okray","11/20/1996 (26 years old)","ST (C)","Denden","Eritrean Premier Division","ERI","No","6/15/2020","-","$0","Right","Reasonable","Very Strong","5'7""","138 lbs","-","-",50,60,3,2,11,12,9,2,12,1,1,4,2,9,1,10,7,6,6,11,4,10,14,11,3,9,3,4,3,5,12,12,5,1,13,12,8,4,12,17,10,9,12,10,14,7,13,4,18,13,11,4,2,1,2,3,1,1,2,3,1,2
"5137",82070353,"Kyle Edwards","1/15/1997 (26 years old)","AM (R), ST (C)","Hartford","USSL Championship Eastern Conference","VIN","No","12/7/2022","11/30/2023","$140K - $425K","Right","Reasonable","Very Strong","6'1""","185 lbs","26","6",90,108,8,11,12,10,9,8,10,9,8,7,7,2,6,10,15,9,5,6,7,8,14,13,9,12,8,9,10,11,14,13,11,13,11,12,8,14,12,14,12,10,11,10,5,15,5,5,12,9,19,2,2,2,4,2,2,4,1,2,2,2
"5138",82070823,"Deno John","1/1/1997 (26 years old)","M/AM (C)","System 3","SVG First Division","VIN","No","6/15/2020","12/31/2024","$0","Either","Very Strong","Very Strong","6'4""","176 lbs","-","-",65,107,4,4,4,9,7,4,1,5,3,4,6,2,4,9,10,8,5,6,6,12,16,10,12,6,4,5,8,12,12,9,5,13,13,11,7,4,11,20,12,14,11,12,7,3,9,4,19,8,11,1,1,3,1,1,3,3,2,1,2,3
"5139",82070089,"Oalex Anderson","11/11/1995 (27 years old)","ST (C)","North Carolina","United States Soccer Leagues Division One","VIN","No","1/18/2022","11/30/2023","$85K - $250K","Right","Reasonable","Very Strong","5'8""","156 lbs","110","29",87,98,7,8,14,13,10,11,9,11,8,7,8,12,7,12,13,10,10,8,8,8,13,15,8,11,6,7,6,12,13,12,9,8,12,14,9,7,9,15,9,9,9,12,10,10,6,8,7,10,14,3,2,3,1,2,2,1,2,3,2,2
"5140",2000068007,"Erel Hector","12/10/1999 (23 years old)","AM (C), ST (C)","Avenues Utd","SVG Premier Division","VIN","No","6/15/2020","12/31/2025","$0 - $1.5K","Right","Reasonable","Very Strong","6'0""","160 lbs","20","17",66,97,7,4,14,12,13,12,9,4,1,6,8,2,2,8,9,12,6,11,7,7,15,10,7,10,7,6,7,8,12,10,7,9,13,11,7,5,12,11,11,15,9,14,9,2,9,8,13,15,9,4,1,3,1,2,1,4,3,2,4,2
"5141",2000312503,"Garvin Davis","4/7/2004 (19 years old)","GK","Largo Height","SVG First Division","VIN","No","7/1/2022","-","$0","Right","Fairly Strong","Very Strong","6'0""","163 lbs","-","-",72,97,3,3,3,1,4,6,1,1,2,1,11,3,2,2,9,7,11,6,6,14,5,2,6,2,11,8,7,7,10,6,8,8,9,13,5,7,11,12,13,11,10,9,14,15,5,7,9,11,7,9,6,14,12,9,10,14,5,5,9,13
"5142",82050361,"Myron Samuel","12/19/1992 (30 years old)","ST (C)","Avenues Utd","SVG Premier Division","VIN","No","6/14/2021","12/31/2023","$2.5K - $8K","Right Only","Weak","Very Strong","5'9""","163 lbs","63","44",88,95,7,11,12,11,9,7,7,8,8,7,9,10,6,11,12,9,11,10,10,10,12,10,7,11,6,9,11,13,14,11,11,9,12,13,13,10,8,10,12,10,11,12,10,8,10,5,12,13,15,3,2,2,3,4,3,3,2,1,3,2
"5143",20015119,"Cornelius Stewart","10/7/1989 (33 years old)","AM (RL), ST (C)","Sheikh Jamal","Bangladeshi Premier League","VIN","No","11/7/2022","12/31/2023","$0 - $2K","Right Only","Weak","Very Strong","5'9""","171 lbs","149","27",91,95,5,6,12,13,11,8,8,6,7,7,7,11,6,7,10,7,12,10,11,7,2,12,10,10,6,9,5,11,15,13,10,8,9,15,11,8,10,17,12,12,12,10,5,11,8,4,10,8,7,2,2,1,2,2,2,3,2,1,1,3
"5144",2000200135,"Mekeal Williams","2/12/2001 (22 years old)","D (RC), WB (R)","Jebelle FC","SVG Premier Division","VIN","No","7/1/2020","12/31/2024","$0 - $1.5K","Right","Reasonable","Very Strong","5'11""","163 lbs","-","-",69,90,5,9,5,3,10,4,10,3,8,9,10,4,13,9,12,14,10,6,7,7,4,6,14,8,8,9,9,9,9,10,9,12,18,8,8,9,9,19,10,12,7,11,8,14,8,8,17,11,20,1,1,3,3,1,2,1,1,4,3,1
"5145",2000024413,"Diel Spring","12/26/2000 (22 years old)","DM, M (C)","Predators","SVG Premier Division","VIN","No","1/1/2023","12/31/2024","$2.5K - $7K","Right Only","Weak","Very Strong","5'6""","149 lbs","42","2",75,90,9,9,8,8,11,9,7,10,3,9,11,4,11,10,10,9,9,9,9,11,13,5,12,11,9,11,11,11,11,11,10,7,6,11,12,6,11,13,11,15,9,13,6,17,5,7,11,14,16,3,3,4,2,3,1,1,3,1,1,1
"5146",82089434,"Adrian Serberie","10/31/1991 (31 years old)","DM, M (C)","SV Estrellas","Bonaire Kampionato","BOE","No","1/1/2021","12/31/2023","$0","Right","Reasonable","Very Strong","6'1""","152 lbs","-","-",62,65,6,1,3,5,11,6,6,4,4,8,8,2,14,7,5,10,6,7,7,14,15,5,9,7,11,7,10,12,12,7,7,9,13,8,7,8,10,17,10,14,12,10,8,3,7,1,9,11,16,2,1,3,2,2,3,1,2,2,1,3
"5147",82070332,"Lemus Christopher","5/27/1995 (28 years old)","GK","Mont-Royal Outremont","Ligue1 Québec","VIN","No","1/1/2021","-","$0","Right","Fairly Strong","Very Strong","6'6""","176 lbs","4","-",70,90,3,1,1,3,3,5,1,1,1,3,9,1,3,2,5,9,14,7,13,13,12,2,11,2,11,7,6,6,8,9,7,10,15,8,12,6,12,15,10,12,11,11,11,8,6,4,20,9,20,9,8,9,14,6,13,7,5,9,12,9
"5148",30001619,"Azinho Solomon","10/12/1994 (28 years old)","AM (L), ST (C)","System 3","SVG First Division","VIN","No","7/1/2022","12/31/2023","$0 - $2.5K","Left","Very Strong","Fairly Strong","5'10""","152 lbs","14","11",85,90,6,5,10,8,9,6,8,8,2,7,8,6,5,11,11,7,8,9,7,13,14,11,3,11,8,6,6,8,13,13,7,4,13,13,13,5,11,14,14,12,11,10,6,3,7,8,20,11,19,1,3,3,3,2,3,2,2,2,1,3
"5149",82074139,"Jahvin Sutherland","11/10/1994 (28 years old)","D (C)","Springfield ASC","USSL D2 - Heartland Division","VIN","No","5/1/2023","-","$0","Right","Reasonable","Very Strong","5'10""","165 lbs","36","3",88,90,4,1,4,3,8,1,14,5,5,10,8,2,8,5,14,12,9,6,9,14,15,5,9,6,9,7,4,8,14,14,8,8,9,14,13,11,11,17,11,12,12,11,5,16,12,7,16,15,17,3,2,3,3,1,2,1,2,2,2,2
"5150",2000067738,"Zidane Sam","7/24/1998 (24 years old)","ST (C)","Jebelle FC","SVG Premier Division","VIN","No","11/1/2020","12/31/2024","$0 - $9K","Right","Reasonable","Very Strong","5'8""","152 lbs","20","21",70,90,5,3,12,12,14,7,7,8,1,4,8,3,6,11,14,13,8,11,8,13,10,10,1,13,8,7,5,8,11,11,8,5,10,11,6,7,10,18,10,14,10,11,12,14,15,3,12,12,12,2,1,1,3,2,3,1,1,3,2,2
"5151",29105417,"Jazzi Barnum-Bobb","9/15/1995 (27 years old)","D/WB (R)","Chelmsford","Vanarama National League South","VIN","No","6/9/2023","5/31/2024","$8K - $24K","Right","Reasonable","Very Strong","5'9""","132 lbs","161","1",65,90,2,9,9,3,7,4,6,6,6,7,10,3,9,8,6,8,9,5,7,7,12,9,4,8,8,11,9,7,12,11,10,9,8,12,12,10,10,13,11,14,11,12,12,7,5,2,9,11,20,3,1,3,2,3,1,1,3,1,1,3
"5152",82070807,"Morelli Solomon","8/9/1999 (23 years old)","D (C)","System 3","SVG First Division","VIN","No","6/15/2020","12/31/2024","$0","Right","Reasonable","Very Strong","6'3""","178 lbs","-","-",52,89,1,1,1,1,4,1,9,1,1,11,3,2,11,2,10,5,7,4,4,11,5,5,12,1,9,1,1,4,11,10,4,12,7,11,8,6,14,16,9,12,11,13,7,5,7,1,7,12,17,3,1,2,1,4,3,1,4,3,1,2
"5153",82082794,"Joel Quashie","6/16/2001 (21 years old)","M/AM (C)","Avenues Utd","SVG Premier Division","VIN","No","6/13/2022","12/31/2025","$0","Right","Reasonable","Very Strong","6'0""","160 lbs","-","-",62,89,5,1,7,11,13,5,3,8,1,6,6,7,7,8,11,8,5,9,6,9,12,10,9,9,5,6,13,11,13,12,3,8,12,13,6,4,11,19,12,11,11,9,11,4,10,1,18,10,14,3,3,1,2,3,1,1,1,1,1,3
"5154",82070357,"Chavel Cunningham","7/20/1995 (27 years old)","M (C), AM (LC), ST (C)","Tryum","Antigua and Barbuda Premier Division","VIN","No","7/1/2021","6/30/2024","$3.5K - $10K","Left","Very Strong","Reasonable","6'1""","165 lbs","-","-",82,88,6,8,8,9,9,6,8,8,1,5,13,13,5,10,13,11,6,9,7,8,13,10,2,10,6,5,11,8,13,12,7,8,14,13,13,6,11,19,12,9,14,13,15,1,10,7,11,14,18,2,1,2,2,2,3,2,1,2,1,1
"5155",2000200138,"Iruel Matthias","4/26/2003 (20 years old)","D (R)","Jebelle FC","SVG Premier Division","VIN","No","7/1/2019","12/31/2025","$0 - $4.5K","Right","Reasonable","Very Strong","5'11""","163 lbs","-","-",68,88,8,12,5,3,10,3,9,1,8,9,9,5,13,5,13,6,9,8,12,9,14,8,12,5,8,9,9,9,11,10,6,10,12,10,11,7,12,10,12,12,10,10,8,7,6,7,9,13,7,3,1,2,1,2,3,2,4,3,3,3
"5156",2000067739,"Tevin Thompson","10/22/2002 (20 years old)","M/AM (C)","Hope International","SVG Premier Division","VIN","No","11/1/2020","12/31/2025","$0 - $1.5K","Right","Reasonable","Very Strong","5'3""","119 lbs","-","-",66,88,6,2,7,11,14,4,6,7,6,8,10,5,7,14,8,9,7,8,5,13,10,13,11,10,7,7,7,12,14,9,7,1,15,9,11,1,13,13,12,12,10,8,11,17,5,3,10,13,13,2,2,3,1,4,3,1,2,4,3,1
"5157",2000308151,"Dani Martinus","9/13/1997 (25 years old)","D (LC), WB (L)","DESTO","Dutch Derde Klasse Zaterdag D West 1","BOE","Yes","6/12/2023","-","$0","Left","Very Strong","Weak","6'4""","176 lbs","-","-",58,65,3,6,4,2,6,1,6,3,4,5,6,1,8,7,14,6,8,7,7,10,14,5,9,5,10,6,5,8,11,13,6,14,15,11,13,6,13,17,14,12,10,10,14,10,8,4,12,13,18,3,2,3,3,2,2,3,2,3,2,2
"5158",2000067936,"Jellando John","4/16/2001 (22 years old)","GK","Sion Hill","SVG Premier Division","VIN","No","10/1/2020","-","$0","Right","Reasonable","Very Strong","6'2""","171 lbs","-","-",65,88,3,3,3,3,1,7,1,1,2,3,6,3,3,1,11,8,14,6,6,13,5,1,12,2,12,6,5,5,7,7,6,11,8,12,3,5,11,20,14,13,14,12,5,3,5,5,11,11,8,9,7,12,9,9,9,8,5,6,6,7
"5159",2000117885,"Tristan Marshall","12/19/2003 (19 years old)","D (C)","North Toronto Nitros","League1 Ontario","VIN","No","1/1/2022","-","$0","Right","Reasonable","Very Strong","5'11""","160 lbs","9","-",68,88,1,4,2,3,6,1,7,1,1,13,6,3,13,1,15,6,8,6,8,10,12,5,8,3,13,5,3,6,10,13,6,9,8,13,6,7,11,19,10,14,13,12,6,9,13,8,7,12,10,1,2,1,2,2,2,1,1,2,3,1
"5160",2000310124,"Jahva Audain","2/21/2002 (21 years old)","WB/M (L), AM (R)","Pastures Utd","SVG Premier Division","VIN","No","2/21/2020","-","$0","Left","Very Strong","Reasonable","5'11""","165 lbs","-","-",68,87,3,7,10,6,10,3,4,6,5,5,6,6,7,13,10,7,13,11,4,9,13,13,12,6,3,6,7,7,11,9,9,10,13,12,8,9,10,12,14,10,14,11,14,12,6,5,4,10,7,3,2,2,3,1,1,1,2,2,2,1
"5161",82070817,"Nazron Hoyte","9/21/1996 (26 years old)","D/WB (L)","Parham FC","Antigua and Barbuda Premier Division","VIN","No","6/15/2020","6/30/2025","$0","Left","Very Strong","Reasonable","5'4""","136 lbs","-","-",65,86,3,10,4,5,11,2,6,1,3,7,7,1,12,7,8,10,7,6,8,9,4,6,3,5,7,6,4,7,13,13,8,2,13,13,12,10,12,19,9,10,12,9,7,1,7,11,8,9,14,2,3,2,3,3,2,3,1,2,3,3
"5162",82070836,"Jowan Sawyers","5/2/1997 (26 years old)","M/AM (RLC)","System 3","SVG First Division","VIN","No","6/15/2020","12/31/2024","$0","Right","Fairly Strong","Very Strong","6'0""","154 lbs","-","-",56,86,4,8,10,8,5,4,3,6,1,2,7,4,6,10,10,7,6,6,5,7,2,15,9,8,4,5,10,7,12,12,5,7,14,12,12,3,10,11,12,10,11,12,14,14,6,4,7,14,15,4,2,3,3,1,2,2,3,4,1,3
"5163",2000201476,"Rondell Thomas","12/12/2000 (22 years old)","ST (C)","Faulkland FC","Jamaican Football Federation Championship","VIN","No","2/1/2023","6/30/2025","$0","Right","Reasonable","Very Strong","5'10""","149 lbs","18","5",69,86,6,4,14,14,8,6,13,7,4,5,7,6,1,8,7,8,7,12,7,13,6,7,9,7,1,7,7,7,14,14,7,6,18,14,6,4,11,10,11,10,11,12,8,10,5,1,8,12,11,2,1,2,2,1,3,2,3,3,4,1
"5164",82090236,"Brad Richards","11/7/1996 (26 years old)","DM, M/AM (C)","Hope International","SVG Premier Division","VIN","No","7/1/2020","12/31/2024","$0 - $9K","Left","Very Strong","Reasonable","5'10""","156 lbs","-","-",77,85,3,4,10,9,12,7,7,14,7,9,12,1,12,10,12,8,8,8,5,14,8,11,14,8,10,8,8,6,10,9,8,6,11,9,9,5,13,11,12,11,12,8,8,12,11,4,11,13,14,3,2,3,2,1,2,4,2,2,3,2
"5165",2000201512,"Kurtlon Williams","6/21/1990 (32 years old)","DM, M/AM (C), ST (C)","Predators","SVG Premier Division","VIN","No","7/1/2019","12/31/2024","Not for Sale","Right","Weak","Very Strong","5'10""","174 lbs","-","-",68,85,6,2,8,12,13,6,8,7,1,8,12,2,9,8,8,10,7,8,8,9,7,8,12,10,8,7,6,10,9,13,7,7,14,10,10,6,9,14,12,12,10,12,13,6,6,3,18,11,7,1,2,2,4,1,1,1,2,1,3,3
"5166",2000199670,"Jadiel Chance","8/8/1999 (23 years old)","GK","Predators","SVG Premier Division","VIN","No","6/15/2020","12/31/2025","$0 - $4K","Right","Reasonable","Very Strong","5'11""","154 lbs","-","-",70,85,4,3,3,3,2,7,1,1,3,2,4,3,3,2,5,10,15,6,8,11,13,1,5,2,5,6,5,5,10,10,6,8,16,9,1,5,9,11,11,13,11,9,13,3,9,8,9,10,19,7,11,12,7,6,7,12,5,7,10,12
"5167",30001600,"Nazir McBurnette","2/18/1993 (30 years old)","AM (RLC), ST (C)","All Saints Utd","Antigua and Barbuda Premier Division","VIN","No","1/1/2023","6/30/2024","$0 - $10K","Right","Reasonable","Very Strong","5'10""","167 lbs","6","6",84,85,8,9,11,9,10,8,10,10,6,6,12,5,9,12,15,8,13,9,9,12,14,15,8,12,8,9,9,9,11,10,9,8,6,10,13,10,9,18,10,10,12,11,7,12,12,7,8,13,9,1,2,1,2,1,3,3,2,4,3,3
"5168",90051287,"Christopher Isenia","10/29/1993 (29 years old)","D/WB (L)","SV Vespo","Bonaire Kampionato","BOE","No","7/1/2020","12/31/2023","$0","Left","Very Strong","Reasonable","5'9""","152 lbs","-","-",63,64,4,9,2,1,7,1,7,4,4,8,4,4,10,7,7,10,3,7,11,11,8,6,3,5,7,7,6,7,14,14,7,5,12,14,6,7,12,18,9,9,10,11,11,3,5,4,15,11,14,4,2,3,1,2,3,1,2,2,2,3
"5169",30001622,"Nical Stephens","7/17/1992 (30 years old)","D/WB (L), DM, M/AM (L)","Jabloteh","TT Premier Football League Tier 1","VIN","No","1/1/2023","6/30/2024","$0 - $8K","Right","Fairly Strong","Very Strong","5'9""","149 lbs","6","-",84,85,6,10,8,10,6,6,6,10,5,7,10,5,9,7,7,9,13,10,10,10,13,15,14,13,8,8,5,12,13,10,8,7,9,12,11,4,17,18,11,13,8,9,13,9,15,7,14,12,14,1,2,3,3,3,3,2,2,2,2,3
"5170",30001586,"Jason Hope","12/2/1984 (38 years old)","M (C)","Santa Rosa (TRI)","TT Eastern FA Divisions","VIN","No","6/14/2021","6/30/2024","$0","Right","Reasonable","Very Strong","5'11""","156 lbs","-","-",55,85,6,4,3,6,14,6,5,9,1,10,5,3,8,9,9,7,6,9,7,14,13,9,15,7,6,8,8,12,7,7,7,11,15,7,7,5,13,13,12,15,11,8,7,7,14,8,10,12,7,3,3,1,3,1,3,2,3,2,1,1
"5171",30001597,"Jovan Lynch","9/28/1993 (29 years old)","GK","System 3","SVG First Division","VIN","No","6/15/2020","12/31/2024","$0","Right","Weak","Very Strong","6'1""","169 lbs","-","-",50,84,4,1,1,2,1,7,1,1,2,2,8,3,3,2,7,6,9,4,7,12,7,1,7,2,8,4,4,4,8,10,5,9,15,10,4,6,10,12,11,11,12,13,7,4,13,4,7,11,19,2,5,11,7,8,9,12,5,7,6,11
"5172",2000201472,"Garret Leigertwood","2/19/2000 (23 years old)","ST (C)","Avenues Utd","SVG Premier Division","VIN","No","7/1/2019","12/31/2024","$0 - $5K","Right","Fairly Strong","Very Strong","5'11""","182 lbs","-","-",70,84,5,2,10,12,10,5,12,6,3,3,6,7,4,9,6,10,7,9,6,5,12,13,2,12,6,4,4,6,12,12,8,7,13,12,7,9,12,11,11,13,10,12,10,3,6,4,20,9,19,1,3,3,3,1,2,1,2,3,2,1
"5173",2000199673,"Josh Stowe","5/6/2003 (20 years old)","GK","Bequia","SVG First Division","VIN","No","1/1/2021","-","$0","Right","Reasonable","Very Strong","6'4""","178 lbs","-","-",67,83,2,2,2,3,1,6,1,2,2,3,6,3,1,1,12,6,15,5,11,12,16,1,12,2,9,5,4,4,8,14,5,9,12,6,1,3,11,17,11,10,9,10,5,7,6,7,10,11,12,8,8,8,8,5,6,12,5,8,6,9
"5174",82082860,"Kevan Henry","4/25/1995 (28 years old)","GK","Jebelle FC","SVG Premier Division","VIN","No","6/15/2020","12/31/2024","$0","Right","Reasonable","Very Strong","6'0""","160 lbs","-","-",63,82,3,3,3,1,1,5,1,3,1,1,10,1,3,6,11,10,11,5,9,12,7,1,4,1,10,7,6,6,10,10,7,9,13,12,6,4,9,17,11,10,12,12,10,6,7,7,20,13,10,7,11,14,11,11,7,7,6,9,11,10
"5175",82070344,"Vasbert Ledger","2/18/1995 (28 years old)","M/AM (C)","System 3","SVG First Division","VIN","No","6/15/2020","12/31/2024","$0","Right","Weak","Very Strong","5'9""","143 lbs","-","-",60,80,5,4,7,5,12,5,2,6,4,7,8,2,6,7,6,6,7,11,6,8,4,10,7,5,5,6,12,8,13,13,6,4,16,13,13,3,10,15,12,10,11,11,12,11,5,6,17,7,20,2,3,3,3,3,1,2,3,3,2,1
"5176",2000016806,"Malcolm Stewart","11/19/1997 (25 years old)","M/AM (L), ST (C)","Parham FC","Antigua and Barbuda Premier Division","VIN","No","1/1/2023","6/30/2024","$0 - $6K","Left","Very Strong","Reasonable","5'8""","149 lbs","-","-",75,80,6,7,12,9,11,6,8,7,6,3,12,4,4,8,7,8,5,10,6,7,6,8,10,10,6,7,5,12,13,9,13,3,17,12,12,4,10,15,11,10,11,12,14,1,5,1,9,11,17,1,3,2,1,2,3,1,3,3,4,1
"5177",82070358,"Kevin Francis","1/21/1994 (29 years old)","D (RC)","System 3","SVG First Division","VIN","No","1/1/2020","12/31/2024","$0 - $6K","Right Only","Weak","Very Strong","6'3""","176 lbs","-","-",71,80,2,8,1,3,7,1,10,3,2,13,6,1,11,6,15,9,9,5,9,13,13,5,8,6,10,6,2,7,13,13,7,12,12,13,6,7,18,17,13,13,11,9,14,15,12,3,16,12,18,3,3,3,1,2,1,2,1,2,2,1
"5178",30001610,"Reginal Richardson","3/1/1990 (33 years old)","D (C)","Pastures Utd","SVG Premier Division","VIN","No","7/1/2020","12/31/2024","Not for Sale","Right","Reasonable","Very Strong","6'5""","189 lbs","26","4",70,80,1,3,1,1,6,1,12,1,3,13,7,1,13,2,15,9,9,7,7,11,9,5,7,6,13,6,1,7,8,9,7,16,13,5,6,7,12,19,13,12,8,10,9,14,7,4,14,15,13,2,4,2,3,1,1,3,2,2,1,2
"5179",82089224,"Rudolph Kastaneer","8/2/1991 (31 years old)","D (C)","SV Estrellas","Bonaire Kampionato","BOE","No","6/14/2021","-","$0","Right","Fairly Strong","Very Strong","6'1""","171 lbs","-","-",60,64,2,1,1,2,5,1,4,3,2,13,3,4,9,3,12,12,8,3,10,13,11,5,3,5,12,5,1,6,12,8,6,7,7,9,3,6,14,11,8,13,13,12,6,2,6,4,11,11,13,3,1,3,1,1,1,1,1,1,1,3
"5180",2000200478,"Aaron Jackson","1/24/2001 (22 years old)","M/AM (C)","Sion Hill","SVG Premier Division","VIN","No","7/1/2022","-","$0","Right","Reasonable","Very Strong","6'4""","174 lbs","15","3",72,78,6,6,8,8,13,6,5,13,1,6,12,6,5,11,8,5,6,8,7,13,9,14,8,8,5,7,10,12,13,13,7,10,14,13,8,5,17,20,12,9,11,11,5,3,9,5,12,11,12,2,2,1,1,2,1,2,2,3,1,2
"5181",30001589,"Keith James","5/18/1988 (35 years old)","D (RC)","Avenues Utd","SVG Premier Division","VIN","No","6/14/2021","12/31/2024","$0","Right","Fairly Strong","Very Strong","6'2""","176 lbs","-","-",66,78,5,9,2,6,6,5,9,4,7,6,7,3,12,5,8,7,9,8,7,12,18,5,7,3,11,7,7,8,8,10,8,11,9,9,7,8,12,20,11,14,11,12,12,1,5,6,10,12,11,2,3,3,3,3,2,2,2,3,2,4
"5182",82082830,"Marlo Marshall","6/27/1982 (40 years old)","GK","Jugglers","SVG Second Division","VIN","No","6/14/2021","-","$0","Right","Reasonable","Very Strong","6'3""","178 lbs","-","-",61,78,2,1,3,2,1,5,1,2,1,1,11,3,1,1,8,10,15,7,12,14,7,3,13,2,8,7,6,6,5,10,5,12,12,4,5,5,9,16,13,13,10,10,9,5,12,7,7,11,17,9,14,5,14,7,10,14,5,7,11,9
"5183",2000310134,"Kennijha Joseph","8/10/2000 (22 years old)","DM, M (C)","Layou FC","SVG Premier Division","VIN","No","8/10/2018","-","$0","Right","Fairly Strong","Very Strong","5'5""","125 lbs","-","-",68,78,6,4,4,7,14,6,6,8,4,9,9,4,14,9,13,7,7,4,8,14,8,5,1,4,5,7,12,4,14,14,7,4,15,14,9,2,15,19,14,11,12,12,10,9,6,4,11,11,14,4,3,3,2,2,2,2,2,3,2,1
"5184",2000201506,"Keshorn Durham","9/4/1998 (24 years old)","ST (C)","Notch","SVB Eerste Divisie","VIN","No","7/1/2022","6/30/2025","$0 - $90K","Right","Reasonable","Very Strong","5'10""","163 lbs","-","-",70,77,6,6,13,13,7,6,8,5,2,5,5,5,1,4,5,12,7,9,7,9,17,12,10,8,7,6,5,8,13,13,7,3,8,13,12,9,9,14,12,10,13,11,10,7,6,5,20,12,17,1,3,2,3,2,2,2,2,1,2,2
"5185",82082982,"Mark Browne","11/11/1995 (27 years old)","ST (C)","Hoppers","Antigua and Barbuda Premier Division","VIN","No","7/1/2018","6/30/2025","$0","Left","Very Strong","Fairly Strong","5'6""","143 lbs","-","-",63,77,4,1,4,12,10,1,11,4,1,4,4,9,3,8,10,9,5,11,5,7,16,10,7,12,4,4,5,6,12,12,5,2,5,12,11,5,12,18,11,10,9,12,5,13,8,2,9,9,17,2,1,3,2,1,1,2,3,1,2,1
"5186",2000310112,"Sherwyn Alexander","10/12/1997 (25 years old)","D/WB/M/AM (R)","Jebelle FC","SVG Premier Division","VIN","No","1/1/2021","-","$0","Right","Reasonable","Very Strong","5'10""","178 lbs","-","-",72,77,2,7,8,9,11,4,4,7,1,7,6,3,8,10,13,6,8,8,8,9,1,13,13,13,8,7,8,8,13,13,7,8,14,13,9,7,16,16,11,12,11,13,10,11,11,11,19,14,13,1,3,2,2,4,1,3,1,2,1,3
"5187",2000200437,"Terris Joseph","8/12/1998 (24 years old)","M/AM (L)","Jebelle FC","SVG Premier Division","VIN","No","7/1/2020","12/31/2025","$1.5K - $4.5K","Left","Very Strong","Reasonable","5'10""","152 lbs","-","-",68,77,5,9,9,9,11,5,3,5,5,3,8,2,1,11,12,6,7,6,5,12,6,11,14,10,5,6,4,11,13,13,6,3,15,13,12,5,8,13,10,12,15,9,9,12,15,6,8,10,16,1,1,2,1,1,3,2,3,3,4,3
"5188",82082799,"Raheem Westfield","12/13/2000 (22 years old)","AM (RL), ST (C)","Avenues Utd","SVG Premier Division","VIN","No","6/15/2020","12/31/2025","$0","Right","Reasonable","Very Strong","5'9""","147 lbs","-","-",58,76,5,8,8,9,11,5,7,5,5,2,9,1,2,6,10,9,2,10,5,13,3,11,5,10,5,6,4,7,13,13,6,3,10,13,6,3,10,12,12,10,8,12,9,14,11,4,20,11,10,3,1,1,2,2,1,2,1,3,1,2
"5189",2000200425,"Adeem Charles","3/17/1996 (27 years old)","DM, M (C)","Predators","SVG Premier Division","VIN","No","6/15/2020","12/31/2024","$1.5K - $5K","Right","Weak","Very Strong","5'7""","169 lbs","-","-",70,75,8,4,8,8,13,7,8,9,2,6,15,1,9,8,10,10,13,9,10,11,13,5,10,9,8,10,12,12,8,9,5,8,13,8,11,9,12,20,12,13,12,11,9,14,5,7,10,10,14,3,3,1,1,1,3,2,1,3,3,1
"5190",82089419,"Robbert Barendse","9/5/1992 (30 years old)","D (R)","SV Uruguay","Bonaire Kampionato","BOE","Yes","7/1/2019","-","$0","Right","Reasonable","Very Strong","6'2""","165 lbs","3","-",63,63,3,5,3,1,8,1,6,1,4,5,4,1,11,5,8,9,7,5,6,10,14,8,13,4,8,6,6,7,13,13,7,11,14,13,13,4,10,18,11,12,9,14,7,9,10,7,10,11,15,1,3,3,2,1,3,1,1,1,4,1
"5191",45021432,"Jolanshoy McDowall","8/21/1989 (33 years old)","D (LC), WB/M/AM (L)","Tryum","Antigua and Barbuda Premier Division","VIN","No","1/1/2023","6/30/2024","$0","Left","Very Strong","Reasonable","5'9""","152 lbs","-","-",70,75,7,8,9,8,9,12,8,7,5,9,11,3,10,6,8,10,8,9,14,13,8,10,7,14,10,8,8,9,10,9,8,4,9,9,6,5,10,17,12,11,13,12,14,12,6,7,11,10,15,3,2,2,3,3,1,3,3,3,1,2
"5192",2000260005,"Dylan Ramos","8/6/2001 (21 years old)","GK","Gold Star FC","National Independent Soccer Association","VIR","No","2/28/2023","11/30/2023","$12K - $35K","Right","Reasonable","Very Strong","6'2""","174 lbs","-","-",71,107,3,3,1,2,1,4,1,2,3,2,8,2,1,2,12,4,13,7,10,13,10,1,8,3,6,7,6,6,10,8,5,13,13,7,1,6,13,11,13,14,11,10,10,10,8,6,12,12,17,8,8,13,8,9,9,9,15,6,10,13
"5193",20028724,"Lionel Brown","9/17/1987 (35 years old)","GK","Helenites","USVIR Saint Croix League","VIR","No","11/30/2019","-","$0","Right Only","Weak","Very Strong","6'0""","180 lbs","10","-",72,82,4,1,2,3,8,6,3,1,2,3,9,4,1,7,10,8,11,10,11,7,12,3,9,3,10,12,7,12,12,13,10,11,10,10,9,11,9,17,16,18,10,16,14,1,10,1,11,3,17,9,12,11,5,10,8,10,5,8,10,12
"5194",2000187800,"Jett Blaschka","9/16/1999 (23 years old)","D (R), DM, M (C)","Man 62","Gibraltar Football League","VIR","No","7/8/2022","6/30/2024","$0","Right","Reasonable","Very Strong","6'3""","160 lbs","11","-",60,80,7,9,6,3,11,4,7,5,6,11,11,5,13,9,15,10,7,15,9,15,14,5,12,8,11,14,8,10,4,7,8,16,14,5,6,7,16,17,10,11,11,11,6,5,7,1,6,9,13,2,3,2,1,2,2,4,1,2,2,1
"5195",20040218,"Aaron Dennis","2/24/1993 (30 years old)","ST (C)","NY Pancyprian Freedoms","Lower Leagues","VIR","No","7/1/2020","-","$0","Right Only","Weak","Very Strong","6'2""","180 lbs","38","5",76,79,5,2,12,12,12,3,12,6,1,5,6,4,1,10,5,9,2,12,5,11,14,11,1,9,5,5,2,7,12,8,8,11,8,12,12,11,13,12,12,11,11,11,8,12,5,8,9,12,20,1,1,2,3,2,2,4,1,3,3,3
"5196",82076714,"Tnoy Andrew","11/7/1992 (30 years old)","WB/M (L), AM (RL)","Otto's Rangers","Antigua and Barbuda Premier Division","VIR","No","4/21/2019","6/30/2024","$0 - $4.5K","Left","Very Strong","Reasonable","5'9""","152 lbs","6","2",70,75,4,9,11,8,8,6,6,4,1,5,10,5,5,10,6,8,8,8,3,12,12,12,3,6,6,7,7,8,13,13,7,3,7,13,12,5,9,10,10,11,10,11,5,13,6,7,8,12,20,1,2,2,2,3,3,2,1,2,3,3
"5197",20016235,"J.C. Mack","8/10/1988 (34 years old)","M/AM (RL), ST (C)","Napier City Rovers","New Zealand Central League","VIR","No","1/1/2022","-","$0","Right Only","Weak","Very Strong","5'9""","160 lbs","163","34",75,75,8,11,12,6,8,7,4,8,4,7,7,6,8,11,14,8,11,10,10,7,8,10,6,9,7,9,8,13,12,12,12,5,8,11,9,10,15,18,13,12,12,12,16,15,8,7,10,11,19,3,3,3,2,3,2,2,1,1,1,1
"5198",82076681,"Kassall Greene","9/8/1985 (37 years old)","D (C)","Cayon FC","SKNFA Super League","VIR","No","1/1/2019","6/30/2024","$0","Right","Reasonable","Very Strong","6'3""","178 lbs","7","-",50,64,1,3,2,1,2,1,9,1,4,7,5,1,13,5,9,11,8,6,8,13,7,5,7,4,12,5,2,6,7,5,6,10,10,7,3,6,12,16,10,11,10,11,10,3,14,4,10,11,18,2,3,1,3,3,3,2,1,1,2,2
"5199",82074768,"Avier Christian","1/16/1996 (27 years old)","M (R), AM (RLC), ST (C)","Liberta FC","Antigua and Barbuda First Division","VIR","No","7/1/2019","6/30/2024","$0","Right","Reasonable","Very Strong","5'11""","156 lbs","-","-",62,62,2,6,8,8,6,5,6,5,5,5,10,6,2,9,8,6,7,10,4,7,6,11,9,9,3,6,7,7,13,13,6,10,9,13,10,4,11,19,12,11,12,12,5,2,5,5,14,12,20,3,3,3,2,2,1,1,2,1,1,2
"5200",2000192413,"Tyler Humphrey","7/13/1991 (31 years old)","DM, M (C)","Fort Worth","NPSL South Region","VIR","No","6/14/2021","-","$0","Right","Reasonable","Very Strong","6'1""","167 lbs","-","-",60,60,4,6,4,8,10,7,7,6,4,10,12,2,11,9,15,6,7,7,8,13,17,5,7,8,13,8,12,12,8,9,5,15,13,6,10,5,11,14,11,10,13,12,14,11,6,3,14,9,7,3,3,1,2,1,3,2,3,1,3,3
"5201",82075701,"Ilfred Piar","8/19/1989 (33 years old)","ST (C)","Real Rincon","Bonaire Kampionato","BOE","Yes","6/14/2021","12/31/2024","Not for Sale","Right","Fairly Strong","Very Strong","6'1""","171 lbs","20","32",58,62,4,5,10,11,8,6,11,8,5,6,7,9,5,7,8,8,5,11,8,11,15,7,7,9,7,7,7,8,11,7,8,13,14,9,10,8,8,19,10,11,11,11,7,1,5,7,7,10,15,1,1,1,1,1,3,2,3,2,2,1
"5202",2000189765,"Raejae Joseph","8/9/1997 (25 years old)","D/WB/M/AM (R)","Helenites","USVIR Saint Croix League","VIR","No","6/15/2020","-","$0","Right","Weak","Very Strong","5'8""","143 lbs","-","-",50,57,3,6,6,11,7,5,5,2,2,4,5,3,7,9,14,8,5,7,6,9,1,9,6,13,7,6,6,7,12,10,4,6,14,10,12,4,10,19,12,10,10,9,11,9,14,2,12,10,14,1,2,1,1,3,3,3,3,3,2,1
"5203",2000158866,"Taylor Nick","9/2/1998 (24 years old)","M/AM (L)","Svay Rieng","Cambodian Premier League","CAM","No","2/4/2023","12/31/2023","$0 - $18K","Left","Very Strong","Fairly Strong","5'10""","154 lbs","113","17",87,105,7,11,10,9,10,9,6,6,9,9,9,6,8,10,13,11,7,8,10,8,4,15,4,14,9,10,11,11,12,12,10,8,12,13,8,9,13,12,13,10,9,14,11,19,7,6,8,11,16,1,3,3,3,3,1,2,2,1,1,1
"5204",2000122425,"Sieng Chanthea","9/9/2002 (20 years old)","ST (C)","Boeung Ket","Cambodian Premier League","CAM","No","1/1/2020","5/31/2025","$4.5K - $14K","Right","Fairly Strong","Very Strong","5'5""","125 lbs","-","-",65,85,5,2,14,14,14,6,10,4,1,3,7,8,1,13,11,5,1,12,2,6,6,12,10,8,6,6,7,7,14,12,3,2,11,14,9,1,11,19,10,10,9,14,6,16,6,4,12,12,20,1,2,3,2,1,4,1,1,3,2,3
"5205",34011942,"Bin Thierry","6/1/1991 (32 years old)","D/WB (L), DM, M (C)","Svay Rieng","Cambodian Premier League","CAM","Yes","1/30/2023","5/31/2024","$0 - $5K","Left Only","Very Strong","Weak","5'10""","160 lbs","50","1",65,85,5,9,8,8,9,7,2,9,2,9,8,5,13,10,12,11,7,9,9,11,9,5,15,6,9,8,10,9,7,9,6,8,6,9,6,10,10,13,13,9,8,12,11,13,14,1,11,11,7,1,2,4,3,2,3,1,3,2,2,3
"5206",23253196,"Chan Vathanaka","1/23/1994 (29 years old)","AM (L), ST (C)","Boeung Ket","Cambodian Premier League","CAM","No","7/1/2019","12/31/2023","$0 - $9K","Left","Very Strong","Weak","5'8""","147 lbs","59","83",69,75,7,7,12,12,8,11,7,9,5,3,11,13,3,12,7,13,8,10,8,9,18,15,10,10,2,7,11,8,11,12,5,7,10,12,8,6,7,17,10,11,11,10,11,8,5,1,11,12,19,3,2,3,1,3,1,2,3,1,2,3
"5207",23099180,"Sou Yaty","12/17/1991 (31 years old)","GK","Nagaworld","Cambodian Premier League","CAM","No","7/1/2018","12/31/2023","$0","Right","Weak","Very Strong","5'10""","149 lbs","-","-",55,73,3,1,2,2,3,2,1,1,3,1,9,2,2,1,10,8,9,5,7,13,18,3,11,1,12,6,5,5,9,6,5,8,13,11,1,5,9,11,12,12,11,11,13,13,10,2,7,12,9,4,10,12,7,8,12,9,15,6,6,13
"5208",23350285,"Chreng Polroth","7/4/1997 (25 years old)","M/AM (C)","Visakha","Cambodian Premier League","CAM","No","1/1/2020","12/31/2023","$0","Right","Weak","Very Strong","5'9""","149 lbs","-","-",55,69,4,5,6,5,11,5,1,7,1,4,10,1,3,7,8,8,2,6,5,10,13,11,9,7,7,7,4,11,13,13,6,3,13,13,13,6,9,20,11,13,13,10,13,6,5,5,10,13,17,1,3,1,2,2,2,2,2,2,2,2
"5209",23047413,"Kouch Sokumpheak","2/15/1987 (36 years old)","DM, M (C)","Nagaworld","Cambodian Premier League","CAM","No","6/14/2021","12/31/2023","$0","Right","Weak","Very Strong","5'6""","138 lbs","-","-",56,68,6,6,5,12,11,7,8,9,3,8,11,8,9,9,13,10,5,9,9,12,9,5,14,8,8,8,8,13,7,8,9,3,8,8,10,7,13,14,11,11,10,13,6,6,6,8,10,11,13,1,2,3,2,3,1,2,3,2,2,3
"5210",23099129,"Prak Mony Udom","3/24/1994 (29 years old)","AM (RLC)","Svay Rieng","Cambodian Premier League","CAM","No","7/2/2018","12/31/2023","$0","Right","Weak","Very Strong","5'7""","152 lbs","6","7",58,67,5,6,11,6,11,5,5,6,4,5,10,1,5,7,8,4,7,7,7,9,6,7,10,12,3,6,10,7,13,13,7,1,15,13,8,1,13,16,14,11,11,12,7,12,12,8,10,12,7,2,4,1,3,3,3,3,2,1,1,3
"5211",2000250018,"Chansopheak Ken","6/15/1998 (24 years old)","D (R)","Visakha","Cambodian Premier League","CAM","No","1/1/2019","12/31/2023","$0","Right","Reasonable","Very Strong","5'8""","143 lbs","-","-",55,65,5,6,4,1,5,1,5,2,5,6,7,1,7,4,11,6,8,7,4,13,13,6,12,5,6,7,6,8,13,13,7,5,13,13,12,4,9,13,12,10,13,12,12,14,6,7,19,12,16,1,1,1,2,2,3,2,3,3,2,2
"5212",82075754,"Edsel Martha","3/29/1991 (32 years old)","M (C)","Flamingo","Bonaire Kampionato","BOE","Yes","6/14/2021","-","$0","Right","Weak","Very Strong","5'10""","154 lbs","-","-",62,62,6,3,2,5,11,6,5,5,1,9,10,4,6,10,15,8,6,12,7,13,17,8,13,6,7,7,9,12,13,9,6,9,14,8,13,6,7,16,12,12,12,9,15,5,15,2,18,12,13,2,2,2,3,2,2,3,3,3,1,3
"5213",23469050,"Sun Vandeth","8/22/1997 (25 years old)","AM (R)","National Police","Cambodian Lower Division","CAM","No","6/15/2020","12/31/2023","$0","Right","Weak","Very Strong","5'9""","143 lbs","-","-",55,65,5,7,7,7,6,5,6,2,5,3,9,3,4,9,10,7,6,9,6,10,1,9,9,7,5,6,5,7,13,13,6,3,16,13,12,3,10,14,9,11,13,9,7,8,6,8,9,11,20,2,1,1,1,2,2,1,1,3,2,1
"5214",23350239,"Hoy Phallin","3/30/1996 (27 years old)","M (C), AM (L)","Svay Rieng","Cambodian Premier League","CAM","No","1/1/2023","5/31/2024","$0","Right","Weak","Very Strong","5'7""","149 lbs","-","-",50,65,5,7,6,10,5,5,5,7,5,6,6,3,5,7,5,6,1,5,6,11,11,8,9,8,6,6,6,7,13,13,6,1,12,13,12,1,12,17,11,10,12,12,7,17,7,3,10,10,14,1,2,1,3,3,1,1,1,4,4,2
"5215",23268662,"Kouch Dani","10/11/1990 (32 years old)","M/AM (L)","Svay Rieng","Cambodian Premier League","CAM","Yes","1/21/2023","12/31/2023","$0","Right","Weak","Very Strong","6'0""","167 lbs","-","-",57,64,6,8,9,6,7,4,5,7,3,6,10,5,7,11,11,7,7,5,7,9,11,10,7,12,6,8,8,11,13,11,4,10,13,9,6,7,11,16,14,12,12,12,10,5,6,4,7,12,10,3,1,1,1,1,2,1,3,1,4,3
"5216",23350214,"Sos Suhana","4/4/1992 (31 years old)","M (RC), AM (R)","Nagaworld","Cambodian Premier League","CAM","No","6/14/2021","12/31/2023","$0","Right","Weak","Very Strong","5'7""","143 lbs","-","-",52,64,6,9,6,9,12,6,2,7,6,6,7,5,5,7,14,9,3,8,7,7,8,8,9,11,5,7,6,11,11,10,7,6,13,8,14,4,10,15,10,11,14,12,7,11,9,4,15,10,13,2,2,2,2,4,2,3,4,3,3,2
"5217",23481197,"Phan Makara","7/1/2001 (21 years old)","M (C)","Soltilo Angkor","Cambodian Lower Division","CAM","No","6/13/2022","12/31/2023","$0","Right Only","Weak","Very Strong","5'10""","149 lbs","-","-",55,63,6,6,2,4,7,6,2,6,1,10,12,3,5,9,10,7,2,6,7,6,4,7,11,9,8,8,14,13,9,11,7,4,14,11,11,4,15,16,11,13,13,11,10,6,12,5,15,12,15,3,3,2,3,3,1,2,3,3,4,1
"5218",23481188,"Orn Chanpolin","3/15/1998 (25 years old)","DM, M (C)","Phnom Penh Crown","Cambodian Premier League","CAM","No","1/8/2022","12/31/2024","$0","Right","Weak","Very Strong","5'9""","147 lbs","-","-",54,60,3,4,1,4,5,5,5,4,4,8,6,1,13,9,7,7,4,5,7,13,3,5,13,6,4,7,6,10,13,13,6,8,12,13,7,6,10,11,10,9,9,12,12,13,6,8,11,9,16,1,2,1,2,3,1,2,2,3,2,3
"5219",23350175,"Cheng Meng","2/27/1998 (25 years old)","D (RL), WB/M (R)","Visakha","Cambodian Premier League","CAM","No","1/1/2019","12/31/2023","$0","Right","Reasonable","Very Strong","5'9""","143 lbs","-","-",50,60,5,8,7,2,6,5,6,5,5,7,7,5,9,7,12,9,8,5,8,4,15,5,7,6,7,6,3,7,13,11,6,5,15,13,10,3,10,10,10,11,13,11,5,8,8,3,8,9,19,2,2,3,1,2,3,1,1,2,2,3
"5220",23350234,"Soeuy Visal","8/19/1995 (27 years old)","D (C)","Svay Rieng","Cambodian Premier League","CAM","No","6/15/2020","12/31/2023","$0","Right","Weak","Very Strong","5'8""","147 lbs","-","-",51,59,3,1,1,1,4,1,8,1,5,12,4,1,6,3,9,9,8,6,5,13,16,5,13,5,8,5,1,7,13,13,6,2,8,13,11,6,11,14,10,11,13,13,10,13,7,5,18,11,9,3,2,3,3,2,2,1,3,2,1,1
"5221",23350243,"Nub Tola","10/1/1996 (26 years old)","D (C)","Kirivong","Cambodian Premier League","CAM","No","2/10/2023","12/31/2023","$0","Right","Reasonable","Very Strong","5'9""","154 lbs","-","-",52,55,3,1,4,3,8,1,8,5,1,7,4,3,8,4,11,12,8,6,8,7,12,5,8,4,11,5,3,6,13,13,6,5,8,13,11,7,14,13,11,10,10,10,5,3,5,4,17,11,18,3,1,2,1,1,1,3,2,3,1,3
"5222",38057466,"Ganbold Ganbayar","9/3/2000 (22 years old)","AM (RLC), ST (C)","Puskás Akadémia","Hungarian Division I","MGL","No","6/15/2020","6/30/2025","$16K - $160K","Right","Strong","Very Strong","5'10""","167 lbs","112","30",85,105,9,9,10,11,6,9,8,7,7,9,8,4,5,12,13,12,8,12,8,9,12,11,5,11,9,10,11,10,11,11,6,6,8,11,10,7,12,12,10,13,9,13,13,12,7,6,13,12,12,2,2,3,1,4,1,1,2,2,3,3
"5223",82089771,"Farson Rijna","4/6/2003 (20 years old)","D/WB (L)","Young Boys (BON)","Bonaire Kampionato","BOE","Yes","1/1/2020","-","$0","Left","Very Strong","Reasonable","6'0""","160 lbs","-","-",55,75,4,8,7,7,10,2,3,3,7,9,8,1,12,5,15,10,5,8,6,12,16,5,5,6,7,8,5,8,14,13,7,10,14,10,6,5,14,20,11,10,12,13,13,3,12,5,16,11,15,2,3,1,3,1,1,3,2,1,2,1
"5224",82075750,"Christopher Martha","4/25/1995 (28 years old)","ST (C)","SV Juventus","Bonaire Kampionato","BOE","Yes","6/15/2020","12/31/2023","$0","Right","Weak","Very Strong","5'9""","154 lbs","-","-",53,62,1,1,4,12,12,4,12,5,1,4,5,7,4,7,14,7,6,5,3,8,6,11,9,8,5,4,1,6,12,12,4,4,15,12,11,8,10,12,8,11,9,10,9,8,5,3,8,11,16,2,1,3,1,2,1,1,3,3,1,2
"5225",2000304286,"Saranjav Baatarsukh","6/5/2006 (17 years old)","AM (C)","Etoile Carouge","Swiss Promotion League","MGL","No","6/12/2023","6/30/2025","$0 - $8K","Right","Reasonable","Very Strong","5'6""","121 lbs","-","-",52,88,5,5,8,5,13,5,5,6,1,5,8,1,4,13,7,3,3,5,5,13,8,13,11,8,5,6,10,11,10,13,6,4,17,12,7,1,10,19,12,11,13,9,5,4,12,6,14,15,13,3,2,2,4,2,1,2,1,2,2,2
"5226",16250804,"Naranbat Ankhbat","9/11/1999 (23 years old)","D (L)","SV Seekirchen","Austrian Salzburg League","MGL","No","6/30/2022","6/30/2024","$0","Left Only","Very Strong","Weak","5'7""","134 lbs","133","5",68,80,8,13,3,2,7,3,6,1,6,7,4,6,13,6,6,6,8,6,10,10,17,5,14,4,7,7,6,7,14,14,7,2,14,14,10,3,10,17,7,10,11,12,7,7,12,6,9,11,13,3,1,2,2,3,1,1,3,2,2,3
"5227",23445463,"Gajkhüü Khishigdorj","2/26/1996 (27 years old)","M (R)","Ulaanbaatar City","Mongolian First League","MGL","No","6/15/2020","12/31/2024","$0","Right","Reasonable","Very Strong","5'7""","123 lbs","-","-",53,58,5,9,8,2,13,5,5,6,3,5,6,2,5,8,12,9,5,7,6,13,16,7,3,6,5,6,7,7,13,9,6,3,6,13,12,1,10,20,10,12,9,11,13,5,11,3,6,11,15,4,3,3,1,1,4,2,2,2,2,3
"5228",23445453,"Dashdorj Ankhbayar","7/15/1994 (28 years old)","D (C)","Ulaanbaatar City","Mongolian First League","MGL","No","6/15/2020","12/31/2024","$0","Right","Reasonable","Very Strong","6'0""","158 lbs","-","-",52,57,1,1,1,4,6,1,7,2,1,11,6,4,9,3,12,7,8,6,9,8,3,5,9,5,13,5,3,6,13,13,6,8,10,13,10,5,16,12,13,12,9,11,5,4,11,7,9,11,8,3,3,3,3,2,1,1,1,3,2,2
"5229",23445464,"Batbold Tögsbileg","2/5/1995 (28 years old)","ST (C)","Ulaanbaatar City","Mongolian First League","MGL","No","6/15/2020","12/31/2024","$0","Right","Fairly Strong","Very Strong","5'6""","132 lbs","-","-",50,57,4,1,10,12,6,4,8,5,1,4,5,7,2,8,5,9,6,9,5,9,15,14,12,7,5,4,4,6,12,12,5,2,12,12,11,1,9,15,14,10,11,10,10,3,12,1,12,9,18,1,2,1,2,2,3,2,1,1,3,1
"5230",23445414,"Amaraa Temüüjin","6/21/1998 (24 years old)","ST (C)","Deren","Mongolian Premier League","MGL","No","6/15/2020","12/31/2023","$0","Right Only","Weak","Very Strong","5'9""","156 lbs","-","-",51,55,4,1,9,12,10,4,12,1,1,4,4,2,1,9,12,8,1,6,5,11,12,12,1,12,5,4,3,6,12,12,5,2,12,12,11,2,12,19,9,11,10,14,12,14,5,4,10,8,17,1,3,1,2,2,3,2,1,2,1,2
"5231",82073890,"Briel Thomas","11/25/1994 (28 years old)","DM, M (C)","Dublanc","Dominican Premier League","DMA","No","7/1/2021","6/30/2024","$0 - $22K","Right","Reasonable","Very Strong","5'11""","176 lbs","9","1",92,105,8,7,4,7,13,8,8,7,8,9,7,6,12,12,10,9,9,8,10,14,3,5,12,8,12,9,10,11,14,14,9,6,11,14,14,7,18,20,10,11,11,10,5,8,6,6,11,9,14,2,3,2,1,2,1,4,3,3,1,3
"5232",2000064917,"Audell Laville","9/14/2002 (20 years old)","AM (R), ST (C)","Harlem Utd","Dominican Premier League","DMA","No","6/13/2022","6/30/2024","$1.5K - $4.5K","Right","Reasonable","Very Strong","5'10""","156 lbs","-","-",70,95,6,6,9,12,12,6,13,2,1,6,8,6,1,7,7,9,5,9,2,13,6,7,11,9,7,6,6,8,13,13,7,7,14,13,7,6,11,12,12,10,14,12,9,13,8,3,20,12,19,2,2,1,1,2,3,3,1,2,1,1
"5233",2000204101,"Zion Emanuel","1/12/2001 (22 years old)","D (C)","Harlem Utd","Dominican Premier League","DMA","No","7/1/2019","6/30/2024","$0","Right","Weak","Very Strong","6'4""","182 lbs","-","-",62,90,1,1,4,4,4,1,9,1,2,12,5,2,12,5,10,10,8,6,13,13,10,5,12,5,12,5,5,6,12,9,6,10,9,10,4,5,11,11,11,11,11,11,13,5,12,6,18,10,7,4,3,1,3,2,2,2,3,2,1,3
"5234",82090245,"Reon Cuffy","1/17/1999 (24 years old)","M/AM (R)","All Saints FC","Dominican First Division","DMA","No","10/25/2019","-","$0","Right","Reasonable","Very Strong","5'10""","152 lbs","-","-",68,90,4,6,12,10,6,4,4,5,4,1,7,5,4,11,15,8,5,7,5,11,7,12,10,8,3,5,5,11,12,12,5,6,13,12,9,4,9,18,14,10,13,12,7,7,12,8,10,11,10,2,2,1,2,2,4,1,2,2,1,1
"5235",2000014474,"Felix Verhaar","10/31/1991 (31 years old)","ST (C)","VOC","Dutch Vierde Divisie B","BOE","Yes","7/1/2021","-","$0","Right","Reasonable","Very Strong","5'9""","156 lbs","-","-",50,60,6,4,5,14,10,6,10,5,1,5,4,8,1,10,5,9,7,9,7,7,8,10,8,14,7,6,5,7,9,9,6,7,14,8,10,8,10,17,10,10,10,14,5,5,13,1,10,11,9,3,2,1,1,2,3,1,2,3,3,3
"5236",82075419,"Ajaya Royer","9/4/1997 (25 years old)","D/WB/M/AM (R)","Cunupia","TT Premier Football League Tier 1","DMA","No","12/18/2019","6/30/2024","$0 - $2K","Right","Reasonable","Very Strong","5'10""","158 lbs","-","-",78,90,6,11,8,10,11,5,2,3,3,5,6,3,8,8,7,5,8,8,7,11,11,8,1,11,7,7,5,8,13,13,7,3,15,13,11,9,8,6,7,10,13,12,9,10,14,1,12,12,13,1,2,1,2,1,2,3,1,3,3,1
"5237",82075297,"Sidney Lockhart","3/8/1996 (27 years old)","M/AM (L)","South East (DMA)","Dominican Premier League","DMA","No","7/1/2021","6/30/2024","$1.5K - $5K","Left","Very Strong","Reasonable","5'11""","158 lbs","-","-",72,90,6,11,9,8,12,3,5,5,4,3,11,3,5,7,6,6,7,7,5,10,16,8,5,11,5,6,6,11,12,12,6,4,13,12,12,5,9,19,11,9,9,11,9,11,5,8,20,12,19,2,3,3,4,2,1,2,2,3,3,1
"5238",82079945,"Kiano Martin","8/9/2000 (22 years old)","M/AM (RC)","Soca Strikers","Dominican First Division","DMA","No","6/15/2020","-","$0","Right","Weak","Very Strong","6'1""","163 lbs","-","-",55,87,5,7,5,6,13,5,1,4,5,6,7,12,7,13,15,10,7,6,2,10,13,13,13,12,1,6,8,10,13,11,3,8,14,13,5,4,10,10,12,11,9,12,8,11,14,1,9,9,7,3,1,2,3,3,2,3,2,2,1,3
"5239",82065110,"Anfernee Frederick","1/29/1996 (27 years old)","DM, M (C)","Bath Estate","Dominican Premier League","DMA","No","6/15/2020","6/30/2024","$0 - $10K","Right","Fairly Strong","Very Strong","5'5""","123 lbs","-","-",82,85,9,6,10,9,10,9,9,10,8,11,9,8,7,13,8,12,9,11,10,16,5,14,9,11,12,10,11,14,8,9,6,2,14,8,14,2,13,15,10,13,12,13,7,8,5,7,20,12,15,1,3,1,2,2,2,1,2,3,2,3
"5240",30001040,"Kelrick Walters","11/6/1989 (33 years old)","M/AM (C), ST (C)","Bath Estate","Dominican Premier League","DMA","No","7/1/2020","6/30/2024","$0","Right","Fairly Strong","Very Strong","5'10""","160 lbs","-","-",76,85,6,7,6,13,11,7,6,9,1,8,8,8,8,7,6,11,2,10,5,10,7,7,13,12,8,4,7,9,12,12,8,6,9,9,12,7,11,17,14,12,8,13,12,20,11,4,10,9,17,3,3,2,1,1,4,1,1,2,2,1
"5241",82079932,"Rufuson Pierre Louis","6/21/1996 (26 years old)","D/WB/M/AM (L)","Caledonia Utd","TT Premier Football League Tier 1","DMA","No","6/15/2020","6/30/2024","$0","Left","Very Strong","Reasonable","5'6""","125 lbs","-","-",70,85,4,9,6,8,7,3,6,2,1,6,9,1,8,8,5,8,8,8,8,10,3,13,11,10,8,7,7,8,13,13,7,3,15,13,12,1,13,13,11,9,9,14,11,1,5,6,11,11,19,2,3,3,2,3,1,2,3,2,1,1
"5242",30001016,"Malcolm Joseph","10/10/1993 (29 years old)","D (C)","Bombers (DMA)","Dominican Premier League","DMA","No","6/15/2020","6/30/2024","$0 - $5K","Right","Weak","Very Strong","6'2""","163 lbs","5","-",72,82,4,1,1,2,6,1,12,5,2,12,5,1,10,3,10,10,7,4,10,13,17,5,11,5,13,6,1,7,13,13,7,11,8,13,9,5,14,16,8,10,11,11,6,2,8,1,12,11,10,2,1,3,3,2,1,3,1,3,1,1
"5243",30001345,"Julian Wade","7/12/1990 (32 years old)","ST (C)","Formartine","Highland Football League","DMA","No","6/1/2022","5/31/2024","$2K - $7K","Right","Reasonable","Very Strong","5'11""","163 lbs","33","15",61,80,4,1,10,13,9,5,10,2,1,4,6,6,3,13,10,10,6,6,6,10,17,13,11,13,6,5,6,7,11,7,6,7,10,7,12,6,7,13,11,15,11,12,11,14,8,3,8,13,15,3,1,1,2,2,3,1,4,3,2,3
"5244",2000291239,"Troy Jules","6/26/2000 (22 years old)","M (C), AM (LC), ST (C)","John Hughes","Antigua and Barbuda Premier Division","DMA","No","1/1/2023","-","$0","Right","Weak","Very Strong","5'6""","134 lbs","6","4",65,80,6,8,14,8,12,6,5,6,2,5,11,6,8,7,8,8,3,5,6,11,10,7,5,10,7,7,9,10,13,9,4,1,12,12,6,3,11,20,12,11,12,10,11,10,5,7,8,12,19,1,2,1,2,3,2,2,3,3,2,2
"5245",82090199,"Erskim Williams","10/21/1994 (28 years old)","D (C)","Dublanc","Dominican Premier League","DMA","No","7/1/2021","6/30/2024","$500 - $2.5K","Right","Reasonable","Very Strong","6'2""","185 lbs","-","-",80,80,2,1,2,7,7,1,13,6,1,12,6,2,12,5,15,11,9,8,10,12,9,5,7,5,11,6,6,8,13,10,7,7,15,11,12,13,15,19,10,12,12,14,12,10,8,5,9,11,14,3,2,2,2,3,2,2,1,3,1,2
"5246",2000252862,"Nathaniel Meyer","12/17/1997 (25 years old)","GK","Jong Holland (CUR)","Kampionato Liga MCB - Promé Division","BOE","No","7/1/2018","6/30/2025","$0 - $7K","Right","Reasonable","Very Strong","6'4""","178 lbs","-","-",57,60,3,3,3,1,3,6,1,1,3,3,5,3,1,3,5,6,8,6,9,12,7,1,4,3,11,6,5,5,11,7,6,12,14,8,5,5,12,10,11,9,9,12,8,1,11,1,4,14,16,5,7,13,9,7,9,12,5,5,10,13
"5247",82086353,"Usher George","4/17/1998 (25 years old)","M/AM (L)","Bombers (DMA)","Dominican Premier League","DMA","No","7/1/2018","6/30/2024","$0","Left","Very Strong","Weak","5'9""","149 lbs","-","-",55,78,6,9,8,12,13,6,4,3,6,6,13,6,7,8,15,7,1,7,7,14,12,7,8,10,6,8,5,13,7,7,7,8,13,8,14,5,11,10,11,10,10,12,11,5,11,3,16,10,19,1,2,2,2,2,1,3,3,2,1,1
"5248",82080075,"Fitz Jolly","3/16/1999 (24 years old)","M/AM (LC)","Bath Estate","Dominican Premier League","DMA","No","7/1/2018","6/30/2024","$0 - $1.5K","Left","Very Strong","Reasonable","5'8""","147 lbs","-","-",70,75,6,7,12,7,12,6,6,6,5,5,9,6,4,7,12,9,8,11,4,13,19,8,7,12,5,7,10,11,13,13,7,6,14,13,6,7,9,16,10,13,11,12,5,7,6,2,13,12,14,4,2,1,1,2,2,2,2,1,3,3
"5249",82080047,"Shanon Stoute","7/9/1996 (26 years old)","AM (R), ST (C)","Kensboro","Dominican First Division","DMA","No","6/15/2020","-","$0","Right","Reasonable","Very Strong","6'1""","167 lbs","-","-",51,75,4,7,12,12,6,4,6,4,4,3,8,6,2,7,5,7,3,4,4,12,15,8,2,8,5,4,3,7,12,11,4,6,11,12,11,5,9,13,8,12,9,11,9,4,15,1,10,9,14,2,1,2,1,1,3,2,1,1,3,2
"5250",2000288009,"Jervanie Xavier","10/18/2000 (22 years old)","D (LC), WB (L)","Middleham Utd","Dominican Premier League","DMA","No","10/26/2022","-","$0","Right","Reasonable","Very Strong","6'2""","169 lbs","-","-",60,75,6,11,5,3,7,5,7,5,5,14,8,1,8,8,10,8,8,7,4,11,5,6,13,3,10,7,6,7,10,11,7,12,12,11,6,5,13,15,8,14,9,12,7,10,12,1,12,14,11,1,2,3,3,2,2,2,3,3,4,2
"5251",2000288010,"Felix Anselm","9/13/2003 (19 years old)","ST (C)","Dublanc","Dominican Premier League","DMA","No","9/13/2021","-","$0","Right","Reasonable","Very Strong","5'9""","149 lbs","-","-",60,74,5,2,8,13,5,5,13,3,1,3,3,4,1,7,14,11,5,5,6,11,2,9,7,11,4,5,6,6,13,13,6,3,11,13,11,6,10,17,10,10,11,9,13,11,7,3,17,14,8,2,2,1,1,1,1,3,2,1,2,1
"5252",82050358,"Glenson Prince","9/17/1987 (35 years old)","GK","Bombers (DMA)","Dominican Premier League","DMA","No","7/1/2020","6/30/2024","$0","Left","Very Strong","Reasonable","6'0""","171 lbs","-","-",68,73,2,2,2,1,4,5,1,3,1,3,8,2,3,4,11,5,9,7,10,14,13,3,13,1,11,7,6,6,10,17,8,6,8,10,2,6,8,14,16,15,11,15,13,7,7,3,13,12,15,4,14,5,8,5,8,9,11,7,7,11
"5253",82080034,"Jamie Parillon","12/10/1994 (28 years old)","ST (C)","Bombers (DMA)","Dominican Premier League","DMA","No","6/15/2020","6/30/2024","$0","Right","Reasonable","Very Strong","6'2""","174 lbs","-","-",56,72,4,1,12,12,8,4,7,5,1,2,5,4,3,4,14,10,6,4,5,5,14,8,13,11,5,4,5,5,12,12,5,10,13,12,10,8,11,20,11,8,10,11,7,17,5,8,6,11,20,2,1,4,1,3,3,1,3,1,1,1
"5254",2000204139,"Marcelus Bonney","2/16/2000 (23 years old)","M/AM (L)","Bath Estate","Dominican Premier League","DMA","No","7/1/2018","6/30/2024","$0","Right","Reasonable","Very Strong","6'2""","165 lbs","-","-",62,72,5,10,13,6,6,5,4,4,5,5,9,5,4,7,12,9,4,9,6,10,4,7,5,9,5,6,7,7,13,12,7,8,16,12,6,5,14,16,14,11,14,10,9,9,5,6,12,10,9,2,3,3,3,1,3,2,3,3,2,1
"5255",82080070,"Montell James","7/17/1997 (25 years old)","M (L), AM (LC)","Harlem Utd","Dominican Premier League","DMA","No","6/15/2020","6/30/2024","$0","Left","Very Strong","Weak","5'11""","156 lbs","-","-",55,70,7,8,6,6,8,11,4,3,2,2,5,5,2,5,11,9,4,9,5,9,10,8,9,9,3,5,9,7,12,12,5,9,9,12,9,4,12,11,10,12,11,11,7,11,13,3,19,10,12,1,1,1,3,2,1,3,2,1,2,1
"5256",2000204118,"Triston Sandy","1/10/2001 (22 years old)","M (C), AM (RLC)","Bombers (DMA)","Dominican Premier League","DMA","No","7/1/2021","6/30/2024","$0","Right","Reasonable","Very Strong","5'9""","147 lbs","-","-",64,70,5,7,7,9,13,5,2,6,2,5,4,1,6,9,5,7,7,10,3,9,11,9,7,12,6,6,8,7,13,13,6,3,11,13,12,4,11,19,11,10,11,13,14,11,10,7,8,8,13,2,2,4,3,1,3,1,3,1,1,1
"5257",5430258,"Harrison Róchez","11/29/1983 (39 years old)","AM (RC), ST (C)","Police Utd (BLZ)","Belizean Lower Leagues","BLZ","No","6/14/2021","6/30/2024","$0 - $10K","Right","Reasonable","Very Strong","6'0""","178 lbs","145","31",65,111,7,8,9,10,9,6,10,7,7,11,10,6,7,10,14,10,12,10,11,8,13,7,15,11,7,8,8,13,6,7,9,10,8,7,9,10,10,10,4,16,12,15,5,14,8,1,15,7,11,1,3,2,1,3,3,2,3,1,2,2
"5258",82079958,"Jerran Sebastian","3/28/1995 (28 years old)","M/AM (C), ST (C)","Soca Strikers","Dominican First Division","DMA","No","6/15/2020","-","$0","Right","Reasonable","Very Strong","5'9""","156 lbs","-","-",53,70,2,3,9,9,8,3,5,5,4,5,10,4,4,6,10,8,6,9,4,9,6,10,12,12,7,6,7,7,12,9,6,8,12,11,12,9,9,15,10,10,9,12,9,7,5,3,15,11,11,2,2,4,3,1,1,3,1,2,1,4
"5259",82075415,"Chad Phillip","10/1/1996 (26 years old)","GK","FC Camerhogne","Grenadian Premier Division","DMA","No","7/1/2018","12/31/2024","$0","Right","Reasonable","Very Strong","6'2""","196 lbs","2","-",65,70,2,1,1,1,1,7,1,3,3,1,6,2,2,1,14,8,10,6,7,12,14,2,9,1,10,6,5,5,13,9,6,9,9,12,5,5,10,15,12,9,10,13,8,8,7,7,17,11,8,7,11,13,5,3,13,10,5,8,6,7
"5260",2000204107,"Marcus Bredas","11/29/2003 (19 years old)","D/WB/M/AM (R)","Pointe Michel","Dominican Premier League","DMA","No","7/1/2019","-","$0","Right","Reasonable","Very Strong","5'10""","156 lbs","-","-",62,70,6,9,8,10,7,6,6,6,6,5,9,5,7,10,15,8,7,6,6,6,11,13,6,9,6,7,8,8,14,8,2,5,9,11,8,4,20,17,11,12,11,10,15,4,11,2,13,13,19,3,2,1,2,1,1,3,1,3,2,3
"5261",94047744,"Jeanmal Prosper","5/25/1993 (30 years old)","D/WB (R)","Slough","Vanarama National League South","DMA","No","5/19/2023","5/30/2024","$0 - $9K","Right","Weak","Very Strong","5'9""","160 lbs","346","37",55,70,5,9,9,6,9,4,11,6,5,9,9,8,11,8,14,9,11,10,10,8,10,5,13,8,9,9,8,12,9,7,11,7,17,10,8,12,13,14,12,11,10,12,5,7,5,4,11,11,8,2,1,1,1,3,1,4,1,3,4,4
"5262",82075354,"Andrez Joseph","5/20/1998 (25 years old)","D/WB/M/AM (L)","Harlem Utd","Dominican Premier League","DMA","No","6/15/2020","6/30/2024","$0","Left","Very Strong","Weak","5'5""","130 lbs","-","-",55,69,6,9,7,7,7,6,4,7,4,7,11,1,7,8,13,5,7,8,8,10,10,7,13,9,8,7,5,8,11,12,7,2,12,11,12,7,14,8,12,12,12,9,11,9,10,3,8,12,13,1,1,3,3,2,2,3,3,3,3,2
"5263",2000204110,"Javid George","6/14/1998 (24 years old)","M/AM (R)","South East (DMA)","Dominican Premier League","DMA","No","6/15/2020","6/30/2024","$0","Right","Reasonable","Very Strong","5'10""","152 lbs","-","-",65,68,6,11,7,7,8,5,1,6,2,5,4,1,4,5,7,8,7,4,6,8,9,11,1,8,5,7,4,12,13,13,6,3,9,13,10,4,10,11,12,9,9,9,5,16,12,3,8,12,10,2,3,1,1,2,2,3,1,2,2,3
"5264",2000204133,"Trai Douglas","12/21/1998 (24 years old)","DM, M (C)","We United","Dominican Premier League","DMA","No","7/1/2021","6/30/2024","$0","Right","Reasonable","Very Strong","6'1""","165 lbs","-","-",60,67,5,1,5,3,8,5,5,5,1,7,9,1,7,6,13,7,6,7,6,13,13,6,5,7,8,7,6,12,13,13,6,8,12,13,7,5,14,19,11,11,10,12,11,10,14,1,18,13,18,1,3,3,1,2,3,2,2,1,3,3
"5265",82075303,"Aldrin Lawrence","5/29/1994 (29 years old)","D/WB/M/AM (L)","Bombers (DMA)","Dominican Premier League","DMA","No","6/15/2020","6/30/2024","$0","Left","Very Strong","Reasonable","5'11""","152 lbs","-","-",53,66,4,6,4,7,4,4,4,1,4,5,6,1,5,3,9,6,7,6,5,12,7,7,8,11,6,5,4,7,12,12,4,4,12,12,12,3,9,17,13,11,12,8,7,6,6,8,10,11,17,3,2,4,4,1,3,2,3,2,3,4
"5266",82075423,"Kassim Peltier","3/28/1997 (26 years old)","D/WB/M/AM (L)","Harlem Utd","Dominican Premier League","DMA","No","6/15/2020","6/30/2024","$0","Right","Strong","Very Strong","6'1""","165 lbs","-","-",60,65,5,8,6,5,4,5,5,1,5,6,9,4,7,6,6,5,5,7,7,10,15,8,13,12,7,6,6,7,13,13,6,13,10,13,9,5,14,20,12,12,13,12,6,6,5,7,14,13,20,1,1,2,1,2,2,1,1,1,3,1
"5267",82075321,"Travist Joseph","5/23/1993 (30 years old)","M/AM (L), ST (C)","Dublanc","Dominican Premier League","DMA","No","1/1/2020","6/30/2024","$0","Left","Very Strong","Reasonable","5'10""","158 lbs","-","-",65,65,6,9,7,11,9,6,8,5,2,6,6,2,2,6,5,8,3,9,6,11,6,11,1,11,6,7,6,8,14,14,7,6,9,14,7,7,11,15,9,10,10,10,5,4,6,5,15,9,19,3,1,1,2,3,1,3,3,1,2,2
"5268",5430059,"Shane Orio","8/7/1980 (42 years old)","GK","Bandits (BLZ)","Belizean Premier Football League","BLZ","No","6/14/2021","6/30/2024","$0 - $1.5K","Right","Reasonable","Very Strong","6'2""","185 lbs","301","-",67,110,3,2,1,1,9,4,1,1,2,3,7,3,1,9,14,9,13,9,10,8,13,7,12,2,8,8,8,5,8,7,10,11,13,11,6,10,8,10,14,12,11,10,15,6,6,8,13,13,20,9,13,11,9,8,9,8,11,9,9,10
"5269",2000204136,"Cheston Prosper","4/6/1992 (31 years old)","D/WB/M/AM (R)","We United","Dominican Premier League","DMA","No","7/1/2022","6/30/2024","$0","Right","Reasonable","Very Strong","5'3""","121 lbs","-","-",64,65,8,11,7,9,8,6,3,7,6,7,8,4,6,7,13,10,4,8,7,13,10,12,5,12,6,7,8,8,11,10,7,3,12,11,11,1,13,18,9,9,10,11,14,6,11,8,8,13,20,1,2,3,4,1,2,3,1,3,2,3
"5270",82075457,"Elijah Toulon","10/6/1993 (29 years old)","GK","Bath Estate","Dominican Premier League","DMA","No","6/15/2020","6/30/2024","$0","Right","Fairly Strong","Very Strong","6'2""","167 lbs","-","-",55,65,3,3,1,3,1,3,1,1,3,1,5,3,3,1,12,9,15,4,9,10,10,1,4,3,8,6,5,5,12,5,6,12,15,8,2,3,10,10,12,11,12,13,13,12,7,4,16,12,10,3,6,13,6,7,8,13,5,5,8,13
"5271",82050359,"Kurlson Benjamin","12/7/1984 (38 years old)","ST (C)","Bath Estate","Dominican Premier League","DMA","No","6/14/2021","6/30/2024","$0","Left","Very Strong","Reasonable","5'10""","158 lbs","-","-",55,64,6,2,5,14,12,6,11,7,3,6,7,4,3,11,13,10,5,9,6,9,16,10,10,8,6,6,7,7,7,7,7,7,11,7,7,7,9,17,11,12,11,10,5,4,10,6,8,11,8,2,3,3,3,1,1,1,3,2,3,1
"5272",30001017,"Mitchell Joseph","9/2/1986 (36 years old)","AM (R), ST (C)","Bath Estate","Dominican Premier League","DMA","No","6/14/2021","6/30/2024","$0","Right","Weak","Very Strong","5'11""","167 lbs","-","-",56,63,7,9,8,14,11,7,9,5,7,5,10,5,2,7,9,7,7,10,8,10,7,5,13,10,7,7,7,9,10,9,8,8,8,9,5,7,7,20,10,12,11,12,7,5,10,7,11,13,11,1,3,2,1,3,1,4,4,3,2,3
"5273",2000204132,"Michael Gasper","9/6/1993 (29 years old)","DM, M (C)","We United","Dominican Premier League","DMA","No","7/1/2019","6/30/2024","$0","Right","Reasonable","Very Strong","6'1""","167 lbs","-","-",61,63,6,5,4,7,10,5,6,5,1,6,6,1,11,6,5,9,7,8,8,12,4,5,9,8,12,7,7,11,14,13,7,12,7,14,7,4,11,20,11,9,13,11,12,9,12,5,11,12,8,1,2,1,1,1,3,3,3,1,1,3
"5274",82075366,"Gylles Mitchell","12/16/1997 (25 years old)","D/WB/M/AM (R)","Harlem Utd","Dominican Premier League","DMA","No","6/15/2020","6/30/2024","$0","Right","Weak","Very Strong","5'7""","141 lbs","-","-",57,62,6,9,8,8,8,6,4,2,6,7,10,3,8,8,13,11,7,7,8,12,4,7,14,9,6,7,8,8,9,11,7,5,5,12,12,2,10,15,9,12,12,11,10,15,10,7,8,10,14,2,2,2,1,2,2,3,3,2,1,3
"5275",82075359,"Eustace Marshall","2/3/1997 (26 years old)","D (C)","Bath Estate","Dominican Premier League","DMA","No","6/15/2020","6/30/2024","$0","Right","Reasonable","Very Strong","6'0""","167 lbs","-","-",50,62,1,1,4,1,5,1,10,3,1,13,6,1,10,2,5,9,8,3,5,8,12,5,7,3,13,5,3,6,13,12,6,9,14,9,4,8,13,20,12,9,13,9,11,4,7,4,10,11,18,3,3,1,1,4,3,1,4,3,3,1
"5276",82075334,"Randolph Peltier","9/16/1982 (40 years old)","ST (C)","South East (DMA)","Dominican Premier League","DMA","No","7/1/2020","-","$0","Right Only","Very Weak","Very Strong","5'8""","134 lbs","-","-",50,62,7,4,6,15,7,7,15,7,3,6,8,6,1,10,6,12,8,13,7,10,18,12,17,13,8,7,5,8,6,6,6,4,18,6,10,5,10,20,10,18,10,8,8,8,5,3,7,12,20,3,1,3,1,3,1,1,2,2,3,3
"5277",30001027,"Raleighson Pascal","7/31/1990 (32 years old)","GK","We United","Dominican Premier League","DMA","No","7/1/2018","6/30/2024","$0","Right","Reasonable","Very Strong","6'3""","171 lbs","-","-",61,62,2,3,3,2,2,6,1,2,2,2,8,2,3,1,9,7,8,4,12,6,9,2,11,3,11,6,5,5,11,16,6,11,13,10,3,4,11,17,14,11,10,11,9,11,6,4,9,13,9,3,9,11,13,7,6,9,5,6,8,11
"5278",82075325,"Naielle Lee","10/14/1994 (28 years old)","D/WB/M (L)","Bath Estate","Dominican Premier League","DMA","No","6/15/2020","6/30/2024","$0","Left","Very Strong","Weak","5'7""","147 lbs","-","-",52,61,5,8,6,1,6,4,2,1,3,5,5,1,6,4,11,6,6,5,6,12,6,5,11,5,6,5,5,7,12,12,5,1,7,12,12,6,13,18,9,11,12,12,5,4,8,8,9,10,20,2,2,4,2,1,3,4,3,3,3,1
"5279",87001964,"Woodrow West","9/19/1985 (37 years old)","GK","Verdes FC","Belizean Premier Football League","BLZ","No","7/1/2019","6/30/2024","$0 - $6K","Left","Very Strong","Weak","5'10""","169 lbs","101","-",80,110,4,3,2,2,10,8,2,3,3,2,8,4,2,7,13,10,14,10,10,9,4,2,10,3,11,11,8,8,11,13,10,9,14,13,9,10,8,11,11,11,12,10,13,4,10,7,15,12,11,7,13,12,4,11,8,9,10,10,9,10
"5280",82080043,"Nigel Sanderson","4/1/1994 (29 years old)","ST (C)","Panthers (VGB)","BVI Premier League","DMA","No","10/1/2019","-","$0","Right","Reasonable","Very Strong","6'0""","174 lbs","-","-",52,61,3,1,11,11,10,3,8,2,3,3,1,7,1,5,6,7,4,10,4,7,11,7,2,11,4,3,3,4,11,11,4,6,7,11,8,10,8,20,14,13,11,10,6,7,9,3,16,15,16,4,1,2,3,2,3,2,1,2,2,3
"5281",30001020,"Lester Langlais","2/21/1984 (39 years old)","ST (C)","Bath Estate","Dominican Premier League","DMA","No","6/14/2021","6/30/2024","$0","Right","Fairly Strong","Very Strong","5'7""","138 lbs","325","140",52,60,6,3,7,15,12,7,10,8,4,6,8,6,1,11,5,10,7,7,7,10,16,9,13,15,6,7,5,8,7,7,3,7,15,7,6,3,11,14,12,11,13,9,6,5,9,2,11,13,13,1,1,2,1,1,3,3,2,3,1,2
"5282",29129365,"Chad Bertrand","12/19/1986 (36 years old)","M/AM (C)","Dublanc","Dominican Premier League","DMA","No","6/14/2021","6/30/2024","$0","Right","Reasonable","Very Strong","6'0""","165 lbs","-","-",60,60,7,6,4,7,10,7,4,9,4,8,14,13,5,15,13,9,3,9,8,9,14,13,14,10,9,8,10,13,8,10,8,12,9,10,10,5,10,20,11,11,11,12,10,4,15,6,11,11,15,3,1,3,2,1,1,1,3,3,1,4
"5283",82074207,"Albert Barthley","11/6/1986 (36 years old)","M/AM (L)","Empire F.C.","Antigua and Barbuda Premier Division","DMA","No","6/14/2021","6/30/2024","$0","Left","Very Strong","Weak","5'6""","134 lbs","8","2",52,60,9,12,10,9,8,6,5,5,6,7,9,3,8,12,10,9,6,8,6,14,13,11,8,15,7,8,9,9,9,9,3,2,15,8,9,2,12,18,12,11,10,12,12,7,9,6,16,11,12,3,1,4,3,4,2,2,2,1,1,3
"5284",82075379,"Delroy Parker","10/15/1997 (25 years old)","ST (C)","Tarish Utd","Dominican First Division","DMA","No","6/15/2020","-","$0","Right","Weak","Very Strong","5'10""","158 lbs","-","-",52,60,5,2,8,10,5,5,13,4,3,5,5,1,1,8,9,8,1,7,3,11,7,8,5,10,6,5,2,6,13,11,6,7,15,13,5,11,11,14,9,9,7,11,6,5,8,7,12,14,10,2,4,3,3,3,1,1,3,3,3,1
"5285",2000090145,"Javis Humpreys","12/8/2000 (22 years old)","D (LC), WB/M/AM (L)","Harlem Utd","Dominican Premier League","DMA","No","6/15/2020","6/30/2024","$0","Left","Very Strong","Weak","6'2""","176 lbs","-","-",59,59,5,5,8,8,5,5,8,6,7,7,10,1,8,5,12,5,8,4,8,11,16,5,12,6,10,8,5,9,10,10,7,9,14,10,11,9,13,19,10,11,15,11,8,10,12,8,15,11,10,2,3,2,1,1,3,3,1,3,2,4
"5286",37062007,"Chovanie Amatkarijo","5/20/1999 (24 years old)","M/AM (RL), ST (C)","Östersunds FK","Swedish First Division Elite","SIM","Yes","2/22/2022","11/30/2024","$0","Right","Reasonable","Very Strong","5'9""","152 lbs","107","27",97,105,7,7,12,9,10,9,6,7,6,4,11,8,6,11,10,8,12,9,9,8,11,14,3,13,6,9,7,9,15,14,9,8,12,14,10,7,6,8,7,7,10,9,8,6,9,6,11,11,12,3,1,1,2,2,3,3,1,3,3,1
"5287",2000249753,"Len Bleeker","8/28/2005 (17 years old)","ST (C)","Excelsior","Eredivisie","SIM","Yes","6/13/2022","6/30/2026","$190K - $550K","Right","Reasonable","Very Strong","6'1""","163 lbs","-","-",67,102,5,2,12,11,10,5,10,7,1,1,7,1,1,9,8,7,4,5,2,9,12,10,6,11,5,5,4,7,13,12,2,11,12,12,11,11,9,20,12,11,11,13,10,9,6,1,9,12,11,3,3,1,3,2,1,4,2,3,1,2
"5288",82079730,"Kael Richards","2/25/2000 (23 years old)","DM, M/AM (C)","Soualiga","Sint Maarten Championship","SIM","Yes","7/1/2018","-","$0","Right","Reasonable","Very Strong","6'0""","160 lbs","-","-",55,87,4,5,7,5,7,5,1,7,2,6,7,1,12,5,9,9,7,7,7,9,3,8,10,7,5,7,10,10,13,13,6,8,8,13,6,3,11,12,11,12,11,12,11,12,11,7,15,11,8,3,1,1,3,3,3,3,2,2,3,1
"5289",37064796,"Quintón Christina","5/3/1995 (28 years old)","DM, M (C)","Noordwijk","Dutch Tweede Divisie","SIM","Yes","1/29/2023","-","$0","Right Only","Weak","Very Strong","5'7""","152 lbs","93","2",72,85,9,9,8,7,10,8,5,9,5,6,9,8,8,9,14,8,8,10,8,8,11,12,6,9,9,10,10,10,13,14,10,6,12,11,11,10,6,7,7,11,11,8,5,7,14,8,9,11,12,3,1,2,2,1,2,1,3,1,3,3
"5290",5430097,"Elroy Kuylen","6/6/1983 (40 years old)","WB (L), M/AM (RL), ST (C)","Bandits (BLZ)","Belizean Premier Football League","BLZ","No","6/14/2021","6/30/2024","$1.5K - $5K","Left","Very Strong","Fairly Strong","5'9""","141 lbs","43","9",63,107,6,9,9,6,9,4,10,4,6,7,9,1,9,9,12,7,10,8,10,6,11,8,7,10,6,6,9,11,10,10,8,5,13,11,11,6,10,18,3,12,11,11,10,17,6,8,13,10,17,1,1,1,2,2,1,2,3,4,1,1
"5291",37084858,"Sergio Hughes","2/24/2002 (21 years old)","AM (RL)","Kozakken Boys","Dutch Tweede Divisie","SIM","Yes","6/30/2022","-","$0","Right","Reasonable","Very Strong","5'10""","149 lbs","1","-",70,85,7,11,10,11,7,6,6,7,6,6,8,1,6,11,13,7,4,5,8,10,7,9,1,7,6,8,8,11,13,10,8,7,13,12,12,13,11,15,9,12,12,9,2,12,6,7,12,9,18,2,2,3,4,2,3,2,3,2,2,3
"5292",2000072352,"Mitchell de Nooijer","2/29/2000 (23 years old)","D (C), DM, M (C)","GOES","Dutch Vierde Divisie C","SIM","Yes","7/1/2022","-","$0","Right","Reasonable","Very Strong","6'0""","158 lbs","2","-",63,85,1,4,4,3,11,1,8,3,2,14,8,4,14,6,11,8,7,8,11,9,13,5,13,5,11,7,9,8,12,10,7,10,10,8,5,6,10,11,11,12,10,10,14,10,6,7,16,11,9,2,1,2,1,1,3,3,3,3,2,1
"5293",37072283,"Gerwin Lake","4/9/1996 (27 years old)","M (L), AM (RL), ST (C)","Poortugaal","Dutch Vierde Divisie B","SIM","Yes","6/30/2021","-","$0","Left","Very Strong","Reasonable","6'5""","178 lbs","12","3",73,84,6,8,6,13,13,6,3,6,6,3,9,7,7,9,15,5,8,9,7,10,19,11,7,9,6,7,7,8,13,10,7,12,15,11,13,5,12,18,8,10,11,13,7,4,11,7,13,12,14,3,1,3,3,2,1,3,1,3,1,2
"5294",37069416,"Ilounga Pata","11/12/2000 (22 years old)","D/WB (R)","TOP Oss","Keuken Kampioen Divisie","SIM","Yes","1/7/2022","6/30/2024","$24K - $250K","Right Only","Weak","Very Strong","5'10""","160 lbs","54","2",75,80,5,12,6,3,10,3,5,2,7,9,10,4,10,11,14,6,9,8,8,14,15,8,12,7,9,8,6,8,13,12,9,7,11,13,10,9,11,20,11,11,10,11,9,11,8,4,19,12,18,1,3,1,1,1,2,4,2,1,3,3
"5295",2000308190,"Tyrell Richardson","7/8/2003 (19 years old)","GK","Alphense Boys","Dutch Vierde Divisie A","SIM","Yes","6/12/2023","-","$0","Right","Reasonable","Very Strong","6'4""","178 lbs","-","-",56,76,2,2,3,1,1,4,1,3,2,3,5,1,3,2,6,6,14,5,9,12,6,2,7,2,4,5,1,4,9,11,4,9,10,6,1,4,10,14,10,11,12,11,8,16,5,3,7,11,19,5,7,11,6,4,9,12,6,6,11,12
"5296",37075674,"Kay Gerritsen","4/25/1997 (26 years old)","DM, M (C)","DSOV","Dutch Tweede Klasse Zondag B","SIM","Yes","7/1/2019","-","$0","Right","Reasonable","Very Strong","6'0""","169 lbs","1","-",53,74,3,4,4,3,5,5,5,9,1,9,10,1,10,6,14,9,7,4,7,13,12,5,11,3,8,6,8,11,13,11,6,10,9,11,9,7,9,10,11,11,9,12,5,6,5,1,11,12,8,1,2,1,3,2,1,4,1,3,1,2
"5297",2000251894,"T-Shawn Illidge","8/22/2003 (19 years old)","ST (C)","Gemert","Dutch Derde Divisie B","SIM","Yes","7/1/2022","-","$0","Right","Fairly Strong","Very Strong","5'10""","152 lbs","21","3",60,72,5,2,8,13,8,5,11,6,2,3,6,5,2,8,10,10,5,8,5,10,14,10,4,13,3,5,3,6,9,12,6,5,8,11,8,4,7,15,10,13,13,10,10,18,8,6,8,10,8,1,3,2,1,1,1,2,2,1,1,2
"5298",2000148399,"Ronan Olivacce","3/27/2004 (19 years old)","D (C), DM","Excelsior","Eredivisie","SIM","Yes","6/13/2022","6/30/2024","$3K - $28K","Right","Reasonable","Very Strong","6'1""","169 lbs","-","-",63,71,4,3,1,5,6,1,13,5,1,11,5,3,13,4,10,6,8,6,4,13,4,5,11,5,11,5,6,7,9,10,6,8,15,10,8,7,11,17,13,13,11,9,10,7,8,4,10,11,15,1,3,3,3,1,1,3,3,1,1,1
"5299",82089994,"Jean-Jacques Craane","7/17/2003 (19 years old)","ST (C)","Soualiga","Sint Maarten Championship","SIM","No","6/13/2022","-","$0","Right","Fairly Strong","Very Strong","5'6""","130 lbs","-","-",51,71,5,2,11,14,12,6,14,7,4,2,5,5,2,7,6,5,7,5,7,11,4,10,6,8,7,6,3,7,14,13,6,3,15,11,4,1,7,19,10,10,10,12,13,8,12,6,9,13,19,3,1,2,2,1,1,3,2,4,3,3
"5300",82089962,"Roy Gerritsen","1/20/1999 (24 years old)","D (C)","DSOV","Dutch Tweede Klasse Zondag B","SIM","Yes","7/1/2022","-","$0","Right","Fairly Strong","Very Strong","6'0""","169 lbs","-","-",52,70,2,1,1,1,4,1,9,3,1,8,4,1,9,4,8,5,7,3,8,12,3,5,5,4,12,4,4,6,10,9,5,6,11,9,11,8,10,14,10,8,12,12,5,10,5,7,15,9,13,3,1,3,1,3,2,3,1,2,3,2
"5301",87034790,"Carlos Bernárdez","12/28/1992 (30 years old)","ST (C)","Victoria (HON)","Liga Nacional de Honduras","BLZ","No","12/31/2022","6/30/2025","$18K - $180K","Right","Reasonable","Very Strong","6'2""","178 lbs","167","35",89,102,7,3,14,14,14,7,14,8,6,5,6,7,6,12,8,12,6,10,6,9,3,11,8,12,8,7,8,8,14,12,8,9,13,12,6,10,10,14,8,13,12,13,13,3,12,2,18,10,15,2,2,2,1,2,1,3,1,1,1,2
"5302",82079596,"Djai Essed","4/25/1998 (25 years old)","D (C)","Flames United","Sint Maarten Championship","SIM","Yes","6/15/2020","-","$0","Right","Fairly Strong","Very Strong","5'11""","163 lbs","-","-",52,70,1,1,1,1,5,1,3,1,1,12,5,1,11,2,15,5,7,3,10,12,12,5,11,2,12,4,2,5,12,12,5,5,6,12,10,7,13,6,7,9,10,12,6,8,13,11,15,16,12,3,1,1,1,1,2,2,3,1,2,1
"5303",82075820,"Ramsleii Boelijn","2/23/1995 (28 years old)","D/WB/M (R), AM (RC), ST (C)","Scherpenheuvel","Kampionato Liga MCB - Promé Division","SIM","Yes","1/1/2021","6/30/2025","$0 - $8K","Right","Reasonable","Very Strong","5'7""","134 lbs","-","-",56,68,4,5,4,8,11,2,5,5,4,3,4,1,6,6,7,6,6,5,6,11,2,7,2,9,6,5,2,6,12,12,5,5,12,12,10,1,9,18,11,12,12,11,10,1,5,7,10,12,12,2,3,2,1,1,2,3,3,3,1,2
"5304",88025019,"Frankie Walkington","10/25/2000 (22 years old)","GK","Metro","New Zealand NRFL Championship","SIM","No","12/31/2022","-","$0","Right","Reasonable","Very Strong","6'5""","185 lbs","17","-",58,66,3,1,2,2,5,5,1,2,3,2,7,1,3,5,7,8,7,6,12,7,11,1,14,3,5,6,1,5,7,8,4,14,12,4,1,6,8,11,11,12,9,12,7,3,5,7,20,12,15,7,9,13,8,9,9,13,5,4,8,11
"5305",2000308167,"Cartalino Joseph","4/22/2002 (21 years old)","GK","Charlois","Dutch Derde Klasse Zaterdag C West 2","SIM","No","7/1/2022","-","$0","Right","Fairly Strong","Very Strong","6'2""","176 lbs","-","-",56,65,3,1,1,2,1,8,1,1,2,2,9,3,2,2,10,8,15,6,5,12,7,1,10,2,7,6,5,4,7,11,6,9,10,3,1,4,9,20,10,11,13,10,5,6,14,5,9,9,13,5,6,13,7,7,8,12,5,7,10,9
"5306",82089963,"Edermar La Cruz","6/10/1987 (36 years old)","M/AM (C)","Soualiga","Sint Maarten Championship","SIM","No","6/14/2021","-","$0","Right","Fairly Strong","Very Strong","5'4""","125 lbs","-","-",55,60,5,3,9,11,6,7,6,8,4,6,10,3,9,11,13,6,3,12,8,14,4,9,7,11,9,8,13,12,7,10,8,1,14,6,10,1,14,20,8,10,12,14,5,5,12,5,9,12,10,3,1,1,3,2,2,1,3,3,1,3
"5307",2000290287,"Jeroen Cox","12/13/1997 (25 years old)","ST (C)","Maastricht West","Dutch Tweede Klasse Zondag F","SIM","No","7/1/2020","-","$0","Right","Reasonable","Very Strong","6'1""","174 lbs","-","-",53,60,1,2,5,12,10,1,8,3,1,4,5,2,1,7,6,5,6,4,5,8,5,13,2,12,5,4,5,3,12,12,5,12,13,12,8,9,8,12,13,8,12,10,9,5,12,3,7,12,7,1,1,2,2,2,1,1,3,1,1,3
"5308",2000074742,"Imar Kort","6/13/1998 (24 years old)","AM (R), ST (C)","Zuidvogels","Dutch Eerste Klasse B","SIM","Yes","6/15/2020","-","$0","Right","Reasonable","Very Strong","5'7""","134 lbs","-","-",53,59,1,6,5,10,5,1,7,6,5,3,6,2,2,9,5,8,2,7,4,9,5,11,9,11,5,6,4,7,13,13,6,2,13,13,12,2,8,19,11,8,11,11,12,5,11,6,11,11,8,1,3,3,2,3,2,2,1,3,2,3
"5309",2000193953,"Elmer de Vries","5/5/2001 (22 years old)","AM (RL)","Unitas","Dutch Derde Divisie B","SIM","Yes","7/1/2022","-","$0","Right","Reasonable","Very Strong","6'4""","182 lbs","29","3",50,57,7,10,4,6,8,5,5,6,5,3,6,1,5,7,13,6,4,3,4,10,12,12,1,13,5,6,7,7,12,11,6,15,13,12,8,7,10,17,13,13,10,12,11,6,7,7,10,12,15,2,2,3,2,1,3,3,3,2,2,2
"5310",82079603,"Rick de Punder","9/4/1986 (36 years old)","D (R), M (RC)","Luctor Heinkenszand","Dutch Derde Klasse Zaterdag A Zuid 1","SIM","Yes","7/1/2022","-","$0","Right","Weak","Very Strong","5'7""","141 lbs","-","-",55,55,6,10,5,8,12,7,5,9,2,9,9,1,8,7,5,6,8,9,8,13,14,7,10,8,8,8,9,9,10,9,8,5,9,10,10,3,13,19,10,14,13,12,10,7,7,2,7,11,8,3,3,3,3,3,2,1,2,4,2,1
"5311",82089945,"Sjoerd van Griensven","6/20/1991 (31 years old)","GK","Reggae Lions","Sint Maarten Championship","SIM","Yes","7/1/2019","-","$0","Right","Reasonable","Very Strong","6'4""","176 lbs","-","-",51,55,4,2,1,2,5,6,1,2,3,2,9,3,1,3,10,9,10,6,13,6,15,3,14,2,10,6,5,4,11,9,4,11,13,9,1,6,9,13,11,9,12,11,13,9,10,3,19,11,13,5,15,8,12,6,6,13,5,11,8,13
"5312",5430110,"Tyrone Muschamp","7/1/1978 (44 years old)","AM (C), ST (C)","FC Belize","Belizean Lower Leagues","BLZ","No","6/14/2021","6/30/2024","$0 - $12K","Right","Strong","Very Strong","5'7""","136 lbs","-","-",54,101,6,6,4,14,13,6,8,8,1,6,12,4,5,14,5,8,7,10,7,14,15,13,7,10,7,7,8,8,4,4,4,7,16,4,4,3,10,11,8,12,12,11,12,6,5,5,8,11,17,2,1,3,4,1,3,2,2,2,1,2
"5313",82079639,"Brandon Potmis","11/6/1998 (24 years old)","M/AM (L), ST (C)","Inter Willemstad","Kampionato Liga MCB - Promé Division","SIM","Yes","6/15/2020","6/30/2025","$0 - $1.5K","Left","Very Strong","Weak","5'10""","149 lbs","-","-",50,55,6,4,5,6,6,12,7,5,5,2,10,12,1,10,8,8,3,8,5,9,14,10,5,8,5,4,3,7,13,11,3,3,12,13,12,4,8,20,12,12,10,9,13,3,14,6,18,13,8,1,2,2,3,2,4,3,2,4,1,2
"5314",82089939,"Gikay Croes","3/6/1990 (33 years old)","GK","River Plate (ARU)","Aruban Division di Honor","SIM","Yes","6/14/2021","-","$0","Right","Reasonable","Very Strong","6'2""","169 lbs","-","-",51,52,3,2,1,3,4,2,1,1,3,2,5,1,2,1,15,9,10,5,8,12,16,3,7,3,11,5,4,4,7,14,5,8,9,10,5,4,11,16,12,10,12,11,8,3,13,1,10,10,18,3,5,4,13,2,5,5,5,6,7,6
"5315",82079690,"Loxley Parker","2/3/1989 (34 years old)","D (C), DM, M/AM (C)","SCSA Eagles","Sint Maarten Championship","SIM","No","10/1/2022","-","$0","Right","Reasonable","Very Strong","6'4""","189 lbs","2","-",50,51,1,1,6,9,9,5,7,4,1,10,10,2,8,4,12,7,7,6,7,9,3,7,14,6,9,5,5,7,5,9,6,11,13,7,10,10,13,19,10,12,10,9,8,7,10,6,10,11,17,1,2,3,1,3,2,1,3,4,3,1
"5316",72048214,"Napo Matsoso","5/27/1994 (29 years old)","M/AM (RLC)","Oakland","USSL Championship Western Conference","LES","No","12/8/2022","11/30/2023","$55K - $550K","Right","Reasonable","Very Strong","5'6""","138 lbs","111","15",93,105,10,10,11,9,12,10,6,9,4,8,12,11,10,12,4,8,10,11,8,9,10,9,7,11,8,8,11,9,13,13,12,5,14,13,11,9,10,16,10,12,12,10,8,12,5,7,8,12,16,1,2,2,3,3,2,2,2,4,2,3
"5317",2000069467,"Katiso Selili","7/13/2001 (21 years old)","M (C)","Bantu FC","Lesothoan Premier Division","LES","No","7/1/2020","6/30/2025","$0 - $1.5K","Right","Reasonable","Very Strong","5'9""","149 lbs","-","-",67,102,6,6,3,7,14,6,6,11,3,10,14,2,8,14,14,10,6,8,7,13,17,9,7,4,7,7,14,12,7,10,3,9,15,8,9,4,11,17,11,11,12,11,7,12,13,3,11,9,12,2,2,3,1,1,1,1,3,3,2,2
"5318",65026599,"Tshwarelo Bereng","10/30/1990 (32 years old)","M/AM (R)","Marumo Gallants","South African National First Division Championship","LES","No","7/1/2020","6/30/2024","$0","Right","Weak","Very Strong","5'9""","152 lbs","126","5",93,101,10,14,7,14,13,8,8,10,7,9,15,5,9,11,13,8,7,6,9,15,15,9,11,14,10,11,8,11,11,14,11,8,14,11,7,7,11,16,10,11,9,12,5,4,12,7,13,12,20,2,4,1,2,3,2,2,2,4,1,2
"5319",13202826,"Thabiso Brown","10/3/1995 (27 years old)","ST (C)","DD Tengyue","Chinese National First Division","LES","No","4/1/2023","12/31/2023","$35K - $350K","Right","Weak","Very Strong","5'8""","165 lbs","94","83",94,100,5,8,10,13,10,5,10,10,4,4,10,13,5,12,10,13,12,11,11,11,8,8,9,13,6,11,9,12,12,12,13,7,12,12,7,13,8,10,12,13,13,12,5,11,8,7,13,13,15,3,1,2,2,1,2,1,3,2,1,2
"5320",20031862,"Tsotleho Jane","7/17/1991 (31 years old)","AM (RL), ST (C)","East Riffa","Bahrain Premier League","LES","No","7/12/2022","6/30/2024","$0 - $35K","Right","Fairly Strong","Very Strong","5'6""","147 lbs","102","15",93,97,13,9,12,7,9,8,4,6,8,4,8,8,6,9,6,8,6,9,10,8,15,14,3,10,7,10,9,12,14,13,13,6,12,14,8,6,11,16,15,15,12,12,10,1,4,18,10,14,17,1,3,2,2,3,1,4,3,2,1,2
"5321",13100321,"Thapelo Tale","4/22/1988 (35 years old)","AM (R), ST (C)","Lijabatho","Lesothoan Premier Division","LES","No","8/1/2022","6/30/2024","$0","Right","Weak","Very Strong","5'7""","160 lbs","35","17",75,95,8,11,9,11,13,7,13,9,8,6,13,8,2,9,10,12,2,12,9,12,4,10,11,11,9,8,9,10,10,11,9,4,15,10,11,4,13,20,11,12,9,13,11,7,11,1,15,12,20,2,2,1,3,2,1,1,1,2,2,3
"5322",13178057,"Motebang Sera","5/1/1995 (28 years old)","ST (C)","Royal AM","South African Premier Soccer League","LES","No","7/1/2022","6/30/2024","$18K - $55K","Right","Reasonable","Very Strong","6'0""","171 lbs","62","13",90,95,6,3,10,13,13,7,13,5,3,6,7,6,1,11,7,12,6,13,8,12,6,15,6,13,6,7,8,8,13,11,8,5,15,11,13,12,10,17,12,11,9,12,11,4,8,6,13,12,7,1,3,1,2,4,2,1,2,2,1,1
"5323",82050073,"Michael Salazar","11/15/1992 (30 years old)","AM (R), ST (C)","Miami FC","USSL Championship Eastern Conference","BLZ","No","1/3/2023","11/30/2024","$550K - $1.6M","Right Only","Weak","Very Strong","5'11""","182 lbs","142","31",97,97,6,10,12,11,10,8,9,9,5,7,10,10,7,10,9,8,9,10,10,8,12,8,8,11,9,10,8,13,14,12,10,12,11,15,10,12,7,12,13,10,8,12,10,9,9,3,9,11,10,1,1,1,1,1,1,1,1,1,1,12
"5324",13104165,"Tsoanelo Koetle","11/22/1992 (30 years old)","D/WB/AM (R)","Bantu FC","Lesothoan Premier Division","LES","No","7/1/2020","6/30/2024","$1.5K - $4K","Right","Reasonable","Very Strong","5'9""","149 lbs","-","-",83,95,6,9,8,13,5,2,5,5,2,7,12,1,9,8,5,9,8,5,8,14,7,14,8,13,7,7,6,8,13,13,5,6,15,13,13,7,12,12,12,13,12,8,12,11,8,1,11,9,19,2,2,2,2,2,1,2,1,3,1,3
"5325",2000191870,"Katleho Makateng","9/20/1998 (24 years old)","ST (C)","Richards Bay","South African Premier Soccer League","LES","No","7/23/2022","6/30/2024","$0 - $70K","Right","Reasonable","Very Strong","5'10""","165 lbs","15","-",85,94,6,4,12,13,13,5,9,5,1,6,3,8,1,9,12,13,2,13,6,11,6,13,13,13,7,6,7,7,13,13,7,3,11,13,12,11,8,16,12,11,10,11,5,6,8,2,16,10,13,3,3,1,3,1,1,2,2,1,3,2
"5326",13202761,"Bokang Sello","8/8/1994 (28 years old)","D/WB (L)","Bantu FC","Lesothoan Premier Division","LES","No","7/1/2018","6/30/2024","$0","Left","Very Strong","Reasonable","5'7""","141 lbs","-","-",87,92,7,13,5,3,8,4,9,7,6,10,9,6,11,9,10,8,9,8,10,8,8,5,6,7,9,9,8,9,15,15,9,4,13,15,14,6,14,11,10,12,12,11,11,8,13,2,10,14,10,2,3,1,1,3,3,3,3,3,1,2
"5327",2000107683,"Thabo Lesoaoana","7/22/1999 (23 years old)","DM, M (C)","Bantu FC","Lesothoan Premier Division","LES","No","6/15/2020","6/30/2025","$0","Right","Fairly Strong","Very Strong","5'8""","145 lbs","-","-",71,90,6,4,3,7,11,4,6,8,1,8,13,3,12,7,5,6,6,3,8,11,8,5,7,7,8,6,7,11,13,13,7,3,10,13,9,4,11,12,13,10,9,12,8,6,5,2,19,10,10,3,3,3,3,1,2,1,2,4,3,1
"5328",13167802,"Jane Thabantso","1/22/1996 (27 years old)","AM (RL), ST (C)","Matlama","Lesothoan Premier Division","LES","No","6/15/2020","6/30/2024","$0 - $5K","Right","Reasonable","Very Strong","6'2""","176 lbs","-","-",83,90,6,9,12,12,11,5,7,5,4,3,5,3,4,12,5,8,8,5,5,10,19,13,6,10,5,6,6,7,12,10,4,8,12,12,12,9,12,14,13,8,12,11,9,16,14,2,7,12,10,3,1,1,1,3,2,4,2,4,3,3
"5329",13167794,"Hlompho Kalake","9/2/1994 (28 years old)","M (R), AM (RL)","Linare","Lesothoan Premier Division","LES","No","7/1/2020","6/30/2024","$0 - $6K","Right","Reasonable","Very Strong","5'10""","136 lbs","-","-",80,90,5,11,10,9,11,3,6,7,3,6,8,1,8,7,10,7,8,3,7,10,10,12,13,10,6,7,10,8,13,13,7,4,16,13,11,5,12,15,9,12,11,11,12,4,11,6,7,9,17,2,2,2,1,1,2,1,3,2,3,1
"5330",13211583,"Tšepo Toloane","7/15/1997 (25 years old)","AM (C), ST (C)","LDF","Lesothoan Premier Division","LES","No","6/15/2020","6/30/2024","$0 - $1.5K","Right","Reasonable","Very Strong","5'9""","147 lbs","-","-",77,90,5,7,11,10,13,6,8,6,1,5,8,5,3,12,12,7,3,8,6,7,14,12,9,11,7,7,8,8,13,12,7,7,14,13,13,6,9,20,12,10,9,12,9,12,9,2,11,10,11,3,2,2,2,3,2,1,2,1,3,1
"5331",2000107687,"Monaheng Ramalefane","12/22/1998 (24 years old)","GK","Matlama","Lesothoan Premier Division","LES","No","6/15/2020","6/30/2024","$0","Right","Fairly Strong","Very Strong","6'3""","176 lbs","-","-",72,90,4,1,1,1,3,6,1,3,3,2,8,3,2,1,6,10,15,7,12,11,9,1,6,3,12,7,6,6,12,6,5,14,14,10,3,6,9,16,13,15,11,12,9,13,5,7,10,11,12,9,14,11,6,6,13,13,5,9,7,13
"5332",13225813,"Thabiso Lichaba","6/16/1995 (27 years old)","GK","Bantu FC","Lesothoan Premier Division","LES","No","6/15/2020","6/30/2024","$1.5K - $4K","Left","Very Strong","Reasonable","6'2""","167 lbs","-","-",80,90,2,3,3,2,1,4,1,2,1,1,6,3,2,5,5,7,14,7,10,13,12,1,3,3,10,7,6,6,11,6,5,7,13,13,6,5,12,11,12,9,11,9,11,8,7,6,8,10,13,7,9,11,14,11,11,11,10,8,13,12
"5333",2000118461,"Jessy Matsie","12/1/2000 (22 years old)","GK","Lioli","Lesothoan Premier Division","LES","No","7/1/2020","6/30/2024","$0","Left","Very Strong","Reasonable","6'0""","167 lbs","-","-",65,90,2,1,3,1,3,4,1,3,2,2,8,2,2,5,15,7,7,7,9,14,14,2,12,2,12,7,6,6,13,10,4,7,12,13,4,8,12,20,11,11,9,12,8,18,9,4,10,12,10,11,9,12,13,5,8,10,5,7,6,9
"5334",2000230505,"Richajier Oleana","11/12/2000 (22 years old)","D/WB/M/AM (R)","Flamingo","Bonaire Kampionato","BOE","No","7/1/2020","-","$0","Right","Reasonable","Very Strong","6'3""","176 lbs","-","-",64,75,6,10,4,8,9,3,6,6,2,7,9,1,8,7,9,11,7,8,6,11,7,9,9,10,8,7,4,8,14,11,7,15,12,13,10,6,10,10,11,10,11,12,12,7,5,7,11,11,14,4,1,3,3,1,1,2,2,1,2,3
"5335",29218376,"Angelo Cappello","1/27/2002 (21 years old)","D/WB (L)","FC Halifax","Vanarama National League","BLZ","No","6/4/2023","6/30/2024","$50K - $500K","Left","Very Strong","Reasonable","5'7""","154 lbs","43","1",78,95,9,12,9,8,7,5,4,4,7,8,10,7,11,7,7,12,10,9,8,9,11,11,5,8,7,10,9,14,13,11,8,5,10,13,11,8,15,9,3,9,13,11,6,14,5,7,13,12,15,3,2,3,3,4,1,4,2,1,1,2
"5336",13167807,"Tsepo Seturumane","7/6/1992 (30 years old)","AM (RL), ST (C)","LMPS","Lesothoan Premier Division","LES","No","8/1/2020","6/30/2024","$0","Left","Very Strong","Reasonable","6'0""","158 lbs","-","-",78,90,7,10,12,11,11,4,7,6,3,3,12,4,4,11,5,8,7,10,5,11,6,12,7,9,5,6,4,7,12,10,6,4,12,12,11,3,12,14,11,11,10,11,10,3,7,3,5,13,19,4,3,4,3,2,3,3,3,3,2,3
"5337",2000081468,"Sekhoane Moerane","9/18/1997 (25 years old)","GK","LMPS","Lesothoan Premier Division","LES","No","6/15/2020","6/30/2024","$0","Right","Fairly Strong","Very Strong","6'1""","167 lbs","-","-",77,90,3,3,3,1,1,6,1,3,3,1,7,2,2,1,5,12,9,6,12,12,3,3,12,3,8,6,5,5,10,9,6,9,16,6,3,5,11,17,12,13,10,8,15,15,13,2,12,9,10,10,12,12,8,6,10,12,5,7,9,12
"5338",12008743,"Bokang Mothoana","12/9/1987 (35 years old)","D/WB (L), AM (LC)","LMPS","Lesothoan Premier Division","LES","No","7/1/2021","6/30/2024","$0","Left Only","Very Strong","Very Weak","5'9""","158 lbs","15","-",70,90,6,9,9,4,10,4,8,8,10,6,7,5,9,10,12,9,11,7,6,6,5,10,8,9,6,10,8,10,11,11,10,10,12,10,10,10,14,12,11,10,11,12,6,1,5,2,11,8,14,1,2,3,3,3,1,3,3,2,2,1
"5339",13167803,"Masoabi Nkoto","1/14/1992 (31 years old)","ST (C)","Jawalakhel","Nepali A-Division League","LES","No","1/2/2023","12/31/2023","$0","Right","Reasonable","Very Strong","6'0""","165 lbs","33","10",81,88,2,3,11,14,14,5,14,8,6,6,5,7,2,12,10,12,6,8,8,14,13,12,3,14,8,7,7,8,8,13,8,9,12,13,8,8,13,15,10,13,11,8,8,7,5,7,10,11,19,3,1,2,3,2,4,1,2,1,2,2
"5340",2000069465,"Teboho Letsema","4/21/2001 (22 years old)","M (R)","Linare","Lesothoan Premier Division","LES","No","7/1/2021","6/30/2024","$0","Right","Reasonable","Very Strong","6'0""","160 lbs","-","-",55,88,5,8,12,6,8,6,5,7,5,6,7,2,5,13,15,4,3,9,7,8,13,5,9,7,5,7,7,10,14,12,3,6,12,13,5,4,14,16,9,9,12,10,12,14,13,4,13,12,13,1,2,2,2,1,4,1,3,3,2,4
"5341",2000118462,"Tumelo Makha","10/22/1999 (23 years old)","DM, M (C)","Lioli","Lesothoan Premier Division","LES","No","1/1/2023","6/30/2024","$0 - $3.5K","Right","Fairly Strong","Very Strong","6'1""","169 lbs","20","-",75,85,7,7,3,6,14,5,8,8,3,11,9,6,14,9,12,11,7,9,9,9,2,5,7,7,8,8,9,10,12,9,8,8,10,11,5,5,10,16,11,10,10,12,5,8,8,7,12,12,9,3,2,2,3,2,1,2,2,3,2,2
"5342",13178058,"Motlomelo Mkhwanazi","11/5/1994 (28 years old)","D (C)","Bantu FC","Lesothoan Premier Division","LES","No","1/1/2020","6/30/2024","$0","Right","Reasonable","Very Strong","5'11""","167 lbs","2","-",80,85,2,2,1,3,7,1,13,4,1,13,7,3,13,6,7,10,9,7,6,13,5,5,12,6,13,6,3,7,13,13,7,5,13,11,12,13,13,4,13,15,11,10,7,11,5,15,9,11,11,2,3,1,2,1,1,2,1,1,3,4
"5343",2000241869,"Retšelisitsoe Mopeli","11/4/1998 (24 years old)","ST (C)","LDF","Lesothoan Premier Division","LES","No","7/1/2021","6/30/2024","$0","Right","Reasonable","Very Strong","5'10""","156 lbs","-","-",70,85,5,4,12,12,12,5,11,5,4,1,5,5,5,7,8,9,7,7,4,10,8,8,11,11,3,5,3,7,12,12,6,6,12,12,10,7,10,12,10,11,12,10,8,8,14,2,12,11,20,2,3,3,1,1,2,3,2,2,2,3
"5344",2000241863,"Moteloa Khemisi","3/15/1999 (24 years old)","M/AM (C)","Matlama","Lesothoan Premier Division","LES","No","6/15/2020","6/30/2024","$0","Right","Weak","Very Strong","5'6""","130 lbs","-","-",70,85,6,4,8,11,12,6,6,13,1,6,11,4,7,13,12,8,2,7,8,11,10,13,9,8,5,7,11,11,13,9,7,2,12,12,12,1,12,20,10,11,9,11,8,17,5,4,13,12,14,1,3,1,2,2,3,2,1,2,1,1
"5345",13113374,"Emmanuel Lekhanya","6/24/1992 (30 years old)","ST (C)","Lioli","Lesothoan Premier Division","LES","No","6/14/2021","6/30/2024","$0 - $9K","Right","Reasonable","Very Strong","6'0""","163 lbs","-","-",82,85,6,5,12,13,12,6,12,7,2,6,7,9,4,7,14,12,8,11,7,13,16,7,11,11,7,6,7,7,13,11,6,9,13,13,12,7,12,18,11,13,13,13,12,8,5,6,10,10,14,1,1,2,1,1,3,3,3,3,2,3
"5346",2000022805,"Blake Tejeda","11/13/1997 (25 years old)","D (C)","Bandits (BLZ)","Belizean Premier Football League","BLZ","No","7/1/2022","6/30/2024","$14K - $45K","Right","Weak","Very Strong","6'1""","165 lbs","-","-",64,88,1,1,5,2,4,1,11,1,1,13,6,1,7,2,8,7,8,5,12,6,4,5,12,5,12,5,3,6,13,13,6,8,16,13,8,6,13,16,5,12,11,11,11,15,10,4,13,10,7,1,1,1,3,1,1,4,4,1,3,1
"5347",2000089041,"Rethabile Mokokoane","4/6/1998 (25 years old)","D (LC)","Matlama","Lesothoan Premier Division","LES","No","7/1/2018","6/30/2024","$1.5K - $4K","Left","Very Strong","Weak","6'2""","174 lbs","-","-",75,85,2,7,3,6,7,1,6,6,8,12,12,1,15,9,6,12,9,7,10,10,14,5,10,8,12,9,9,14,10,11,7,12,5,13,11,6,12,10,10,9,11,11,7,5,11,2,10,9,8,3,2,2,3,3,2,2,2,3,2,1
"5348",13113371,"Mafa Moreomoholo","11/24/1994 (28 years old)","D (C)","Lioli","Lesothoan Premier Division","LES","No","6/15/2020","6/30/2024","$0 - $1.5K","Right","Reasonable","Very Strong","5'11""","160 lbs","-","-",75,85,2,1,1,4,7,1,11,2,5,13,2,3,13,5,15,8,9,7,8,13,4,5,4,6,13,6,3,7,13,13,7,8,11,13,6,6,13,18,10,11,13,11,5,12,5,6,11,11,11,2,3,2,3,1,1,2,1,4,3,1
"5349",13167784,"Nkau Lerotholi","9/27/1990 (32 years old)","D (C)","LMPS","Lesothoan Premier Division","LES","No","6/14/2021","6/30/2024","$0","Right","Reasonable","Very Strong","6'0""","171 lbs","-","-",81,85,7,4,1,8,7,5,15,4,5,15,7,2,15,7,13,9,9,9,11,15,2,5,7,8,12,8,6,9,7,6,9,8,14,8,6,8,13,12,10,10,14,9,8,11,11,4,10,9,20,3,2,3,3,3,3,3,2,3,1,1
"5350",2000089034,"Neo Mokhachane","9/22/1996 (26 years old)","M/AM (R)","Bantu FC","Lesothoan Premier Division","LES","No","7/1/2018","6/30/2024","$0 - $18K","Right","Fairly Strong","Very Strong","5'11""","154 lbs","-","-",79,85,8,11,13,10,10,6,5,2,6,4,10,5,7,9,13,8,4,7,5,8,11,10,6,11,6,7,9,11,13,13,7,8,14,13,6,5,10,19,11,11,12,13,11,14,7,6,7,8,19,3,1,1,1,1,3,3,1,3,3,1
"5351",13167787,"Thapelo Mokhele","4/18/1986 (37 years old)","D (C)","Bantu FC","Lesothoan Premier Division","LES","No","6/14/2021","6/30/2024","$0","Right","Reasonable","Very Strong","5'11""","158 lbs","-","-",70,85,4,3,3,6,6,1,11,3,1,12,8,6,14,8,12,8,7,8,9,14,17,5,13,7,14,7,5,9,7,8,8,11,18,8,8,6,12,17,10,10,12,10,5,8,10,1,13,11,15,2,1,2,1,1,1,3,1,2,3,3
"5352",13167800,"Phafa Tsosane","3/15/1987 (36 years old)","M/AM (C)","Matlama","Lesothoan Premier Division","LES","No","6/14/2021","6/30/2024","$0","Right","Reasonable","Very Strong","5'7""","136 lbs","-","-",70,85,8,9,7,13,15,8,4,10,3,9,11,5,7,10,9,11,9,8,8,11,14,8,15,10,9,9,9,13,10,10,5,3,11,10,9,2,15,18,11,8,10,13,6,7,6,3,10,13,16,3,2,2,1,2,3,2,1,2,3,3
"5353",13113369,"Sepiriti Malefane","8/8/1994 (28 years old)","M (RC)","Bantu FC","Lesothoan Premier Division","LES","No","6/15/2020","6/30/2024","$0","Right","Fairly Strong","Very Strong","5'9""","132 lbs","-","-",74,80,5,9,8,5,10,6,6,8,6,7,10,5,8,10,15,8,6,9,7,10,11,5,4,8,7,7,9,12,13,10,7,6,11,13,8,4,13,20,11,12,12,11,5,15,5,7,18,12,14,1,2,1,1,1,3,3,3,3,3,3
"5354",13104161,"Basia Makepe","3/4/1991 (32 years old)","D (C)","LMPS","Lesothoan Premier Division","LES","No","7/1/2018","6/30/2024","$0","Right","Reasonable","Very Strong","6'2""","178 lbs","-","-",78,80,2,1,1,5,4,1,13,5,1,13,6,1,13,6,13,11,9,6,8,12,2,6,14,6,13,6,1,7,10,10,7,9,8,8,12,7,12,14,11,11,9,11,9,12,13,5,7,10,18,3,1,4,3,1,4,3,1,2,3,3
"5355",2000089036,"Thabo Matšoele","5/23/1993 (30 years old)","D/WB (L)","Matlama","Lesothoan Premier Division","LES","No","7/1/2020","6/30/2024","$0 - $4.5K","Left","Very Strong","Fairly Strong","6'4""","180 lbs","-","-",77,80,4,11,7,2,9,1,8,3,4,9,9,4,13,9,15,9,9,5,10,13,17,6,14,7,9,8,5,8,14,12,8,11,11,13,5,7,16,12,12,11,11,10,8,4,6,1,11,11,13,2,3,1,1,2,1,1,3,1,1,2
"5356",13178059,"Thabo Seakhoa","9/15/1996 (26 years old)","M/AM (R)","LCS","Lesothoan Premier Division","LES","No","6/15/2020","6/30/2024","$0 - $1.5K","Right","Strong","Very Strong","6'1""","165 lbs","-","-",75,80,6,9,12,6,13,6,6,7,1,6,9,2,7,13,13,7,8,6,7,10,5,13,13,12,6,7,8,8,13,13,7,12,14,13,5,5,14,16,11,11,13,11,6,10,7,5,10,9,10,2,1,3,3,3,2,1,4,3,1,3
"5357",5430214,"Trevor Lennan","6/5/1983 (40 years old)","D (RC), DM","Bandits (BLZ)","Belizean Premier Football League","BLZ","No","7/1/2018","6/30/2024","$0 - $5K","Right Only","Weak","Very Strong","5'9""","160 lbs","-","-",62,87,6,6,6,5,8,5,10,8,5,10,8,5,10,8,14,8,12,11,11,8,15,4,14,8,11,12,6,11,7,8,12,13,17,8,9,12,13,10,5,10,11,11,8,7,15,2,11,9,10,3,3,3,2,3,1,3,2,2,2,3
"5358",13202738,"Likano Mphuthi","4/24/1989 (34 years old)","GK","LDF","Lesothoan Premier Division","LES","No","6/14/2021","6/30/2024","$0","Right","Reasonable","Very Strong","6'0""","165 lbs","-","-",75,80,2,1,1,2,1,4,1,2,2,3,8,1,2,1,12,9,9,6,7,13,12,2,12,2,7,7,6,6,10,6,7,7,15,10,1,6,10,19,12,8,9,12,6,9,10,1,13,13,8,9,13,10,6,6,13,13,5,8,13,10
"5359",2000107717,"Lesia Thetsane","5/24/1997 (26 years old)","D/WB/AM (L)","Ballard FC","USSL D2 - Northwest Division","LES","No","4/14/2022","-","$0","Left","Very Strong","Reasonable","5'8""","145 lbs","-","-",72,80,7,10,8,12,10,6,6,4,6,5,7,4,8,9,5,8,8,8,8,7,11,10,12,11,8,7,7,8,13,13,7,1,9,13,10,5,14,18,11,13,9,13,7,10,10,6,10,11,16,2,2,1,2,1,1,3,1,2,3,2
"5360",2000107718,"John Mohai","5/1/1998 (25 years old)","D/WB (R)","Matlama","Lesothoan Premier Division","LES","No","6/15/2020","6/30/2024","$0","Right","Reasonable","Very Strong","6'0""","163 lbs","-","-",70,80,5,11,7,1,9,4,7,4,6,9,9,4,11,8,8,9,5,8,7,11,13,5,7,7,7,3,8,8,13,12,7,6,12,12,12,5,11,10,10,13,12,12,12,8,11,2,10,12,8,1,1,2,3,3,3,1,1,1,2,2
"5361",2000107593,"Mokoteli Mohapi","4/21/1998 (25 years old)","DM, M (C)","Lioli","Lesothoan Premier Division","LES","No","12/31/2021","6/30/2024","$0","Right","Reasonable","Very Strong","5'11""","165 lbs","-","-",68,80,5,1,4,6,10,5,5,9,1,7,13,3,12,5,5,10,7,7,6,12,14,5,13,7,8,7,9,11,13,13,7,10,12,13,6,9,11,12,11,11,10,10,12,4,12,4,10,13,17,4,2,3,2,1,1,4,2,3,2,2
"5362",2000089029,"Tumelo Ngatane","7/28/1993 (29 years old)","DM, M (C)","Manonyane","Lesothoan Premier Division","LES","No","7/1/2020","6/30/2024","$0","Right","Weak","Very Strong","5'10""","149 lbs","-","-",70,80,3,5,7,7,11,6,6,5,1,8,12,1,13,7,9,6,8,6,5,13,15,7,11,8,7,7,9,12,13,13,7,3,16,13,12,6,12,13,12,11,10,10,6,1,11,5,12,10,7,2,2,2,1,2,2,3,3,1,3,3
"5363",13202797,"Lehlohonolo Fothoane","2/23/1997 (26 years old)","M/AM (C)","Bantu FC","Lesothoan Premier Division","LES","No","6/15/2020","6/30/2024","$0","Right","Reasonable","Very Strong","5'8""","147 lbs","-","-",75,80,8,3,12,9,15,8,8,10,1,10,15,4,8,13,12,8,7,10,9,7,8,11,2,10,7,14,10,10,10,13,9,3,11,11,10,6,13,19,11,9,11,11,7,9,6,2,11,11,7,2,3,1,3,4,1,3,1,3,1,3
"5364",2000081473,"Thabang Malane","6/10/1997 (26 years old)","D (R)","LMPS","Lesothoan Premier Division","LES","No","7/1/2018","6/30/2024","$0","Right","Fairly Strong","Very Strong","5'3""","121 lbs","-","-",73,80,7,10,5,5,6,3,8,4,7,8,8,3,12,8,11,8,7,8,8,14,15,5,7,7,11,8,7,8,14,14,8,2,10,14,10,1,9,12,11,13,10,12,7,17,8,5,11,10,7,2,1,1,1,3,2,2,2,1,2,3
"5365",13113370,"Thabiso Mohapi","9/17/1992 (30 years old)","M/AM (C)","Lioli","Lesothoan Premier Division","LES","No","7/1/2018","6/30/2024","$0","Left","Very Strong","Reasonable","5'7""","136 lbs","-","-",71,80,6,7,12,11,9,4,3,7,4,7,13,4,8,12,15,7,4,8,4,12,2,12,5,7,5,6,9,8,12,12,6,4,10,12,11,1,15,13,12,11,11,8,5,7,14,6,11,12,8,1,2,2,3,2,1,1,3,2,1,2
"5366",2000089043,"Rethabile Rasethuntsa","11/22/1994 (28 years old)","D/WB (L)","Linare","Lesothoan Premier Division","LES","No","7/1/2018","-","$0","Left","Very Strong","Weak","5'7""","147 lbs","-","-",71,80,3,11,3,1,7,1,8,2,5,6,7,1,12,8,10,8,8,7,13,13,10,5,14,6,10,7,7,7,13,13,7,3,10,13,12,7,10,15,11,12,12,9,11,4,15,2,12,13,13,2,1,3,3,3,3,2,2,3,1,1
"5367",13202833,"Raboama Koloti","12/4/1998 (24 years old)","ST (C)","LMPS","Lesothoan Premier Division","LES","No","6/15/2020","6/30/2024","$0","Right","Reasonable","Very Strong","6'2""","180 lbs","-","-",62,80,4,3,12,12,12,4,6,5,1,1,4,4,2,8,12,10,1,11,3,6,3,9,8,7,5,4,5,6,12,10,5,7,10,11,11,10,9,18,9,10,12,12,11,5,12,7,9,12,12,2,1,2,1,3,1,3,2,2,1,3
"5368",2000249922,"Eugene Martinez","10/20/1997 (25 years old)","D (C)","Vancouver FC","Canadian Premier League","BLZ","No","2/23/2023","12/31/2023","$0 - $40K","Right Only","Weak","Very Strong","6'1""","176 lbs","14","1",75,87,4,5,1,1,7,2,9,2,2,13,7,1,11,5,5,7,9,7,6,13,9,5,7,6,13,6,5,7,13,12,7,9,15,12,12,12,12,12,3,12,11,11,9,11,6,2,8,11,10,2,3,3,3,1,1,1,3,3,1,3
"5369",2000069472,"Percy Mohami","1/6/2001 (22 years old)","D (C), DM, M (C)","LCS","Lesothoan Premier Division","LES","No","7/1/2020","6/30/2024","$0","Right","Weak","Very Strong","6'0""","160 lbs","-","-",60,79,3,3,2,2,10,5,7,7,1,11,13,5,13,6,10,8,5,7,6,13,5,5,10,5,11,6,6,11,11,13,5,5,13,13,9,5,13,14,10,12,12,10,8,5,13,8,19,9,17,2,2,1,3,1,2,1,1,4,3,2
"5370",2000118460,"Thabiso Mari","9/14/1996 (26 years old)","ST (C)","Likhopo","Lesothoan Lower Divisions","LES","No","7/1/2020","6/30/2024","$0","Right","Fairly Strong","Very Strong","6'2""","171 lbs","-","-",72,76,5,3,9,12,11,3,12,4,1,5,6,7,1,12,15,4,1,12,6,11,4,15,8,10,3,5,1,6,12,12,6,6,12,12,11,5,8,13,12,10,11,9,7,16,10,3,12,12,17,1,1,2,2,3,3,3,1,3,2,1
"5371",13104175,"Makara Ntaitsane","8/6/1990 (32 years old)","M/AM (C)","LCS","Lesothoan Premier Division","LES","No","6/14/2021","6/30/2024","$0","Right","Reasonable","Very Strong","5'10""","152 lbs","-","-",75,75,7,7,5,11,14,2,1,9,1,8,13,5,7,10,14,8,8,4,7,10,5,9,10,9,8,8,11,9,9,8,8,4,13,10,13,5,12,19,12,12,12,13,11,10,8,5,10,10,11,1,1,3,1,3,1,2,1,2,2,1
"5372",53143309,"Anas Farah","3/3/2000 (23 years old)","M (C), AM (RC), ST (C)","Moss","Norwegian First Division","DJI","Yes","2/28/2023","8/31/2024","$26K - $75K","Right","Weak","Very Strong","5'10""","141 lbs","108","31",91,104,9,9,11,7,11,8,6,9,3,4,9,10,3,12,10,7,7,8,8,7,12,13,7,8,9,11,11,11,12,11,9,7,12,12,12,8,14,12,13,15,12,11,13,4,5,4,10,15,16,1,2,1,1,1,1,1,2,4,2,3
"5373",2000301572,"Ayanleh Karieh","9/8/2005 (17 years old)","D/WB (L)","AS Ali Sabieh","Djiboutian Premier Division","DJI","No","6/12/2023","6/30/2024","$0","Left","Very Strong","Reasonable","6'2""","169 lbs","-","-",51,98,6,10,7,6,9,1,6,5,5,7,8,3,12,8,11,4,8,5,4,9,18,9,9,4,8,7,7,8,14,9,7,14,8,9,7,5,12,11,9,11,12,13,6,16,14,5,8,11,8,4,2,1,2,1,2,2,1,3,1,2
"5374",2000301583,"Zouber Meraneh","4/26/2003 (20 years old)","D (C)","AS Ali Sabieh","Djiboutian Premier Division","DJI","No","6/12/2023","6/30/2024","$0","Right","Reasonable","Very Strong","6'2""","171 lbs","-","-",52,97,1,2,2,1,4,1,13,5,1,13,6,1,10,5,15,12,8,6,8,13,16,5,12,4,5,5,1,6,9,9,6,11,15,9,7,6,15,16,10,10,12,12,12,7,11,8,9,9,13,3,1,3,1,3,2,1,3,1,1,1
"5375",2000301564,"Liban Said","11/12/2001 (21 years old)","GK","AS Ali Sabieh","Djiboutian Premier Division","DJI","No","7/1/2022","6/30/2024","$0","Right","Reasonable","Very Strong","6'2""","169 lbs","-","-",55,95,2,2,3,3,1,5,1,3,1,1,9,3,3,5,5,5,9,6,6,13,5,3,11,2,6,6,5,5,10,6,6,8,14,12,2,5,11,12,11,13,10,11,14,12,15,5,10,13,7,6,14,13,9,5,9,13,5,9,6,13
"5376",18101846,"Warsama Hassan","3/17/1999 (24 years old)","DM, M (C)","AS Arta","Djiboutian Premier Division","DJI","Yes","6/1/2022","6/30/2024","$0","Right Only","Weak","Very Strong","5'9""","152 lbs","10","-",82,95,6,3,6,9,14,8,5,10,6,11,10,5,12,10,6,10,8,10,10,14,15,7,1,9,14,9,11,12,13,10,8,10,12,12,8,8,13,15,14,11,12,11,5,8,8,1,17,11,20,3,3,2,3,3,2,3,3,2,2,1
"5377",2000228659,"Aptidon Daher","11/11/2000 (22 years old)","D (L)","ACS Hayableh","Djiboutian Premier Division","DJI","No","6/15/2020","6/30/2024","$0","Left","Very Strong","Reasonable","5'7""","141 lbs","-","-",55,86,4,10,5,2,10,1,5,1,5,6,6,1,12,5,8,6,8,6,7,13,6,5,14,5,9,6,6,6,13,11,6,2,12,11,6,3,13,10,13,9,9,11,14,1,11,5,10,11,13,3,3,2,3,1,3,1,1,2,1,3
"5378",85009411,"Yannick Bileck","12/14/1987 (35 years old)","D (C)","USS Aigues-Mortes","French Regional 1 - Occitanie - Group A","DJI","Yes","7/1/2022","-","$0","Right Only","Weak","Very Strong","6'1""","171 lbs","132","6",70,82,3,7,5,5,6,5,13,6,7,10,9,6,10,6,11,10,11,10,7,8,13,6,5,6,10,12,8,11,11,10,12,12,14,11,11,12,10,14,14,9,10,10,8,12,12,8,12,11,9,2,2,2,3,3,3,2,3,3,3,2
"5379",2000022860,"Kerry González","3/3/1999 (24 years old)","GK","Verdes FC","Belizean Premier Football League","BLZ","No","6/15/2020","6/30/2025","$0 - $40K","Right","Fairly Strong","Very Strong","6'4""","182 lbs","-","-",66,87,3,2,3,3,1,6,1,1,3,1,6,1,2,1,10,9,13,6,6,7,13,1,11,1,10,6,5,5,11,14,6,11,12,12,5,8,12,2,5,11,10,8,11,13,14,5,9,12,19,7,6,10,13,10,12,13,5,10,8,10
"5380",2000100301,"Samuel Akinbinu","6/6/1995 (28 years old)","ST (C)","AS Arta","Djiboutian Premier Division","DJI","No","7/1/2021","6/30/2024","$0","Right","Reasonable","Very Strong","5'10""","160 lbs","-","-",78,80,5,4,9,12,11,5,10,6,1,4,6,3,1,12,15,10,8,7,6,9,13,13,14,12,6,5,4,7,12,12,1,7,15,12,12,10,9,11,11,8,12,10,7,1,5,7,20,13,13,1,3,1,3,2,3,1,2,2,1,3
"5381",13186207,"Innocent Mbonihankuye","11/5/1996 (26 years old)","GK","AS Ali Sabieh","Djiboutian Premier Division","DJI","No","7/1/2022","6/30/2024","$0","Right","Reasonable","Very Strong","6'1""","163 lbs","-","-",74,80,3,2,3,3,1,8,1,3,2,3,9,3,2,1,15,9,10,7,9,13,1,2,13,3,12,7,6,6,12,8,7,11,12,10,2,4,13,19,11,11,10,12,5,7,15,4,12,11,7,6,12,12,10,12,12,9,5,6,12,13
"5382",13176028,"Mohamed Batio","11/28/1998 (24 years old)","D (C), DM","Guelleh Batal","Djiboutian Premier Division","DJI","No","7/1/2018","-","$0","Right","Reasonable","Very Strong","5'11""","163 lbs","-","-",64,80,1,3,2,3,7,4,13,4,1,9,7,2,13,4,11,8,8,6,8,6,18,5,4,5,13,5,5,7,13,13,6,10,10,13,4,8,11,10,11,12,12,10,11,5,13,8,9,13,17,1,2,2,1,2,2,1,1,1,2,2
"5383",13231552,"Mahdi Houssein Mahabeh","12/20/1995 (27 years old)","AM (R), ST (C)","AS Arta","Djiboutian Premier Division","DJI","No","7/1/2022","6/30/2024","$0","Left","Very Strong","Weak","5'10""","163 lbs","-","-",76,80,5,8,12,10,10,5,7,5,5,5,6,3,3,12,12,6,5,6,6,12,6,13,12,8,5,6,7,7,12,12,6,6,5,12,12,8,10,14,11,11,11,12,11,6,7,2,9,10,10,1,3,1,3,1,3,1,3,2,2,1
"5384",13231550,"Mohamed Fouad Mohamed","2/25/2000 (23 years old)","ST (C)","AS Port","Djiboutian Premier Division","DJI","No","7/1/2018","6/30/2024","$0","Right","Reasonable","Very Strong","5'5""","125 lbs","-","-",62,80,5,2,12,14,14,1,8,7,3,6,7,5,2,13,6,7,7,12,7,9,10,12,9,12,4,6,3,7,14,13,7,1,14,13,7,1,11,10,11,13,10,10,8,14,5,6,12,9,11,1,3,2,3,3,3,1,1,2,4,1
"5385",2000100302,"Gabriel Dadzie","3/6/1997 (26 years old)","AM (C), ST (C)","AS Arta","Djiboutian Premier Division","DJI","No","7/1/2020","6/30/2024","$0","Right","Reasonable","Very Strong","5'9""","143 lbs","16","18",74,80,6,5,11,13,8,6,8,8,1,6,8,9,6,12,14,10,6,9,5,13,14,13,1,9,5,6,8,8,13,13,7,6,15,13,7,5,12,20,13,11,13,11,15,5,12,6,13,14,9,2,2,2,3,3,1,1,1,3,1,2
"5386",2000147928,"Sabri Ali","9/20/2000 (22 years old)","ST (C)","FC Dikhil","Djiboutian Premier Division","DJI","No","7/1/2020","6/30/2024","$0","Right","Reasonable","Very Strong","5'9""","145 lbs","-","-",60,79,3,2,11,12,11,4,8,6,1,3,4,7,3,6,14,12,4,10,5,4,11,11,9,11,5,4,4,6,13,12,5,7,14,12,7,3,8,14,13,11,12,13,5,5,15,8,20,9,15,2,3,4,3,2,3,1,2,1,1,3
"5387",13105228,"Mohamed Liban","10/30/1985 (37 years old)","M/AM (C)","Guelleh Batal","Djiboutian Premier Division","DJI","No","6/14/2021","6/30/2024","$0","Left","Very Strong","Reasonable","5'7""","149 lbs","-","-",60,75,7,7,6,12,14,7,7,9,5,8,10,5,7,14,5,11,8,7,9,10,6,12,13,7,9,8,9,9,9,7,9,3,13,8,6,6,11,13,10,10,8,13,6,8,5,3,18,12,19,2,1,3,1,1,2,1,2,1,2,2
"5388",13231553,"Mogueh Omar","1/1/2000 (23 years old)","M/AM (C)","AS Arta","Djiboutian Premier Division","DJI","No","9/29/2021","6/30/2024","$0","Right","Fairly Strong","Very Strong","5'11""","138 lbs","-","-",61,75,4,4,7,9,8,1,2,9,1,6,9,1,7,8,14,10,3,7,4,8,8,8,10,7,7,7,9,11,13,13,6,6,15,11,6,4,12,13,8,11,9,10,8,13,7,4,12,12,18,3,3,1,2,3,1,3,1,4,2,4
"5389",2000100470,"Moussa Hamadou","7/24/1997 (25 years old)","D (RC)","FC Dikhil","Djiboutian Premier Division","DJI","No","7/1/2021","6/30/2024","$0","Right","Reasonable","Very Strong","6'1""","167 lbs","-","-",67,75,3,8,5,3,7,2,8,1,5,12,5,1,11,6,10,8,8,4,8,8,11,5,9,4,10,6,6,6,13,12,6,12,9,13,9,5,12,12,10,14,13,10,7,12,5,1,7,14,16,1,2,1,4,3,3,2,3,1,1,2
"5390",2000023221,"Carlos Gonzalez","7/27/1999 (23 years old)","ST (C)","Bandits (BLZ)","Belizean Premier Football League","BLZ","No","7/1/2018","6/30/2024","$16K - $45K","Right","Reasonable","Very Strong","6'0""","165 lbs","-","-",62,86,5,1,8,13,9,2,10,6,1,5,6,5,1,11,10,10,4,13,4,9,7,11,11,9,6,5,3,6,13,9,6,8,13,11,3,6,10,9,7,12,13,11,10,13,13,4,11,10,13,1,4,4,1,3,3,2,3,3,4,1
"5391",2000092924,"Siad Yabe","3/12/1998 (25 years old)","D/WB (R)","AS Arta","Djiboutian Premier Division","DJI","No","7/1/2018","6/30/2024","$0","Right","Reasonable","Very Strong","5'9""","149 lbs","-","-",69,75,6,10,6,4,8,2,7,5,1,8,8,6,12,8,7,8,7,7,12,14,6,5,13,6,11,7,6,7,14,10,7,7,13,12,11,6,12,16,11,8,10,12,8,15,5,5,8,11,18,1,3,1,4,2,2,3,3,1,3,3
"5392",13231555,"Ahmed Youssouf Omar","9/1/1998 (24 years old)","ST (C)","AS Port","Djiboutian Premier Division","DJI","No","7/1/2018","6/30/2024","$0","Right","Strong","Very Strong","5'11""","163 lbs","-","-",60,75,3,4,7,11,10,3,11,4,1,2,3,2,1,9,6,8,3,7,4,7,8,11,7,11,4,3,1,4,11,10,4,5,7,10,9,6,12,16,12,12,10,11,10,13,11,2,8,11,9,2,1,1,2,3,3,3,4,2,3,2
"5393",13176040,"Mohamed Bourhan","5/18/1998 (25 years old)","D/WB (R)","AS Port","Djiboutian Premier Division","DJI","No","7/1/2018","6/30/2024","$0","Right","Reasonable","Very Strong","5'7""","136 lbs","-","-",65,75,5,12,6,1,9,2,7,1,6,8,7,1,13,8,9,9,8,7,12,11,9,5,10,4,10,7,3,7,13,14,7,2,8,13,9,1,14,10,10,7,9,12,7,5,7,8,10,11,11,1,1,3,2,3,2,3,2,2,3,1
"5394",13176032,"Ibrahim Warsama","5/12/1998 (25 years old)","D (L)","AS Port","Djiboutian Premier Division","DJI","No","6/15/2020","6/30/2024","$0","Left","Very Strong","Reasonable","6'0""","154 lbs","-","-",64,75,4,8,7,1,8,1,8,2,1,11,11,3,10,5,6,12,6,8,9,9,16,5,15,6,12,9,7,13,9,12,8,9,16,12,13,4,16,18,11,12,13,11,6,16,11,6,7,12,17,3,2,1,3,1,3,1,4,3,1,3
"5395",13176037,"Ahmed Hassan Moussa","9/12/1998 (24 years old)","ST (C)","AS Ali Sabieh","Djiboutian Premier Division","DJI","No","6/15/2020","-","$0","Right","Reasonable","Very Strong","5'11""","154 lbs","-","-",64,75,2,5,13,13,10,4,10,6,1,5,6,2,1,9,15,6,7,6,6,11,7,9,13,7,6,2,1,6,13,11,4,8,13,13,10,5,12,15,9,11,11,12,9,12,15,7,9,11,19,4,3,3,2,2,2,1,3,1,1,1
"5396",2000301573,"Ahmed Abdi","10/11/1997 (25 years old)","M/AM (C)","AS Ali Sabieh","Djiboutian Premier Division","DJI","No","7/1/2021","6/30/2024","$0","Right","Reasonable","Very Strong","6'0""","163 lbs","-","-",64,75,3,1,6,9,12,4,4,12,1,5,8,1,7,8,15,7,1,5,6,8,12,9,8,6,5,6,12,11,12,11,5,6,8,12,10,5,10,11,9,12,12,13,13,8,11,4,11,11,14,1,3,3,2,2,1,1,1,3,3,1
"5397",2000301556,"Sadick Djama","12/12/2000 (22 years old)","DM, M (C)","AS Arta","Djiboutian Premier Division","DJI","No","7/1/2022","6/30/2024","$0","Right","Strong","Very Strong","5'11""","163 lbs","-","-",59,75,6,4,2,7,13,6,7,5,6,7,8,1,13,9,7,9,4,4,4,14,7,5,2,7,7,8,9,11,5,7,7,11,16,8,6,7,13,20,8,9,10,12,11,16,11,2,12,13,15,1,2,2,1,3,3,2,3,4,1,1
"5398",2000301571,"Abass Fouad Abdourahman","11/1/1999 (23 years old)","D/WB (R)","AS Ali Sabieh","Djiboutian Premier Division","DJI","No","6/15/2020","6/30/2024","$0","Right","Strong","Very Strong","5'7""","141 lbs","-","-",58,75,4,10,7,3,10,1,7,2,5,7,9,4,12,9,5,8,7,8,10,11,7,5,7,6,7,8,8,9,13,10,8,8,6,12,6,4,8,17,10,12,10,12,10,5,5,4,10,12,18,2,3,3,2,1,2,3,2,3,3,2
"5399",13176031,"Daoud Wais","12/6/1986 (36 years old)","D (C)","AS Arta","Djiboutian Premier Division","DJI","No","7/1/2020","6/30/2024","$0","Right","Fairly Strong","Very Strong","5'7""","136 lbs","-","-",56,75,2,1,1,6,7,1,14,4,1,12,7,6,12,5,13,9,8,7,9,14,10,5,10,6,14,6,6,7,9,7,7,2,17,5,9,2,12,13,12,13,10,12,7,11,6,6,12,11,13,1,3,3,4,2,2,1,2,3,1,2
"5400",2000100303,"Ahmed Aden","12/4/1990 (32 years old)","M (C)","AS Arta","Djiboutian Premier Division","DJI","No","7/1/2019","6/30/2024","$0","Right","Reasonable","Very Strong","6'3""","178 lbs","-","-",55,75,3,4,3,3,13,5,3,5,4,8,13,1,6,10,9,9,5,7,7,12,16,7,10,7,6,7,12,12,9,4,6,15,13,5,7,6,12,14,10,10,10,10,5,7,5,5,9,11,14,1,1,1,2,3,4,3,2,3,3,3
"5401",87017485,"Deon McCaulay","9/2/1987 (35 years old)","M/AM (L), ST (C)","Atletico Atlanta","United Premier Soccer League","BLZ","No","11/3/2020","-","$0","Left Only","Very Strong","Weak","5'9""","152 lbs","42","7",80,86,8,9,10,10,7,8,9,7,7,6,8,6,7,9,10,9,7,8,9,8,9,13,6,11,8,7,8,12,14,13,10,9,14,13,11,8,9,5,2,11,11,10,12,2,10,5,10,11,10,3,4,1,2,3,2,1,2,1,3,2
"5402",2000100419,"Omar Mohamed","10/31/2002 (20 years old)","ST (C)","Guelleh Batal","Djiboutian Premier Division","DJI","No","7/1/2021","6/30/2024","$0","Right","Reasonable","Very Strong","5'10""","152 lbs","-","-",57,73,5,6,13,13,13,3,12,6,1,2,6,3,1,10,9,10,7,7,3,11,12,10,9,12,6,5,4,6,13,8,6,5,12,10,4,5,8,15,12,11,9,14,5,13,12,8,20,11,15,1,1,2,2,2,2,3,2,2,1,1
"5403",13231546,"Ali Youssouf Farada","8/25/1995 (27 years old)","D (C)","FC Dikhil","Djiboutian Premier Division","DJI","No","7/1/2021","6/30/2024","$0","Right","Reasonable","Very Strong","6'0""","171 lbs","-","-",68,72,7,3,3,8,9,3,10,5,5,9,9,6,15,4,5,10,9,11,9,10,11,5,5,7,8,5,7,9,9,10,9,8,9,10,10,10,16,19,9,10,12,9,7,6,6,2,10,13,20,3,1,3,2,2,2,2,2,2,4,3
"5404",2000092925,"Doualeh Elabeh","11/11/1991 (31 years old)","M/AM (C)","AS Arta","Djiboutian Premier Division","DJI","No","7/1/2020","6/30/2024","$0","Right","Reasonable","Very Strong","5'11""","156 lbs","-","-",71,71,5,5,6,8,9,7,4,8,1,8,9,4,6,14,5,8,8,11,6,14,12,14,6,8,9,8,13,13,9,8,8,6,15,8,8,5,15,18,12,10,13,11,5,18,8,5,9,14,19,2,2,2,3,4,1,2,3,3,3,3
"5405",2000147929,"Kenedid Mohamed","11/26/2002 (20 years old)","AM (R), ST (C)","FC Dikhil","Djiboutian Premier Division","DJI","No","7/1/2018","-","$0","Right","Fairly Strong","Very Strong","6'4""","176 lbs","-","-",58,71,4,6,12,11,10,4,6,3,4,4,10,2,5,9,7,6,6,7,5,6,9,13,10,10,4,5,3,6,11,12,1,11,13,12,10,5,10,18,9,11,9,12,7,11,11,1,9,10,14,4,1,3,1,2,3,2,4,2,2,2
"5406",2000147927,"Abdulkader Dabar","1/5/1994 (29 years old)","D (C)","FC Dikhil","Djiboutian Premier Division","DJI","No","7/1/2021","-","$0","Right","Reasonable","Very Strong","6'4""","176 lbs","-","-",50,70,3,3,1,3,6,1,13,1,1,12,5,4,8,2,9,6,8,6,11,12,2,5,12,4,8,5,1,6,13,9,6,12,11,9,7,4,11,14,11,14,12,11,7,16,11,7,17,11,18,3,4,1,1,1,2,2,3,1,2,3
"5407",13176035,"Darar Aboubaker","12/27/1989 (33 years old)","ST (C)","AS Ali Sabieh","Djiboutian Premier Division","DJI","No","6/14/2021","-","$0","Right","Fairly Strong","Very Strong","5'9""","147 lbs","-","-",65,70,5,4,9,13,11,5,13,4,1,5,6,10,5,9,15,12,7,11,6,4,8,10,12,8,6,5,4,6,10,11,6,8,14,10,10,5,7,18,8,11,7,12,8,8,15,8,9,13,9,3,1,1,1,3,3,1,3,2,2,2
"5408",13176033,"Abdi Hamza Idleh","12/16/1991 (31 years old)","M (C)","FC Dikhil","Djiboutian Premier Division","DJI","No","8/1/2021","6/30/2024","$0","Right","Reasonable","Very Strong","5'5""","143 lbs","-","-",65,70,2,5,2,6,10,4,1,7,1,8,13,3,7,13,12,9,4,5,6,13,10,5,9,8,8,6,10,7,9,11,6,2,12,11,12,1,10,14,11,13,10,11,5,2,10,4,5,11,7,4,3,1,1,3,1,1,2,2,2,1
"5409",2000092919,"Moussa Fahmi","4/25/1996 (27 years old)","D (C)","AS Arta","Djiboutian Premier Division","DJI","No","7/1/2018","6/30/2024","$0","Right","Reasonable","Very Strong","6'0""","169 lbs","-","-",65,70,3,2,2,1,6,1,11,5,2,9,6,1,13,4,12,10,8,5,8,13,9,5,7,5,9,5,4,6,13,11,6,10,9,12,9,7,15,16,10,10,10,13,5,2,12,3,18,10,7,1,3,2,1,1,1,1,2,2,3,2
"5410",13231539,"Nasradine Aptidon","6/5/1994 (29 years old)","GK","AS Port","Djiboutian Premier Division","DJI","No","7/1/2018","6/30/2024","$0","Right","Fairly Strong","Very Strong","5'11""","156 lbs","-","-",63,70,2,1,1,1,1,4,1,2,2,2,5,2,1,3,11,7,12,5,8,12,19,2,12,3,6,4,4,5,8,13,5,9,12,10,4,4,9,19,11,11,10,12,11,4,7,1,12,13,10,7,9,12,11,8,12,10,11,7,10,12
"5411",13231545,"Abdoulkader Djama","1/5/1994 (29 years old)","D (C)","FC Dikhil","Djiboutian Premier Division","DJI","No","7/1/2021","-","$0","Right","Weak","Very Strong","5'11""","171 lbs","-","-",62,70,2,3,4,6,7,1,13,3,3,7,7,2,10,5,15,9,8,7,5,11,9,5,7,2,14,6,4,7,14,12,7,6,9,12,11,11,13,12,11,12,13,11,14,12,11,2,9,10,7,3,2,3,3,3,3,3,2,1,1,2
"5412",5430062,"Ian Gaynair","2/26/1986 (37 years old)","D (RC), WB (R)","Bandits (BLZ)","Belizean Premier Football League","BLZ","No","6/14/2021","6/30/2024","$0 - $6K","Right","Reasonable","Very Strong","6'2""","171 lbs","-","-",75,85,5,8,5,8,6,3,10,3,8,11,6,5,11,5,14,9,13,11,10,7,15,4,17,5,9,13,6,12,14,11,11,13,6,13,12,11,12,14,2,12,11,11,5,9,9,8,10,12,19,1,3,1,2,1,3,2,2,1,1,2
"5413",2000100309,"Mourad Saleh","6/13/1998 (24 years old)","AM (R), ST (C)","AS Arta","Djiboutian Premier Division","DJI","No","7/1/2020","6/30/2024","$0","Right","Weak","Very Strong","5'5""","125 lbs","-","-",60,70,3,7,12,7,12,4,7,6,3,5,6,1,5,9,11,6,7,7,6,5,5,9,13,9,5,6,5,11,13,13,10,1,12,13,11,1,12,12,9,9,10,11,14,11,5,2,11,10,16,1,2,1,3,1,1,1,2,1,1,2
"5414",2000301554,"Said Abdallah","8/8/1998 (24 years old)","D (RC)","AS Arta","Djiboutian Premier Division","DJI","No","6/12/2023","6/30/2024","$0","Right","Fairly Strong","Very Strong","6'2""","174 lbs","-","-",56,70,3,7,4,2,6,3,6,2,3,10,3,1,8,5,10,6,7,6,6,12,18,5,9,3,6,5,1,6,12,9,3,12,12,11,11,6,12,19,10,11,10,12,12,9,11,6,11,10,13,2,2,1,3,3,3,2,3,3,3,3
"5415",2000100416,"Said Ali Gamil","7/13/1998 (24 years old)","GK","Guelleh Batal","Djiboutian Premier Division","DJI","No","3/26/2019","-","$0","Right Only","Weak","Very Strong","6'1""","167 lbs","-","-",54,70,3,3,1,3,1,6,1,1,1,1,5,1,3,1,12,8,9,4,6,7,12,3,1,3,8,5,4,4,12,14,6,12,13,11,3,6,7,12,8,10,13,10,12,8,6,7,9,13,20,6,14,11,10,6,12,12,5,7,5,10
"5416",2000301581,"Ahmed Houmed","10/26/1999 (23 years old)","AM (LC)","AS Ali Sabieh","Djiboutian Premier Division","DJI","No","6/12/2023","6/30/2024","$0","Left","Very Strong","Fairly Strong","6'2""","165 lbs","-","-",54,70,4,7,7,7,11,4,1,6,4,2,11,2,2,12,6,6,2,4,4,9,7,13,3,7,2,6,7,11,12,10,5,11,14,11,6,3,10,16,13,12,10,14,6,2,5,5,8,9,17,1,1,3,4,3,3,2,1,2,2,3
"5417",2000100424,"Mahad Abdillahi","7/11/1999 (23 years old)","M/AM (R)","Guelleh Batal","Djiboutian Premier Division","DJI","No","7/1/2021","-","$0","Right","Weak","Very Strong","5'9""","145 lbs","-","-",53,70,4,8,7,9,10,1,1,6,1,5,8,3,2,9,14,8,5,5,6,11,8,10,13,8,4,6,6,11,13,12,6,4,13,11,9,3,12,17,11,9,9,10,11,2,5,7,17,11,14,4,2,3,1,1,1,1,3,3,3,2
"5418",2000301577,"Rahad Daher","10/4/1997 (25 years old)","ST (C)","AS Ali Sabieh","Djiboutian Premier Division","DJI","No","7/1/2020","6/30/2024","$0","Right","Weak","Very Strong","6'0""","171 lbs","-","-",58,70,3,3,10,12,9,1,8,5,1,1,3,7,1,4,5,9,6,6,2,11,4,5,8,5,5,4,4,6,12,12,5,9,11,12,11,10,8,20,10,10,13,12,5,4,11,2,10,13,10,3,3,2,3,1,2,1,1,1,3,3
"5419",2000215952,"Ibrahim Ali Mohamed","10/14/1996 (26 years old)","DM, M (C)","AS Arta","Djiboutian Premier Division","DJI","No","7/1/2020","6/30/2024","$0","Right","Reasonable","Very Strong","6'0""","169 lbs","-","-",61,70,5,2,3,6,10,5,6,7,1,10,7,1,13,7,7,7,7,7,7,9,7,5,6,6,9,7,9,12,13,10,6,10,7,11,7,7,14,14,11,13,8,9,10,10,13,2,17,9,18,3,1,2,3,2,3,1,3,4,1,3
"5420",2000301555,"Idriss Bilha","8/27/1997 (25 years old)","D (LC)","AS Arta","Djiboutian Premier Division","DJI","No","6/12/2023","6/30/2024","$0","Left","Very Strong","Reasonable","6'4""","182 lbs","-","-",62,70,4,8,5,1,5,3,8,5,2,8,7,5,13,4,7,12,6,6,10,7,7,5,12,5,9,6,5,7,9,10,7,12,10,13,6,8,14,20,12,13,9,13,7,3,9,1,7,11,8,1,3,3,2,2,2,2,4,3,4,3
"5421",2000121191,"Haroun Kadamy Youssouf","4/11/1998 (25 years old)","M (C)","La Louvière Centre","Belgian Second Amateur Division ACFF C","DJI","Yes","7/1/2021","6/30/2024","$500 - $3.5K","Right Only","Weak","Very Strong","5'10""","152 lbs","10","-",66,69,6,3,2,7,13,2,4,6,1,8,6,2,10,8,10,7,5,7,8,10,12,10,3,8,8,8,9,13,14,14,7,9,15,14,10,6,10,18,12,13,10,14,12,2,15,3,8,10,8,1,1,1,2,1,2,3,3,3,2,4
"5422",2000100425,"Abdourrahouf Adama","7/30/1998 (24 years old)","AM (L), ST (C)","FC Dikhil","Djiboutian Premier Division","DJI","No","7/1/2021","-","$0","Left","Very Strong","Fairly Strong","5'10""","152 lbs","-","-",51,65,4,7,10,5,11,1,7,5,4,4,7,1,4,6,9,5,4,5,2,11,12,7,10,8,4,4,3,6,12,12,5,4,13,12,8,4,10,15,10,13,9,10,6,4,12,8,10,11,7,1,4,1,1,2,3,1,3,1,3,1
"5423",2000022867,"Allan Barillas","1/13/1999 (24 years old)","D (C)","Placencia","Belizean Lower Leagues","BLZ","No","7/1/2019","6/30/2024","$2K - $20K","Right","Reasonable","Very Strong","6'4""","171 lbs","-","-",63,84,2,1,1,1,3,1,11,3,1,7,5,1,8,1,7,9,8,6,6,13,8,5,8,4,13,5,1,6,13,9,6,11,15,13,9,5,12,3,8,9,11,10,8,3,10,3,12,11,14,2,2,2,1,4,3,3,1,3,2,3
"5424",13176034,"Houssein Migameh","9/21/1988 (34 years old)","M/AM (L)","Gendarmerie","Djiboutian Premier Division","DJI","No","6/14/2021","-","$0","Right","Reasonable","Very Strong","5'10""","154 lbs","-","-",58,65,7,9,6,10,7,7,1,8,7,7,12,7,6,12,9,9,5,14,7,12,3,10,11,12,6,8,5,11,10,9,8,10,12,11,9,5,12,14,12,11,12,13,12,5,8,4,9,12,14,2,1,3,3,3,2,1,1,3,1,2
"5425",2000092960,"Mohamed Haroun","4/11/1998 (25 years old)","M (C)","CO Vincennois","French Regional Divisions","DJI","No","1/1/2020","-","$0","Right","Reasonable","Very Strong","6'2""","169 lbs","-","-",55,65,6,6,3,5,5,7,4,7,5,9,8,2,9,10,8,10,6,11,7,15,11,6,13,9,9,8,7,9,9,9,8,13,13,9,14,5,10,17,9,10,11,12,11,7,15,2,18,12,20,3,1,1,3,3,3,1,3,2,4,3
"5426",13231556,"Yonis Moussa Dirir","2/13/1997 (26 years old)","M (C)","ACS Hayableh","Djiboutian Premier Division","DJI","No","7/1/2018","-","$0","Right","Fairly Strong","Very Strong","5'5""","130 lbs","-","-",57,65,4,1,6,5,11,5,2,8,1,11,10,1,7,6,13,7,7,6,3,9,16,9,14,8,7,7,7,12,13,12,6,1,11,10,12,2,13,11,9,12,10,11,12,7,5,2,15,13,12,2,2,2,1,1,3,3,1,3,2,3
"5427",30001733,"Billy Forbes","12/13/1990 (32 years old)","AM (RL)","Fuego FC","United States Soccer Leagues Division One","TCA","No","5/3/2023","11/30/2023","$160K - $475K","Left Only","Very Strong","Weak","5'9""","165 lbs","241","54",96,102,8,13,11,10,10,8,7,9,8,6,12,7,7,10,6,9,10,12,9,8,13,13,7,10,7,10,12,13,15,9,10,8,16,13,11,11,12,14,13,14,12,10,5,17,6,2,8,13,18,3,1,3,3,3,2,1,1,1,3,3
"5428",2000100559,"Christopher Louisy","4/6/2005 (18 years old)","D (L), DM, M (C)","Academy Eagles","Turks and Caicos Islands Premier League","TCA","No","6/13/2022","12/31/2023","$0","Left","Very Strong","Weak","5'7""","141 lbs","11","1",50,78,8,9,6,9,9,7,7,8,5,8,8,5,9,10,10,8,8,8,7,15,2,5,11,7,9,8,9,9,6,4,8,5,10,4,8,4,11,12,10,10,13,8,8,8,10,7,15,12,15,3,4,3,3,3,1,3,1,3,2,1
"5429",72044271,"Marc Fenelus","8/22/1992 (30 years old)","D (C), ST (C)","TN City TW Steel","Chinese Taipei Football Premier League","TCA","No","1/1/2020","12/31/2023","$2.5K - $26K","Right","Reasonable","Very Strong","6'0""","160 lbs","160","209",72,77,6,2,6,9,6,6,9,4,2,6,7,2,6,9,7,13,8,6,8,13,14,9,3,11,7,6,6,7,13,10,7,10,6,12,12,11,9,20,9,11,9,8,5,1,5,5,8,11,12,3,2,1,1,2,1,2,3,4,1,1
"5430",82084681,"Pendieno Brooks","1/4/2000 (23 years old)","GK","SWA Sharks","Turks and Caicos Islands Premier League","TCA","No","6/15/2020","-","$0","Right","Weak","Very Strong","5'11""","149 lbs","30","-",50,70,3,3,1,1,1,5,1,2,1,2,11,2,1,1,15,8,15,6,9,9,10,1,9,3,5,6,4,5,10,14,5,10,12,9,1,5,11,17,13,10,14,8,9,7,5,8,14,11,12,5,6,8,12,8,7,9,12,10,8,7
"5431",2000087948,"Callum Park","12/6/2004 (18 years old)","M (C)","SWA Sharks","Turks and Caicos Islands Premier League","TCA","No","1/1/2022","-","$0","Right","Strong","Very Strong","6'1""","156 lbs","7","-",50,67,7,4,7,8,7,7,3,9,1,5,9,4,7,10,15,5,2,7,6,13,11,5,11,9,9,8,9,9,8,5,4,15,15,7,7,4,13,10,8,11,11,12,6,11,9,4,8,13,18,2,1,1,1,1,1,2,3,1,2,3
"5432",2000054408,"Sebastian Turbyfield","12/19/2002 (20 years old)","GK","SWA Sharks","Turks and Caicos Islands Premier League","TCA","No","1/1/2022","-","$0","Right","Fairly Strong","Very Strong","6'1""","174 lbs","9","-",55,65,2,2,2,1,6,7,1,2,1,2,8,2,2,6,9,6,8,7,7,14,14,3,1,1,9,7,6,5,8,15,7,11,14,8,1,4,8,20,11,11,11,11,7,13,7,2,10,10,12,12,8,12,10,10,1,12,5,8,7,5
"5433",2000054464,"Mackenson Cadet","1/20/2000 (23 years old)","D (RC), DM, M (RC), AM (C)","Cavalier","Jamaican Premier League","TCA","No","3/1/2023","6/30/2026","$0","Left","Very Strong","Reasonable","6'0""","169 lbs","50","15",55,62,2,5,7,7,12,5,8,7,1,9,5,2,7,8,15,8,7,7,8,12,11,9,9,7,9,12,4,12,8,8,7,11,7,8,7,5,11,15,9,12,13,11,7,3,11,4,8,11,13,1,1,1,2,2,2,3,1,1,3,1
"5434",2000022862,"Devin Nunez","1/28/2001 (22 years old)","GK","Placencia","Belizean Lower Leagues","BLZ","No","7/1/2019","6/30/2024","$0 - $35K","Right","Fairly Strong","Very Strong","6'2""","169 lbs","-","-",60,84,3,2,1,2,1,8,1,1,3,1,7,1,2,4,7,9,7,6,6,13,12,2,6,1,13,6,5,5,13,7,1,12,8,10,1,4,13,14,2,13,8,11,11,11,11,2,14,9,8,5,7,13,9,7,8,13,5,6,10,7
"5435",2000239301,"Junior Paul","6/14/2001 (21 years old)","ST (C)","SWA Sharks","Turks and Caicos Islands Premier League","TCA","No","6/13/2022","-","$0","Right","Fairly Strong","Very Strong","5'9""","152 lbs","-","-",50,60,4,1,8,12,12,4,12,5,1,2,4,7,1,10,7,8,1,9,5,9,1,11,8,12,4,4,4,5,9,10,5,3,12,10,11,6,10,16,12,12,12,10,5,14,5,4,10,10,12,3,1,1,2,3,4,1,2,2,3,2
"5436",2000241816,"Kwakhe Thwala","4/4/2002 (21 years old)","D (LC)","Mbabane Swallows","Premier League of Eswatini","SWZ","No","2/19/2023","6/30/2025","$20K - $190K","Left Only","Very Strong","Very Weak","5'10""","147 lbs","17","-",75,100,5,8,6,1,9,2,11,3,5,9,8,5,12,8,10,11,9,7,9,14,6,5,7,7,12,8,5,8,10,14,8,9,17,12,8,5,14,13,12,12,11,13,12,6,11,2,8,11,19,3,2,3,2,2,3,1,3,2,1,3
"5437",65008831,"Felix Badenhorst","6/12/1989 (34 years old)","AM (C), ST (C)","Mbabane Swallows","Premier League of Eswatini","SWZ","No","7/1/2021","6/30/2024","$1.5K - $14K","Right","Reasonable","Very Strong","6'2""","163 lbs","122","35",86,100,9,12,9,13,15,7,15,9,1,9,9,2,9,12,10,10,11,7,10,11,9,9,3,11,10,10,8,14,8,11,9,14,17,11,9,8,10,10,9,11,11,9,14,7,11,2,12,8,20,1,2,3,1,2,1,2,3,2,2,1
"5438",65042719,"Banele Ndzabandzaba","2/23/1998 (25 years old)","DM, M (RC)","Mbabane Highlanders","Premier League of Eswatini","SWZ","No","7/1/2019","6/30/2025","$0","Right Only","Weak","Very Strong","5'11""","154 lbs","-","-",82,100,7,8,11,7,10,5,7,14,1,9,10,4,14,12,15,8,8,11,6,11,14,5,5,10,12,13,6,13,14,11,14,8,12,12,13,8,11,17,13,13,10,13,12,5,15,5,20,9,14,2,2,1,3,2,2,1,2,4,4,3
"5439",5686014,"Tony Tsabedze","10/29/1984 (38 years old)","M (L), AM (LC)","Mbabane Swallows","Premier League of Eswatini","SWZ","No","6/14/2021","6/30/2024","$0 - $10K","Right","Reasonable","Very Strong","5'6""","132 lbs","130","26",75,100,9,8,14,8,10,11,5,12,1,3,10,5,4,12,12,9,8,8,10,9,6,14,3,12,5,10,10,12,11,8,10,3,12,10,9,6,14,19,9,11,10,10,6,15,6,1,7,13,20,2,2,4,2,3,1,1,1,3,4,2
"5440",2000241857,"Neliswa Dlamini","12/28/2002 (20 years old)","M/AM (RL)","Mbabane Swallows","Premier League of Eswatini","SWZ","No","2/1/2023","6/30/2025","$40K - $120K","Right Only","Weak","Very Strong","5'9""","147 lbs","-","-",74,99,8,13,13,9,13,7,7,8,7,7,11,5,8,8,13,4,6,9,8,9,13,15,4,12,7,8,8,12,14,11,5,7,13,12,7,7,12,14,12,10,10,12,14,17,8,3,11,10,15,3,1,2,1,3,1,4,1,2,2,2
"5441",2000018027,"Vusi Vilakati","5/7/2001 (22 years old)","D (RC)","Mbabane Highlanders","Premier League of Eswatini","SWZ","No","7/1/2019","6/30/2025","$4.5K - $45K","Right","Reasonable","Very Strong","6'0""","165 lbs","-","-",73,98,6,11,8,8,10,5,11,8,7,14,10,4,15,5,7,6,6,9,8,11,14,5,2,8,10,9,8,9,14,11,9,8,12,9,8,8,13,16,11,12,11,9,12,15,6,8,13,10,15,1,2,2,1,1,3,2,2,2,2,2
"5442",13161955,"Njabulo Ndlovu","12/29/1994 (28 years old)","DM, M (C)","Green Mamba","Premier League of Eswatini","SWZ","No","7/1/2022","6/30/2024","$9K - $90K","Left Only","Very Strong","Weak","5'9""","154 lbs","39","2",92,98,9,7,7,10,15,9,9,9,3,9,14,7,9,15,11,10,6,8,11,15,2,5,10,11,12,14,14,10,11,11,15,10,15,11,8,6,13,17,8,12,10,9,9,14,6,8,9,8,18,4,2,3,2,2,1,1,1,1,3,1
"5443",13161945,"Sabelo Ndzinisa","7/31/1991 (31 years old)","ST (C)","Green Mamba","Premier League of Eswatini","SWZ","No","8/1/2022","6/30/2024","$65K - $190K","Right Only","Weak","Very Strong","5'8""","149 lbs","89","46",92,95,6,7,11,14,12,10,12,10,4,6,10,12,7,13,10,11,13,12,11,11,12,11,13,12,10,12,11,11,10,11,12,11,15,11,11,10,5,15,12,10,10,12,10,13,6,5,16,11,8,4,3,1,2,3,2,2,2,3,2,3
"5444",59148343,"Leon Manyisa","6/3/1999 (24 years old)","DM, M/AM (C)","Mbabane Swallows","Premier League of Eswatini","SWZ","No","7/1/2022","6/30/2024","$7K - $70K","Right Only","Weak","Very Strong","5'9""","147 lbs","-","-",86,95,4,5,9,10,12,2,7,10,1,10,13,1,9,13,9,10,8,8,8,14,8,10,6,13,10,8,9,8,13,11,12,6,12,13,13,5,14,15,10,11,10,13,14,15,8,5,10,10,13,2,1,3,2,1,1,3,3,3,3,2
"5445",2000242799,"Ginel Ronde","8/8/2002 (20 years old)","AM (RC)","Neuruppin","German Lower Division","BOE","Yes","1/10/2023","-","$0","Right","Weak","Very Strong","5'10""","152 lbs","11","1",53,75,5,7,6,7,6,1,4,7,1,4,9,4,4,9,5,3,2,6,2,8,7,9,9,8,6,6,8,7,13,13,6,4,12,13,7,3,9,20,10,9,14,12,9,8,9,8,8,12,15,4,2,3,1,1,3,1,3,3,1,2
"5446",2000022868,"Horace Avila","9/18/1999 (23 years old)","D/WB/M (L), AM (RL)","Wagiya","Belizean Premier Football League","BLZ","No","6/15/2020","6/30/2024","$0 - $75K","Left","Very Strong","Reasonable","6'3""","176 lbs","-","-",68,82,6,10,10,8,9,5,6,6,6,5,12,4,8,4,12,9,5,6,7,11,11,9,12,10,6,7,7,7,13,10,7,14,13,11,8,7,10,1,2,10,13,12,5,10,7,8,9,8,15,1,3,2,2,1,1,2,2,2,2,2
"5447",2000310320,"Bongiswa Dlamini","4/4/2001 (22 years old)","DM, M (C)","Young Buffaloes","Premier League of Eswatini","SWZ","No","7/1/2021","6/30/2025","$0 - $80K","Right Only","Very Weak","Very Strong","5'9""","145 lbs","-","-",71,94,7,6,3,8,11,2,8,7,4,8,11,4,12,11,9,10,7,5,8,15,17,5,6,6,12,9,10,13,10,12,9,5,16,8,9,6,11,13,9,12,10,10,9,16,10,1,10,13,10,3,3,3,2,1,1,1,2,3,1,1
"5448",2000033211,"Deshawon Nembhard","10/8/1994 (28 years old)","D (L)","Tormenta FC","United States Soccer Leagues Division One","BLZ","No","2/9/2022","11/30/2023","$4.5K - $45K","Left Only","Very Strong","Weak","6'1""","160 lbs","60","2",81,82,6,9,7,1,7,1,8,1,6,9,10,3,12,8,12,9,9,8,7,13,7,5,12,5,10,8,7,13,10,10,9,12,13,13,14,10,13,11,13,12,10,12,5,13,6,3,11,11,10,3,2,2,4,1,4,3,1,2,3,1
"5449",2000172750,"Randy Padilla","3/17/1991 (32 years old)","AM (R), ST (C)","Mictlán","Primera División de Ascenso Guatemala","BLZ","No","7/1/2019","6/30/2024","$0","Right","Reasonable","Very Strong","5'10""","158 lbs","-","-",75,81,7,10,12,9,11,7,11,6,7,7,10,6,1,8,8,9,8,12,8,9,18,12,10,14,8,7,5,9,13,11,4,5,10,10,13,5,9,14,9,10,10,11,7,12,9,3,8,10,17,3,2,1,3,1,2,1,2,4,3,1
"5450",82050069,"Dalton Eiley","12/10/1983 (39 years old)","D (C)","Bandits (BLZ)","Belizean Premier Football League","BLZ","No","6/14/2021","6/30/2024","$0","Left","Very Strong","Reasonable","6'2""","174 lbs","-","-",65,81,4,1,2,3,6,2,11,3,6,10,5,1,11,1,10,6,8,6,7,14,17,5,7,6,14,6,1,7,6,6,6,12,10,10,6,6,15,18,9,13,10,9,12,8,5,7,8,12,7,2,2,3,2,3,1,2,3,4,3,3
"5451",2000019310,"Jardehl Muschamp","3/22/2002 (21 years old)","ST (C)","Placencia","Belizean Lower Leagues","BLZ","No","6/13/2022","6/30/2024","$0 - $55K","Left","Very Strong","Reasonable","6'2""","176 lbs","-","-",60,80,5,1,5,13,13,5,13,6,1,3,5,5,2,8,13,10,4,6,6,8,15,8,8,11,4,5,6,6,8,10,6,11,8,12,11,8,11,10,10,15,12,11,5,2,10,3,12,13,7,2,1,1,1,3,3,1,1,1,1,1
"5452",2000022878,"Andir Chi","6/27/2001 (21 years old)","M (C), AM (RC)","Progresso FC","Belizean Premier Football League","BLZ","No","7/1/2018","-","$0","Right","Weak","Very Strong","6'0""","158 lbs","-","-",66,78,5,6,7,9,13,5,4,7,5,5,4,1,5,12,15,9,6,5,6,13,13,12,9,10,6,7,9,11,9,12,3,7,14,13,6,4,12,1,1,9,12,8,8,7,8,3,12,9,12,2,1,3,1,3,1,3,3,1,1,1
"5453",82050068,"Frank Lopéz","3/12/1989 (34 years old)","GK","Police Utd (BLZ)","Belizean Lower Leagues","BLZ","No","6/14/2021","6/30/2024","$0 - $22K","Right","Fairly Strong","Very Strong","6'2""","171 lbs","-","-",60,78,4,1,3,3,1,7,1,2,3,3,8,3,2,1,9,9,14,6,6,13,7,3,8,1,6,6,5,5,10,12,5,10,9,9,5,5,10,15,2,11,10,11,12,12,5,8,9,11,8,6,13,4,12,7,8,12,5,9,9,13
"5454",2000022869,"Latrell Middleton","11/3/1999 (23 years old)","D/WB/M/AM (R)","FF Valley Pride","Belizean Lower Leagues","BLZ","No","7/1/2019","-","$0","Right","Reasonable","Very Strong","5'8""","141 lbs","-","-",59,77,4,7,7,4,7,5,2,5,1,6,9,5,5,6,7,5,4,7,7,9,10,11,8,11,7,6,6,7,13,13,6,5,12,13,8,3,11,16,9,11,12,9,11,2,15,7,11,9,19,2,3,2,1,3,2,3,3,3,3,3
"5455",2000019030,"Norman Anderson","1/25/1997 (26 years old)","D/WB/M/AM (R)","Verdes FC","Belizean Premier Football League","BLZ","No","7/1/2019","6/30/2025","$0 - $65K","Right","Reasonable","Very Strong","6'1""","154 lbs","-","-",69,77,6,8,10,8,8,4,4,5,6,9,8,4,11,10,15,8,7,8,6,13,13,9,13,7,7,13,4,9,11,9,7,12,16,9,11,4,10,14,9,11,13,10,10,5,14,8,8,11,13,4,1,2,3,2,2,1,2,1,2,2
"5456",2000193495,"Aarón López","8/11/1997 (25 years old)","D (C)","Verdes FC","Belizean Premier Football League","BLZ","No","7/1/2022","6/30/2025","$2K - $20K","Right","Reasonable","Very Strong","6'2""","165 lbs","-","-",67,77,4,2,1,1,6,1,11,1,1,13,6,1,13,4,11,11,8,4,7,13,16,5,6,3,12,5,2,7,13,10,6,11,15,10,12,3,11,1,11,9,11,13,5,9,13,2,12,12,10,1,1,2,3,3,2,1,3,2,1,2
"5457",2000023751,"Gendrick Meye","2/8/2002 (21 years old)","D/WB (R)","Nacional (ARU)","Aruban Division di Honor","BOE","Yes","8/1/2020","6/30/2025","$0","Right","Reasonable","Very Strong","5'7""","136 lbs","4","-",55,74,4,10,6,5,8,1,4,5,4,8,7,4,10,5,7,11,8,7,9,13,13,7,4,6,6,6,6,7,13,10,7,4,15,14,7,4,16,18,11,11,12,14,15,11,12,1,10,15,15,3,1,3,3,2,4,1,1,1,1,2
"5458",2000023229,"Alexis Chan","8/5/2001 (21 years old)","M/AM (C)","Progresso FC","Belizean Premier Football League","BLZ","No","7/1/2018","-","$0","Right","Weak","Very Strong","5'6""","134 lbs","-","-",60,75,4,1,8,8,13,6,4,6,1,6,13,2,6,11,11,4,2,9,7,7,3,10,8,9,8,7,14,11,11,13,7,1,7,14,7,2,13,8,9,12,14,11,10,2,14,4,20,11,16,1,2,1,1,2,2,3,2,3,3,3
"5459",82050074,"Denmark Casey","1/14/1994 (29 years old)","DM, M (C)","Pirates (BLZ)","Belizean Premier Football League","BLZ","No","1/1/2020","6/30/2024","$0 - $90K","Right","Reasonable","Very Strong","5'9""","160 lbs","1","-",72,75,5,6,5,5,12,6,6,8,1,11,11,3,12,11,12,10,8,5,3,13,8,5,11,6,8,7,9,12,13,13,7,3,13,13,11,9,12,1,9,14,12,10,9,5,11,1,12,12,17,3,1,3,2,2,3,1,3,3,1,2
"5460",2000019173,"Highking Roberts","5/23/1994 (29 years old)","M/AM (C), ST (C)","Wagiya","Belizean Premier Football League","BLZ","No","7/1/2018","6/30/2024","$24K - $75K","Right","Strong","Very Strong","5'7""","132 lbs","-","-",67,75,4,3,9,8,12,4,6,6,2,4,7,6,5,11,11,6,2,8,6,10,12,12,13,7,3,4,3,9,12,12,12,1,16,12,12,1,9,16,8,8,12,9,6,13,6,3,9,8,14,3,3,2,3,2,1,1,4,2,3,2
"5461",82050066,"Daniel Jiminez","4/14/1988 (35 years old)","ST (C)","Police Utd (BLZ)","Belizean Lower Leagues","BLZ","No","6/14/2021","6/30/2024","$0","Right","Reasonable","Very Strong","6'0""","171 lbs","-","-",65,75,6,3,7,12,10,6,9,7,3,2,7,11,1,5,8,11,5,14,5,10,7,14,10,12,4,6,5,7,10,9,7,11,13,9,4,10,11,20,7,12,10,10,5,11,9,3,12,12,8,3,2,1,3,3,2,1,4,3,2,2
"5462",82050067,"Evan Mariano","1/20/1988 (35 years old)","AM (RL), ST (C)","Bandits (BLZ)","Belizean Premier Football League","BLZ","No","7/1/2019","6/30/2024","$0 - $1.5K","Right","Reasonable","Very Strong","5'8""","147 lbs","-","-",65,75,6,8,10,13,11,4,9,6,4,7,13,9,5,8,5,12,5,13,8,11,10,6,15,11,5,8,8,9,11,9,8,4,10,10,6,5,11,6,5,11,10,10,8,2,6,1,9,14,15,1,1,1,3,1,1,1,1,4,1,3
"5463",2000093101,"Charles Tillett","7/29/2001 (21 years old)","GK","Verdes FC","Belizean Premier Football League","BLZ","No","7/1/2021","6/30/2025","$14K - $40K","Right","Reasonable","Very Strong","6'3""","176 lbs","-","-",60,75,3,3,1,2,1,3,1,3,1,3,8,2,3,1,7,5,10,3,6,13,5,1,10,1,7,6,5,5,7,9,1,14,15,9,2,6,10,14,9,8,10,13,6,8,7,3,12,11,19,5,13,13,13,7,6,13,5,6,5,10
"5464",2000018375,"Jaren Lumbey","1/22/1998 (25 years old)","ST (C)","FF Valley Pride","Belizean Lower Leagues","BLZ","No","6/15/2020","-","$0","Right","Reasonable","Very Strong","6'0""","163 lbs","-","-",64,74,4,4,12,10,6,4,8,2,6,6,6,6,1,7,14,9,5,10,5,8,12,6,7,11,6,6,7,8,14,11,5,6,15,13,13,8,10,15,5,10,9,11,14,13,9,4,20,13,13,1,2,2,3,1,3,3,1,1,2,2
"5465",82050064,"Evrall Trapp","1/22/1987 (36 years old)","D (RLC), DM","Verdes FC","Belizean Premier Football League","BLZ","No","6/14/2021","6/30/2024","$0 - $3.5K","Left Only","Very Strong","Weak","5'7""","152 lbs","-","-",65,74,7,10,7,5,9,8,10,9,6,10,9,1,11,9,13,8,9,9,8,9,16,4,10,8,10,11,8,11,9,7,10,12,17,8,9,12,9,13,5,11,8,10,6,10,6,8,10,10,17,3,2,3,3,1,2,3,1,1,3,3
"5466",2000018381,"Jordi Polanco","6/8/1996 (27 years old)","M/AM (C)","Bandits (BLZ)","Belizean Premier Football League","BLZ","No","6/15/2020","6/30/2024","$18K - $55K","Right","Reasonable","Very Strong","5'7""","134 lbs","-","-",67,74,3,1,6,11,10,4,5,13,1,4,9,5,2,8,12,7,7,7,6,11,12,8,13,10,7,6,10,11,13,13,5,3,12,13,12,1,11,7,1,12,12,13,8,1,7,5,9,10,17,3,1,1,3,3,3,2,3,2,3,3
"5467",2000019158,"Daniel Jiménez","4/14/1988 (35 years old)","M/AM (R)","Bandits (BLZ)","Belizean Premier Football League","BLZ","No","7/1/2019","6/30/2024","$0 - $9K","Right","Strong","Very Strong","5'11""","156 lbs","-","-",73,73,8,10,7,10,12,7,5,8,7,7,12,5,6,7,13,8,7,10,8,11,15,11,10,12,6,8,8,13,10,9,5,10,18,10,10,7,12,9,4,11,10,10,12,4,8,2,7,13,20,2,3,2,2,3,2,2,2,2,2,1
"5468",82089745,"Jeremy Loogman","8/8/2001 (21 years old)","GK","Flamingo","Bonaire Kampionato","BOE","No","1/1/2022","-","$0","Right","Reasonable","Very Strong","6'4""","180 lbs","-","-",60,74,1,2,1,1,1,2,1,2,2,3,4,1,3,4,8,4,14,4,6,12,7,3,3,3,11,2,4,4,10,14,6,12,10,12,1,6,9,12,11,7,14,10,6,1,6,4,10,9,8,4,6,12,13,4,11,6,5,5,6,12
"5469",2000021556,"Dale Pelayo","5/9/2000 (23 years old)","D (RC), DM, M (C)","Bandits (BLZ)","Belizean Premier Football League","BLZ","No","6/15/2020","6/30/2024","$0 - $40K","Right","Reasonable","Very Strong","6'4""","178 lbs","-","-",58,73,4,8,3,4,9,5,6,6,4,10,8,1,13,7,15,8,7,4,5,13,7,5,1,5,10,6,8,7,11,6,6,13,13,7,9,4,9,14,13,11,11,10,8,9,8,7,11,10,13,1,3,1,3,3,1,2,4,1,2,2
"5470",82050083,"Khalil Velasquez","8/13/1985 (37 years old)","D (C)","Bandits (BLZ)","Belizean Premier Football League","BLZ","No","6/14/2021","6/30/2024","$0","Right","Reasonable","Very Strong","5'11""","165 lbs","-","-",63,72,5,2,3,1,7,3,13,5,6,9,7,2,12,2,8,12,9,7,10,15,12,5,10,7,10,7,5,8,7,9,8,8,12,6,5,7,10,12,5,12,10,8,6,2,5,1,8,12,20,3,1,3,2,1,3,1,3,2,2,2
"5471",82050072,"Devon Makin","11/11/1990 (32 years old)","M (RC), AM (R)","Police Utd (BLZ)","Belizean Lower Leagues","BLZ","No","6/14/2021","6/30/2024","$0 - $40K","Right","Reasonable","Very Strong","5'10""","156 lbs","-","-",67,72,7,10,8,9,10,8,6,8,6,5,11,5,10,13,13,9,8,12,9,10,13,10,6,10,7,11,10,15,9,10,5,8,12,8,10,5,11,5,2,10,10,12,8,12,5,2,19,11,16,2,1,3,3,1,1,4,3,1,3,2
"5472",2000167823,"Eldon Reneau","5/22/2003 (20 years old)","M (C)","Verdes FC","Belizean Premier Football League","BLZ","No","7/1/2021","6/30/2025","$2K - $22K","Right","Weak","Very Strong","5'10""","152 lbs","-","-",65,72,6,6,2,4,14,6,6,7,3,9,14,6,6,12,7,8,7,8,6,14,4,9,7,9,4,7,7,11,12,10,7,6,12,11,13,5,9,4,4,11,9,13,9,18,7,3,11,13,11,4,3,1,1,2,3,1,4,2,2,3
"5473",2000022856,"Jesse Smith","11/24/1994 (28 years old)","ST (C)","Pirates (BLZ)","Belizean Premier Football League","BLZ","No","6/15/2020","6/30/2024","$0 - $85K","Right","Weak","Very Strong","5'8""","145 lbs","-","-",67,72,5,4,10,13,12,5,13,4,1,5,5,4,1,9,11,9,6,7,5,8,3,10,4,10,6,5,6,7,13,12,2,5,15,12,12,6,7,4,1,12,9,10,5,13,7,7,20,13,13,2,3,1,3,2,3,2,4,3,3,1
"5474",2000018374,"Jonard Castillo","12/11/1999 (23 years old)","ST (C)","Wagiya","Belizean Premier Football League","BLZ","No","6/15/2020","6/30/2024","$0 - $70K","Right","Fairly Strong","Very Strong","6'6""","189 lbs","-","-",63,72,1,4,12,10,11,3,11,6,1,4,5,4,4,11,9,9,4,6,6,13,3,11,2,9,4,5,6,6,13,10,6,12,8,13,3,7,12,11,1,12,9,12,5,5,9,4,7,11,14,3,2,1,3,2,3,2,4,3,2,3
"5475",2000022877,"Alexander Scott","7/17/1999 (23 years old)","D (C), DM, M (C)","Bandits (BLZ)","Belizean Premier Football League","BLZ","No","7/1/2018","6/30/2024","$14K - $45K","Right","Fairly Strong","Very Strong","6'1""","169 lbs","-","-",62,71,3,4,1,1,7,5,7,4,1,11,11,1,9,6,5,9,7,6,7,13,11,5,3,5,9,6,5,9,12,10,6,12,12,11,5,6,11,9,5,12,12,11,10,13,8,8,15,9,7,1,1,3,1,2,3,1,3,4,2,3
"5476",82050082,"Dellon Torres","6/14/1984 (38 years old)","M (RC), AM (R)","Placencia","Belizean Lower Leagues","BLZ","No","6/14/2021","6/30/2024","$0 - $5K","Right","Reasonable","Very Strong","5'9""","156 lbs","-","-",64,71,7,10,4,11,9,9,9,7,6,8,11,6,10,13,5,12,8,10,10,14,12,10,7,11,10,11,9,14,6,5,5,10,11,4,9,7,9,18,1,11,9,11,9,8,12,3,13,12,18,1,3,1,1,3,1,2,3,2,3,2
"5477",2000019258,"Sean Caliz","9/1/1996 (26 years old)","D/WB/M/AM (R)","Wagiya","Belizean Premier Football League","BLZ","No","7/1/2018","6/30/2024","$0 - $80K","Right","Reasonable","Very Strong","6'0""","154 lbs","-","-",66,70,7,11,6,9,6,5,4,5,1,6,6,3,7,10,12,9,6,7,7,11,17,14,14,10,7,6,2,7,13,13,6,7,13,13,7,3,13,5,3,9,10,13,10,1,5,5,10,10,17,4,1,3,3,3,1,2,1,1,1,3
"5478",82050070,"Luis Alonzo Torres","2/3/1993 (30 years old)","M/AM (R), ST (C)","Placencia","Belizean Lower Leagues","BLZ","No","7/1/2019","6/30/2024","$0 - $70K","Right","Reasonable","Very Strong","5'8""","147 lbs","-","-",68,70,5,7,9,9,10,5,7,3,5,3,8,3,6,10,7,7,3,9,4,7,14,10,1,8,3,7,4,11,13,13,13,4,6,13,6,4,10,5,1,8,13,12,9,12,7,3,12,12,14,1,3,1,2,3,2,3,3,1,3,1
"5479",82089455,"Jermaine Windster","5/29/1994 (29 years old)","AM (C), ST (C)","Flamingo","Bonaire Kampionato","BOE","Yes","7/1/2021","-","$0","Right","Reasonable","Very Strong","5'11""","180 lbs","16","17",70,73,2,3,12,10,7,5,8,7,4,3,9,1,6,12,9,9,8,9,7,12,10,12,12,9,6,7,7,8,13,13,7,9,17,13,13,5,10,15,11,13,9,6,8,18,6,3,9,9,20,2,3,2,3,3,3,2,1,3,3,2
"5480",2000088257,"Asrel Sutherland","3/8/1993 (30 years old)","D (C)","Pirates (BLZ)","Belizean Premier Football League","BLZ","No","6/14/2021","6/30/2024","$20K - $60K","Right","Reasonable","Very Strong","6'4""","185 lbs","-","-",67,70,1,1,1,2,6,1,6,4,5,13,6,1,8,2,15,7,8,6,7,13,14,5,7,5,13,5,3,6,13,9,6,11,18,11,8,11,14,11,2,10,13,11,13,1,6,2,10,13,17,2,2,2,3,2,3,3,1,1,3,3
"5481",82050071,"Andrés Makin","4/11/1992 (31 years old)","DM, M (C)","Police Utd (BLZ)","Belizean Lower Leagues","BLZ","No","6/14/2021","6/30/2024","$2K - $20K","Right","Reasonable","Very Strong","5'8""","154 lbs","-","-",70,70,7,7,3,3,14,7,7,8,1,10,11,4,13,11,5,10,5,9,9,14,12,5,12,9,11,8,11,13,7,9,3,6,6,9,10,7,14,16,1,9,11,12,6,13,10,2,11,12,9,3,1,2,3,4,1,2,3,3,3,3
"5482",82050081,"Gilroy Thurton","9/7/1993 (29 years old)","M/AM (L), ST (C)","Wagiya","Belizean Premier Football League","BLZ","No","6/1/2021","6/30/2024","$22K - $65K","Left","Very Strong","Reasonable","5'7""","138 lbs","-","-",63,70,5,6,9,6,9,6,7,6,1,6,9,3,3,5,15,8,4,7,6,6,11,6,10,6,5,6,7,9,14,14,12,6,13,13,11,4,8,13,5,11,13,12,8,3,13,3,8,10,9,2,2,2,1,3,3,2,3,2,1,1
"5483",7640132,"Sunil Chhetri","8/3/1984 (38 years old)","AM (L), ST (C)","Bengaluru","Indian National Division","IND","No","5/31/2023","5/31/2024","$0 - $14K","Right","Fairly Strong","Very Strong","5'7""","152 lbs","333","141",83,110,6,8,12,13,11,13,8,11,5,4,10,18,4,11,11,9,14,10,10,8,17,10,18,12,4,19,12,17,8,14,14,9,11,8,8,8,5,16,18,18,17,19,8,12,11,4,5,17,19,3,2,1,2,2,4,3,1,3,2,2
"5484",2000031701,"Aniket Bharti","5/10/2003 (20 years old)","AM (C), ST (C)","Independiente Santa Fe","Colombian First Division","IND","Yes","4/28/2023","12/31/2023","$70K - $210K","Right","Weak","Very Strong","6'0""","158 lbs","3","2",75,97,6,7,7,13,11,6,13,9,1,4,6,9,4,9,7,11,8,12,2,13,7,14,8,5,7,7,7,8,14,11,2,7,18,13,8,6,9,10,10,10,9,13,14,2,8,5,10,12,9,2,1,1,4,2,3,1,1,2,3,1
"5485",40007755,"Gurpreet Singh Sandhu","2/3/1992 (31 years old)","GK","Bengaluru","Indian National Division","IND","No","2/3/2023","5/31/2028","Not for Sale","Right","Reasonable","Very Strong","6'6""","202 lbs","160","-",80,93,3,3,1,3,7,5,12,3,3,1,6,3,6,5,11,12,12,9,6,10,13,4,16,3,11,17,7,12,4,7,5,15,13,5,10,12,9,15,14,15,12,14,5,15,7,6,9,15,18,12,9,13,13,12,10,9,6,13,13,16
"5486",40028819,"Lallianzuala Chhangte","8/6/1997 (25 years old)","AM (RL)","Mumbai","Indian National Division","IND","No","6/28/2022","5/31/2025","$5K - $50K","Left","Very Strong","Strong","5'6""","134 lbs","136","31",85,90,5,7,9,9,7,7,6,6,6,3,7,13,3,7,6,7,11,4,8,8,16,19,5,11,3,11,7,14,16,11,6,5,11,17,10,7,12,10,13,13,12,15,6,11,2,2,16,14,16,3,2,1,3,1,2,1,1,3,1,3
"5487",40035740,"Anwar Ali","8/28/2000 (22 years old)","D (C)","DFC","Indian National Football League","IND","No","5/1/2021","5/31/2026","$10K - $100K","Left","Very Strong","Reasonable","5'10""","163 lbs","71","6",73,90,11,3,7,9,5,15,12,3,4,6,13,4,7,12,5,6,10,8,13,11,10,7,13,9,7,9,9,14,11,14,12,13,12,13,12,11,15,17,12,12,11,14,6,6,10,3,8,12,9,1,2,2,2,2,1,1,1,1,1,1
"5488",36139091,"Gurjinder Singh","4/12/1997 (26 years old)","D/WB/M/AM (L)","Proodeftiki","Greek National C Division Group 4","IND","Yes","7/21/2022","6/30/2024","$1K - $8K","Left Only","Very Strong","Weak","5'9""","143 lbs","98","11",70,90,12,10,9,7,8,11,7,6,8,7,7,1,10,12,7,8,7,7,10,9,11,10,7,11,9,12,9,10,10,11,8,11,12,12,11,7,11,12,10,9,10,14,11,16,5,7,9,9,7,1,3,3,2,1,4,2,3,2,2,2
"5489",2000174020,"Anandha Krishna","11/22/2002 (20 years old)","GK","Gulf United","UAE First Division","IND","No","7/1/2022","6/30/2024","$0 - $14K","Right","Reasonable","Very Strong","6'4""","182 lbs","1","-",55,90,4,2,2,3,4,6,1,3,3,2,7,1,2,1,9,7,13,3,10,12,8,2,11,2,5,5,4,4,9,6,5,14,9,9,3,6,9,20,12,10,11,10,9,5,10,7,8,12,12,3,5,12,15,2,8,9,5,7,7,12
"5490",82089463,"Yannick Bekman","5/13/1997 (26 years old)","M/AM (C), ST (C)","Flamingo","Bonaire Kampionato","BOE","Yes","7/1/2018","-","$0","Right","Reasonable","Very Strong","6'0""","160 lbs","-","-",60,72,5,5,8,7,7,5,5,5,1,5,9,1,1,12,12,7,7,8,6,12,10,12,7,5,7,6,7,7,13,13,6,8,10,13,9,4,10,15,13,11,12,10,13,18,13,4,9,10,19,2,2,1,3,1,3,3,1,2,1,2
"5491",40037028,"Akash Mishra","11/27/2001 (21 years old)","D/WB (L)","Hyderabad","Indian National Division","IND","No","7/5/2020","6/30/2025","$90K - $900K","Left","Very Strong","Reasonable","5'10""","149 lbs","83","2",74,89,5,6,3,3,4,1,6,5,10,7,7,7,8,6,9,7,8,6,5,8,6,6,8,5,7,12,6,16,14,12,7,7,11,14,13,9,7,18,13,12,14,11,8,9,12,5,9,10,7,3,2,1,4,3,2,2,1,2,2,1
"5492",40030289,"Apuia","10/17/2000 (22 years old)","DM, M (C)","Mumbai","Indian National Division","IND","No","8/13/2021","5/31/2026","$45K - $130K","Right","Reasonable","Very Strong","5'10""","149 lbs","82","5",59,88,5,7,4,2,4,8,6,6,3,10,12,4,6,7,7,10,8,8,7,9,13,7,11,7,7,13,6,16,12,11,13,6,12,12,13,6,15,18,10,9,13,14,5,9,9,5,13,10,8,1,3,4,3,2,1,1,3,3,3,1
"5493",40029402,"Anirudh Thapa","1/15/1998 (25 years old)","DM, M (C)","Chennai","Indian National Division","IND","No","6/15/2020","6/30/2024","$90K - $900K","Right","Reasonable","Very Strong","5'7""","132 lbs","117","9",80,83,9,6,9,8,7,8,5,8,7,7,12,11,7,10,9,10,13,9,10,7,14,14,9,8,7,11,12,15,13,12,7,4,13,13,13,6,12,15,15,14,9,17,6,11,5,5,9,12,14,3,2,3,2,3,2,3,1,2,3,2
"5494",40035742,"Vikram Pratap Singh","1/16/2002 (21 years old)","AM (RL), ST (C)","Mumbai","Indian National Division","IND","No","6/7/2023","5/31/2026","$0 - $90K","Right","Weak","Very Strong","5'8""","138 lbs","69","10",50,80,7,4,6,5,4,6,3,7,3,4,7,11,4,6,6,5,5,8,7,4,9,15,14,7,4,10,6,13,11,10,8,4,11,12,10,5,11,17,11,10,9,9,7,10,6,5,8,12,15,3,2,3,3,2,4,1,1,2,2,1
"5495",40036904,"Sahal Abdul Samad","4/1/1997 (26 years old)","M (RC), AM (RLC)","Kerala","Indian National Division","IND","No","6/15/2020","6/30/2024","$28K - $275K","Right","Fairly Strong","Very Strong","5'10""","154 lbs","102","17",79,80,6,6,5,4,9,8,6,8,5,7,11,11,6,12,7,9,6,9,8,9,9,16,7,7,7,13,9,12,10,11,7,8,11,11,12,8,8,10,13,13,10,13,6,7,5,5,6,12,13,1,1,1,1,3,1,1,1,2,3,4
"5496",40028904,"Phurba Lachenpa","2/4/1998 (25 years old)","GK","Mumbai","Indian National Division","IND","No","10/23/2020","6/30/2024","$0 - $14K","Right","Reasonable","Very Strong","6'0""","171 lbs","63","-",61,80,2,2,1,1,5,4,1,2,2,2,10,2,2,7,9,13,8,8,9,8,17,3,10,1,5,9,8,8,10,9,7,10,8,10,7,10,8,11,11,11,11,14,12,5,10,4,10,11,11,8,11,10,8,8,11,6,7,10,13,15
"5497",40035798,"Jeakson Singh","6/21/2001 (21 years old)","DM, M (C)","Kerala","Indian National Division","IND","No","4/25/2022","5/31/2025","$0 - $140K","Right","Fairly Strong","Very Strong","6'2""","178 lbs","77","2",63,80,6,5,3,2,4,8,8,10,6,9,8,6,8,5,10,7,11,10,10,8,10,4,8,6,6,11,8,16,12,12,8,8,13,12,11,9,8,14,13,11,10,12,6,9,11,1,11,10,7,2,2,2,2,3,1,3,3,3,1,3
"5498",40029832,"Liston Colaco","11/12/1998 (24 years old)","M/AM (RL), ST (C)","Kolkata","Indian National Division","IND","No","10/1/2022","5/31/2027","$0 - $30K","Right","Reasonable","Very Strong","5'10""","141 lbs","85","16",68,79,3,3,9,11,6,6,4,7,5,2,5,11,4,6,5,7,7,4,7,4,12,12,8,6,3,11,5,14,13,11,10,3,12,14,10,5,5,11,10,10,11,11,7,10,7,3,13,14,17,1,3,2,2,3,2,3,3,3,2,3
"5499",20501521,"Sahil Sandhu","1/5/1991 (32 years old)","M/AM (R)","SFC Pegasus","Lower Leagues","IND","No","6/14/2021","-","$0","Right","Weak","Very Strong","5'10""","165 lbs","71","14",60,79,6,8,11,7,7,5,8,7,6,8,7,7,8,8,9,6,9,7,7,7,10,7,9,8,7,7,8,12,11,10,9,9,10,11,9,8,11,4,8,7,9,18,7,10,9,17,9,12,8,2,2,1,3,4,2,1,2,2,1,2
"5500",65025628,"Brandon Fernandes","9/20/1994 (28 years old)","AM (RLC)","Goa","Indian National Division","IND","Yes","4/10/2021","5/31/2024","$0 - $75K","Right","Fairly Strong","Very Strong","5'6""","138 lbs","119","15",73,78,11,6,7,5,8,12,5,9,6,6,12,12,5,11,8,9,8,8,10,7,8,16,5,8,5,12,12,11,12,11,8,5,12,12,12,7,9,14,11,10,9,12,15,11,8,3,11,17,18,2,2,1,1,2,3,1,1,2,1,1
"5501",98028755,"Mohamed Salah","6/15/1992 (30 years old)","AM (RL), ST (C)","Liverpool","English Premier Division","EGY","No","7/1/2022","6/30/2025","Not for Sale","Left","Very Strong","Weak","5'9""","158 lbs","398","193",180,187,11,14,16,16,17,12,10,13,6,7,15,17,7,17,11,15,10,15,15,15,18,15,11,17,9,16,17,15,18,16,17,8,17,17,15,15,7,17,16,18,16,13,4,16,6,8,14,19,16,1,4,2,1,1,2,3,3,2,2,2
"5502",2000119329,"Marwan Ateya","8/12/1998 (24 years old)","DM, M (C)","Al-Ahly","Egyptian Premier League","EGY","No","1/10/2023","7/31/2027","$1M - $2.1M","Right","Reasonable","Very Strong","5'9""","160 lbs","92","1",128,140,10,12,13,9,14,7,8,12,6,9,16,12,13,15,10,13,13,14,12,12,14,12,8,13,14,14,15,13,12,14,13,8,14,12,13,8,12,13,6,11,12,10,11,14,9,6,14,13,14,2,1,2,2,2,4,3,3,2,3,2
"5503",55013851,"Babá","1/5/1988 (35 years old)","ST (C)","Al-Nasr (OMA)","Omani Professional League","SEN","No","10/11/2021","6/30/2024","$500 - $3.5K","Right","Reasonable","Very Strong","5'10""","158 lbs","289","84",113,138,6,8,11,13,11,6,13,11,6,6,8,12,7,11,8,13,12,11,9,11,12,11,8,14,9,11,10,13,14,13,13,14,9,13,11,12,9,15,14,14,13,13,13,10,6,5,11,13,12,3,1,2,3,3,2,3,1,3,2,2
"5504",824041,"Andrés Iniesta","5/11/1984 (39 years old)","M/AM (C)","Kobe","J1 League","ESP","Yes","6/14/2021","12/31/2024","Not for Sale","Right","Fairly Strong","Very Strong","5'7""","149 lbs","627","63",130,185,13,12,14,10,20,13,4,8,6,4,18,12,6,20,8,17,10,17,12,16,14,19,13,13,7,16,20,8,9,10,11,5,12,7,8,6,16,16,16,20,17,18,13,18,5,3,14,16,7,4,2,3,2,1,1,1,3,3,4,2
"5505",67030171,"David De Gea","11/7/1990 (32 years old)","GK","Man UFC","English Premier Division","ESP","Yes","6/14/2021","6/30/2023","$140K - $1.4M","Right","Reasonable","Very Strong","6'4""","167 lbs","512","-",144,178,5,2,3,3,13,9,3,2,2,3,7,2,1,8,5,14,11,8,12,13,16,5,14,10,15,9,5,12,13,17,12,15,17,13,13,13,11,19,18,17,13,14,3,15,5,5,14,18,17,8,3,19,10,14,14,16,6,10,8,16
"5506",67296654,"Alejandro Balde","10/18/2003 (19 years old)","D/WB/M/AM (L)","Barcelona","Spanish First Division","ESP","Yes","7/22/2021","6/30/2024","$86M - $130M","Left","Very Strong","Weak","5'9""","152 lbs","53","1",154,178,8,13,13,8,14,9,8,9,10,12,12,8,12,14,12,13,12,13,12,12,14,13,7,15,11,13,14,14,17,17,12,9,15,17,14,11,16,15,13,14,15,14,8,13,8,5,14,13,12,3,1,3,2,1,1,2,2,3,3,2
"5507",67217524,"Rodri","6/22/1996 (26 years old)","D (C), DM, M (C)","Man City","English Premier Division","ESP","Yes","7/12/2022","6/30/2027","Not for Sale","Right","Fairly Strong","Very Strong","6'3""","165 lbs","275","19",177,177,7,8,13,9,15,8,13,14,8,13,15,8,17,14,13,17,15,18,17,18,13,9,11,14,17,16,15,16,14,13,12,17,16,13,17,16,10,16,13,18,15,13,4,18,10,4,18,16,15,2,2,3,3,1,1,1,4,1,3,1
"5508",67293495,"Pedri","11/25/2002 (20 years old)","M (C), AM (RLC)","Barcelona","Spanish First Division","ESP","Yes","10/15/2021","6/30/2026","$111M - $140M","Right","Fairly Strong","Very Strong","5'9""","143 lbs","111","16",162,176,9,15,17,11,18,9,6,10,5,6,17,11,9,18,10,17,11,16,15,16,14,17,9,13,8,13,18,15,14,16,13,7,16,13,16,9,15,17,15,15,13,14,12,13,5,3,15,14,13,4,3,4,3,3,3,4,3,1,2,2
"5509",67295650,"Yeremy Pino","10/20/2002 (20 years old)","AM (RLC), ST (C)","Villarreal","Spanish First Division","ESP","Yes","11/15/2021","6/30/2027","$68M - $103M","Right","Fairly Strong","Very Strong","5'8""","143 lbs","111","16",142,175,12,13,16,12,14,9,9,11,9,8,14,12,9,16,12,13,10,13,13,13,14,16,6,9,8,10,14,10,14,15,14,7,13,14,13,9,14,15,11,17,16,14,7,14,6,6,13,14,17,3,1,1,3,1,4,1,1,1,2,1
"5510",6701096,"Pepe Reina","8/31/1982 (40 years old)","GK","Villarreal","Spanish First Division","ESP","Yes","7/8/2022","6/30/2024","$240K - $2.4M","Right","Fairly Strong","Very Strong","6'2""","202 lbs","692","-",135,175,6,1,2,1,10,8,6,3,2,1,13,2,1,12,10,18,13,16,10,12,20,7,17,1,12,14,14,14,8,8,12,14,20,9,13,13,13,12,19,20,14,14,6,13,9,9,12,20,20,18,18,13,13,13,18,13,13,18,16,11
"5511",1502117,"Raúl García","7/11/1986 (36 years old)","M/AM (C), ST (C)","A. Bilbao","Spanish First Division","ESP","Yes","6/14/2021","6/30/2024","$2.3M - $4.6M","Right","Fairly Strong","Very Strong","6'0""","185 lbs","609","112",135,175,10,10,11,14,14,10,16,17,10,11,14,15,12,13,15,12,15,16,13,14,14,13,13,15,14,16,13,13,10,11,12,12,12,10,10,14,14,8,7,15,9,15,11,13,15,9,12,14,15,3,2,3,3,3,3,3,2,2,3,1
"5512",67276122,"Ansu Fati","10/31/2002 (20 years old)","AM (RL), ST (C)","Barcelona","Spanish First Division","ESP","Yes","10/20/2021","6/30/2027","$24M - $37M","Right","Fairly Strong","Very Strong","5'10""","145 lbs","77","22",148,174,7,13,16,15,15,7,11,14,6,4,12,12,5,16,8,14,11,13,12,12,16,18,9,16,5,10,14,10,16,16,13,9,15,15,11,10,15,16,15,14,11,14,14,14,5,6,13,15,15,2,3,2,1,2,4,1,3,3,2,1
"5513",13185644,"Akram Tawfik","11/8/1997 (25 years old)","D/WB (R), DM, M (C)","Al-Ahly","Egyptian Premier League","EGY","No","1/27/2021","7/31/2025","$190K - $7M","Right","Reasonable","Very Strong","5'10""","160 lbs","105","4",119,140,2,11,10,7,10,4,11,10,9,11,11,10,13,11,15,11,17,11,11,12,14,8,5,7,12,17,10,17,12,9,11,12,16,14,16,13,17,4,7,11,8,14,11,12,12,12,14,12,10,2,3,3,3,3,1,3,1,2,4,2
"5514",7458272,"Sergio Ramos","3/30/1986 (37 years old)","D (C)","Paris SG","Ligue 1 Uber Eats","ESP","Yes","7/8/2021","6/30/2023","$275K - $2.8M","Right","Fairly Strong","Very Strong","6'0""","180 lbs","579","80",156,174,9,11,13,12,14,14,18,13,12,16,15,17,16,14,18,15,15,13,10,11,20,14,19,12,13,13,13,14,12,13,15,16,15,12,15,16,14,8,8,18,18,17,13,20,17,14,13,18,12,3,2,2,3,3,1,1,1,2,3,3
"5515",2000256231,"Lamine Yamal","7/13/2007 (15 years old)","AM (RL), ST (C)","Barcelona","Spanish First Division","ESP","Yes","6/13/2022","6/30/2028","$23M - $29M","Left","Very Strong","Reasonable","5'11""","132 lbs","2","-",125,174,10,11,15,11,15,10,9,12,6,3,13,10,4,16,9,11,11,12,11,14,16,19,6,15,4,11,14,9,14,16,12,9,14,13,8,8,12,10,12,14,18,12,6,18,10,14,16,14,12,3,4,3,3,4,3,3,1,3,1,2
"5516",67022040,"Thiago","4/11/1991 (32 years old)","DM, M (C)","Liverpool","English Premier Division","ESP","Yes","9/17/2020","6/30/2024","$36M - $55M","Right","Reasonable","Very Strong","5'9""","154 lbs","335","28",163,173,11,13,16,8,18,12,10,11,5,12,17,12,14,18,14,16,12,17,14,15,15,17,13,15,13,15,18,15,13,17,15,10,12,11,14,9,8,12,10,16,14,11,13,14,8,12,14,17,18,2,2,3,2,1,1,1,2,3,2,2
"5517",1510566,"Sergio Busquets","7/16/1988 (34 years old)","DM, M (C)","Barcelona","Spanish First Division","ESP","Yes","6/14/2021","6/30/2024","$6M - $9M","Right","Fairly Strong","Very Strong","6'2""","167 lbs","506","13",152,171,8,11,12,8,16,8,11,9,8,15,17,10,15,16,10,19,12,18,18,18,16,9,13,10,17,19,16,15,8,9,12,14,15,9,12,11,13,12,7,15,15,18,5,14,13,6,15,14,12,2,1,1,3,4,1,3,3,3,1,2
"5518",67276230,"Nico Williams","7/12/2002 (20 years old)","M/AM (RL)","A. Bilbao","Spanish First Division","ESP","Yes","1/20/2022","6/30/2025","$43M - $64M","Right","Strong","Very Strong","5'11""","167 lbs","99","15",148,171,7,14,14,12,14,8,12,10,8,9,13,14,9,15,14,13,13,13,12,13,17,12,11,15,13,13,14,14,15,15,11,10,14,14,13,14,12,11,12,13,12,15,9,9,9,6,13,13,11,2,1,1,1,2,2,3,2,3,3,1
"5519",85085378,"Aymeric Laporte","5/27/1994 (29 years old)","D (C)","Man City","English Premier Division","ESP","Yes","6/14/2021","6/30/2025","$29M","Left","Very Strong","Reasonable","6'3""","187 lbs","322","17",155,170,6,9,12,8,13,10,16,11,8,15,15,11,14,14,13,14,15,16,14,16,14,10,12,12,16,15,14,13,12,11,13,16,15,13,14,15,8,14,13,16,12,14,7,15,8,7,14,16,14,1,3,3,1,2,1,3,4,2,1,4
"5520",2000049413,"Gavi","8/5/2004 (18 years old)","M (C), AM (LC)","Barcelona","Spanish First Division","ESP","Yes","9/14/2022","6/30/2026","$123M - $148M","Right","Fairly Strong","Very Strong","5'8""","149 lbs","72","4",154,169,12,14,14,11,15,11,6,11,8,12,15,9,13,15,17,15,18,14,14,14,18,15,13,16,12,16,15,17,14,17,15,6,16,13,14,11,16,8,9,16,14,13,7,14,13,6,14,17,15,3,2,2,3,3,3,3,1,2,3,1
"5521",55002038,"Diego Costa","10/7/1988 (34 years old)","ST (C)","Wolves","English Premier Division","ESP","Yes","9/12/2022","6/30/2024","$650K - $11M","Right","Strong","Very Strong","6'1""","191 lbs","417","147",134,168,11,12,11,14,14,11,15,11,7,5,12,15,9,13,19,14,19,14,12,15,19,15,12,16,6,16,13,17,10,11,12,14,9,10,10,15,13,3,5,14,15,12,14,16,18,13,11,17,16,1,3,3,2,1,2,2,1,1,3,3
"5522",67200923,"Unai Simón","6/11/1997 (26 years old)","GK","A. Bilbao","Spanish First Division","ESP","Yes","8/20/2020","6/30/2025","$93M - $117M","Right","Reasonable","Very Strong","6'3""","196 lbs","237","-",154,168,5,1,3,3,13,8,13,3,2,1,12,3,2,13,12,13,12,15,13,14,15,2,12,2,15,13,14,12,13,14,7,15,12,13,12,12,12,12,9,12,11,9,7,11,9,1,15,8,16,15,13,16,9,15,13,14,13,15,15,16
"5523",67217522,"Pau Torres","1/16/1997 (26 years old)","D (C)","Villarreal","Spanish First Division","ESP","Yes","6/14/2021","6/30/2028","$27M - $40M","Left","Very Strong","Reasonable","6'3""","176 lbs","233","13",155,167,7,8,11,6,14,5,16,7,7,16,14,8,16,14,13,15,14,12,15,13,13,5,10,6,16,14,11,15,15,11,6,17,14,15,16,16,16,19,14,14,10,17,7,12,6,4,13,16,7,3,2,1,1,1,3,3,3,2,1,2
"5524",13156726,"Trezeguet","10/1/1994 (28 years old)","M/AM (RL)","Trabzonspor","Turkish Super League","EGY","No","7/4/2022","6/30/2026","$7M - $10.5M","Right","Weak","Very Strong","5'10""","156 lbs","253","60",130,140,13,14,16,14,14,11,8,16,4,6,14,13,7,15,15,12,12,11,11,11,13,16,12,17,8,11,11,14,14,12,14,11,15,12,14,11,12,10,10,13,8,15,8,13,10,16,10,17,10,1,1,3,2,3,3,2,3,3,3,1
"5525",67220143,"Mikel Oyarzábal","4/21/1997 (26 years old)","AM (RLC), ST (C)","Real San Sebastián","Spanish First Division","ESP","Yes","2/11/2023","6/30/2028","$58M - $73M","Left","Very Strong","Reasonable","5'11""","169 lbs","260","70",153,167,14,12,15,15,14,14,12,12,12,13,15,19,12,16,13,14,13,14,14,14,16,14,17,15,13,14,16,16,12,14,14,13,14,12,13,14,17,13,16,18,13,20,5,14,7,8,12,14,12,2,1,1,3,2,3,2,2,1,3,3
"5526",67117360,"Álvaro Morata","10/23/1992 (30 years old)","ST (C)","A. Madrid","Spanish First Division","ESP","Yes","7/1/2020","6/30/2024","$25M - $38M","Right","Fairly Strong","Very Strong","6'2""","185 lbs","419","155",153,166,5,11,13,15,14,10,16,14,5,5,13,14,8,15,14,16,13,12,13,14,14,14,12,16,5,17,13,17,15,14,14,14,13,15,14,13,11,9,10,14,11,16,9,14,14,7,14,13,17,2,2,1,3,2,3,1,3,4,2,3
"5527",67052513,"Jordi Alba","3/21/1989 (34 years old)","D/WB (L)","Barcelona","Spanish First Division","ESP","Yes","6/14/2021","6/30/2024","$2.7M - $5.4M","Left","Very Strong","Weak","5'7""","149 lbs","453","34",149,166,12,14,13,13,16,10,5,10,12,12,13,10,14,15,15,15,15,12,12,14,16,13,13,17,12,15,15,16,17,14,15,6,13,15,14,9,12,8,7,14,13,14,11,14,14,13,13,18,15,2,4,2,1,1,4,1,3,2,3,3
"5528",2000223081,"Jaime Vázquez","2/1/2006 (17 years old)","D (C)","R. Madrid C","Spanish Federation Third Group 7","ESP","Yes","7/1/2022","6/30/2026","$40K - $120K","Left","Very Strong","Reasonable","6'1""","174 lbs","-","-",71,165,8,3,1,2,7,12,13,5,3,13,12,5,13,6,8,13,9,3,7,13,7,6,14,4,6,6,11,7,7,12,7,12,9,10,4,11,11,12,13,14,10,12,12,6,5,3,9,11,9,3,1,2,1,3,1,1,1,3,3,2
"5529",67086280,"Rodrigo","3/6/1991 (32 years old)","AM (RLC), ST (C)","Leeds","Sky Bet Championship","ESP","Yes","8/29/2020","6/30/2025","$10.5M - $16M","Left","Very Strong","Weak","6'0""","169 lbs","367","98",140,165,11,12,13,16,15,12,9,12,3,5,13,12,7,16,13,13,14,14,8,11,13,14,11,15,4,11,13,11,16,16,14,12,12,15,14,11,13,8,13,15,8,11,10,13,10,6,10,14,12,2,2,2,2,1,3,3,1,2,1,3
"5530",2000034344,"Javi Guerra","5/13/2003 (20 years old)","DM, M/AM (C)","Valencia","Spanish First Division","ESP","Yes","5/16/2023","6/30/2027","$65M - $98M","Right","Fairly Strong","Very Strong","6'2""","167 lbs","59","2",139,165,10,12,14,12,15,11,9,14,9,9,14,13,9,15,11,12,13,14,13,14,15,14,12,13,11,15,14,15,13,13,12,13,14,13,14,11,12,14,14,16,14,15,14,5,9,5,13,14,13,1,2,3,2,3,2,2,1,2,1,4
"5531",67104772,"Íñigo Martínez","5/17/1991 (32 years old)","D (C)","A. Bilbao","Spanish First Division","ESP","Yes","6/14/2021","6/30/2026","Not for Sale","Left","Very Strong","Reasonable","6'0""","169 lbs","410","25",145,165,7,7,9,8,12,12,14,16,7,15,15,7,16,15,17,15,16,14,11,11,16,13,15,7,17,15,13,15,14,12,13,12,12,13,13,15,5,11,14,14,13,10,14,13,14,10,13,14,14,2,2,1,2,2,1,1,1,1,2,3
"5532",67037570,"Iker Muniain","12/19/1992 (30 years old)","M (LC), AM (RLC)","A. Bilbao","Spanish First Division","ESP","Yes","6/14/2021","6/30/2024","$50M - $75M","Right","Fairly Strong","Very Strong","5'7""","145 lbs","433","57",144,165,15,11,14,11,15,14,7,12,7,9,15,13,8,15,12,14,14,9,11,10,12,18,15,14,11,11,14,14,15,15,16,6,13,15,13,10,14,8,8,11,11,14,6,14,7,14,9,13,13,2,4,2,1,2,4,1,1,2,4,1
"5533",2000082598,"Stefan Bajčetić","10/22/2004 (18 years old)","D (C), DM, M (C)","Liverpool","English Premier Division","ESP","Yes","1/26/2023","6/30/2027","$6M - $9M","Right Only","Weak","Very Strong","6'1""","165 lbs","11","1",120,165,3,8,12,5,14,7,12,7,6,13,13,8,14,14,13,13,13,14,13,13,15,9,5,10,13,15,10,14,14,14,13,11,11,13,12,9,13,12,10,12,12,12,7,12,8,4,12,15,16,2,1,1,4,4,3,3,2,2,3,1
"5534",67214613,"Pablo Fornals","2/22/1996 (27 years old)","M (C), AM (LC)","West Ham","English Premier Division","ESP","Yes","6/15/2020","6/30/2024","$28M","Right","Fairly Strong","Very Strong","5'10""","147 lbs","305","40",138,165,9,13,13,12,14,12,8,12,7,12,14,9,13,15,15,14,8,14,12,12,14,15,11,15,12,15,14,15,12,15,12,9,14,12,15,11,10,16,16,19,17,16,7,10,7,4,10,16,20,2,2,2,1,3,4,3,1,2,1,1
"5535",12035892,"Ahmed Hegazi","1/25/1991 (32 years old)","D (C)","Al-Ittihad","Saudi Professional League","EGY","No","12/20/2022","6/30/2026","Not for Sale","Right Only","Weak","Very Strong","6'4""","182 lbs","245","11",135,140,5,9,8,9,11,6,17,8,12,15,13,7,15,12,15,14,14,12,13,13,15,9,17,8,15,14,10,13,11,8,15,15,14,11,13,16,5,10,8,13,11,13,7,14,10,8,13,12,12,3,3,1,1,3,1,1,1,2,1,2
"5536",824057,"Rubén Castro","6/27/1981 (41 years old)","ST (C)","Málaga","Spanish Federation First Division B","ESP","Yes","7/6/2022","6/30/2023","$3K - $10K","Right","Reasonable","Very Strong","5'7""","152 lbs","761","317",114,165,5,12,10,15,13,15,12,14,6,7,9,15,2,13,10,13,9,17,15,16,16,15,7,15,7,8,14,13,10,10,12,6,12,10,10,10,16,12,14,13,13,12,12,12,6,12,14,12,10,2,3,1,3,2,3,1,2,1,3,1
"5537",1510305,"Pedro","7/28/1987 (35 years old)","AM (RLC)","Lazio","Italian Serie A","ESP","Yes","8/19/2021","6/30/2024","$1.8M - $3.8M","Either","Very Strong","Very Strong","5'6""","143 lbs","516","126",142,165,13,12,16,15,17,10,11,15,4,4,13,13,10,16,15,15,13,14,12,15,20,18,8,17,5,14,14,15,14,13,15,6,20,13,7,6,17,17,12,20,15,14,10,19,7,5,14,20,17,1,1,2,2,1,1,2,1,1,2,1
"5538",1512305,"Javi Martínez","9/2/1988 (34 years old)","D (C), DM, M (C)","Qatar SC","Qatar Stars League","ESP","Yes","6/1/2023","5/31/2024","$800K - $1.8M","Right","Reasonable","Very Strong","6'2""","196 lbs","436","37",135,165,5,10,8,10,12,7,15,10,8,14,13,11,15,12,11,16,15,14,15,13,15,8,14,9,15,17,12,12,8,8,15,15,12,10,12,16,12,12,13,17,16,15,12,16,9,4,14,16,15,3,1,1,1,3,4,2,3,2,3,4
"5539",67033300,"César Azpilicueta","8/28/1989 (33 years old)","D (RLC), WB (RL)","Chelsea","English Premier Division","ESP","Yes","6/14/2021","6/30/2025","Not for Sale","Right","Strong","Very Strong","5'10""","171 lbs","522","13",145,165,8,15,12,6,11,7,10,9,11,14,13,8,16,15,15,15,16,14,16,15,18,8,18,12,14,18,10,18,10,12,12,10,15,11,12,12,16,12,15,20,16,18,5,15,12,6,18,14,12,1,3,1,1,4,2,4,3,3,1,1
"5540",67215284,"Marc Cucurella","7/22/1998 (24 years old)","D (LC), WB/M (L)","Chelsea","English Premier Division","ESP","Yes","8/5/2022","6/30/2028","$61M - $92M","Left","Very Strong","Weak","5'8""","156 lbs","213","7",145,164,10,13,11,9,14,7,6,8,12,12,12,7,12,14,15,16,14,15,14,13,18,10,13,15,12,14,14,14,16,15,14,8,13,13,15,12,15,15,13,15,14,13,8,14,9,5,14,14,11,4,1,4,1,1,2,1,3,2,3,1
"5541",67287665,"Álex Baena","7/20/2001 (21 years old)","M (C), AM (RLC)","Villarreal","Spanish First Division","ESP","Yes","1/20/2023","6/30/2028","$64M - $77M","Right","Strong","Very Strong","5'9""","152 lbs","105","11",143,164,11,12,14,14,15,14,10,13,12,8,16,6,9,16,15,12,11,11,12,14,7,14,12,11,10,11,14,11,13,14,13,8,15,13,13,11,16,15,9,10,11,10,9,6,15,6,14,12,7,3,3,2,4,3,3,2,2,3,2,2
"5542",67268221,"Pedro Porro","9/13/1999 (23 years old)","D/WB/M (R)","Tottenham","English Premier Division","ESP","Yes","5/16/2022","6/30/2028","$39M - $47M","Right","Weak","Very Strong","5'9""","156 lbs","132","15",150,164,13,17,15,11,15,13,8,14,11,8,15,12,14,15,15,12,17,11,12,12,16,17,8,16,9,10,15,13,16,16,13,8,17,15,15,12,15,11,7,13,14,9,6,14,16,13,14,15,16,2,2,1,1,2,2,2,3,1,4,1
"5543",67202350,"Dani Ceballos","8/7/1996 (26 years old)","M (C)","R. Madrid","Spanish First Division","ESP","Yes","6/14/2021","6/30/2026","$12M - $18.5M","Right","Reasonable","Very Strong","5'10""","156 lbs","227","12",152,163,12,13,16,13,16,12,7,13,12,8,17,10,12,16,13,14,15,13,14,14,11,14,10,14,13,15,16,13,14,15,15,8,11,14,13,10,15,8,10,13,11,10,11,11,11,13,10,12,12,3,1,2,1,3,2,3,2,3,3,2
"5544",67196198,"Marcos Llorente","1/30/1995 (28 years old)","WB (R), DM, M (RC), AM (C)","A. Madrid","Spanish First Division","ESP","Yes","8/18/2021","6/30/2027","$62M - $93M","Right","Reasonable","Very Strong","6'0""","160 lbs","229","19",152,163,9,11,12,12,12,8,13,11,7,11,14,11,15,14,13,15,13,15,14,14,16,9,12,13,12,16,13,16,13,11,11,10,18,14,16,15,19,12,13,18,16,16,7,13,14,5,14,15,12,1,2,2,1,2,3,3,2,2,1,2
"5545",67197125,"Marco Asensio","1/21/1996 (27 years old)","AM (RLC)","R. Madrid","Spanish First Division","ESP","Yes","6/14/2021","6/30/2027","$114M - $137M","Left","Very Strong","Reasonable","6'0""","167 lbs","295","51",159,163,15,15,16,15,17,15,8,18,7,5,16,14,8,17,9,15,12,14,12,14,15,17,8,13,11,14,16,14,15,15,13,10,16,15,14,13,14,12,10,12,14,10,8,10,10,7,11,8,12,3,3,3,3,3,3,2,1,1,3,2
"5546",2000014584,"Ahmed Abdelkader","5/23/1999 (24 years old)","M/AM (L)","Al-Ahly","Egyptian Premier League","EGY","No","9/24/2020","7/31/2023","$50K - $500K","Right","Weak","Very Strong","5'11""","149 lbs","56","12",115,140,11,11,15,11,14,6,6,8,4,6,13,9,7,14,12,13,13,13,11,11,15,16,6,13,5,12,13,11,13,14,12,7,14,14,12,8,13,15,11,14,11,12,6,13,7,5,14,17,3,2,1,1,3,2,2,3,2,4,3,3
"5547",2000125958,"Pablo Barrios","6/15/2003 (19 years old)","DM, M (C)","A. Madrid","Spanish First Division","ESP","Yes","1/23/2023","6/30/2028","$79M - $120M","Right","Weak","Very Strong","5'11""","165 lbs","34","1",131,162,9,11,12,10,15,11,6,14,8,12,15,6,12,15,13,13,12,13,13,14,14,14,11,12,13,14,14,14,13,13,12,8,11,12,13,10,12,16,12,15,14,10,6,11,10,6,13,14,17,2,3,3,2,3,2,2,2,1,3,3
"5548",67139735,"Dani Carvajal","1/11/1992 (31 years old)","D/WB (R)","R. Madrid","Spanish First Division","ESP","Yes","7/29/2021","6/30/2025","$15.5M - $19.5M","Right","Reasonable","Very Strong","5'8""","163 lbs","345","9",151,162,11,14,13,8,13,8,10,10,13,13,13,9,15,12,17,14,18,13,13,13,16,12,14,17,14,16,12,18,14,14,17,8,14,14,16,13,13,9,8,19,14,19,18,12,12,5,14,15,15,1,2,1,2,3,3,1,1,1,1,1
"5549",28066082,"Héctor Bellerín","3/19/1995 (28 years old)","D/WB (R)","Sporting CP","Portuguese Premier League","ESP","Yes","9/1/2022","6/30/2026","$9.8M - $15M","Right","Reasonable","Very Strong","5'10""","163 lbs","227","9",141,162,7,13,13,9,12,6,9,10,10,12,13,8,13,13,12,14,14,11,11,13,13,12,12,14,12,15,11,15,16,14,15,9,14,16,15,10,14,15,15,14,14,14,8,14,8,5,12,14,15,2,1,3,2,3,2,2,3,3,2,3
"5550",67047092,"Koke","1/8/1992 (31 years old)","DM, M (RLC)","A. Madrid","Spanish First Division","ESP","Yes","6/14/2021","6/30/2024","$87M - $132M","Right","Fairly Strong","Very Strong","5'10""","160 lbs","484","44",157,162,15,15,13,12,14,14,9,14,6,12,16,10,14,14,14,15,15,15,15,15,16,10,16,13,15,17,15,16,13,12,15,9,14,13,15,12,18,12,11,16,12,17,6,13,10,6,15,15,13,2,2,3,1,3,2,3,1,1,3,1
"5551",24048100,"Dani Olmo","5/7/1998 (25 years old)","M (C), AM (RLC)","RB Leipzig","Bundesliga","ESP","Yes","6/1/2023","6/30/2027","$42M - $64M","Right","Reasonable","Very Strong","5'10""","158 lbs","191","36",155,162,14,12,17,12,17,14,8,12,6,8,16,14,10,17,12,16,12,16,13,14,14,17,10,15,10,16,17,14,13,16,15,9,11,12,15,10,14,10,13,17,16,12,10,16,7,2,15,16,13,2,3,3,2,2,1,1,1,3,2,3
"5552",2000211220,"Iker Villar","1/10/2006 (17 years old)","ST (C)","Sevilla","Spanish First Division","ESP","Yes","7/1/2021","6/30/2028","$500K - $4.9M","Right","Reasonable","Very Strong","5'10""","147 lbs","1","-",80,162,6,7,13,13,13,2,13,6,3,1,7,6,3,12,5,11,4,6,2,8,14,12,10,12,7,6,7,7,13,12,7,6,15,13,6,7,10,14,8,9,10,12,5,9,7,2,9,13,11,3,3,3,2,2,3,3,1,2,4,1
"5553",2000056415,"Ilias Akhomach","4/16/2004 (19 years old)","M/AM (RC)","Barcelona","Spanish First Division","ESP","Yes","6/13/2022","6/30/2026","$450K - $4.4M","Left","Very Strong","Reasonable","5'9""","145 lbs","44","4",125,162,12,12,15,11,14,12,6,13,6,5,13,11,6,16,11,9,12,12,9,14,14,17,8,13,5,11,13,7,14,16,12,7,14,13,11,10,15,12,11,14,15,10,5,15,10,10,15,15,12,3,3,2,3,1,2,3,4,4,1,3
"5554",67260204,"Oihan Sancet","4/25/2000 (23 years old)","M/AM (C)","A. Bilbao","Spanish First Division","ESP","Yes","4/1/2023","6/30/2032","$23M - $34M","Right","Fairly Strong","Very Strong","6'2""","160 lbs","120","26",145,162,7,8,13,12,15,8,11,9,6,9,15,12,9,15,5,14,10,13,14,15,17,16,12,14,14,14,15,15,14,14,8,14,15,14,14,14,8,17,9,16,12,18,10,12,8,3,12,13,14,3,1,3,1,3,1,1,1,2,3,2
"5555",67103336,"Saúl","11/21/1994 (28 years old)","DM, M (RLC)","A. Madrid","Spanish First Division","ESP","Yes","6/14/2021","6/30/2026","$20M - $30M","Left","Very Strong","Reasonable","6'0""","167 lbs","375","39",143,162,13,12,15,13,13,13,15,12,7,13,15,12,14,16,8,13,12,14,16,11,15,15,13,14,14,14,15,14,13,13,12,13,12,13,14,11,20,10,12,15,12,16,11,13,8,5,13,12,17,3,2,3,3,1,4,2,3,2,2,1
"5556",67115823,"Gerard Moreno","4/7/1992 (31 years old)","AM (R), ST (C)","Villarreal","Spanish First Division","ESP","Yes","8/9/2021","6/30/2027","Not for Sale","Left","Very Strong","Fairly Strong","5'11""","169 lbs","387","169",154,161,8,11,13,17,15,9,14,13,8,5,14,15,6,14,13,15,13,15,14,14,16,13,12,16,8,15,13,16,13,13,13,13,12,14,14,14,8,16,15,15,12,14,12,17,4,5,15,13,17,1,1,2,3,1,3,2,3,2,1,3
"5557",2000008435,"Mahmoud Gad","10/11/1998 (24 years old)","GK","Al-Masry","Egyptian Premier League","EGY","No","9/18/2022","7/31/2026","$75K - $750K","Right Only","Very Weak","Very Strong","6'3""","180 lbs","82","-",109,140,4,2,3,1,8,7,3,3,3,3,9,1,3,7,11,14,12,13,12,10,16,1,7,3,14,11,10,10,11,14,10,14,12,12,10,9,13,10,6,14,11,12,6,12,9,4,16,14,11,11,12,15,9,12,10,13,14,13,13,13
"5558",7452450,"Raúl Albiol","9/4/1985 (37 years old)","D (C)","Villarreal","Spanish First Division","ESP","Yes","5/10/2023","6/30/2024","$600K - $9.6M","Right","Reasonable","Very Strong","6'3""","180 lbs","568","16",152,161,4,10,8,9,12,6,15,11,12,16,12,9,16,12,11,14,17,14,14,16,13,6,14,9,16,17,12,16,10,11,16,15,13,11,13,15,9,7,12,15,13,14,12,16,9,6,16,15,16,3,2,1,3,3,2,3,1,3,3,2
"5559",86078360,"Moisés Caicedo","11/2/2001 (21 years old)","DM, M (C)","Brighton","English Premier Division","ECU","No","3/3/2023","6/30/2027","$92M - $141M","Right","Weak","Very Strong","5'10""","160 lbs","82","7",156,185,5,8,14,11,14,8,9,12,4,13,15,8,18,14,13,14,15,15,15,15,14,14,9,13,15,15,14,16,16,16,12,9,18,14,16,12,10,11,11,14,10,12,6,12,8,8,14,14,14,1,2,3,3,1,1,3,2,1,2,1
"5560",2000252303,"Kendry Páez","5/4/2007 (16 years old)","M (C), AM (LC)","Independiente del Valle","Ecuadorian Serie A","ECU","No","1/1/2022","12/31/2025","$17M - $22M","Left","Very Strong","Reasonable","5'10""","141 lbs","5","-",110,167,9,5,14,12,13,13,8,9,5,5,12,12,7,15,15,7,10,6,6,7,5,16,10,13,7,10,9,12,14,15,10,8,16,13,15,8,13,15,11,11,8,10,11,7,6,7,17,12,11,3,3,3,3,2,2,1,2,2,1,1
"5561",86066853,"Piero Hincapié","1/9/2002 (21 years old)","D (LC), WB (L)","Bayer 04","Bundesliga","ECU","No","2/12/2023","6/30/2027","$92M - $111M","Left","Very Strong","Reasonable","6'0""","169 lbs","73","2",136,166,3,10,12,6,12,4,13,6,12,15,13,8,15,12,17,13,16,13,13,12,16,11,10,11,14,13,12,15,14,12,13,13,13,15,14,14,15,8,8,13,12,12,7,13,13,6,14,15,15,2,4,3,4,2,2,2,2,3,2,2
"5562",86075795,"Willian Pacho","10/16/2001 (21 years old)","D (C)","Antwerp","Jupiler Pro League","ECU","No","1/28/2022","6/30/2027","$7.6M - $9.6M","Left","Very Strong","Weak","6'2""","178 lbs","67","-",132,160,3,6,10,7,11,4,13,7,8,15,13,8,13,12,12,14,15,13,13,13,16,9,8,8,14,13,12,15,13,12,15,13,13,15,13,15,11,13,13,14,15,10,7,14,8,7,15,16,17,2,3,2,2,3,3,3,4,1,2,3
"5563",2000191278,"Allen Obando","6/13/2006 (16 years old)","ST (C)","Barcelona S.C.","Ecuadorian Serie A","ECU","No","6/13/2022","12/31/2025","$425K - $4.2M","Right","Reasonable","Very Strong","6'1""","158 lbs","4","-",94,158,8,9,14,14,10,8,14,7,1,7,9,6,3,14,7,14,9,12,8,14,4,13,9,14,6,8,8,9,12,8,9,8,13,10,8,9,9,17,12,9,9,11,8,11,11,1,10,9,12,2,4,4,1,3,4,3,3,2,3,3
"5564",83262111,"Jeremy Sarmiento","6/16/2002 (20 years old)","AM (RL)","Brighton","English Premier Division","ECU","Yes","7/2/2021","6/30/2027","$25M - $31M","Right","Reasonable","Very Strong","5'10""","156 lbs","14","-",132,157,8,11,16,13,14,8,10,13,6,6,12,7,7,14,9,11,11,13,11,9,13,14,7,14,8,10,11,14,15,14,15,10,14,15,14,9,15,17,7,7,12,4,14,19,7,6,14,10,14,2,2,1,3,1,3,1,3,2,1,2
"5565",86045976,"Pervis Estupiñán","1/21/1998 (25 years old)","D/WB/M (L)","Brighton","English Premier Division","ECU","Yes","8/16/2022","6/30/2027","$61M - $92M","Left","Very Strong","Weak","5'9""","160 lbs","232","7",149,156,9,14,12,9,13,9,10,9,14,11,13,12,14,14,14,12,13,14,12,13,13,12,10,14,12,14,13,16,15,12,13,10,16,16,18,13,14,11,12,10,11,13,13,12,5,1,12,11,9,3,3,3,4,3,3,2,3,1,3,2
"5566",2000103991,"Emerson Pata","7/11/2004 (18 years old)","M/AM (R), ST (C)","Independiente del Valle","Ecuadorian Serie A","ECU","No","6/13/2022","12/31/2023","$140K - $1.4M","Right","Reasonable","Very Strong","5'9""","152 lbs","-","-",95,149,8,11,14,14,14,8,9,9,8,6,10,4,9,11,7,6,8,10,4,12,5,15,6,9,8,9,8,10,14,14,9,5,15,14,7,7,10,19,12,9,10,11,10,14,12,3,20,11,9,2,1,1,1,2,2,2,1,1,1,1
"5567",2000255199,"Jhon Acurio","1/18/2007 (16 years old)","ST (C)","Barcelona S.C.","Ecuadorian Serie A","ECU","No","1/1/2022","12/31/2025","$140K - $1.4M","Right","Reasonable","Very Strong","5'10""","171 lbs","4","1",89,149,6,6,13,13,13,6,13,7,4,5,7,8,1,13,5,12,8,12,6,6,15,13,11,10,2,6,4,7,13,13,7,7,14,12,12,4,9,18,9,13,9,11,5,13,13,6,12,10,18,1,3,1,3,3,3,2,3,3,2,1
"5568",2000119255,"El Sayed Ateya","2/13/2001 (22 years old)","GK","Zamalek","Egyptian Premier League","EGY","No","7/1/2018","6/30/2025","$500 - $4.5K","Right","Reasonable","Very Strong","6'1""","167 lbs","-","-",79,139,3,3,2,1,2,5,1,1,1,3,6,1,2,4,10,6,8,7,12,13,3,1,11,2,11,7,6,6,8,5,7,12,12,8,6,4,12,15,7,11,12,12,6,14,5,8,12,11,16,9,9,13,7,11,12,13,5,8,10,13
"5569",2000191269,"Michael Bermúdez","1/13/2006 (17 years old)","AM (L), ST (C)","Liga de Quito","Ecuadorian Serie A","ECU","No","6/13/2022","12/31/2024","$1.4M - $2.9M","Left","Very Strong","Fairly Strong","5'11""","154 lbs","-","-",93,148,7,9,13,13,13,7,13,8,3,4,12,8,6,13,6,9,8,8,7,10,7,13,1,8,6,7,7,9,13,13,8,9,12,11,9,6,11,17,12,9,12,10,7,19,5,4,20,11,12,1,3,3,3,1,1,2,1,1,3,1
"5570",2000190842,"Jair Collahuazo","1/21/2006 (17 years old)","D (C)","Emelec","Ecuadorian Serie A","ECU","No","6/13/2022","12/31/2024","$250K - $2.5M","Left","Very Strong","Weak","6'4""","167 lbs","-","-",94,147,4,5,6,5,8,4,13,4,5,12,9,4,13,10,12,9,10,6,6,11,9,5,2,6,13,7,7,8,12,11,13,16,12,12,8,13,10,13,10,10,12,11,12,5,8,8,8,9,10,3,4,1,1,2,1,2,2,2,1,2
"5571",2000255418,"Geremy de Jesús","9/16/2006 (16 years old)","AM (L), ST (C)","Independiente del Valle","Ecuadorian Serie A","ECU","No","1/1/2022","12/31/2025","$300K - $3M","Left","Very Strong","Reasonable","5'5""","119 lbs","-","-",84,147,8,12,13,14,9,7,9,8,7,6,14,4,8,13,7,7,7,9,6,12,8,12,7,14,7,8,9,9,14,11,4,5,5,14,10,1,7,15,10,9,10,14,13,9,13,7,10,9,11,3,1,1,1,3,2,3,2,2,1,2
"5572",86066846,"Gonzalo Plata","11/1/2000 (22 years old)","M (R), AM (RL)","Valladolid","Spanish Second Division","ECU","No","7/13/2022","6/30/2026","$11.5M - $17.5M","Left Only","Very Strong","Weak","5'10""","145 lbs","112","13",130,145,15,14,16,13,14,14,9,14,5,6,13,12,5,15,8,10,8,11,9,10,9,17,8,12,5,10,13,13,16,15,13,9,15,15,13,8,11,10,6,5,11,12,8,8,8,11,9,13,12,1,2,1,1,1,3,2,2,1,1,3
"5573",2000035844,"Sebastián González","6/6/2003 (20 years old)","M/AM (C)","Liga de Quito","Ecuadorian Serie A","ECU","Yes","7/1/2021","12/31/2025","$350K - $3.5M","Left","Very Strong","Reasonable","5'10""","143 lbs","36","7",110,145,13,13,13,7,15,10,9,11,5,9,13,4,11,14,15,8,5,9,11,13,3,15,5,13,10,13,9,11,14,11,10,4,13,14,14,7,12,10,10,11,12,13,11,17,7,1,12,10,20,1,3,1,1,2,1,2,2,3,4,3
"5574",80007070,"Miler Bolaños","6/1/1990 (33 years old)","AM (RLC), ST (C)","Emelec","Ecuadorian Serie A","ECU","No","12/12/2022","12/31/2024","Not for Sale","Right","Reasonable","Very Strong","5'7""","141 lbs","368","94",123,145,11,11,15,14,14,12,8,12,9,7,14,11,7,15,7,13,13,14,12,13,13,15,8,13,6,6,15,6,13,12,10,8,10,14,10,11,15,12,12,11,11,7,10,8,8,5,7,12,13,2,2,3,2,1,1,3,3,2,2,2
"5575",69002017,"Felipe Caicedo","9/5/1988 (34 years old)","ST (C)","Abha","Saudi Professional League","ECU","Yes","8/28/2022","6/30/2024","$1.4M - $2.9M","Left","Very Strong","Reasonable","6'0""","180 lbs","435","114",130,145,4,6,11,15,13,6,14,11,5,5,11,13,8,14,14,16,15,15,12,13,16,13,12,14,8,15,12,16,13,12,14,11,12,13,10,15,7,15,17,18,11,11,12,12,14,5,12,13,16,2,2,1,3,2,3,1,2,3,2,1
"5576",86009323,"Ángel Mena","1/21/1988 (35 years old)","M (R), AM (RL)","León","Mexican First Division","ECU","No","6/14/2021","6/30/2024","$75K - $750K","Left Only","Very Strong","Weak","5'7""","154 lbs","485","134",135,145,14,15,15,14,14,15,9,12,10,9,15,14,8,14,9,15,9,13,13,15,13,14,14,13,15,15,15,12,11,11,14,8,8,11,11,11,11,5,11,12,11,11,9,12,9,6,14,8,13,3,1,1,3,3,3,2,2,1,3,1
"5577",86059765,"Jordan Sierra","4/23/1997 (26 years old)","DM, M (C)","FC Juárez","Mexican First Division","ECU","No","12/15/2022","12/31/2024","$1.5M - $3.2M","Right","Fairly Strong","Very Strong","5'7""","134 lbs","227","13",122,144,10,12,12,9,13,9,9,10,13,12,13,12,13,12,11,12,12,12,13,11,11,11,10,12,13,11,13,11,13,12,11,8,10,13,14,10,13,11,9,10,11,13,8,11,10,6,14,10,12,3,1,3,2,3,3,2,4,2,1,2
"5578",86060139,"José Cifuentes","3/12/1999 (24 years old)","DM, M (C)","LAFC","Major League Soccer","ECU","No","1/13/2020","12/31/2025","$150K - $1.5M","Right","Reasonable","Very Strong","5'9""","158 lbs","183","22",127,143,8,9,13,13,14,13,8,12,8,9,15,10,12,14,8,13,8,11,11,11,13,7,9,12,10,12,14,12,14,15,16,7,16,13,16,9,10,12,11,10,8,8,2,15,7,2,13,11,10,2,3,2,3,1,3,3,3,2,1,1
"5579",13208828,"Ammar Hamdi","11/26/1999 (23 years old)","D/WB (R), M (RC), AM (RLC)","Al-Ittihad","Egyptian Premier League","EGY","No","7/16/2018","7/31/2025","$275K - $2.8M","Right","Weak","Very Strong","5'6""","141 lbs","66","2",110,139,10,8,13,10,14,8,6,12,3,4,14,10,8,15,6,11,8,9,7,10,10,14,3,15,3,10,14,11,11,13,10,6,11,14,11,7,8,15,8,13,10,14,10,12,6,8,10,13,11,1,3,1,2,3,1,2,1,1,4,3
"5580",86078361,"José Hurtado","12/23/2001 (21 years old)","D/WB/M (R)","BRA","Brazilian National First Division","ECU","No","1/18/2022","12/31/2026","$5.6M - $10M","Right","Reasonable","Very Strong","5'10""","152 lbs","68","2",119,143,9,13,12,6,12,7,11,8,13,10,13,8,14,12,10,12,11,12,11,12,11,12,6,11,9,10,8,11,14,13,11,9,15,14,16,9,16,17,12,12,10,10,8,12,11,1,12,9,11,1,3,1,2,2,3,3,2,1,3,1
"5581",86075794,"Pedro Vite","3/9/2002 (21 years old)","M/AM (LC)","Vancouver","Major League Soccer","ECU","No","8/5/2021","12/31/2025","$600K - $10M","Left","Very Strong","Reasonable","5'7""","127 lbs","60","11",112,142,15,10,14,12,13,11,7,12,4,6,13,10,6,14,5,8,9,9,8,12,17,14,6,16,5,12,12,13,13,13,8,6,15,13,16,8,15,20,10,11,12,10,6,13,8,8,13,10,11,1,1,2,2,3,3,1,2,2,3,3
"5582",2000238729,"Keny Arroyo","2/14/2006 (17 years old)","AM (RLC)","Independiente del Valle","Ecuadorian Serie A","ECU","No","1/1/2022","12/31/2024","$1.4M - $2.9M","Right","Fairly Strong","Very Strong","5'10""","143 lbs","-","-",92,141,8,12,12,13,12,4,7,6,7,7,9,8,8,10,5,11,7,8,7,11,5,11,10,10,6,8,6,8,13,13,5,3,15,13,7,5,15,12,10,12,12,11,12,12,8,1,11,11,7,3,4,4,3,3,1,4,1,3,2,1
"5583",2000238751,"Jairo Reyes","1/7/2006 (17 years old)","DM, M (C)","Independiente del Valle","Ecuadorian Serie A","ECU","No","1/1/2022","12/31/2024","$110K - $1.1M","Right","Reasonable","Very Strong","5'9""","145 lbs","-","-",88,141,6,3,7,7,14,7,7,9,3,8,14,6,14,14,12,10,8,9,4,14,8,8,8,7,11,8,9,13,13,11,8,4,14,10,8,7,13,12,11,11,11,9,11,13,7,7,9,11,19,3,2,3,3,3,4,3,2,1,1,2
"5584",2000007847,"Liberman Torres","5/16/2002 (21 years old)","D (C), DM","Villarreal B","Spanish Second Division","ECU","No","7/1/2022","6/30/2025","$16K - $170K","Right","Weak","Very Strong","6'1""","154 lbs","38","-",96,140,3,6,7,5,9,1,10,5,8,12,10,2,11,9,8,13,10,8,9,13,6,6,4,7,13,7,5,9,12,14,10,13,13,11,14,10,14,10,9,13,11,10,6,16,10,7,14,12,7,2,3,4,1,3,1,2,1,1,2,3
"5585",86043746,"Jhegson Méndez","4/26/1997 (26 years old)","M/AM (C)","SPO","Brazilian National First Division","ECU","No","1/12/2023","1/12/2025","$500K - $5.2M","Right","Fairly Strong","Very Strong","5'9""","154 lbs","176","6",124,140,6,8,10,5,11,6,5,9,5,8,15,13,10,14,8,10,10,11,11,12,11,11,10,10,7,17,13,14,15,14,10,7,14,13,17,12,12,12,9,12,10,11,5,10,8,8,14,10,11,2,2,3,1,3,2,1,1,1,2,2
"5586",80001411,"Joao Rojas","6/14/1989 (33 years old)","M (R), AM (RL)","Garcilaso","Peruvian First Division","ECU","No","12/20/2022","12/31/2023","$4K - $40K","Right","Reasonable","Very Strong","5'9""","147 lbs","417","59",121,140,12,14,15,14,15,12,8,12,8,7,14,13,8,14,12,13,14,12,13,13,14,14,9,11,7,12,13,12,13,12,9,8,13,12,10,9,12,12,11,15,8,12,13,12,9,3,11,9,13,1,3,4,3,2,1,3,3,1,3,1
"5587",80000436,"Alexander Domínguez","6/5/1987 (36 years old)","GK","Liga de Quito","Ecuadorian Serie A","ECU","No","7/10/2022","12/31/2024","Not for Sale","Right","Weak","Very Strong","6'5""","185 lbs","391","-",126,140,4,3,2,1,9,9,7,3,2,1,9,3,1,7,13,12,11,12,9,12,13,3,15,7,11,12,11,11,10,16,13,18,16,10,13,12,15,14,12,12,12,13,5,12,6,8,11,10,13,13,16,16,14,15,12,12,9,13,8,17
"5588",58024318,"Christian Noboa","4/8/1985 (38 years old)","DM, M (C)","Sochi","Russian Premier League","ECU","No","1/19/2023","6/10/2024","$190K - $1.9M","Right","Reasonable","Very Strong","6'0""","176 lbs","458","86",130,140,13,11,13,10,12,14,9,15,8,12,14,15,12,14,13,15,11,15,14,15,13,12,14,13,13,15,15,13,11,11,13,11,16,11,10,10,14,12,8,14,10,14,4,16,11,7,15,13,15,1,3,1,3,3,4,3,1,3,1,2
"5589",86053825,"Byron Castillo","11/10/1998 (24 years old)","D/WB/AM (R)","León","Mexican First Division","ECU","No","6/10/2022","6/30/2027","$4.3M - $8.2M","Right","Reasonable","Very Strong","5'7""","134 lbs","163","11",126,140,9,15,14,9,13,8,9,12,13,12,13,7,15,13,14,12,13,14,9,10,11,14,8,13,11,14,9,13,14,15,10,7,12,16,15,8,16,10,11,10,9,10,8,12,9,14,11,14,10,1,2,1,3,3,2,3,1,1,3,3
"5590",13185637,"Mahmoud El Wensh","6/1/1995 (28 years old)","D (C)","Zamalek","Egyptian Premier League","EGY","No","6/20/2021","7/31/2025","$4.8M - $9M","Right","Reasonable","Very Strong","6'0""","158 lbs","212","7",127,138,3,4,4,7,6,7,15,9,5,16,12,7,16,9,18,9,18,11,12,11,12,2,13,8,8,14,7,14,11,10,10,15,11,13,12,17,5,7,5,9,10,14,5,11,16,8,11,11,8,1,3,1,2,2,3,1,2,2,1,1
"5591",86011987,"Robert Arboleda","10/22/1991 (31 years old)","D (C)","SPO","Brazilian National First Division","ECU","No","3/21/2022","12/31/2024","Not for Sale","Right","Reasonable","Very Strong","6'2""","182 lbs","332","26",136,140,8,8,8,9,11,8,16,10,9,14,11,6,16,11,12,13,11,11,15,13,12,12,11,12,15,13,12,13,13,12,12,16,13,12,13,13,11,12,9,6,9,10,8,11,10,14,11,12,10,1,3,1,1,3,3,2,3,2,3,4
"5592",19354849,"Jackson Porozo","8/4/2000 (22 years old)","D (C)","Troyes","Ligue 2 BKT","ECU","No","7/1/2022","6/30/2027","$3.3M - $6.6M","Right","Reasonable","Very Strong","6'4""","187 lbs","75","5",120,140,5,6,10,8,11,5,16,6,10,13,9,8,14,11,18,12,15,8,7,9,15,6,10,9,12,13,9,13,14,13,13,16,16,16,15,14,10,10,13,12,12,13,3,9,15,8,11,14,11,1,3,2,2,3,3,1,1,1,2,2
"5593",86066845,"Ángelo Preciado","2/18/1998 (25 years old)","D/WB/M (R)","KRC Genk","Jupiler Pro League","ECU","No","1/4/2021","6/30/2025","$2.9M - $6M","Right","Weak","Very Strong","5'8""","163 lbs","133","8",124,139,8,14,13,9,11,7,6,14,11,9,12,8,13,14,12,9,11,10,9,11,16,13,7,12,10,13,8,11,15,14,10,9,16,15,16,10,17,15,10,11,10,11,8,13,8,2,11,11,11,3,2,3,4,3,3,2,1,1,1,3
"5594",2000191266,"Ariel Bao","7/10/2006 (16 years old)","GK","Liga de Quito","Ecuadorian Serie A","ECU","No","6/13/2022","12/31/2025","$190K - $1.9M","Right","Strong","Very Strong","6'2""","160 lbs","-","-",82,139,3,1,2,1,3,8,1,2,1,1,10,2,1,5,8,6,13,7,12,14,5,3,4,3,11,8,7,6,12,9,7,13,13,12,1,6,9,19,15,11,10,11,13,5,5,8,17,9,10,9,9,12,11,9,13,10,5,8,9,12
"5595",2000033025,"Denil Castillo","3/24/2004 (19 years old)","DM, M (C)","Shakhtar","Ukrainian Premier League","ECU","No","4/24/2023","6/30/2028","$2.4M - $4.9M","Right","Reasonable","Very Strong","6'2""","165 lbs","6","-",100,139,8,8,5,7,14,8,8,10,5,10,13,2,14,15,13,12,9,10,4,9,16,5,7,9,8,8,12,12,17,15,9,13,12,16,7,8,11,18,12,12,8,11,7,8,7,3,11,7,20,1,1,4,2,2,1,2,3,1,1,2
"5596",86065934,"Leonardo Campana","7/24/2000 (22 years old)","ST (C)","Inter Miami","Major League Soccer","ECU","Yes","1/20/2023","12/31/2025","$275K - $8.8M","Left Only","Very Strong","Weak","6'2""","180 lbs","84","21",119,138,5,5,12,13,10,11,14,9,6,4,11,13,5,13,13,12,9,13,12,11,12,13,7,13,5,13,12,13,12,15,16,15,16,14,15,16,11,14,10,11,13,11,12,11,7,4,9,12,8,2,2,2,3,3,2,1,2,3,1,2
"5597",86066843,"Moisés Ramírez","9/9/2000 (22 years old)","GK","Independiente del Valle","Ecuadorian Serie A","ECU","No","6/15/2020","12/31/2023","$170K - $1.7M","Right","Reasonable","Very Strong","6'1""","165 lbs","99","-",127,138,1,2,1,3,11,1,6,3,1,2,12,9,1,13,12,11,13,8,11,10,10,9,10,5,11,9,7,6,15,17,16,14,15,15,17,15,1,17,10,11,13,12,6,11,7,5,13,11,6,8,13,16,9,15,9,10,17,8,13,16
"5598",86029992,"Junior Sornoza","1/28/1994 (29 years old)","AM (RC), ST (C)","Independiente del Valle","Ecuadorian Serie A","ECU","No","1/6/2022","12/31/2024","$550K - $5.8M","Right","Fairly Strong","Very Strong","5'7""","143 lbs","324","74",135,137,16,14,15,11,14,16,8,12,7,9,14,12,7,16,11,13,13,14,13,14,12,16,13,12,8,14,13,11,13,14,9,4,11,13,12,9,12,11,11,12,11,12,9,13,9,5,11,12,10,2,1,2,2,3,2,1,1,2,3,2
"5599",2000255403,"Alan Davis","1/28/2007 (16 years old)","D (C)","Liga de Quito","Ecuadorian Serie A","ECU","No","1/1/2022","12/31/2025","$100K - $1M","Right","Weak","Very Strong","6'0""","158 lbs","-","-",87,136,3,1,4,6,8,1,12,3,4,13,8,5,14,3,15,6,9,8,13,14,8,5,11,6,14,7,4,8,12,12,8,8,10,11,7,9,14,18,10,12,13,9,12,16,5,6,8,11,7,1,2,3,1,1,1,3,2,4,2,1
"5600",19061410,"Fidel Martínez","2/15/1990 (33 years old)","AM (RLC), ST (C)","Barcelona S.C.","Ecuadorian Serie A","ECU","No","6/19/2022","12/31/2024","Not for Sale","Left","Very Strong","Fairly Strong","5'10""","156 lbs","317","85",122,136,11,13,15,13,15,12,9,14,8,6,14,13,7,15,10,13,10,12,5,13,9,16,9,14,7,11,12,9,12,13,10,9,9,13,11,7,14,12,7,9,12,10,11,11,10,4,10,13,10,3,2,2,2,2,1,1,2,2,2,3
"5601",2000071478,"Karim El Debes","6/3/2003 (20 years old)","D/WB/M/AM (L)","Al-Ahly","Egyptian Premier League","EGY","No","10/3/2022","7/31/2027","$475K - $4.6M","Left Only","Very Strong","Weak","5'7""","136 lbs","22","1",95,138,9,10,10,6,10,7,6,9,7,10,12,6,11,11,8,8,11,8,8,9,8,7,13,10,9,13,11,14,14,12,11,7,15,13,12,6,14,12,3,9,9,11,5,11,4,5,10,9,12,1,3,3,2,1,2,2,2,2,3,1
"5602",2000255406,"Steven Heras","1/29/2007 (16 years old)","D (C)","Independiente del Valle","Ecuadorian Serie A","ECU","No","1/1/2022","12/31/2025","$180K - $1.8M","Right","Reasonable","Very Strong","6'2""","154 lbs","-","-",82,136,2,2,5,3,8,1,12,4,4,14,5,6,14,7,10,11,9,8,6,14,14,5,6,6,12,7,5,8,9,13,8,13,17,11,8,6,13,10,11,10,9,11,10,18,12,4,10,10,17,1,1,1,2,1,2,4,2,1,2,1
"5603",2000157040,"Patrik Mercado","7/31/2003 (19 years old)","M (C), AM (RLC), ST (C)","Independiente del Valle","Ecuadorian Serie A","ECU","No","6/13/2022","12/31/2025","$230K - $2.3M","Right","Reasonable","Very Strong","5'9""","154 lbs","20","2",102,136,10,12,12,14,12,8,9,10,6,8,14,13,6,14,11,8,4,8,4,14,7,14,9,8,6,9,10,10,14,14,9,5,15,14,6,6,12,19,10,12,8,12,10,2,8,5,10,13,9,2,1,2,2,2,2,2,2,3,2,2
"5604",67280834,"Mike Cevallos","6/22/2001 (21 years old)","ST (C)","F.E. Grama","Spanish Federation Third Group 5","ECU","Yes","7/1/2022","6/30/2024","$0","Right","Reasonable","Very Strong","5'10""","174 lbs","85","23",94,135,7,8,10,11,11,5,12,8,4,5,6,10,4,11,13,11,10,10,7,9,7,8,7,11,5,10,10,11,14,13,12,10,13,14,12,12,11,16,12,9,12,12,8,14,12,6,12,12,16,1,1,3,1,1,2,3,2,2,1,1
"5605",86039106,"Jefferson Intriago","6/4/1996 (27 years old)","DM, M (C)","Mazatlán","Mexican First Division","ECU","No","6/30/2019","6/30/2025","$190K - $1.9M","Right","Fairly Strong","Very Strong","5'9""","156 lbs","265","9",124,135,5,8,10,8,12,10,7,15,7,12,15,9,14,12,9,11,10,11,12,13,13,5,11,10,12,11,12,14,12,16,13,8,14,12,15,8,18,16,12,11,11,8,7,11,7,10,11,12,11,1,2,3,1,1,3,2,1,2,1,3
"5606",86035420,"Michael Estrada","4/7/1996 (27 years old)","AM (L), ST (C)","Toluca","Mexican First Division","ECU","No","12/17/2019","6/30/2024","$350K - $7.4M","Right","Reasonable","Very Strong","6'2""","189 lbs","296","95",128,135,7,10,13,15,11,13,15,16,4,5,10,14,5,11,12,13,10,13,10,10,12,14,10,14,6,10,9,8,15,13,12,13,11,15,15,14,10,13,10,12,9,11,10,13,7,14,12,11,12,2,2,2,3,1,1,1,3,1,2,3
"5607",86069126,"Joan López","1/11/2002 (21 years old)","GK","Independiente del Valle","Ecuadorian Serie A","ECU","No","6/13/2022","12/31/2024","$50K - $475K","Right","Weak","Very Strong","5'11""","160 lbs","28","-",101,135,4,3,3,3,1,5,1,1,3,1,8,1,1,3,5,11,11,9,13,12,13,3,9,2,12,9,8,8,14,6,4,8,10,13,3,7,12,15,9,11,13,11,12,13,11,8,13,9,7,11,6,14,8,11,14,12,5,11,11,14
"5608",2000091875,"Yaimar Medina","11/5/2004 (18 years old)","M (L), AM (RL)","Independiente del Valle","Ecuadorian Serie A","ECU","No","11/5/2020","11/5/2023","$65K - $650K","Left","Very Strong","Reasonable","5'5""","130 lbs","20","2",97,135,7,12,13,10,12,7,7,10,5,6,11,4,7,11,13,11,7,5,5,7,9,16,6,11,7,8,9,9,14,15,6,5,16,15,14,6,13,13,11,10,11,11,5,4,7,4,19,13,15,3,3,3,1,2,1,1,3,1,2,4
"5609",86057914,"Félix Torres","1/11/1997 (26 years old)","D (C)","Santos Laguna","Mexican First Division","ECU","No","9/21/2021","6/30/2025","$30K - $7.4M","Right","Weak","Very Strong","6'2""","176 lbs","204","12",127,135,5,4,5,6,9,5,15,8,13,14,12,9,14,8,13,14,14,9,11,11,12,10,9,12,11,12,7,10,12,14,15,15,13,13,15,18,10,14,10,10,12,11,13,12,13,1,10,9,18,1,2,2,3,3,3,2,3,3,3,2
"5610",19390301,"John Mercado","6/3/2002 (21 years old)","AM (R), ST (C)","Vilafranquense","Portuguese Lower Regional Divisions","ECU","No","1/27/2023","-","$0","Left","Very Strong","Weak","6'1""","163 lbs","23","2",95,135,7,10,13,8,12,6,7,8,6,7,11,4,8,12,7,12,8,9,9,9,17,10,7,8,9,10,11,12,14,12,8,9,12,13,9,10,12,10,9,10,13,11,5,16,10,8,10,12,11,3,2,1,3,3,2,1,3,1,3,1
"5611",86075791,"Leonardo Realpe","2/26/2001 (22 years old)","D (C)","BRA","Brazilian National First Division","ECU","No","8/8/2022","12/31/2026","$375K - $3.9M","Right","Reasonable","Very Strong","6'1""","174 lbs","41","-",123,134,3,8,7,5,11,9,13,9,9,13,13,9,15,10,12,13,15,12,12,11,13,7,9,11,15,14,12,13,12,14,12,13,16,12,14,10,6,11,10,12,11,11,6,13,6,1,12,13,14,1,3,3,1,3,3,3,4,2,3,2
"5612",12065054,"Mohamed Elneny","7/11/1992 (30 years old)","DM, M (C)","Arsenal","English Premier Division","EGY","No","2/21/2023","6/30/2024","$14M - $21M","Right","Weak","Very Strong","5'11""","169 lbs","241","9",139,155,8,7,11,8,14,8,12,14,8,13,13,12,15,14,12,14,15,14,14,14,14,8,11,11,13,18,12,16,12,12,15,13,18,12,16,15,8,17,14,16,14,18,6,12,8,4,13,14,14,1,3,3,2,3,3,4,3,1,1,2
"5613",2000069326,"Mohamed Sadek","7/6/1997 (25 years old)","D/M (L), AM (LC)","Pyramids","Egyptian Premier League","EGY","No","1/13/2022","7/31/2026","$130K - $1.3M","Left","Very Strong","Reasonable","6'0""","163 lbs","111","4",109,137,7,9,13,13,13,7,7,8,6,8,13,4,13,10,15,12,9,7,9,13,5,10,7,13,8,11,9,7,13,9,13,9,10,13,9,5,15,10,6,12,11,12,11,13,15,6,15,12,9,1,1,3,2,3,3,1,1,3,3,3
"5614",92060753,"Cristian Ramírez","8/12/1994 (28 years old)","D/WB (L)","Krasnodar","Russian Premier League","ECU","No","6/15/2020","6/30/2025","$2.1M - $4.4M","Left","Very Strong","Fairly Strong","5'8""","167 lbs","268","6",131,134,12,12,13,8,12,12,12,15,14,12,14,10,14,12,14,11,12,12,12,11,12,12,7,12,9,11,10,12,15,15,14,7,12,14,14,10,12,8,10,13,11,11,6,10,8,5,14,16,10,2,1,3,2,3,2,3,1,4,2,1
"5615",37024025,"Virgil van Dijk","7/8/1991 (31 years old)","D (C)","Liverpool","English Premier Division","NED","Yes","8/13/2021","6/30/2025","Not for Sale","Right","Reasonable","Very Strong","6'4""","202 lbs","360","34",177,183,3,6,13,8,17,13,17,7,8,16,16,11,17,16,17,16,15,16,16,16,16,11,17,8,16,14,14,14,15,12,15,17,17,15,14,17,4,18,12,16,17,12,5,17,12,10,16,17,18,4,1,2,1,2,2,1,2,1,2,2
"5616",37047745,"Frenkie de Jong","5/12/1997 (26 years old)","DM, M (C)","Barcelona","Spanish First Division","NED","Yes","10/20/2020","6/30/2026","$171M - $205M","Right","Fairly Strong","Very Strong","5'11""","152 lbs","235","22",166,181,12,13,16,11,17,13,10,10,6,10,17,11,13,17,9,17,11,16,15,16,15,15,11,15,14,17,18,14,14,16,15,10,13,13,14,11,17,17,16,16,13,14,5,13,2,8,15,15,15,1,3,3,2,1,1,3,3,2,3,1
"5617",37063644,"Jurriën Timber","6/17/2001 (21 years old)","D (RLC)","Ajax","Eredivisie","NED","Yes","6/13/2022","6/30/2027","$30M - $45M","Right","Reasonable","Very Strong","5'10""","174 lbs","123","6",148,173,4,9,10,7,14,9,13,7,7,13,15,8,13,15,13,14,14,15,14,14,16,12,10,13,15,16,12,15,14,15,13,13,12,15,14,12,11,8,15,14,15,13,10,12,6,1,15,12,7,2,1,3,2,3,2,3,3,1,3,2
"5618",37055843,"Matthijs de Ligt","8/12/1999 (23 years old)","D (C)","FC Bayern","Bundesliga","NED","Yes","7/19/2022","6/30/2027","$116M - $145M","Right","Reasonable","Very Strong","6'2""","196 lbs","212","20",160,173,4,7,10,8,12,10,16,10,5,16,14,8,16,13,16,14,18,15,13,14,16,10,17,9,16,15,12,16,12,11,16,16,13,14,15,18,12,12,15,19,15,14,8,14,9,3,15,17,17,2,2,2,3,1,4,2,2,3,3,2
"5619",37071197,"Ryan Gravenberch","5/16/2002 (21 years old)","DM, M/AM (C)","FC Bayern","Bundesliga","NED","Yes","7/1/2022","6/30/2027","$41M - $49M","Right","Reasonable","Very Strong","6'3""","169 lbs","140","15",141,169,13,12,14,10,15,13,12,13,6,9,15,10,12,15,11,13,13,14,12,13,15,15,8,14,11,12,14,12,13,15,14,14,13,13,14,13,9,12,13,11,13,12,7,12,4,2,12,16,11,2,1,2,3,1,1,2,3,1,2,3
"5620",2000105654,"Jorrel Hato","3/7/2006 (17 years old)","D (LC), WB (L)","Ajax","Eredivisie","NED","Yes","3/15/2022","6/30/2025","$27M - $40M","Left Only","Very Strong","Weak","6'2""","174 lbs","24","1",123,168,8,16,10,10,11,5,12,9,9,13,11,7,13,12,7,10,13,13,11,12,14,12,13,11,13,13,10,13,12,12,14,14,15,13,11,13,11,19,11,13,8,12,11,17,15,4,12,12,11,4,3,3,4,1,3,1,1,2,1,3
"5621",2000204688,"Lucas Jetten","6/7/2007 (16 years old)","D (LC), WB (L)","Ajax","Eredivisie","NED","Yes","6/13/2022","6/30/2025","$7.8M - $11.5M","Left","Very Strong","Reasonable","5'5""","119 lbs","-","-",88,168,8,14,7,6,16,4,11,7,9,7,7,4,13,11,14,6,10,8,7,8,14,5,7,8,7,10,7,11,13,15,11,6,12,14,14,4,7,16,9,10,9,11,14,11,12,3,9,12,14,1,2,1,1,4,1,1,1,1,1,2
"5622",2000177913,"Shaqueel van Persie","11/16/2006 (16 years old)","AM (RL), ST (C)","Feyenoord","Eredivisie","NED","Yes","5/16/2022","6/30/2025","$16.5M - $20M","Left","Very Strong","Fairly Strong","6'0""","152 lbs","-","-",100,167,5,10,13,11,14,8,13,10,1,4,14,12,5,11,7,11,9,7,8,10,14,10,4,11,5,7,7,10,13,10,9,14,15,12,9,7,11,18,11,11,12,12,5,10,7,5,17,11,17,2,2,3,3,2,2,3,2,1,2,3
"5623",37063649,"Sven Botman","1/12/2000 (23 years old)","D (LC)","Newcastle","English Premier Division","NED","Yes","7/1/2022","6/30/2027","$166M - $200M","Left","Very Strong","Reasonable","6'4""","200 lbs","152","7",155,167,8,8,10,6,13,4,15,6,9,16,14,9,16,13,10,15,17,15,15,15,13,8,12,9,16,16,11,15,12,9,14,15,12,12,15,17,12,7,13,15,11,12,9,11,11,8,16,13,13,3,3,2,2,1,1,3,3,1,3,1
"5624",2000115964,"Esho","3/1/2003 (20 years old)","AM (RC)","Zamalek","Egyptian Premier League","EGY","No","7/1/2018","7/31/2025","$275K - $2.8M","Left","Very Strong","Reasonable","5'8""","147 lbs","1","-",83,137,7,7,14,13,14,7,6,14,2,7,14,7,9,14,9,9,8,6,8,6,10,13,6,13,8,8,9,13,11,8,13,3,12,8,8,5,12,18,5,12,10,9,10,7,14,1,12,10,10,4,2,4,1,3,3,2,1,2,1,2
"5625",2000046143,"Gabriël Misehouy","7/18/2005 (17 years old)","M/AM (C), ST (C)","Ajax","Eredivisie","NED","Yes","6/13/2022","6/30/2024","$25M - $31M","Right","Fairly Strong","Very Strong","5'8""","152 lbs","31","4",108,166,10,8,12,12,13,10,7,10,7,10,13,10,8,13,11,8,7,8,11,12,13,12,12,9,8,12,13,13,11,14,12,9,11,11,9,12,14,10,11,11,11,11,10,10,9,8,12,12,19,2,2,3,1,2,3,2,1,3,3,2
"5626",37064720,"Lutsharel Geertruida","7/18/2000 (22 years old)","D (RC), WB (R), DM","Feyenoord","Eredivisie","NED","Yes","3/18/2023","6/30/2025","$61M - $94M","Right","Reasonable","Very Strong","6'0""","174 lbs","107","11",145,165,6,9,9,8,13,11,14,9,12,12,13,9,13,13,12,13,14,14,15,13,15,8,6,14,13,14,12,15,12,15,15,13,16,13,14,13,16,10,15,15,15,14,11,15,6,5,15,14,10,2,3,2,2,2,2,2,1,2,1,2
"5627",37076355,"Bart Verbruggen","8/18/2002 (20 years old)","GK","RSC Anderlecht","Jupiler Pro League","NED","Yes","8/26/2020","6/30/2025","$15M - $19M","Right","Reasonable","Very Strong","6'4""","165 lbs","37","-",131,165,7,12,11,1,13,7,6,1,2,3,15,3,3,14,8,11,13,15,12,12,14,12,12,3,11,14,13,12,12,12,12,14,11,12,12,9,15,9,10,14,15,10,6,15,6,8,10,15,14,12,12,14,14,12,14,13,6,14,15,13
"5628",28113828,"Jeremie Frimpong","12/10/2000 (22 years old)","D/WB/M (R)","Bayer 04","Bundesliga","NED","Yes","1/27/2021","6/30/2025","$68M - $102M","Right","Reasonable","Very Strong","5'8""","143 lbs","105","12",146,164,7,12,16,11,12,7,6,8,8,9,12,7,12,14,13,13,13,11,10,12,14,16,7,16,9,12,12,15,18,16,11,7,16,18,15,10,12,13,13,12,12,11,5,12,6,8,12,17,15,1,2,4,1,1,2,1,4,1,3,3
"5629",37062185,"Cody Gakpo","5/7/1999 (24 years old)","AM (RLC), ST (C)","Liverpool","English Premier Division","NED","Yes","1/1/2023","6/30/2028","$85M - $102M","Right","Reasonable","Very Strong","6'2""","167 lbs","152","60",153,164,14,14,15,13,15,12,12,14,5,7,14,11,7,14,9,13,11,14,14,12,14,14,13,14,8,14,13,14,15,15,14,13,12,14,13,12,11,14,14,15,16,13,7,14,4,7,14,14,14,2,1,2,2,2,3,1,1,2,1,2
"5630",37025551,"Nathan Aké","2/18/1995 (28 years old)","D (LC), DM","Man City","English Premier Division","NED","Yes","8/5/2020","6/30/2026","$46M - $58M","Left","Very Strong","Reasonable","5'11""","165 lbs","201","16",153,164,2,10,13,8,14,6,15,10,10,15,14,3,15,14,12,15,15,16,15,13,15,6,14,5,15,14,13,16,15,14,13,12,14,15,15,15,15,15,11,15,12,12,8,13,10,10,14,14,16,1,2,3,1,2,3,4,2,3,1,1
"5631",37024470,"Memphis Depay","2/13/1994 (29 years old)","AM (LC), ST (C)","A. Madrid","Spanish First Division","NED","Yes","1/19/2023","6/30/2025","$84M - $126M","Right","Fairly Strong","Very Strong","5'9""","171 lbs","299","121",157,161,14,14,15,15,16,14,11,14,2,3,15,14,3,16,9,13,13,13,10,13,15,17,15,15,5,11,14,11,16,14,14,10,16,16,14,14,16,10,13,14,14,12,9,15,7,13,10,17,15,1,2,1,3,1,2,2,4,3,2,3
"5632",37002756,"Kevin Strootman","2/13/1990 (33 years old)","DM, M (C)","OM","Ligue 1 Uber Eats","NED","Yes","6/14/2021","6/30/2024","$170K - $1.7M","Left","Very Strong","Weak","6'1""","171 lbs","371","32",126,161,9,10,11,9,12,8,11,11,5,13,15,13,14,13,17,14,16,15,16,13,19,5,17,14,14,17,13,14,10,10,16,12,16,10,12,13,12,14,13,19,16,14,14,13,11,8,13,16,16,1,2,2,1,3,1,1,3,2,2,3
"5633",37084591,"Micky van de Ven","4/19/2001 (22 years old)","D (LC), WB (L)","VfL Wolfsburg","Bundesliga","NED","Yes","8/31/2021","6/30/2027","$32M - $40M","Left","Very Strong","Weak","6'4""","178 lbs","91","4",147,161,3,11,13,7,12,3,13,7,14,14,13,6,14,13,14,13,16,13,13,13,17,13,14,10,14,13,12,15,16,12,14,15,16,19,13,15,12,12,12,13,13,9,6,14,7,12,14,17,11,3,1,3,3,4,3,2,2,1,1,1
"5634",37051305,"Arnaut Danjuma","1/31/1997 (26 years old)","M (L), AM (RL)","Tottenham","English Premier Division","NED","Yes","8/19/2021","6/30/2026","$56M - $68M","Right","Weak","Very Strong","5'10""","163 lbs","151","45",151,160,12,14,17,14,16,13,11,11,11,6,12,8,7,17,14,13,15,14,14,14,15,16,4,13,6,13,14,11,17,14,13,10,8,16,13,9,17,12,11,10,13,5,14,14,9,16,12,18,16,3,3,2,3,3,4,1,2,4,2,3
"5635",12041467,"Kahraba","4/13/1994 (29 years old)","AM (L), ST (C)","Al-Ahly","Egyptian Premier League","EGY","No","1/1/2020","7/31/2024","$190K - $1.9M","Right","Weak","Very Strong","6'0""","165 lbs","231","80",125,137,11,12,15,14,15,11,9,14,6,4,12,11,7,15,11,13,6,12,8,12,13,16,5,14,6,10,13,12,14,14,11,12,13,14,11,9,12,9,8,10,9,4,7,13,3,15,11,12,10,2,3,2,2,3,1,4,3,2,1,1
"5636",67288555,"Xavi Simons","4/21/2003 (20 years old)","M/AM (C)","PSV","Eredivisie","NED","Yes","7/1/2022","6/30/2028","$5.2M - $6.4M","Right","Fairly Strong","Very Strong","5'10""","127 lbs","41","19",148,160,8,10,14,12,16,12,9,10,5,8,15,13,9,16,15,13,13,14,12,13,17,16,10,13,9,14,15,14,15,15,12,11,15,14,15,10,17,10,12,17,16,9,5,16,6,5,15,18,16,2,2,4,3,2,1,1,1,3,1,3
"5637",859612,"Georginio Wijnaldum","11/11/1990 (32 years old)","DM, M (C), AM (LC)","Paris SG","Ligue 1 Uber Eats","NED","Yes","7/1/2021","6/30/2024","$8.8M - $13.5M","Right","Reasonable","Very Strong","5'9""","163 lbs","484","96",145,160,8,11,15,11,15,6,12,8,6,12,14,7,13,15,12,15,12,15,13,14,13,12,14,14,14,15,11,13,14,15,17,11,18,12,15,13,15,17,15,13,15,10,5,15,7,6,15,15,17,2,2,1,1,2,3,2,2,1,3,2
"5638",37001814,"Stefan de Vrij","2/5/1992 (31 years old)","D (C)","Inter","Italian Serie A","NED","Yes","6/14/2021","6/30/2026","$17M - $26M","Right","Reasonable","Very Strong","6'2""","171 lbs","381","23",147,160,4,8,9,9,13,6,16,7,7,17,14,8,15,14,13,17,13,13,12,13,14,12,12,8,14,16,12,13,12,12,14,15,16,12,14,15,9,16,14,16,14,12,9,13,10,2,12,16,16,2,1,2,1,1,1,2,3,1,2,2
"5639",37088234,"Emanuel Emegha","2/3/2003 (20 years old)","ST (C)","SK Sturm Graz","Austrian Premier Division","NED","Yes","8/4/2022","6/30/2026","$12M - $18M","Right","Fairly Strong","Very Strong","6'5""","178 lbs","69","13",129,159,6,7,15,14,12,8,16,11,5,5,12,13,5,12,10,11,13,10,11,10,14,13,7,15,7,9,8,11,15,12,11,17,14,15,10,12,14,15,8,10,12,9,10,7,5,7,11,14,13,2,2,1,3,3,1,3,2,2,1,1
"5640",37057982,"Teun Koopmeiners","2/28/1998 (25 years old)","DM, M/AM (C)","Atalanta","Italian Serie A","NED","Yes","6/7/2023","6/30/2025","$28M - $42M","Left","Very Strong","Fairly Strong","6'0""","169 lbs","204","52",154,159,12,12,11,13,15,16,9,16,4,11,15,16,12,15,12,17,11,12,15,15,18,10,15,11,13,17,15,15,12,12,15,12,15,11,16,15,13,10,16,18,11,12,5,12,7,8,14,16,18,3,1,2,3,1,3,3,3,3,2,3
"5641",2000088444,"Tygo Land","1/11/2006 (17 years old)","DM, M/AM (C)","PSV","Eredivisie","NED","Yes","7/25/2022","6/30/2025","$10.5M - $16M","Right Only","Weak","Very Strong","6'1""","167 lbs","-","-",106,159,12,9,12,16,13,10,10,12,2,7,13,10,8,11,11,9,10,14,13,13,15,8,9,12,10,14,12,11,11,13,12,10,6,12,12,9,13,19,11,9,11,10,7,11,5,5,10,9,15,1,3,4,2,3,1,3,3,2,3,1
"5642",37071126,"Tijjani Reijnders","7/29/1998 (24 years old)","DM, M/AM (C)","AZ","Eredivisie","NED","Yes","6/15/2020","6/30/2027","$15M - $23M","Right","Reasonable","Very Strong","6'1""","160 lbs","193","26",147,159,11,12,15,12,15,12,8,14,4,8,15,11,8,15,7,14,14,13,12,14,14,14,10,14,11,16,16,15,14,15,13,12,13,13,14,12,12,14,14,13,14,13,5,12,5,5,14,14,15,2,3,2,3,2,1,2,2,3,3,1
"5643",2000257573,"Diego Rambocus","1/5/2007 (16 years old)","M/AM (C)","Feyenoord","Eredivisie","NED","Yes","6/16/2022","6/30/2025","$7M - $8.4M","Right","Reasonable","Very Strong","5'7""","119 lbs","-","-",85,159,7,5,8,14,13,7,6,8,7,5,14,7,6,14,12,9,5,6,8,12,13,11,4,9,6,8,12,9,14,13,8,7,16,13,9,1,16,18,12,11,10,11,10,2,6,4,7,12,14,1,3,3,3,3,2,2,2,3,1,1
"5644",2000109834,"Jason van Duiven","2/24/2005 (18 years old)","ST (C)","PSV","Eredivisie","NED","Yes","9/6/2022","6/30/2025","$15.5M - $23M","Right","Weak","Very Strong","5'9""","156 lbs","34","15",115,158,7,8,11,12,13,10,13,12,7,5,12,14,6,13,12,11,13,13,12,13,15,13,11,12,6,11,11,13,13,15,13,10,15,12,13,11,12,19,12,9,11,13,5,5,14,4,10,11,7,3,2,1,3,2,2,2,2,2,3,3
"5645",37052843,"Denzel Dumfries","4/18/1996 (27 years old)","D/WB/M (R)","Inter","Italian Serie A","NED","Yes","8/14/2021","6/30/2025","$59M - $74M","Right","Reasonable","Very Strong","6'2""","176 lbs","254","24",153,158,11,13,13,12,12,4,16,11,13,10,12,11,14,12,16,14,13,12,10,12,16,11,9,17,11,13,11,14,17,14,14,15,15,18,15,15,13,9,10,17,13,11,5,11,15,7,11,15,12,3,3,4,1,3,2,1,2,1,3,3
"5646",12041334,"Mohamed Awad","7/6/1992 (30 years old)","GK","Zamalek","Egyptian Premier League","EGY","No","7/31/2019","7/31/2024","$140K - $1.4M","Right Only","Very Weak","Very Strong","6'0""","194 lbs","185","-",120,136,1,1,1,1,7,6,9,1,2,1,9,2,2,8,9,19,15,10,10,7,17,4,6,5,18,8,4,9,9,18,15,13,13,12,14,13,11,11,13,12,12,14,8,10,4,2,12,9,3,10,14,17,6,15,16,13,7,9,9,14
"5647",37073317,"Kenneth Taylor","5/16/2002 (21 years old)","DM, M/AM (C)","Ajax","Eredivisie","NED","Yes","7/15/2022","6/30/2027","$84M - $101M","Left","Very Strong","Strong","6'0""","145 lbs","109","23",137,157,12,7,12,11,14,15,9,11,7,11,14,13,8,14,11,12,15,12,12,12,17,12,13,14,12,14,12,13,11,12,13,12,12,12,15,11,14,14,14,14,14,14,4,12,6,4,13,14,11,2,1,1,1,2,3,1,4,1,2,1
"5648",2000045246,"Ruben van Bommel","8/3/2004 (18 years old)","M (L), AM (RL)","MVV Maastricht","Keuken Kampioen Divisie","NED","Yes","7/1/2020","6/30/2025","$40K - $6.4M","Right Only","Weak","Very Strong","6'3""","174 lbs","31","15",118,157,10,12,12,13,13,10,11,9,3,5,12,12,6,12,11,12,12,12,12,12,13,12,6,12,6,12,12,12,15,13,13,13,15,15,12,9,12,19,12,13,11,12,5,8,10,7,13,10,18,2,1,3,2,1,2,3,2,2,3,2
"5649",37062161,"Perr Schuurs","11/26/1999 (23 years old)","D (C)","Torino","Italian Serie A","NED","Yes","8/18/2022","6/30/2026","$27M - $32M","Right","Reasonable","Very Strong","6'3""","191 lbs","180","17",139,157,7,9,7,7,11,14,15,15,7,15,13,10,14,12,10,15,12,13,14,13,16,9,12,8,14,12,13,13,12,12,13,15,14,13,14,14,10,15,16,16,14,15,9,11,6,2,13,13,15,2,2,1,2,2,2,3,2,2,1,3
"5650",37059452,"Pascal Struijk","8/11/1999 (23 years old)","D (LC)","Leeds","Sky Bet Championship","NED","Yes","12/21/2022","6/30/2027","$21M - $32M","Left","Very Strong","Fairly Strong","6'3""","165 lbs","90","4",133,156,3,10,10,6,12,3,16,6,8,13,13,8,14,13,13,13,14,13,13,12,13,8,6,12,13,14,13,14,13,11,13,15,14,14,14,14,15,11,10,14,10,11,6,12,6,5,13,13,14,2,1,2,2,3,2,2,2,4,1,3
"5651",37078404,"Mees Hilgers","5/13/2001 (22 years old)","D (C)","FC Twente","Eredivisie","NED","Yes","6/15/2020","6/30/2027","$12.5M - $18.5M","Right","Weak","Very Strong","6'0""","176 lbs","55","2",128,156,10,7,8,6,11,11,13,8,3,12,11,11,12,9,8,12,13,13,13,13,14,8,11,8,12,14,11,15,13,11,15,16,13,14,14,14,12,15,11,14,11,11,9,12,5,1,14,13,14,3,1,1,2,3,2,2,4,1,2,2
"5652",37060922,"Joshua Zirkzee","5/22/2001 (22 years old)","ST (C)","Bologna","Italian Serie A","NED","Yes","8/29/2022","6/30/2026","$23M - $35M","Right","Fairly Strong","Very Strong","6'4""","185 lbs","104","28",137,156,4,10,16,12,15,12,12,12,4,5,16,12,8,16,13,14,12,12,12,14,11,17,6,13,6,16,16,12,12,14,13,15,14,13,14,14,8,9,12,12,11,10,8,14,11,13,12,14,15,2,3,3,1,3,3,3,1,1,2,1
"5653",37076335,"Jan Paul van Hecke","6/8/2000 (23 years old)","D (C)","Brighton","English Premier Division","NED","Yes","9/10/2020","6/30/2027","$53M - $66M","Right","Weak","Very Strong","6'2""","171 lbs","78","5",138,156,4,7,13,6,13,5,15,5,7,15,13,7,17,13,17,13,15,14,14,12,16,8,12,6,14,14,12,13,12,13,14,15,14,13,14,14,7,13,15,16,15,10,4,13,13,5,13,13,11,3,3,2,1,3,3,4,2,2,2,1
"5654",37079089,"Kian Fitz-Jim","7/5/2003 (19 years old)","WB (RL), DM, M (LC)","Ajax","Keuken Kampioen Divisie","NED","Yes","8/26/2021","6/30/2024","$950K - $2M","Right","Reasonable","Very Strong","5'8""","143 lbs","87","4",109,156,12,9,13,6,13,10,4,6,4,11,14,6,10,15,4,11,8,11,12,12,14,13,8,12,8,15,13,14,12,14,10,4,14,12,13,5,15,10,11,11,11,11,4,5,7,9,14,11,20,2,1,1,3,1,3,2,3,3,3,2
"5655",37076007,"Million Manhoef","1/3/2002 (21 years old)","D/WB/M/AM (RL)","Vitesse","Eredivisie","NED","Yes","6/23/2022","6/30/2025","$12.5M - $15.5M","Left","Very Strong","Weak","5'10""","167 lbs","55","10",127,155,12,12,12,8,13,8,7,8,11,12,14,5,10,12,8,11,13,13,13,11,11,12,8,11,7,13,12,13,13,14,13,10,11,13,13,12,18,18,9,12,13,12,6,11,9,8,12,12,8,3,1,1,1,2,3,3,2,1,2,1
"5656",37002936,"Jasper Cillessen","4/22/1989 (34 years old)","GK","N.E.C. Nijmegen","Eredivisie","NED","Yes","8/8/2022","6/30/2025","Not for Sale","Right Only","Weak","Very Strong","6'2""","182 lbs","227","-",129,155,5,1,1,2,8,7,4,3,2,3,10,3,2,8,12,14,11,13,12,12,16,8,14,3,13,13,9,14,10,12,13,16,12,10,10,11,13,13,14,17,16,15,16,14,3,9,12,16,12,13,12,13,10,14,13,15,11,14,14,16
"5657",13229558,"Baher Elmohamady","11/1/1996 (26 years old)","D (RC), WB (R)","Ismaily","Egyptian Premier League","EGY","No","6/15/2020","7/31/2026","$160K - $1.6M","Right Only","Weak","Very Strong","5'10""","165 lbs","154","11",115,136,9,9,9,8,10,7,14,9,11,12,10,16,14,10,11,12,17,11,13,13,15,11,15,13,13,11,10,11,11,13,11,14,15,13,13,13,18,15,18,10,10,11,7,13,6,7,10,10,20,2,1,3,1,1,1,1,2,1,1,2
"5658",37055841,"Justin Kluivert","5/5/1999 (24 years old)","M/AM (RL)","AS Roma","Italian Serie A","NED","Yes","6/15/2020","6/30/2028","$4.2M - $8.2M","Right","Fairly Strong","Very Strong","5'8""","145 lbs","184","35",139,155,9,10,16,11,16,8,7,12,2,3,14,10,6,16,16,9,13,11,10,10,15,15,7,12,6,11,11,12,17,17,11,7,12,16,11,8,14,12,12,14,13,9,11,14,14,13,12,16,13,3,3,2,3,1,3,3,1,1,1,1
"5659",856957,"Ryan Babel","12/19/1986 (36 years old)","AM (L), ST (C)","Eyüpspor","Turkish 1. League","NED","Yes","8/8/2022","6/30/2024","$230K - $700K","Right","Reasonable","Very Strong","6'1""","187 lbs","487","101",115,155,7,12,13,11,16,13,11,15,5,6,12,13,6,15,8,14,7,15,14,13,7,12,12,13,7,12,13,7,12,11,15,13,15,10,7,12,12,13,13,14,17,8,10,12,6,12,8,14,14,1,1,1,1,1,1,2,2,3,1,3
"5660",2000193585,"Aymen Sliti","3/24/2006 (17 years old)","AM (L)","Feyenoord","Eredivisie","NED","Yes","6/13/2022","6/30/2025","$6M - $11M","Right","Reasonable","Very Strong","5'9""","143 lbs","-","-",90,154,7,11,12,12,12,5,2,6,6,6,6,9,3,9,12,10,7,11,7,12,13,15,10,12,4,7,10,10,14,12,7,6,12,14,5,5,16,12,10,10,13,11,6,13,7,5,12,11,19,3,2,1,1,2,1,3,2,2,2,2
"5661",2000054475,"Antoni Milambo","4/3/2005 (18 years old)","M/AM (C)","Feyenoord","Eredivisie","NED","Yes","7/13/2022","6/30/2025","$6.6M - $8.4M","Right","Weak","Very Strong","5'10""","156 lbs","3","-",110,154,9,10,13,14,14,9,7,9,7,9,12,6,11,13,10,7,8,10,10,14,13,10,3,6,7,10,13,13,14,14,12,9,13,14,11,7,11,17,12,11,9,12,11,13,5,1,13,11,19,3,1,2,3,1,1,2,2,1,2,3
"5662",37050140,"Steven Bergwijn","10/8/1997 (25 years old)","M (RL), AM (RLC), ST (C)","Ajax","Eredivisie","NED","Yes","7/8/2022","6/30/2027","$29M - $44M","Right","Fairly Strong","Very Strong","5'10""","171 lbs","235","64",149,154,11,13,15,14,15,13,7,14,5,5,13,12,7,15,10,14,13,13,12,11,13,17,5,13,5,12,12,11,15,14,13,9,11,14,13,14,13,12,13,11,14,5,7,11,7,4,12,14,13,1,3,2,3,1,3,2,4,3,3,1
"5663",37055844,"Donyell Malen","1/19/1999 (24 years old)","AM (RL), ST (C)","Borussia Dortmund","Bundesliga","NED","Yes","7/27/2021","6/30/2026","$41M - $61M","Right","Reasonable","Very Strong","5'9""","149 lbs","156","67",145,154,12,11,15,13,14,11,12,12,6,6,12,13,6,15,11,14,9,13,12,13,13,14,6,13,6,12,12,11,16,16,13,8,12,16,13,12,12,14,12,12,11,9,9,11,3,7,12,13,12,2,3,1,2,1,3,3,1,3,1,1
"5664",37060952,"Quinten Timber","6/17/2001 (21 years old)","D (C), DM, M (C)","Feyenoord","Eredivisie","NED","Yes","7/28/2022","6/30/2026","$16M - $24M","Right","Reasonable","Very Strong","5'10""","156 lbs","95","8",131,153,5,9,13,6,14,11,8,9,6,11,13,8,12,14,8,14,12,14,13,14,16,12,9,12,12,15,13,14,12,14,14,11,14,12,14,14,14,10,13,16,15,8,6,11,6,3,16,16,14,1,2,1,2,1,2,1,3,2,3,3
"5665",37084822,"Myron van Brederode","7/6/2003 (19 years old)","AM (RLC), ST (C)","AZ","Keuken Kampioen Divisie","NED","Yes","2/20/2023","6/30/2027","$8.6M - $13M","Right","Weak","Very Strong","5'9""","156 lbs","19","1",120,153,10,11,15,13,13,13,5,12,3,4,12,14,5,13,9,11,10,13,9,13,13,13,3,13,3,9,13,10,14,13,15,7,13,13,12,11,8,18,15,14,13,11,5,14,7,7,12,10,20,3,1,2,2,1,1,3,4,2,2,2
"5666",2000181764,"Kees Smit","1/21/2006 (17 years old)","DM, M/AM (C)","AZ","Eredivisie","NED","Yes","6/13/2022","6/30/2024","$4.9M - $7.4M","Right","Fairly Strong","Very Strong","5'11""","149 lbs","4","-",95,153,8,8,10,14,12,8,8,9,4,5,11,8,11,14,10,9,9,7,6,14,12,13,1,9,6,9,13,13,11,13,9,6,14,13,9,6,12,15,13,11,9,12,5,18,11,2,8,11,18,3,1,2,1,1,1,2,3,1,2,3
"5667",37005632,"Daley Blind","3/9/1990 (33 years old)","D (LC), WB (L), DM, M (C)","FC Bayern","Bundesliga","NED","Yes","1/5/2023","6/30/2024","$180K - $8M","Left","Very Strong","Weak","5'11""","158 lbs","337","14",142,152,12,12,8,8,15,10,13,8,10,14,16,11,13,14,12,16,14,17,14,14,17,10,16,14,15,17,16,16,9,11,14,12,17,9,14,12,17,15,16,18,18,16,5,15,12,8,17,14,16,3,3,3,1,2,3,1,1,2,1,1
"5668",8632545,"Abdallah El Saeed","7/13/1985 (37 years old)","M (C), AM (RLC)","Pyramids","Egyptian Premier League","EGY","No","6/14/2021","7/31/2024","Not for Sale","Right","Strong","Very Strong","5'9""","165 lbs","472","131",133,136,14,13,10,14,16,15,10,13,2,5,16,16,8,14,7,13,11,12,11,14,15,14,18,11,6,16,15,11,10,14,11,9,9,12,12,10,9,12,14,13,11,8,9,15,6,2,13,14,11,4,3,2,1,3,1,2,3,2,1,1
"5669",37001813,"Marten de Roon","3/29/1991 (32 years old)","DM, M (C)","Atalanta","Italian Serie A","NED","Yes","6/14/2021","6/30/2024","$12M - $14.5M","Right","Reasonable","Very Strong","6'1""","167 lbs","419","25",147,152,7,8,10,8,12,5,14,10,10,14,13,6,17,12,16,16,16,14,14,14,16,8,14,12,16,18,12,18,12,12,13,14,16,13,17,14,12,10,12,17,13,16,4,14,14,9,16,14,15,3,3,3,1,2,2,2,2,3,3,1
"5670",653054,"Luka Modrić","9/9/1985 (37 years old)","M/AM (C)","R. Madrid","Spanish First Division","CRO","Yes","6/14/2021","6/30/2024","$9M - $13.5M","Right","Fairly Strong","Very Strong","5'8""","147 lbs","588","78",174,180,16,16,17,9,20,13,8,14,7,8,19,14,11,19,12,17,14,18,18,18,17,13,14,15,15,17,19,16,11,14,13,7,13,12,11,8,16,17,19,20,17,17,11,16,12,5,15,15,10,1,3,3,2,2,1,1,1,3,1,4
"5671",24060473,"Joško Gvardiol","1/23/2002 (21 years old)","D (LC), WB (L)","RB Leipzig","Bundesliga","CRO","Yes","9/28/2020","6/30/2028","$90M - $108M","Left","Very Strong","Fairly Strong","6'1""","176 lbs","99","6",148,178,2,11,13,7,13,6,13,8,12,14,14,7,14,13,16,14,17,16,14,13,17,13,14,11,14,14,13,16,14,12,15,13,15,15,14,16,11,10,10,16,18,12,6,16,10,4,14,19,13,3,1,3,2,4,4,3,3,1,2,2
"5672",24016925,"Mateo Kovačić","5/6/1994 (29 years old)","DM, M (C)","Chelsea","English Premier Division","CRO","Yes","6/14/2021","6/30/2027","$32M - $38M","Right","Reasonable","Very Strong","5'9""","180 lbs","338","16",152,172,10,10,16,8,16,12,10,9,7,12,14,12,15,17,14,16,14,18,11,14,17,16,11,13,12,15,15,17,15,12,16,9,12,14,14,13,15,17,14,16,14,12,12,13,12,9,13,14,14,4,4,2,3,2,1,2,1,1,1,1
"5673",5727652,"Ivan Rakitić","3/10/1988 (35 years old)","DM, M/AM (C)","Sevilla","Spanish First Division","CRO","Yes","9/1/2020","6/30/2024","$45K - $7.2M","Right","Fairly Strong","Very Strong","6'0""","171 lbs","574","90",145,168,16,14,13,14,15,14,8,16,8,9,17,16,12,16,11,14,12,14,14,14,13,12,15,14,11,14,16,12,11,11,11,12,10,11,11,11,12,18,14,16,11,13,9,13,12,11,15,12,14,1,1,2,3,3,1,2,1,4,3,2
"5674",24065108,"Martin Baturina","2/16/2003 (20 years old)","M/AM (C)","Dinamo","Croatian First League","CRO","Yes","4/14/2023","6/15/2028","$7.8M - $12M","Right","Fairly Strong","Very Strong","5'8""","149 lbs","57","9",129,167,13,13,16,11,14,13,6,13,6,9,14,10,10,15,11,14,10,14,10,12,16,14,10,13,10,12,14,12,13,14,15,8,13,11,12,10,13,12,9,14,15,9,5,13,6,6,9,16,19,3,2,3,3,1,2,1,2,1,2,3
"5675",24016529,"Marcelo Brozović","11/16/1992 (30 years old)","DM, M (C)","Inter","Italian Serie A","CRO","Yes","6/14/2021","6/30/2026","$19.5M - $23M","Right","Reasonable","Very Strong","5'11""","149 lbs","388","40",155,165,13,11,10,11,16,13,11,12,4,12,17,12,17,16,13,15,13,15,17,13,16,12,14,13,14,18,15,16,11,12,16,10,15,12,18,12,12,16,13,13,17,17,12,15,9,18,15,15,15,2,3,3,1,1,2,1,2,4,3,2
"5676",24058106,"Josip Šutalo","2/28/2000 (23 years old)","D (C)","Dinamo","Croatian First League","CRO","Yes","3/2/2022","6/15/2028","$17M - $26M","Right","Reasonable","Very Strong","6'3""","180 lbs","100","4",144,161,2,8,11,5,13,3,14,5,7,15,13,6,16,14,11,17,13,16,15,14,15,11,9,8,15,14,11,12,14,10,11,16,13,13,14,14,9,15,10,16,17,14,6,13,8,4,14,14,11,2,1,1,3,3,1,1,2,3,2,3
"5677",16254093,"Luka Sučić","9/8/2002 (20 years old)","M/AM (C)","FC RB Salzburg","Austrian Premier Division","CRO","Yes","8/6/2021","5/31/2025","$20M - $24M","Left","Very Strong","Fairly Strong","6'1""","154 lbs","86","15",130,161,8,10,14,10,12,12,11,13,4,5,13,7,8,15,4,13,13,11,12,12,15,12,9,14,6,13,13,13,15,13,13,13,12,15,13,12,7,10,14,12,13,12,8,11,6,12,13,16,18,4,3,2,1,2,3,1,3,1,1,1
"5678",34012563,"Ivan Perišić","2/2/1989 (34 years old)","WB/M/AM (L)","Tottenham","English Premier Division","CRO","Yes","7/1/2022","6/30/2024","$5.6M - $7M","Right","Strong","Very Strong","6'1""","176 lbs","461","117",146,159,15,17,14,14,15,12,16,12,9,10,13,14,12,14,14,15,11,13,13,13,14,12,11,17,11,10,13,14,12,12,13,14,17,11,15,12,18,10,8,12,18,9,6,19,8,13,14,17,15,2,2,3,3,1,1,3,1,2,2,4
"5679",2000114780,"Mohamed Abdelsamia","3/10/2000 (23 years old)","M/AM (C), ST (C)","Ismaily","Egyptian Premier League","EGY","No","6/15/2020","6/30/2025","$60K - $600K","Right","Reasonable","Very Strong","5'7""","132 lbs","19","-",85,135,7,7,13,14,11,7,9,9,5,6,14,3,8,12,9,9,8,8,8,12,5,11,8,13,9,8,9,9,14,12,8,5,15,14,10,3,9,20,11,10,13,12,11,10,6,8,20,9,20,3,2,2,3,1,3,2,3,1,3,1
"5680",24023726,"Ante Rebić","9/21/1993 (29 years old)","AM (L), ST (C)","AC Milan","Italian Serie A","CRO","Yes","9/12/2020","6/30/2026","$0","Right","Fairly Strong","Very Strong","6'1""","169 lbs","260","62",138,156,6,11,13,13,12,9,14,13,9,6,11,10,8,14,15,14,14,12,11,11,9,12,9,14,8,13,13,11,14,14,16,13,9,15,13,14,13,7,7,11,14,10,15,13,11,15,10,11,16,2,2,1,1,3,2,1,1,1,3,3
"5681",24060277,"Stipe Biuk","12/26/2002 (20 years old)","M (L), AM (RLC)","LAFC","Major League Soccer","CRO","Yes","12/30/2022","12/31/2026","$8M - $9.8M","Right","Reasonable","Very Strong","6'0""","167 lbs","84","10",113,155,10,12,14,11,12,11,9,10,5,6,12,11,8,13,10,11,11,12,9,9,13,14,10,12,7,12,12,11,13,14,12,12,12,12,10,10,9,13,12,12,13,12,8,13,7,7,12,12,10,2,2,3,2,3,1,2,1,3,1,3
"5682",24039948,"Nikola Vlašić","10/4/1997 (25 years old)","AM (RLC)","West Ham","English Premier Division","CRO","Yes","8/31/2021","6/30/2026","$24M - $37M","Right","Reasonable","Very Strong","5'10""","174 lbs","237","45",142,155,12,12,16,14,15,12,9,14,4,7,15,13,8,14,13,14,11,13,13,15,17,14,13,14,6,11,14,12,15,14,15,10,17,14,12,12,10,16,15,13,14,11,6,15,6,5,13,15,15,3,4,2,1,4,3,1,1,1,3,3
"5683",2000065728,"Gabriel Vidović","12/1/2003 (19 years old)","M (C), AM (LC), ST (C)","FC Bayern","Bundesliga","CRO","Yes","2/23/2022","6/30/2025","$450K - $4.4M","Right","Reasonable","Very Strong","5'11""","156 lbs","62","25",114,154,12,9,14,11,13,12,7,12,6,7,13,13,8,15,9,12,9,12,9,10,12,17,7,12,7,11,13,12,12,13,11,9,13,13,12,8,14,12,14,13,10,14,7,12,3,6,12,15,10,2,2,1,1,3,2,1,1,1,3,3
"5684",24000971,"Dejan Lovren","7/5/1989 (33 years old)","D (C)","OL","Ligue 1 Uber Eats","CRO","Yes","1/2/2023","6/30/2025","Not for Sale","Right","Reasonable","Very Strong","6'2""","185 lbs","388","15",134,153,7,7,9,8,12,7,15,7,10,14,14,8,14,13,14,15,15,13,11,12,15,9,14,9,15,13,10,12,12,11,14,15,11,12,13,14,5,13,10,14,12,14,11,13,14,12,11,14,15,1,2,3,3,2,2,3,1,1,1,2
"5685",24021244,"Mario Pašalić","2/9/1995 (28 years old)","M/AM (C)","Atalanta","Italian Serie A","CRO","Yes","9/1/2020","6/30/2025","$12M","Right","Strong","Very Strong","6'2""","180 lbs","286","64",142,152,8,10,13,14,14,7,12,14,4,8,14,9,12,14,13,16,12,12,10,13,13,11,11,16,9,14,13,13,13,13,14,14,13,13,12,12,14,15,14,17,13,17,8,12,12,6,13,16,15,3,1,2,2,2,3,2,2,1,1,3
"5686",24004434,"Andrej Kramarić","6/19/1991 (31 years old)","M/AM (C), ST (C)","TSG Hoffenheim","Bundesliga","CRO","Yes","3/12/2022","6/30/2025","Not for Sale","Right","Fairly Strong","Very Strong","5'10""","160 lbs","368","170",143,152,13,12,13,13,16,16,13,12,6,8,14,16,8,16,13,13,11,16,11,13,13,16,13,13,8,12,14,15,13,14,12,10,13,13,14,11,14,15,8,16,12,17,9,16,8,13,13,15,10,2,1,1,3,2,1,4,3,4,2,1
"5687",24025298,"Dominik Livaković","1/9/1995 (28 years old)","GK","Dinamo","Croatian First League","CRO","Yes","2/9/2021","6/15/2024","$7.4M - $11.5M","Right","Reasonable","Very Strong","6'2""","174 lbs","309","-",146,151,4,1,3,3,10,8,7,2,2,3,13,2,9,9,4,16,10,14,15,14,13,8,14,4,16,14,11,9,12,16,12,14,13,11,12,13,13,15,17,18,13,18,4,16,3,2,16,13,12,14,11,18,16,19,13,13,4,9,8,14
"5688",91190673,"Josip Stanišić","4/2/2000 (23 years old)","D (RLC), WB (R)","FC Bayern","Bundesliga","CRO","Yes","11/12/2022","6/30/2026","$4.2M - $8M","Right","Fairly Strong","Very Strong","6'2""","169 lbs","71","1",135,150,3,12,12,7,12,3,13,6,12,13,13,6,15,12,13,12,16,12,14,13,16,11,6,11,13,16,12,15,12,11,13,13,13,15,14,13,18,12,12,18,12,16,9,14,8,6,15,14,13,3,4,3,2,2,1,2,1,3,2,4
"5689",24003525,"Domagoj Vida","4/29/1989 (34 years old)","D (C)","AEK","Greek Super League 1","CRO","Yes","7/31/2022","6/30/2024","$1.8M - $3.7M","Right","Reasonable","Very Strong","6'0""","167 lbs","407","38",130,150,3,9,10,8,11,5,16,6,9,14,11,7,15,12,17,14,17,12,12,12,18,5,16,9,13,15,9,14,12,10,15,14,17,10,12,16,8,12,12,15,15,16,8,13,13,7,14,17,15,4,1,1,1,3,2,2,1,1,2,1
"5690",13185639,"Ahmed Refaat","6/20/1993 (29 years old)","M (L), AM (RL)","Future","Egyptian Premier League","EGY","No","10/7/2021","7/31/2025","$275K - $2.7M","Right","Fairly Strong","Very Strong","5'10""","152 lbs","178","43",120,135,11,14,16,13,12,14,6,10,2,3,12,14,6,16,6,11,5,10,9,12,17,13,4,11,4,9,12,11,16,15,14,7,9,14,10,8,7,10,12,4,4,7,7,16,4,11,13,16,14,1,3,1,2,2,4,1,1,1,1,2
"5691",662876,"Nikola Kalinić","1/5/1988 (35 years old)","ST (C)","Hajduk","Croatian First League","CRO","Yes","2/6/2022","6/30/2024","$45K - $450K","Right","Fairly Strong","Very Strong","6'2""","176 lbs","403","138",120,149,5,8,10,12,13,5,14,12,3,4,12,14,5,12,13,15,12,12,11,13,15,13,9,16,3,17,11,15,11,12,14,15,15,10,11,14,4,13,6,13,10,8,11,12,12,15,11,15,13,3,3,2,2,2,3,3,1,2,4,2
"5692",2000120836,"Domagoj Bukvić","2/22/2004 (19 years old)","AM (RL)","Osijek","Croatian First League","CRO","Yes","7/6/2022","6/30/2025","$80K - $8M","Left","Very Strong","Weak","5'6""","134 lbs","29","3",109,149,10,13,15,10,14,7,7,9,10,7,12,7,7,13,10,11,13,12,11,11,12,15,8,11,6,12,12,10,13,14,10,8,13,12,12,8,15,10,14,16,15,13,13,10,5,8,12,12,14,2,3,1,1,2,1,2,2,2,3,2
"5693",2000056885,"Gabrijel Rukavina","1/16/2004 (19 years old)","AM (RL)","Dinamo","Croatian First League","CRO","Yes","1/18/2022","1/18/2028","$140K - $425K","Right","Reasonable","Very Strong","5'11""","165 lbs","33","4",104,149,7,8,12,11,12,7,7,8,4,3,8,10,5,12,12,10,11,8,9,7,11,13,5,11,4,9,8,11,17,17,10,9,13,15,9,7,12,10,8,13,9,12,13,7,8,6,7,12,18,2,2,2,3,1,3,3,2,3,1,1
"5694",2000199684,"Marin Šotiček","9/18/2004 (18 years old)","AM (RL)","Jarun","Croatian Second League","CRO","Yes","3/1/2023","6/15/2024","$425K - $4.3M","Right","Fairly Strong","Very Strong","5'9""","147 lbs","16","2",105,149,9,10,13,10,14,9,7,10,5,5,11,10,6,13,10,11,8,13,7,10,14,14,4,13,6,10,10,13,14,14,9,9,6,12,11,8,11,11,10,13,14,9,8,10,5,4,11,15,12,2,2,2,2,4,2,1,2,1,2,1
"5695",24053458,"Lovro Majer","1/17/1998 (25 years old)","M/AM (RC)","Rennes","Ligue 1 Uber Eats","CRO","Yes","10/22/2022","6/30/2027","$29M - $44M","Left","Very Strong","Reasonable","5'10""","165 lbs","182","35",142,148,15,15,16,11,15,15,8,12,6,9,16,16,11,17,12,14,11,13,12,13,13,16,10,12,11,13,16,15,13,16,11,8,15,11,16,8,12,11,11,14,12,12,8,12,9,8,13,14,12,3,3,3,2,1,1,3,2,1,1,2
"5696",24057528,"Mario Vušković","11/16/2001 (21 years old)","D (C), DM","HSV","Bundesliga 2","CRO","Yes","3/15/2022","6/30/2025","$900K - $10M","Right","Reasonable","Very Strong","6'2""","176 lbs","100","7",120,148,6,9,11,7,12,15,12,12,15,13,13,13,12,12,13,12,12,14,12,12,15,11,13,8,13,12,12,12,12,11,13,13,14,12,12,13,10,9,7,10,12,12,5,10,11,12,13,13,12,1,1,1,2,3,3,3,1,1,2,2
"5697",24057195,"Hrvoje Smolčić","8/17/2000 (22 years old)","D (LC)","Eintracht Frankfurt","Bundesliga","CRO","Yes","7/1/2022","6/30/2027","$5.8M - $7.4M","Left","Very Strong","Reasonable","6'0""","176 lbs","77","1",125,148,3,11,11,6,11,4,15,7,11,13,12,7,13,11,15,13,16,13,12,12,15,8,14,8,13,14,11,12,12,11,13,15,11,12,12,15,12,10,12,13,12,12,11,12,6,6,12,13,10,1,2,4,2,2,2,3,1,3,1,1
"5698",24060471,"Nikola Čavlina","6/2/2002 (21 years old)","GK","Lokomotiva","Croatian First League","CRO","Yes","7/26/2022","6/30/2027","$300K - $3M","Right","Reasonable","Very Strong","6'4""","180 lbs","56","-",112,147,3,2,1,3,10,6,6,1,1,2,13,2,1,8,13,12,12,10,11,9,14,8,12,3,12,11,8,8,10,13,10,14,13,10,10,13,11,7,9,13,13,14,6,13,9,6,13,14,11,10,9,15,10,14,11,12,12,14,11,14
"5699",24039943,"Ivo Grbić","1/18/1996 (27 years old)","GK","A. Madrid","Spanish First Division","CRO","Yes","8/20/2020","6/30/2024","$7M - $8.8M","Right","Reasonable","Very Strong","6'5""","182 lbs","162","-",138,147,5,3,1,3,8,8,8,2,1,2,11,3,1,6,11,16,13,14,14,11,14,1,12,2,16,12,6,10,12,12,13,17,9,11,12,16,13,15,12,16,15,11,8,11,8,4,12,13,12,11,12,14,12,14,12,13,7,12,17,15
"5700",24060250,"Nediljko Labrović","10/10/1999 (23 years old)","GK","Rijeka","Croatian First League","CRO","Yes","6/9/2021","6/15/2025","$600K - $6M","Right Only","Weak","Very Strong","6'5""","200 lbs","157","-",130,146,3,1,2,1,6,7,5,3,3,3,7,2,1,5,10,14,14,10,12,11,12,4,14,3,15,14,5,9,12,14,14,16,13,12,12,14,10,10,10,14,14,14,5,12,6,6,14,13,19,11,9,16,18,14,10,12,8,15,14,14
"5701",2000118647,"Mostafa Shalaby","11/8/1995 (27 years old)","M (RLC), AM (LC)","Zamalek","Egyptian Premier League","EGY","No","10/10/2022","7/31/2026","$150K - $1.5M","Left","Very Strong","Fairly Strong","6'1""","169 lbs","57","12",114,135,7,10,11,12,11,8,8,10,8,7,11,6,8,13,15,11,8,10,8,13,17,15,10,12,9,9,9,7,13,13,9,8,12,13,12,8,12,16,4,12,13,9,12,13,8,4,16,11,9,1,2,3,1,1,1,2,1,4,1,3
"5702",24053167,"Petar Musa","3/4/1998 (25 years old)","ST (C)","Benfica","Portuguese Premier League","CRO","Yes","5/20/2022","6/30/2027","$9.6M - $12M","Right","Fairly Strong","Very Strong","6'3""","178 lbs","178","48",139,146,6,8,10,16,14,4,14,12,7,7,12,13,6,12,15,13,16,14,14,13,15,12,7,13,7,14,13,14,13,11,16,15,12,14,14,16,7,8,12,14,13,12,10,10,9,9,14,13,10,4,2,3,2,1,2,1,1,1,2,2
"5703",24039513,"Marko Pjaca","5/6/1995 (28 years old)","AM (RLC), ST (C)","Juventus","Italian Serie A","CRO","Yes","6/15/2020","6/30/2024","$0","Right","Fairly Strong","Very Strong","6'1""","176 lbs","230","38",123,145,8,12,15,13,14,11,10,14,5,5,13,13,7,15,12,11,9,10,8,10,12,16,8,13,7,10,13,11,13,11,14,12,12,13,10,13,14,16,10,15,9,10,15,14,5,5,10,14,9,3,4,2,2,2,3,1,1,3,2,1
"5704",24061498,"Dion Drena Beljo","3/1/2002 (21 years old)","AM (C), ST (C)","Augsburg","Bundesliga","CRO","Yes","1/13/2023","6/30/2027","$1.1M - $12.5M","Left","Very Strong","Fairly Strong","6'5""","185 lbs","111","35",121,145,3,7,12,14,12,7,13,11,6,6,11,14,6,13,13,14,13,12,12,12,15,14,7,13,6,11,11,13,11,12,13,15,14,12,13,15,10,13,13,16,12,14,7,11,7,11,12,15,11,2,1,1,4,1,3,1,2,3,2,2
"5705",2000078300,"Veldin Hodža","10/15/2002 (20 years old)","DM, M (C)","Rijeka","Croatian First League","CRO","Yes","7/25/2022","6/15/2025","$500K - $5.2M","Right","Fairly Strong","Very Strong","6'0""","163 lbs","79","2",109,145,7,8,9,7,12,8,10,10,8,13,12,9,10,12,12,13,12,11,11,12,13,8,9,10,12,14,12,13,11,10,11,12,15,12,15,12,12,11,9,12,10,12,6,10,9,6,8,12,16,1,2,1,2,3,3,3,1,2,3,2
"5706",24046837,"Josip Brekalo","6/23/1998 (24 years old)","M (L), AM (RLC)","Fiorentina","Italian Serie A","CRO","Yes","1/28/2023","6/30/2026","$8.8M - $10.5M","Right","Fairly Strong","Very Strong","5'9""","154 lbs","188","25",135,145,14,12,15,12,15,15,6,16,4,4,13,10,4,15,8,13,8,12,10,13,10,16,3,14,4,9,14,8,15,16,11,7,13,15,13,9,14,12,8,7,15,7,9,12,5,17,10,12,13,1,3,1,1,3,1,3,2,1,3,3
"5707",24048099,"Borna Sosa","1/21/1998 (25 years old)","D/WB/M (L)","VfB Stuttgart","Bundesliga","CRO","Yes","11/27/2020","6/30/2025","$7.2M - $9.2M","Left","Very Strong","Reasonable","6'2""","174 lbs","146","4",136,145,16,18,13,8,15,15,8,11,16,10,14,8,12,15,13,12,11,14,10,12,13,14,12,15,11,14,14,12,13,12,14,12,12,14,14,11,11,12,11,15,14,12,12,16,7,8,12,17,14,2,2,1,1,3,2,1,2,2,3,2
"5708",24054803,"Domagoj Bradarić","12/10/1999 (23 years old)","D/WB (L)","Salernitana","Italian Serie A","CRO","Yes","7/15/2022","6/30/2026","$1M - $6M","Left","Very Strong","Reasonable","5'10""","152 lbs","153","5",129,145,12,12,13,7,13,10,7,10,13,11,13,8,13,13,12,14,12,11,12,10,15,12,11,13,12,14,10,15,15,15,9,8,14,14,16,7,13,12,8,9,10,12,10,12,12,11,13,12,17,2,2,2,3,2,3,3,3,2,2,2
"5709",2000054378,"Marin Ljubičić","2/28/2002 (21 years old)","ST (C)","LASK","Austrian Premier Division","CRO","Yes","12/23/2022","6/30/2027","$650K - $11M","Right","Fairly Strong","Very Strong","6'0""","171 lbs","65","15",115,145,7,8,10,14,13,7,11,12,8,5,10,7,7,10,13,13,13,9,11,10,15,11,9,14,6,13,9,14,13,13,12,12,14,14,11,13,5,11,10,12,8,12,7,8,11,6,11,13,14,2,4,1,2,1,4,3,1,3,3,1
"5710",24012760,"Marko Livaja","8/26/1993 (29 years old)","AM (LC), ST (C)","Hajduk","Croatian First League","CRO","Yes","7/14/2022","6/30/2027","$5.8M - $9M","Right","Strong","Very Strong","6'0""","176 lbs","278","90",142,144,13,13,14,15,15,12,12,13,4,4,13,17,5,15,11,14,12,15,10,11,11,17,13,14,6,11,14,10,14,11,18,11,12,12,12,15,9,13,11,8,13,13,11,12,13,16,9,12,14,2,2,4,3,2,1,2,3,1,1,1
"5711",2000130512,"Luka Vrbančić","7/4/2005 (17 years old)","M/AM (C)","Dinamo","Croatian First League","CRO","Yes","6/5/2023","6/19/2024","$220K - $8.4M","Right","Reasonable","Very Strong","5'11""","156 lbs","-","-",103,144,11,10,13,10,13,11,8,12,5,11,13,12,9,14,13,13,14,11,7,10,16,13,12,12,10,15,12,12,9,10,11,9,14,12,12,10,9,12,14,14,12,17,7,7,10,4,12,15,18,1,3,3,2,1,1,3,1,2,3,3
"5712",12041043,"Ahmed Hassan","3/5/1993 (30 years old)","ST (C)","Olympiacos","Greek Super League 1","EGY","Yes","8/21/2020","6/30/2024","$0","Right","Fairly Strong","Very Strong","6'3""","187 lbs","244","86",115,135,8,8,12,14,12,8,15,10,6,7,11,13,7,12,10,13,14,12,13,12,12,11,7,14,8,15,12,12,9,9,13,16,12,11,14,15,6,16,16,14,12,12,10,12,6,6,12,11,13,1,4,1,2,1,1,1,2,3,3,1
"5713",24039427,"Duje Ćaleta-Car","9/17/1996 (26 years old)","D (C)","Southampton","Sky Bet Championship","CRO","Yes","9/1/2022","6/30/2026","$375K - $3.8M","Right","Reasonable","Very Strong","6'4""","196 lbs","251","13",134,144,5,5,8,7,13,8,14,10,8,14,13,8,14,9,14,15,15,12,12,13,15,10,13,8,14,14,12,14,11,10,15,15,14,11,14,16,6,13,14,14,12,10,12,13,11,8,14,13,14,2,3,3,2,1,2,2,1,3,3,1
"5714",24051702,"Luka Ivanušec","11/26/1998 (24 years old)","M/AM (RLC)","Dinamo","Croatian First League","CRO","Yes","8/31/2021","6/15/2026","$6.6M - $10M","Right","Reasonable","Very Strong","5'9""","167 lbs","189","34",137,144,10,10,16,13,13,13,7,13,5,6,14,13,9,14,14,12,11,11,9,10,16,13,11,14,8,13,13,14,16,14,18,7,13,12,13,13,17,10,10,13,13,14,7,12,7,6,12,14,7,3,1,2,1,2,3,1,1,1,1,3
"5715",2000262919,"Luka Vušković","2/24/2007 (16 years old)","D (C)","Hajduk","Croatian First League","CRO","Yes","7/1/2021","6/30/2026","$12M - $15M","Right","Fairly Strong","Very Strong","6'4""","189 lbs","8","-",92,144,5,7,11,8,12,8,13,12,9,11,12,11,11,11,11,12,12,11,7,8,13,13,11,9,11,11,10,11,9,7,7,15,13,10,12,14,12,8,8,11,12,12,10,20,5,8,8,14,17,1,3,2,3,3,3,2,2,1,2,2
"5716",2000266176,"Tomas Baković","3/29/2007 (16 years old)","DM, M (C)","Dinamo","Croatian First League","CRO","Yes","3/10/2023","6/30/2027","$350K - $3.6M","Right","Reasonable","Very Strong","5'9""","132 lbs","-","-",81,144,9,8,10,8,12,9,8,9,4,8,14,7,7,11,9,10,10,12,8,8,12,11,9,11,10,12,13,11,9,11,10,10,12,8,11,7,13,9,10,9,12,8,6,10,9,2,9,11,9,4,1,2,3,1,2,2,3,3,3,3
"5717",43212365,"Martin Erlić","1/24/1998 (25 years old)","D (C)","Sassuolo","Italian Serie A","CRO","Yes","8/31/2021","6/30/2026","$6M - $11M","Right","Reasonable","Very Strong","6'4""","182 lbs","134","6",134,143,4,6,8,7,11,6,14,8,13,13,14,8,13,11,14,14,14,13,14,13,15,12,13,8,14,13,11,14,12,12,14,15,13,14,15,14,12,10,10,15,13,13,11,10,11,6,12,14,15,1,3,1,3,2,3,1,3,1,1,3
"5718",24014057,"Mislav Oršić","12/29/1992 (30 years old)","M/AM (L), ST (C)","Southampton","Sky Bet Championship","CRO","Yes","1/6/2023","6/30/2026","$4.3M - $8.2M","Right","Reasonable","Very Strong","5'10""","152 lbs","367","115",140,143,16,11,11,16,12,14,7,18,4,6,11,14,8,13,6,11,5,11,11,9,13,13,4,16,11,10,11,14,16,16,14,10,16,17,12,8,13,12,16,18,17,17,7,18,6,2,9,12,8,3,2,3,1,3,3,2,1,1,2,3
"5719",24003746,"Ante Budimir","7/22/1991 (31 years old)","ST (C)","Atlético Pamplona","Spanish First Division","CRO","Yes","10/5/2020","6/30/2025","Not for Sale","Left","Very Strong","Weak","6'3""","165 lbs","387","118",135,142,6,8,10,15,11,4,17,10,3,7,12,16,12,12,13,16,14,14,13,13,16,13,5,16,12,14,10,14,11,11,15,16,15,12,14,18,8,12,12,13,10,8,7,12,8,7,14,13,11,3,3,1,3,2,2,2,2,1,3,3
"5720",2000135490,"Fabijan Krivak","2/24/2005 (18 years old)","DM, M/AM (C)","Jarun","Croatian Second League","CRO","Yes","6/15/2022","6/15/2024","$475K - $4.8M","Left","Very Strong","Reasonable","6'0""","167 lbs","14","1",95,142,9,8,11,7,13,8,10,9,7,9,13,8,10,13,12,12,11,14,10,8,14,11,7,9,9,12,13,11,11,13,10,10,13,12,11,10,14,10,10,13,12,10,11,4,9,6,12,14,15,2,3,1,3,1,1,1,3,1,1,2
"5721",2000045802,"Roko Šimić","9/10/2003 (19 years old)","ST (C)","Zürich","Swiss Super League","CRO","Yes","10/10/2021","6/30/2025","$6.6M - $9.8M","Right","Reasonable","Very Strong","6'3""","176 lbs","75","26",121,142,7,8,12,11,13,10,12,12,4,4,9,13,6,13,14,12,13,12,12,10,16,12,9,14,5,12,11,15,14,13,13,14,15,13,12,12,9,9,10,13,13,12,5,9,6,5,12,16,16,2,2,1,1,1,3,2,2,3,2,3
"5722",24047634,"Josip Juranović","8/16/1995 (27 years old)","D/WB (RL)","Union Berlin","Bundesliga","CRO","Yes","1/22/2023","6/30/2027","$10.5M - $15.5M","Right","Reasonable","Very Strong","5'8""","149 lbs","253","33",137,142,15,14,12,8,12,15,7,10,16,10,12,16,11,13,14,13,13,13,12,12,17,12,12,13,11,13,12,13,15,13,12,7,16,15,15,11,17,14,19,16,12,16,5,15,8,6,13,12,18,2,2,2,2,2,1,1,1,3,2,1
"5723",18084626,"Zizo","1/10/1996 (27 years old)","M (C), AM (RLC)","Zamalek","Egyptian Premier League","EGY","No","6/15/2020","7/31/2025","$7.2M - $11M","Right","Reasonable","Very Strong","5'9""","147 lbs","211","43",134,148,12,14,16,14,14,14,7,12,5,8,14,17,11,17,12,12,14,12,14,11,11,14,11,11,8,13,15,15,14,13,12,8,12,14,13,8,13,11,8,9,12,11,10,13,13,14,14,11,10,1,2,1,1,3,2,1,2,1,3,3
"5724",95074523,"Mohamed Reda","11/10/2000 (22 years old)","M/AM (C)","Future","Egyptian Premier League","EGY","No","9/1/2022","6/30/2026","$110K - $1.1M","Right","Reasonable","Very Strong","6'2""","178 lbs","110","9",110,135,7,10,14,14,16,11,10,14,7,6,16,8,11,14,10,10,9,9,10,16,6,15,14,14,13,12,12,12,7,11,13,13,7,9,7,7,17,14,3,11,12,12,9,13,11,6,20,10,12,3,4,2,3,2,3,3,3,1,2,1
"5725",24060905,"Ivor Pandur","3/25/2000 (23 years old)","GK","Hellas Verona","Italian Serie A","CRO","Yes","8/31/2020","6/30/2027","$0","Right Only","Weak","Very Strong","6'2""","180 lbs","57","-",125,141,1,2,3,2,8,1,5,3,1,3,10,2,2,9,8,12,13,12,13,12,13,6,14,4,14,12,8,12,10,13,11,16,16,12,10,12,1,17,12,15,12,10,7,11,7,2,13,11,14,13,11,13,14,13,12,14,8,12,13,15
"5726",2000065061,"Oscar Gloukh","4/1/2004 (19 years old)","M/AM (C), ST (C)","FC RB Salzburg","Austrian Premier Division","ISR","No","1/27/2023","6/30/2027","$16M - $19M","Right","Strong","Very Strong","5'7""","132 lbs","39","9",124,179,11,11,13,11,13,10,8,11,7,6,13,12,6,14,7,12,13,13,12,10,13,14,10,13,6,12,12,12,12,14,13,5,14,12,13,7,10,14,12,14,16,11,5,13,7,8,13,15,15,1,3,2,1,2,2,2,3,4,4,2
"5727",2000188095,"Idan Toklomati","8/9/2004 (18 years old)","AM (RLC), ST (C)","Maccabi Petach-Tikva","Israeli Premier League","ISR","No","8/26/2022","5/31/2027","$110K - $1.1M","Right","Reasonable","Very Strong","6'0""","167 lbs","32","11",110,159,6,8,12,13,11,9,10,9,10,6,12,8,7,11,13,12,10,8,11,11,12,13,7,13,6,12,13,13,13,14,9,13,13,12,13,12,10,13,15,13,12,12,7,11,5,5,12,12,11,2,1,1,3,1,4,3,1,2,4,3
"5728",42102601,"Liel Abada","10/3/2001 (21 years old)","AM (R), ST (C)","Celtic","cinch Premiership","ISR","Yes","7/14/2021","5/31/2026","$32M - $38M","Right","Fairly Strong","Very Strong","5'7""","145 lbs","127","40",129,158,11,12,13,13,12,10,7,9,9,3,12,9,7,13,12,15,10,12,10,13,15,12,12,13,8,11,13,12,15,13,11,7,14,14,14,12,6,13,11,12,13,10,4,15,7,10,14,15,16,2,2,2,3,1,1,3,1,1,2,2
"5729",42002173,"Eran Zahavi","7/25/1987 (35 years old)","AM (LC), ST (C)","Maccabi Tel-Aviv","Israeli Premier League","ISR","Yes","6/26/2022","5/31/2024","$300K - $900K","Right","Fairly Strong","Very Strong","5'11""","158 lbs","469","270",132,152,11,11,12,15,14,14,11,13,7,7,14,14,7,12,11,14,13,15,14,13,19,14,17,14,9,13,13,15,10,12,12,10,10,11,12,12,15,13,10,17,17,13,9,16,7,13,16,15,16,3,2,1,3,3,3,3,2,2,2,1
"5730",42005879,"Eyal Golasa","10/7/1991 (31 years old)","DM, M/AM (C)","Maccabi Tel-Aviv","Israeli Premier League","ISR","Yes","6/8/2023","5/31/2024","$20K - $200K","Right","Reasonable","Very Strong","5'10""","165 lbs","317","25",102,150,8,6,11,9,11,8,5,6,10,11,10,12,11,12,13,13,12,11,11,12,11,11,9,10,12,13,12,14,12,9,10,8,7,11,13,12,11,14,12,13,12,11,16,12,6,10,12,11,8,2,3,1,2,2,1,2,1,3,2,3
"5731",42083355,"Daniel Peretz","7/10/2000 (22 years old)","GK","Maccabi Tel-Aviv","Israeli Premier League","ISR","Yes","9/12/2021","5/31/2024","$950K - $5.8M","Right","Reasonable","Very Strong","6'3""","171 lbs","103","2",130,150,2,2,11,2,11,1,8,3,3,4,12,13,10,11,12,12,13,13,12,12,15,10,13,1,13,12,11,14,10,14,12,16,15,10,12,13,1,11,11,14,15,16,5,15,10,6,15,14,11,16,14,15,11,13,13,13,11,12,12,12
"5732",42074464,"Eden Kartsev","4/11/2000 (23 years old)","D (R), DM, M/AM (C)","Başakşehir FK","Turkish Super League","ISR","No","1/31/2023","6/30/2027","$9.2M - $14M","Right","Reasonable","Very Strong","6'2""","187 lbs","107","12",115,150,8,8,10,8,11,11,10,12,14,11,10,8,12,10,15,13,15,10,10,10,15,10,13,10,12,14,11,16,9,12,13,13,15,12,13,14,12,8,8,10,11,9,11,14,13,11,9,15,11,2,2,1,3,1,2,1,2,1,2,1
"5733",42077304,"Manor Solomon","7/24/1999 (23 years old)","AM (RLC)","Shakhtar","Ukrainian Premier League","ISR","Yes","6/14/2021","6/30/2027","$0","Right","Reasonable","Very Strong","5'6""","138 lbs","162","28",135,146,10,14,17,13,14,14,8,13,10,8,14,2,8,15,7,13,11,15,12,12,15,11,9,12,8,10,12,10,13,13,13,7,13,14,14,13,11,10,13,14,10,5,10,12,5,7,10,13,13,3,2,4,1,1,3,2,1,2,1,4
"5734",42009301,"Hatem Abd Elhamed","3/18/1991 (32 years old)","D (RC), WB (R), DM","Hapoel Be'er-Sheva","Israeli Premier League","ISR","No","2/7/2021","5/31/2024","$0","Right","Weak","Very Strong","6'1""","176 lbs","247","9",108,145,7,11,12,6,10,7,10,10,6,12,11,11,12,12,15,11,12,10,8,9,14,13,13,12,12,8,12,13,14,11,15,13,14,14,12,15,18,8,12,12,12,9,11,15,10,8,10,17,4,1,2,2,3,1,1,1,2,3,3,1
"5735",13228708,"Hamdi Fathi","9/29/1994 (28 years old)","DM, M (C)","Al-Ahly","Egyptian Premier League","EGY","No","1/12/2019","6/30/2025","$600K - $6.2M","Right","Fairly Strong","Very Strong","5'11""","167 lbs","196","18",130,135,6,6,12,10,12,6,14,12,5,13,14,7,16,10,14,12,15,12,13,12,7,8,11,12,14,15,12,14,12,11,10,13,13,13,16,13,14,18,4,12,10,9,6,12,14,6,15,9,11,1,1,1,2,2,3,2,1,2,1,2
"5736",42024353,"Munas Dabbur","5/14/1992 (31 years old)","ST (C)","TSG Hoffenheim","Bundesliga","ISR","No","1/7/2020","6/30/2025","$1.6M - $3.4M","Right","Fairly Strong","Very Strong","6'0""","171 lbs","328","131",130,145,11,9,13,12,15,11,13,12,5,7,14,12,8,15,15,14,12,15,13,13,14,14,12,14,8,15,14,12,11,13,12,12,13,12,13,12,7,8,8,12,10,10,9,13,8,11,11,12,8,2,1,1,3,3,2,3,1,4,1,3
"5737",42068311,"Eylon Almog","1/8/1999 (24 years old)","AM (RLC), ST (C)","Maccabi Tel-Aviv","Israeli Premier League","ISR","Yes","6/1/2023","5/31/2024","$85K - $850K","Right","Strong","Very Strong","5'11""","167 lbs","119","18",109,145,8,11,13,12,13,9,9,13,7,7,12,13,8,13,11,10,13,5,5,5,15,12,12,13,8,11,10,13,12,12,14,10,14,13,13,14,12,13,14,15,4,9,8,12,10,5,5,6,11,4,1,2,1,1,3,1,2,3,3,2
"5738",7862103,"Tomer Hemed","5/2/1987 (36 years old)","ST (C)","Hapoel Be'er-Sheva","Israeli Premier League","ISR","Yes","7/3/2022","5/31/2024","$3K - $28K","Right","Fairly Strong","Very Strong","6'1""","176 lbs","458","117",103,144,6,8,8,14,12,6,15,10,7,7,13,16,5,11,14,13,14,13,14,13,15,8,15,10,8,15,11,11,8,8,13,13,11,7,12,15,6,13,14,17,13,9,5,14,7,12,11,16,17,3,3,1,3,3,1,3,4,3,2,1
"5739",7868191,"Bibars Natcho","2/18/1988 (35 years old)","DM, M/AM (C)","Partizan","Serbian SuperLeague","ISR","No","11/30/2022","6/30/2024","$16K - $150K","Right","Strong","Very Strong","5'9""","160 lbs","449","95",128,141,13,12,12,12,14,14,8,13,6,8,16,18,8,16,10,13,12,14,13,14,14,13,13,11,8,14,16,10,10,11,11,7,12,10,11,9,9,14,15,18,15,12,6,13,5,6,14,15,13,2,3,2,3,1,3,4,3,1,2,3
"5740",42095244,"Hamode Kanaan","1/14/2000 (23 years old)","M/AM (RLC), ST (C)","S.C. Ashdod","Israeli Premier League","ISR","No","8/4/2020","5/31/2025","$275K - $2.8M","Right","Reasonable","Very Strong","5'10""","171 lbs","104","18",121,140,9,8,14,11,13,7,9,13,7,7,13,14,8,12,11,12,11,12,12,12,12,13,13,12,10,12,12,13,13,14,11,8,10,12,8,10,12,5,7,9,11,7,15,8,10,12,11,15,9,1,3,1,2,1,3,3,3,2,1,2
"5741",42039799,"Omer Atzili","7/27/1993 (29 years old)","M (RL), AM (RLC), ST (C)","Maccabi Haifa","Israeli Premier League","ISR","Yes","1/19/2021","5/31/2025","$210K - $2.1M","Left","Very Strong","Weak","5'10""","149 lbs","292","96",130,140,14,13,13,14,14,14,8,15,5,9,13,15,10,13,13,13,11,9,11,12,15,16,13,15,9,13,14,16,13,13,12,9,10,12,12,11,12,10,9,9,7,8,10,13,4,12,14,10,7,3,2,2,2,1,1,2,3,3,3,3
"5742",42102493,"Dor Turgeman","10/24/2003 (19 years old)","AM (RL), ST (C)","Maccabi Tel-Aviv","Israeli Premier League","ISR","No","6/11/2023","5/31/2026","$1.7M - $3.6M","Right","Fairly Strong","Very Strong","6'2""","174 lbs","42","4",105,140,10,7,12,12,10,10,13,10,5,10,8,14,8,13,12,10,11,13,10,10,14,13,9,6,5,6,7,11,13,12,10,14,14,11,13,10,11,7,10,9,9,10,10,13,11,12,13,13,12,1,1,2,1,1,1,2,2,2,2,4
"5743",42029363,"Dor Micha","2/10/1992 (31 years old)","WB (RL), M/AM (RLC)","Hapoel Be'er-Sheva","Israeli Premier League","ISR","Yes","7/13/2021","5/31/2025","$0","Right","Weak","Very Strong","5'9""","147 lbs","380","33",111,139,10,14,11,6,14,6,7,5,6,7,15,12,7,13,8,11,8,13,12,14,6,14,12,11,8,15,15,8,9,11,11,8,5,9,10,10,16,16,10,8,8,11,9,14,5,4,10,8,8,1,3,1,2,1,3,2,1,2,3,2
"5744",42051387,"Dor Peretz","5/17/1995 (28 years old)","DM, M (C)","Maccabi Tel-Aviv","Israeli Premier League","ISR","Yes","8/15/2022","5/31/2025","$170K - $1.7M","Right","Reasonable","Very Strong","6'1""","158 lbs","222","21",125,138,6,8,10,9,10,9,12,10,11,12,13,11,14,11,11,13,15,13,13,12,13,11,14,15,14,14,12,15,11,11,13,12,13,11,15,14,15,11,12,12,8,15,10,14,5,5,14,13,7,2,2,4,1,4,3,3,1,1,1,1
"5745",2000186457,"Roei Yizhak","1/7/2005 (18 years old)","M/AM (C)","Hapoel Ra'anana","Israeli A League North Division","ISR","No","7/1/2020","5/31/2024","$350K - $1M","Right","Fairly Strong","Very Strong","5'9""","147 lbs","1","-",60,138,6,7,11,7,10,7,7,8,6,5,9,8,5,11,5,7,7,9,8,9,8,13,6,9,7,10,8,10,10,12,13,9,20,7,9,7,12,12,13,11,10,14,12,7,2,2,8,8,9,1,2,2,1,2,2,2,1,3,1,2
"5746",2000068269,"Osama Galal","9/17/1997 (25 years old)","D (C)","Pyramids","Egyptian Premier League","EGY","No","1/31/2021","7/31/2024","$1.4M - $3M","Right","Reasonable","Very Strong","6'0""","167 lbs","71","3",113,135,7,2,5,8,11,3,13,11,6,13,12,8,16,7,12,13,12,9,13,11,12,5,4,11,13,11,10,12,13,13,12,12,13,13,10,9,16,16,8,11,11,10,8,19,12,7,20,10,14,3,2,1,1,2,1,1,2,1,3,1
"5747",7868189,"Beram Kayal","5/2/1988 (35 years old)","DM, M (C)","Bnei Sakhnin","Israeli Premier League","ISR","No","6/14/2021","-","$130K - $400K","Right","Weak","Very Strong","5'10""","163 lbs","387","26",122,138,7,8,9,7,14,8,10,10,4,11,13,11,15,13,17,13,17,12,14,13,14,12,13,11,12,15,12,15,12,12,11,9,12,11,15,13,12,8,8,16,13,16,15,13,13,8,14,13,17,3,3,1,1,1,1,3,3,2,2,2
"5748",89067532,"Oz Bilu","1/16/2001 (22 years old)","AM (RLC)","Maccabi Netanya","Israeli Premier League","ISR","Yes","6/5/2023","5/31/2026","$220K - $2.2M","Left","Very Strong","Reasonable","5'10""","163 lbs","93","4",94,138,10,11,14,7,11,8,7,10,4,5,11,7,6,13,11,10,8,5,8,8,8,13,7,12,5,8,13,10,12,13,12,9,7,13,10,8,12,12,8,12,11,13,5,11,9,12,9,10,17,1,2,2,3,2,2,2,1,2,3,3
"5749",42056072,"Dan Glazer","9/20/1996 (26 years old)","D (C), DM, M (C)","Maccabi Tel-Aviv","Israeli Premier League","ISR","Yes","3/17/2021","5/31/2024","$75K - $750K","Right","Reasonable","Very Strong","5'10""","147 lbs","213","4",115,138,5,5,8,6,7,12,9,10,13,13,8,12,13,9,16,13,15,12,13,13,13,6,14,7,14,14,9,17,11,11,12,10,13,11,16,12,12,12,13,13,10,12,5,14,10,5,14,12,12,2,4,4,2,1,4,1,1,2,2,3
"5750",55004194,"Miguel Vítor","6/30/1989 (33 years old)","D (C)","Hapoel Be'er-Sheva","Israeli Premier League","ISR","Yes","9/5/2022","5/31/2024","$100K - $1M","Right","Weak","Very Strong","6'0""","189 lbs","282","28",122,138,4,7,7,11,12,4,16,3,3,16,12,8,13,8,16,17,12,16,15,14,17,6,16,6,15,14,9,14,7,7,12,15,13,7,13,13,8,14,12,16,16,14,13,14,8,4,19,17,14,4,1,2,1,3,3,1,2,3,1,4
"5751",2000308500,"Or Mesika","4/19/2007 (16 years old)","ST (C)","Hapoel Tel-Aviv","Israeli Premier League","ISR","No","5/12/2023","5/31/2026","$120K - $1.2M","Right","Reasonable","Very Strong","5'11""","143 lbs","-","-",60,137,5,4,12,11,12,5,12,5,3,2,6,9,5,7,10,6,7,11,6,10,4,8,8,9,6,5,6,7,13,13,6,7,14,13,6,4,9,18,13,8,12,12,5,17,5,2,8,11,7,1,3,1,1,4,3,2,3,3,3,1
"5752",2000231531,"Anan Khalaili","9/3/2004 (18 years old)","M/AM (R), ST (C)","Maccabi Haifa","Israeli Premier League","ISR","No","1/19/2023","5/31/2026","$110K - $1.1M","Right","Fairly Strong","Very Strong","6'0""","171 lbs","-","-",112,137,7,10,12,11,11,11,12,11,11,5,9,4,9,12,13,9,13,9,7,8,15,14,7,12,9,8,6,15,16,13,14,13,14,14,11,13,14,13,13,14,11,13,13,6,9,8,11,9,12,3,2,2,2,2,3,3,2,2,2,3
"5753",42094193,"Omri Gandelman","5/16/2000 (23 years old)","D (C), DM, M (C)","Maccabi Netanya","Israeli Premier League","ISR","Yes","1/5/2022","5/31/2025","$2.7M - $5.6M","Left","Very Strong","Fairly Strong","6'2""","180 lbs","100","9",123,137,8,4,6,4,10,6,14,7,8,11,9,12,12,6,12,13,13,14,14,13,11,7,13,10,13,13,7,14,11,10,11,16,9,11,14,13,14,11,12,14,10,10,12,13,7,7,14,10,12,2,2,3,3,2,2,3,3,1,3,3
"5754",2000308498,"Roey Magor","3/12/2007 (16 years old)","DM, M (C)","Maccabi Tel-Aviv","Israeli Premier League","ISR","No","6/13/2022","5/31/2026","$160K - $1.6M","Right","Reasonable","Very Strong","5'9""","143 lbs","-","-",60,136,5,5,5,6,11,5,5,8,1,9,12,3,10,9,9,8,7,7,4,13,12,5,11,6,5,6,10,9,13,12,3,6,11,13,7,8,11,18,10,10,12,10,8,1,9,1,11,14,16,2,3,3,2,3,2,2,2,3,3,1
"5755",42029692,"Dia Saba","11/18/1992 (30 years old)","AM (RC), ST (C)","Maccabi Haifa","Israeli Premier League","ISR","No","1/30/2023","5/31/2026","$275K - $2.7M","Left","Very Strong","Reasonable","5'5""","149 lbs","305","101",125,135,12,12,14,13,15,12,8,13,8,3,14,14,8,15,10,14,8,15,13,12,14,16,8,15,4,10,14,10,13,15,13,2,11,11,12,7,9,8,12,8,6,10,8,13,10,10,11,14,14,1,3,3,1,1,1,3,3,1,1,1
"5756",42099967,"Aviel Zargari","12/11/2002 (20 years old)","DM, M (LC), AM (C)","Maccabi Haifa","Israeli Premier League","ISR","No","1/12/2023","5/31/2025","$35K - $350K","Left","Very Strong","Reasonable","6'0""","176 lbs","56","-",88,135,6,5,8,7,11,9,9,10,7,10,10,5,11,11,10,10,12,11,11,8,11,12,9,11,10,12,10,12,12,11,12,10,12,11,11,10,15,12,12,10,8,11,12,10,10,4,7,12,7,3,3,3,4,3,3,1,2,3,3,3
"5757",13166348,"Tarek Hamed","10/24/1988 (34 years old)","DM, M (C)","Al-Ittihad","Saudi Professional League","EGY","No","7/24/2022","6/30/2024","$0","Right Only","Weak","Very Strong","5'7""","152 lbs","308","5",125,135,8,8,8,5,10,8,9,10,7,13,13,10,16,9,18,15,16,12,12,11,17,7,15,11,15,17,9,17,12,13,14,7,18,12,16,15,6,15,11,17,17,8,6,16,14,2,13,11,11,1,3,1,4,1,2,1,3,2,3,1
"5758",42058078,"Shon Weissman","2/14/1996 (27 years old)","AM (RL), ST (C)","Granada","Spanish First Division","ISR","Yes","8/31/2020","6/30/2025","$140K - $8.6M","Right","Fairly Strong","Very Strong","5'9""","158 lbs","232","81",125,135,5,9,11,14,11,6,12,10,7,6,10,9,9,13,14,13,14,12,13,13,15,12,14,15,9,13,12,15,13,13,13,8,15,12,14,14,12,10,11,12,10,16,12,14,5,11,14,14,14,2,2,4,2,3,1,1,1,2,4,2
"5759",2000011228,"Eitan Azulay","5/26/2002 (21 years old)","DM, M/AM (C)","Maccabi Netanya","Israeli Premier League","ISR","Yes","8/21/2022","5/31/2025","$275K - $2.8M","Right","Fairly Strong","Very Strong","5'10""","169 lbs","82","2",112,135,9,9,12,10,10,9,11,13,10,9,11,10,13,11,15,12,14,10,12,12,15,10,12,12,10,13,11,16,12,12,10,10,15,11,13,12,12,7,9,10,10,7,11,11,6,12,11,9,8,1,2,2,2,1,1,3,3,2,1,3
"5760",42009400,"Nir Bitton","10/30/1991 (31 years old)","D (C), DM, M (C)","Maccabi Tel-Aviv","Israeli Premier League","ISR","Yes","7/2/2022","5/31/2024","$95K - $950K","Right","Fairly Strong","Very Strong","6'5""","176 lbs","319","26",110,135,7,11,11,8,13,10,12,12,7,10,13,14,12,11,10,12,8,10,10,10,9,10,13,11,11,14,13,12,10,9,13,17,12,11,13,12,14,8,12,18,14,15,10,11,9,13,11,10,18,1,1,1,1,1,3,2,3,2,1,2
"5761",42105091,"Doron Leidner","4/26/2002 (21 years old)","D/WB (L)","FK Austria Vienna","Austrian Premier Division","ISR","Yes","7/29/2022","6/30/2026","$350K - $3.4M","Left","Very Strong","Reasonable","5'10""","149 lbs","67","2",110,135,10,13,12,8,11,8,9,10,13,11,12,8,9,13,11,10,10,12,9,10,11,12,8,11,8,12,12,13,14,13,12,10,12,13,13,10,10,6,12,12,10,7,8,11,9,10,10,14,9,3,3,1,1,3,4,2,1,2,3,2
"5762",42058069,"Yonatan Cohen","6/29/1996 (26 years old)","WB/M (L), AM (RLC)","Maccabi Tel-Aviv","Israeli Premier League","ISR","Yes","6/1/2023","5/31/2025","$2.3M - $4.8M","Left","Very Strong","Reasonable","6'1""","167 lbs","208","52",113,135,11,13,12,11,11,12,11,11,5,7,10,14,8,11,12,12,12,11,11,11,13,12,10,11,7,10,10,13,12,12,12,10,7,12,11,12,9,12,12,12,12,12,7,11,4,12,11,13,5,4,1,2,3,3,1,2,3,1,1,2
"5763",42083315,"Shareef Kayouf","6/25/2001 (21 years old)","GK","Maccabi Haifa","Israeli Premier League","ISR","No","4/16/2023","5/31/2025","$100K - $1M","Right","Reasonable","Very Strong","6'2""","187 lbs","65","-",92,135,1,3,2,3,8,5,1,3,3,4,12,2,10,10,5,11,13,10,11,9,12,3,11,3,11,13,7,13,6,8,10,12,11,10,8,14,13,13,11,13,11,12,12,9,7,1,15,13,19,9,11,12,6,12,10,12,10,10,10,13
"5764",42094298,"Osher Davida","2/18/2001 (22 years old)","AM (RLC), ST (C)","Standard","Jupiler Pro League","ISR","No","8/23/2022","6/30/2025","$210K - $2.1M","Left","Very Strong","Reasonable","5'10""","167 lbs","97","11",113,135,11,12,13,10,9,10,9,10,8,11,12,9,11,13,13,11,12,10,10,10,9,13,10,11,11,11,11,13,13,12,11,8,11,13,11,12,13,19,13,10,11,10,7,11,12,4,12,13,11,1,1,1,2,1,1,3,1,1,1,3
"5765",42101552,"Roy Revivo","5/22/2003 (20 years old)","D (LC), WB (L)","Maccabi Tel-Aviv","Israeli Premier League","ISR","No","12/13/2022","5/31/2025","$325K - $3.2M","Left","Very Strong","Fairly Strong","6'0""","171 lbs","16","-",111,135,6,12,12,5,11,4,13,7,11,9,11,11,11,12,13,10,12,11,10,10,12,5,11,10,11,12,11,13,12,11,11,8,15,12,15,11,12,16,14,14,11,13,10,13,10,9,13,13,14,3,1,2,3,2,1,4,2,2,1,1
"5766",42074457,"Yarden Shua","6/16/1999 (23 years old)","M (R), AM (RLC), ST (C)","Beitar Jerusalem","Israeli Premier League","ISR","No","3/19/2023","5/31/2024","$1.6M - $3.4M","Right","Strong","Very Strong","6'1""","180 lbs","153","31",123,135,11,13,11,12,14,11,11,11,5,5,13,14,4,15,9,11,9,12,9,13,11,15,10,12,4,12,15,11,12,12,11,10,12,11,12,12,13,7,10,10,11,8,7,12,9,11,11,12,8,2,2,2,1,3,3,1,1,3,1,1
"5767",42074305,"Assaf Tzur","8/28/1998 (24 years old)","GK","Kiryat-Shmona","Israeli National League","ISR","No","8/16/2022","-","$275K - $800K","Right","Weak","Very Strong","6'5""","187 lbs","84","-",95,135,8,3,3,1,11,12,1,1,1,2,9,12,2,10,9,10,12,9,9,10,7,3,10,1,11,11,8,10,12,13,11,19,14,11,12,10,11,13,13,9,11,10,6,17,9,4,16,12,7,9,8,14,14,13,11,11,5,10,10,11
"5768",13231887,"Mostafa Mohamed","11/28/1997 (25 years old)","ST (C)","Galatasaray","Turkish Super League","EGY","No","7/1/2022","6/30/2025","$5.6M - $7M","Right","Reasonable","Very Strong","6'1""","176 lbs","180","57",129,135,6,8,9,14,11,7,16,12,8,6,11,13,6,11,12,14,16,14,10,10,12,10,7,13,8,12,10,14,12,13,16,16,18,13,14,16,6,13,14,8,6,8,6,14,6,4,12,15,4,4,2,3,1,1,2,3,1,2,1,3
"5769",42104447,"Or Blorian","3/7/2000 (23 years old)","D (C)","Hapoel Be'er-Sheva","Israeli Premier League","ISR","Yes","9/15/2022","5/31/2026","$40K - $400K","Right","Weak","Very Strong","6'2""","189 lbs","81","1",104,135,5,5,7,1,10,3,12,4,6,10,10,9,12,12,15,11,10,11,13,12,12,7,12,11,12,11,11,13,12,12,13,10,18,12,12,13,7,11,12,11,12,12,5,11,14,6,12,10,10,1,3,1,3,3,1,2,2,4,2,4
"5770",2000065116,"Hamza Shibli","8/19/2004 (18 years old)","AM (RLC)","Maccabi Haifa","Israeli Premier League","ISR","No","11/30/2022","5/31/2025","$220K - $2.2M","Right","Fairly Strong","Very Strong","5'6""","123 lbs","-","-",92,134,6,10,13,7,12,7,5,8,10,6,9,6,5,13,8,9,13,8,8,8,13,15,7,12,5,10,11,13,12,15,10,5,14,12,10,5,15,20,13,12,13,11,9,18,6,4,12,14,15,4,4,1,3,1,1,3,1,2,3,2
"5771",42038668,"Gadi Kinda","3/23/1994 (29 years old)","M (RC), AM (RLC)","Sporting KC","Major League Soccer","ISR","No","11/10/2020","12/31/2023","$400K - $3.9M","Right","Strong","Very Strong","5'9""","158 lbs","263","34",128,133,8,10,15,12,14,6,7,11,4,10,13,8,8,13,9,13,6,12,12,14,11,16,7,14,4,13,15,14,13,14,11,8,15,13,12,8,12,5,7,8,6,8,14,13,12,15,13,11,12,2,3,1,3,2,1,3,2,1,3,3
"5772",42078012,"Ofri Arad","9/11/1998 (24 years old)","D (C), DM","Qairat","Kazakhstan Premier League","ISR","Yes","8/25/2021","5/31/2024","$110K - $1.1M","Right","Fairly Strong","Very Strong","6'0""","174 lbs","144","9",103,133,4,3,9,8,11,7,13,6,6,12,12,11,11,10,12,12,13,10,10,12,14,8,13,8,13,13,8,14,10,11,12,11,13,10,14,12,5,12,12,12,12,15,6,10,5,4,12,10,11,1,1,1,1,2,2,2,2,2,3,3
"5773",42058467,"Neta Lavi","8/25/1996 (26 years old)","D (C), DM, M (C)","G-Osaka","J1 League","ISR","Yes","1/27/2023","1/31/2026","$425K - $4.2M","Right","Fairly Strong","Very Strong","5'10""","167 lbs","218","7",131,133,6,9,11,5,12,8,13,8,11,13,13,10,15,11,12,14,13,13,13,13,12,3,11,10,14,14,11,14,12,12,13,10,8,11,14,12,7,7,11,14,9,16,8,13,11,5,14,12,10,1,2,3,1,2,2,3,1,2,2,3
"5774",89067529,"Gil Cohen","11/8/2000 (22 years old)","D (LC), WB (L), DM","S.C. Ashdod","Israeli Premier League","ISR","Yes","7/14/2022","5/31/2025","$1.1M - $2.3M","Left","Very Strong","Fairly Strong","5'9""","163 lbs","119","-",109,133,9,12,11,9,10,10,11,11,9,10,11,9,9,13,12,12,13,12,12,11,12,5,13,7,10,11,8,12,13,12,11,6,12,12,12,8,12,11,11,12,12,12,10,12,9,2,11,11,19,3,3,4,1,2,1,1,3,2,1,3
"5775",2000228327,"Ido Oli","3/12/2006 (17 years old)","M/AM (C)","Maccabi Tel-Aviv","Israeli Premier League","ISR","No","7/1/2021","5/31/2025","$50K - $475K","Right","Fairly Strong","Very Strong","5'5""","132 lbs","-","-",65,132,5,2,11,7,13,3,3,7,3,3,11,4,1,13,10,8,7,5,7,8,15,14,3,13,3,12,8,12,10,9,13,4,12,9,7,6,12,12,10,9,11,11,8,10,5,1,9,11,20,2,1,2,3,3,1,3,1,1,1,2
"5776",91143529,"Joel Abu Hanna","1/22/1998 (25 years old)","D (LC), WB (L)","Legia","PKO Bank Polski Ekstraklasa","ISR","Yes","7/1/2021","6/30/2025","$0","Left","Very Strong","Weak","6'0""","176 lbs","87","1",105,132,4,10,9,6,11,5,12,7,13,14,13,8,13,12,12,12,12,15,10,10,14,10,8,7,9,11,11,12,11,9,14,13,14,13,12,14,10,11,13,13,13,12,13,12,10,6,11,9,7,3,3,3,3,1,3,3,3,2,2,2
"5777",89067500,"Ido Shahar","8/20/2001 (21 years old)","DM, M/AM (C)","Maccabi Tel-Aviv","Israeli Premier League","ISR","No","1/19/2022","5/31/2024","$180K - $1.8M","Right","Fairly Strong","Very Strong","5'7""","154 lbs","96","13",100,132,7,10,10,8,10,11,6,7,7,10,12,14,11,12,12,11,12,12,12,11,12,13,11,11,10,11,13,13,10,11,13,6,14,11,13,11,8,10,11,13,12,11,5,10,9,4,9,12,11,2,3,2,3,3,1,1,2,2,1,1
"5778",2000278590,"Rom Savitch","1/30/2007 (16 years old)","AM (RL), ST (C)","Maccabi Tel-Aviv","Israeli Premier League","ISR","No","7/1/2022","5/31/2026","$150K - $1.5M","Either","Very Strong","Very Strong","5'9""","160 lbs","-","-",64,131,5,9,12,7,8,4,4,5,4,3,6,1,1,7,5,7,4,7,2,8,3,8,1,8,4,5,5,6,12,12,5,7,15,12,4,5,9,10,11,9,12,11,13,19,5,7,13,11,20,3,4,1,2,2,3,1,1,3,3,3
"5779",12020128,"Mohamed El Shenawy","12/18/1988 (34 years old)","GK","Al-Ahly","Egyptian Premier League","EGY","No","7/7/2020","7/31/2025","Not for Sale","Right Only","Weak","Very Strong","6'3""","189 lbs","231","-",132,135,2,3,2,1,10,2,5,2,3,3,10,2,2,9,11,8,14,12,12,10,16,2,17,2,14,10,2,9,13,13,12,15,15,11,10,15,16,10,16,13,12,17,10,17,3,6,15,13,12,16,12,18,17,13,15,14,12,10,11,15
"5780",7861518,"Lior Refaelov","4/26/1986 (37 years old)","M (R), AM (RLC)","RSC Anderlecht","Jupiler Pro League","ISR","Yes","7/1/2021","6/30/2024","$16K - $160K","Right","Reasonable","Very Strong","5'9""","154 lbs","495","117",110,131,10,12,13,12,14,12,8,12,4,10,15,14,11,15,7,14,14,13,14,14,12,13,18,13,8,10,15,10,9,11,10,7,12,10,10,10,12,11,14,13,6,14,10,10,9,11,14,16,8,1,3,1,1,3,2,2,3,2,1,2
"5781",43591641,"Tommaso Baldanzi","3/23/2003 (20 years old)","M/AM (C)","Empoli","Italian Serie A","ITA","Yes","10/24/2022","6/30/2027","$32M - $38M","Left","Very Strong","Reasonable","5'7""","149 lbs","27","4",129,179,12,9,14,14,14,12,8,13,4,5,14,10,7,15,10,13,11,13,12,14,16,14,7,15,5,13,15,14,14,15,13,6,12,13,13,8,8,9,14,16,12,13,7,14,5,6,12,16,13,2,3,1,3,2,3,4,2,2,1,3
"5782",831079,"Giorgio Chiellini","8/14/1984 (38 years old)","D (C)","LAFC","Major League Soccer","ITA","Yes","6/13/2022","12/31/2023","$55K - $550K","Left Only","Very Strong","Weak","6'2""","187 lbs","548","35",144,174,4,8,4,5,8,2,15,10,19,18,12,3,18,8,17,19,20,16,17,16,20,8,19,8,18,17,7,13,8,7,14,14,6,9,9,14,11,18,16,20,12,17,20,13,14,6,18,10,12,2,4,2,3,2,2,1,1,3,1,3
"5783",1410956,"Leonardo Bonucci","5/1/1987 (36 years old)","D (C)","Juventus","Italian Serie A","ITA","Yes","6/14/2021","6/30/2024","$120K - $1.2M","Right","Reasonable","Very Strong","6'3""","189 lbs","489","37",138,173,3,7,8,8,14,12,15,12,10,14,16,15,13,13,15,16,16,16,14,13,16,10,20,8,17,16,16,12,9,8,15,14,16,11,11,14,8,9,11,16,15,12,15,16,11,11,13,11,10,1,2,2,3,3,3,1,4,3,1,1
"5784",43298481,"Sandro Tonali","5/8/2000 (23 years old)","DM, M (C)","AC Milan","Italian Serie A","ITA","Yes","7/8/2021","6/30/2028","$67M - $81M","Right","Fairly Strong","Very Strong","5'11""","176 lbs","183","13",157,171,14,13,13,9,15,13,9,12,9,13,14,12,15,15,15,15,16,15,15,14,16,12,14,13,14,17,14,16,13,14,15,9,14,14,15,14,10,17,15,15,14,14,6,14,14,3,17,16,12,4,1,1,2,3,2,4,1,1,2,4
"5785",43500755,"Giorgio Scalvini","12/11/2003 (19 years old)","D (C)","Atalanta","Italian Serie A","ITA","Yes","4/27/2023","6/30/2028","$72M - $90M","Right","Reasonable","Very Strong","6'4""","191 lbs","50","3",145,170,5,9,12,8,12,4,14,9,6,14,12,5,15,13,13,17,14,14,15,14,16,7,9,7,15,16,12,16,12,13,13,15,15,13,15,14,7,13,12,18,15,15,6,15,9,6,14,17,16,3,2,3,2,1,3,1,1,2,1,3
"5786",43139595,"Nicolò Barella","2/7/1997 (26 years old)","M (C)","Inter","Italian Serie A","ITA","Yes","11/5/2021","6/30/2026","$119M - $150M","Right","Reasonable","Very Strong","5'8""","149 lbs","255","20",161,169,12,12,14,13,15,14,6,14,4,11,16,11,16,15,20,14,17,14,11,14,19,14,13,16,13,17,16,18,15,14,16,7,17,13,18,12,12,7,10,19,17,15,9,16,14,4,15,18,12,3,2,3,3,1,3,1,4,1,4,1
"5787",43252073,"Gianluigi Donnarumma","2/25/1999 (24 years old)","GK","Paris SG","Ligue 1 Uber Eats","ITA","Yes","7/14/2021","6/30/2026","$122M - $147M","Right Only","Weak","Very Strong","6'5""","198 lbs","270","-",160,169,2,1,4,3,7,1,7,1,8,3,7,6,7,6,8,15,16,14,14,15,15,6,14,2,15,15,8,13,10,16,16,18,15,11,15,16,1,14,15,13,15,11,4,15,4,5,16,16,16,12,11,18,14,16,13,15,9,14,14,15
"5788",2000021281,"Matteo Prati","12/28/2003 (19 years old)","DM, M (C)","SPAL","Italian Serie C/B","ITA","Yes","7/27/2022","6/30/2025","$5.6M - $10.5M","Right","Weak","Very Strong","6'0""","165 lbs","53","7",113,169,8,11,10,8,12,6,14,12,10,9,14,12,12,12,11,14,12,11,13,14,13,9,8,11,12,13,13,12,12,11,11,13,12,11,12,12,15,17,11,17,12,14,6,12,12,8,12,9,16,2,1,2,3,4,2,3,1,1,2,2
"5789",43043933,"Lorenzo Insigne","6/4/1991 (32 years old)","AM (L), ST (C)","Toronto FC","Major League Soccer","ITA","Yes","7/1/2022","12/31/2026","Not for Sale","Right","Fairly Strong","Very Strong","5'4""","130 lbs","447","145",145,166,15,15,15,14,17,14,6,14,6,4,17,17,6,17,8,14,12,14,12,12,14,17,15,14,7,14,16,12,14,16,12,3,17,14,13,6,13,12,12,11,11,16,9,11,5,5,14,12,8,3,2,1,3,2,3,2,2,3,3,2
"5790",2000068166,"Karim El Eraki","11/29/1997 (25 years old)","D/WB/M (R)","Al-Masry","Egyptian Premier League","EGY","No","6/15/2020","7/31/2023","$45K - $425K","Right","Reasonable","Very Strong","5'8""","154 lbs","115","1",114,135,9,11,10,3,11,9,10,5,9,11,11,5,14,11,11,11,10,9,8,13,13,12,5,10,11,13,11,13,13,14,14,7,13,12,14,11,14,19,3,12,11,10,9,4,8,6,20,10,11,2,2,3,1,2,1,2,1,4,3,1
"5791",2000178997,"Simone Pafundi","3/14/2006 (17 years old)","AM (RC)","Udinese","Italian Serie A","ITA","Yes","3/14/2022","6/30/2025","$24M - $29M","Left","Very Strong","Weak","5'5""","132 lbs","9","-",111,166,13,10,13,9,14,13,5,12,4,5,13,11,5,15,6,8,9,11,10,12,18,16,7,11,11,11,14,11,14,15,12,5,12,13,11,8,12,12,10,15,14,10,4,11,10,6,12,14,12,3,1,3,2,3,3,1,3,3,2,4
"5792",43272557,"Davide Frattesi","9/22/1999 (23 years old)","M (C)","Sassuolo","Italian Serie A","ITA","Yes","6/15/2020","6/30/2026","$32M - $39M","Right","Reasonable","Very Strong","6'0""","163 lbs","180","24",147,165,6,9,14,13,14,7,14,13,5,10,14,12,12,14,14,14,14,13,14,15,15,12,11,16,13,15,13,14,15,15,14,13,16,15,15,13,13,12,11,15,16,13,3,12,13,5,15,14,11,2,1,2,2,2,2,1,2,1,3,2
"5793",43036641,"Jorginho","12/20/1991 (31 years old)","DM, M (C)","Arsenal","English Premier Division","ITA","Yes","1/31/2023","6/30/2024","$59M - $71M","Right","Reasonable","Very Strong","5'11""","147 lbs","409","36",152,165,11,12,12,8,17,10,7,9,2,10,16,14,14,16,10,16,14,16,14,17,15,13,14,15,14,17,18,16,11,14,14,9,12,12,14,9,6,12,13,17,13,12,8,15,11,7,15,15,11,3,3,3,2,3,2,2,3,3,2,2
"5794",43026579,"Marco Verratti","11/5/1992 (30 years old)","DM, M (C)","Paris SG","Ligue 1 Uber Eats","ITA","Yes","6/29/2022","6/30/2026","$38M - $48M","Right","Reasonable","Very Strong","5'5""","132 lbs","350","9",160,165,14,17,16,10,18,13,6,13,6,12,18,15,15,17,14,17,16,18,14,15,14,18,12,14,13,17,17,13,12,15,16,6,12,12,12,9,12,8,7,12,14,14,13,13,12,10,14,15,12,1,1,2,2,4,3,3,3,1,3,1
"5795",43161651,"Federico Chiesa","10/25/1997 (25 years old)","AM (RL), ST (C)","Juventus","Italian Serie A","ITA","Yes","7/1/2022","6/30/2025","$78M - $98M","Right","Strong","Very Strong","5'9""","154 lbs","199","37",159,165,8,13,16,15,15,5,9,15,4,5,13,10,5,14,17,12,13,16,10,12,18,15,12,15,7,11,13,14,16,15,13,8,12,17,12,13,18,9,8,17,17,11,11,16,14,11,15,15,13,4,1,1,1,2,3,3,3,2,3,2
"5796",43010773,"Ciro Immobile","2/20/1990 (33 years old)","ST (C)","Lazio","Italian Serie A","ITA","Yes","6/14/2021","6/30/2026","Not for Sale","Right","Strong","Very Strong","6'1""","187 lbs","411","229",154,165,4,3,12,17,12,3,16,13,4,4,12,19,7,12,14,19,15,14,12,13,20,12,15,19,3,15,11,17,13,13,16,11,14,14,16,13,7,12,12,20,12,18,10,10,8,8,15,17,6,3,3,2,2,3,3,2,3,2,2,3
"5797",43252460,"Alessandro Bastoni","4/13/1999 (24 years old)","D (C)","Inter","Italian Serie A","ITA","Yes","6/14/2021","6/30/2028","$44M - $67M","Left","Very Strong","Reasonable","6'3""","165 lbs","149","6",152,165,4,11,11,8,14,5,15,5,12,15,15,8,16,14,14,15,16,13,14,13,16,12,12,11,14,17,15,15,14,13,15,15,17,15,14,15,10,11,14,17,16,14,7,14,13,5,13,17,14,2,3,3,3,3,2,1,3,2,1,1
"5798",43270517,"Nicolò Zaniolo","7/2/1999 (23 years old)","AM (RLC), ST (C)","Galatasaray","Turkish Super League","ITA","Yes","2/8/2023","6/30/2027","$31M - $37M","Left","Very Strong","Reasonable","6'2""","174 lbs","118","20",146,162,13,11,16,13,14,9,12,16,6,5,12,12,5,14,18,11,14,15,9,9,18,14,6,13,6,8,13,11,15,13,15,13,13,17,14,17,15,6,7,12,14,8,10,14,17,15,11,17,7,2,3,3,4,4,3,2,3,1,2,4
"5799",43075156,"Giovanni Di Lorenzo","8/4/1993 (29 years old)","D/WB/M (R)","Parthenope","Italian Serie A","ITA","Yes","7/15/2021","6/30/2026","$110M - $167M","Right","Reasonable","Very Strong","6'0""","182 lbs","357","18",159,162,4,13,11,11,12,3,17,12,11,14,13,10,16,11,15,14,16,14,13,14,17,6,15,14,13,17,11,17,15,14,16,14,18,17,17,14,14,11,13,17,16,14,6,14,10,7,16,15,14,3,2,1,2,1,3,3,2,2,2,3
"5800",43372892,"Nicolò Rovella","12/4/2001 (21 years old)","DM, M (C)","Juventus","Italian Serie A","ITA","Yes","1/28/2021","6/30/2026","$15M - $23M","Right","Reasonable","Very Strong","5'10""","154 lbs","71","1",137,162,14,13,10,8,14,12,8,11,4,11,16,11,15,14,14,14,13,12,13,14,15,13,12,12,13,15,15,13,13,14,12,8,15,13,14,11,13,14,18,16,13,11,6,13,11,4,14,15,10,3,2,2,1,2,3,3,1,2,2,1
"5801",2000068126,"Hassan Ali","5/15/1998 (25 years old)","D/WB (L), M (RL), AM (R)","Al-Masry","Egyptian Premier League","EGY","No","6/15/2020","6/30/2025","$230K - $2.3M","Left","Very Strong","Reasonable","5'10""","165 lbs","92","11",111,135,9,10,10,10,11,14,9,8,9,10,11,16,12,8,10,11,10,9,9,12,13,15,10,11,11,12,10,13,13,14,14,6,14,11,14,11,11,16,6,13,12,10,10,15,13,2,11,14,15,1,2,1,3,3,3,1,3,3,3,1
"5802",43500350,"Wilfried Gnonto","11/5/2003 (19 years old)","AM (RLC), ST (C)","Leeds","Sky Bet Championship","ITA","Yes","9/1/2022","6/30/2027","$15.5M - $24M","Right","Reasonable","Very Strong","5'7""","156 lbs","88","14",132,161,4,9,16,13,13,5,8,9,3,3,11,10,5,15,8,11,13,12,8,10,15,15,5,12,5,11,11,13,16,16,16,5,17,15,13,12,12,9,6,6,9,8,6,12,12,13,10,15,13,3,2,2,1,1,2,3,1,2,2,1
"5803",43372948,"Nicolò Fagioli","2/12/2001 (22 years old)","DM, M/AM (C)","Juventus","Italian Serie A","ITA","Yes","8/10/2022","6/30/2026","$42M - $64M","Right","Reasonable","Very Strong","5'10""","145 lbs","66","6",143,161,12,13,14,12,15,12,7,14,5,10,15,13,12,16,15,14,15,13,14,13,15,15,10,15,12,14,14,14,14,16,13,9,15,13,13,11,12,13,13,14,13,11,7,12,7,10,13,18,14,3,1,2,1,1,1,3,1,1,1,3
"5804",43143488,"Federico Dimarco","11/10/1997 (25 years old)","D (LC), WB/M (L)","Inter","Italian Serie A","ITA","Yes","12/23/2021","6/30/2026","$65M - $99M","Left","Very Strong","Weak","5'9""","165 lbs","170","13",155,160,16,18,11,12,15,16,11,17,11,13,15,13,12,15,12,14,17,15,16,14,16,15,11,15,14,18,13,17,14,14,13,10,15,14,12,11,13,13,13,18,16,17,7,14,7,6,16,15,12,2,2,2,2,3,2,2,3,2,3,3
"5805",43125343,"Mattia Zaccagni","6/16/1995 (27 years old)","AM (LC)","Lazio","Italian Serie A","ITA","Yes","7/1/2022","6/30/2028","$46M - $57M","Right","Strong","Very Strong","5'10""","138 lbs","249","27",155,160,13,14,17,16,15,12,5,13,4,4,15,14,8,15,13,16,12,12,12,15,17,16,13,17,6,15,14,13,15,15,13,10,14,15,12,10,10,11,10,16,13,16,5,14,12,7,14,16,14,2,2,3,3,2,3,1,1,1,2,1
"5806",43140326,"Alex Meret","3/22/1997 (26 years old)","GK","Parthenope","Italian Serie A","ITA","Yes","10/5/2022","6/30/2024","$31M - $47M","Left Only","Very Strong","Weak","6'3""","176 lbs","142","-",151,160,2,1,1,1,8,2,7,2,3,3,9,1,3,9,8,15,12,14,13,14,12,3,9,3,16,14,5,13,10,18,14,16,13,12,13,13,2,12,15,15,12,14,11,12,3,3,12,13,7,11,12,17,11,15,10,16,5,14,14,14
"5807",43378804,"Stefano Turati","9/5/2001 (21 years old)","GK","Sassuolo","Italian Serie A","ITA","Yes","11/25/2020","6/30/2025","$350K - $7.8M","Right Only","Weak","Very Strong","6'2""","187 lbs","61","-",133,159,2,3,1,2,7,4,6,2,6,2,7,1,1,8,10,12,13,11,13,13,15,4,13,8,15,13,8,14,13,13,11,13,12,13,12,12,13,11,12,14,15,13,5,14,4,4,13,13,11,14,11,16,10,16,9,14,8,13,14,12
"5808",43424702,"Edoardo Bove","5/16/2002 (21 years old)","DM, M (C)","AS Roma","Italian Serie A","ITA","Yes","12/29/2021","6/30/2025","$12.5M - $18.5M","Right","Reasonable","Very Strong","5'9""","149 lbs","34","2",132,159,8,10,12,12,14,7,8,10,5,11,14,8,15,13,14,14,16,13,12,12,18,11,9,14,13,16,12,18,13,13,13,8,15,12,14,11,15,18,17,18,15,16,4,12,10,4,13,13,11,2,2,3,2,1,1,1,2,2,2,1
"5809",43429372,"Fabiano Parisi","11/9/2000 (22 years old)","D/WB (L)","Empoli","Italian Serie A","ITA","Yes","9/22/2020","6/30/2028","$8.8M - $13.5M","Left Only","Very Strong","Weak","5'10""","154 lbs","141","7",137,159,10,13,16,9,13,11,7,10,8,12,14,6,14,14,12,13,13,12,12,14,16,5,10,13,12,13,14,14,15,15,14,8,12,15,14,11,12,13,14,16,12,12,7,11,15,8,14,16,13,3,3,3,1,3,3,3,2,3,3,1
"5810",6100739,"Fabio Quagliarella","1/31/1983 (40 years old)","ST (C)","Sampdoria","Italian Serie B","ITA","Yes","6/14/2021","6/30/2024","$18K - $190K","Right","Fairly Strong","Very Strong","5'11""","174 lbs","645","210",120,159,6,10,10,16,16,10,12,15,5,5,16,19,6,16,12,17,15,15,15,15,20,19,20,18,6,17,15,19,6,9,13,11,19,6,8,10,4,10,19,20,12,11,11,16,13,10,12,16,10,2,1,2,2,3,1,2,2,1,1,3
"5811",43094100,"Lorenzo Pellegrini","6/19/1996 (26 years old)","DM, M/AM (C)","AS Roma","Italian Serie A","ITA","Yes","10/2/2021","6/30/2026","$37M - $57M","Right","Fairly Strong","Very Strong","6'1""","169 lbs","229","38",151,158,17,17,14,11,15,15,9,12,4,11,15,12,13,16,13,15,14,12,11,12,15,16,13,16,13,16,16,16,13,15,11,10,15,12,13,10,14,12,13,18,16,20,12,13,13,8,13,15,9,3,1,1,2,1,2,1,1,2,2,3
"5812",29222504,"Mohamed Sherif","2/4/1996 (27 years old)","ST (C)","Al-Ahly","Egyptian Premier League","EGY","No","1/19/2021","7/31/2024","$275K - $2.8M","Left","Very Strong","Fairly Strong","6'0""","174 lbs","179","58",125,135,7,8,13,14,13,9,11,12,1,10,12,11,6,13,14,13,11,12,9,12,13,14,7,15,8,13,11,9,14,12,11,12,10,14,14,11,11,4,8,12,7,10,12,16,16,2,13,11,13,2,3,1,1,3,2,3,1,1,1,1
"5813",19158043,"Emerson","8/3/1994 (28 years old)","D/WB (L)","West Ham","English Premier Division","ITA","Yes","8/23/2022","6/30/2026","$36M - $46M","Left","Very Strong","Reasonable","5'9""","169 lbs","144","4",139,158,12,14,14,7,15,10,9,14,10,12,12,4,13,14,11,14,12,14,12,12,14,14,8,15,12,13,12,14,15,15,15,9,13,15,14,13,13,12,13,14,10,13,5,11,11,9,16,12,8,1,4,1,2,1,2,2,3,2,2,1
"5814",2000022887,"Cher Ndour","7/27/2004 (18 years old)","M/AM (C)","Benfica","Portuguese Premier League","ITA","Yes","7/31/2020","6/30/2026","$90K - $900K","Right","Weak","Very Strong","6'3""","185 lbs","58","5",110,158,11,11,12,10,13,10,11,10,5,11,13,8,12,13,11,11,11,14,12,12,12,15,6,8,12,12,13,11,12,11,12,13,13,12,13,13,12,10,12,13,13,7,4,10,8,11,13,14,12,1,1,1,1,2,2,1,1,3,4,1
"5815",7982744,"Andrea Lazzari","12/3/1984 (38 years old)","DM, M (LC), AM (C)","Vigor Senigallia","Italian Serie D Grp. F","ITA","Yes","7/27/2022","6/30/2024","$0 - $10K","Left","Very Strong","Weak","6'0""","165 lbs","452","36",76,158,10,10,9,8,10,12,9,12,6,8,12,12,9,11,12,12,10,10,9,9,12,14,11,9,10,12,11,9,8,9,12,9,12,9,10,9,15,14,19,13,10,14,6,13,12,9,13,12,13,1,4,3,3,1,1,1,2,3,1,2
"5816",2000021407,"Samuele Vignato","2/24/2004 (19 years old)","AM (RC), ST (C)","Brianza","Italian Serie A","ITA","Yes","8/11/2021","6/30/2025","$6.8M - $8.4M","Right","Weak","Very Strong","5'8""","138 lbs","20","1",112,158,11,10,11,11,12,7,7,10,7,4,12,11,10,13,7,8,11,12,12,10,12,15,9,12,8,12,12,10,14,15,12,7,12,14,13,8,12,12,12,12,12,11,7,12,8,8,11,12,12,3,2,3,1,1,2,1,1,3,2,2
"5817",2000098260,"Aaron Ciammaglichella","1/26/2005 (18 years old)","M/AM (C)","Torino","Italian Serie A","ITA","Yes","7/1/2020","6/30/2024","$450K - $4.6M","Right Only","Weak","Very Strong","5'11""","160 lbs","-","-",89,158,8,8,10,7,11,8,9,10,7,9,12,9,13,13,9,15,12,11,11,12,14,8,8,12,10,14,11,12,11,11,10,9,13,11,10,10,13,12,13,12,11,13,12,12,13,8,12,13,11,1,3,1,2,2,1,1,1,1,2,1
"5818",2000146883,"Francesco Pio Esposito","6/28/2005 (17 years old)","ST (C)","Inter","Italian Serie A","ITA","Yes","7/1/2021","6/30/2025","$85K - $850K","Right","Reasonable","Very Strong","6'2""","176 lbs","-","-",111,157,2,5,12,14,12,3,16,9,2,4,13,15,6,13,10,13,11,13,12,10,15,13,10,13,5,10,10,10,12,12,13,15,14,11,9,13,12,12,10,14,13,11,4,11,9,3,14,15,16,2,1,1,3,3,1,2,2,2,3,3
"5819",43316850,"Giacomo Raspadori","2/18/2000 (23 years old)","AM (RLC), ST (C)","Sassuolo","Italian Serie A","ITA","Yes","6/14/2021","6/30/2028","$23M - $35M","Right","Strong","Very Strong","5'8""","152 lbs","101","20",146,157,13,11,13,14,15,14,11,12,4,4,13,13,6,15,12,14,11,14,12,13,14,16,11,16,4,14,13,14,15,16,15,7,15,14,12,11,13,14,15,17,13,14,7,14,4,6,13,15,15,1,3,3,2,2,1,3,3,3,1,3
"5820",43391659,"Elia Caprile","8/25/2001 (21 years old)","GK","Bari","Italian Serie B","ITA","Yes","7/13/2022","6/30/2026","$6.6M - $8.2M","Right","Weak","Very Strong","6'3""","163 lbs","73","-",125,157,3,2,2,2,6,6,6,1,1,2,10,1,1,6,12,12,12,11,12,12,14,7,8,4,14,12,11,12,10,13,11,13,14,11,15,12,11,14,12,14,14,12,3,15,4,3,13,15,10,12,14,15,12,14,13,15,10,12,13,12
"5821",43425720,"Lorenzo Pirola","2/20/2002 (21 years old)","D (C)","Inter","Italian Serie A","ITA","Yes","6/13/2022","6/30/2027","$850K - $9M","Left","Very Strong","Weak","6'1""","171 lbs","47","2",127,157,3,7,10,8,11,3,14,4,6,13,12,4,15,11,15,14,14,12,12,13,15,5,10,5,14,13,8,14,13,12,14,14,16,13,15,15,10,7,11,16,13,12,3,11,11,3,14,14,12,2,3,3,2,3,3,3,3,1,3,3
"5822",43094150,"Ivan Provedel","3/17/1994 (29 years old)","GK","Lazio","Italian Serie A","ITA","Yes","8/8/2022","6/30/2027","$23M - $35M","Right","Weak","Very Strong","6'4""","185 lbs","266","1",150,157,3,2,3,3,9,2,7,2,2,1,11,5,2,10,6,13,14,12,12,15,18,3,10,7,14,15,14,15,14,14,12,15,14,14,12,13,1,15,14,18,14,18,4,13,3,10,14,15,12,13,11,16,13,14,16,15,16,14,12,13
"5823",13208269,"Afsha","3/6/1996 (27 years old)","M/AM (C)","Al-Ahly","Egyptian Premier League","EGY","No","8/1/2019","7/31/2024","$6M - $11M","Right","Reasonable","Very Strong","5'6""","141 lbs","216","38",127,135,14,13,14,12,15,12,6,14,5,9,16,14,8,15,8,12,7,13,11,13,14,14,11,15,10,14,15,11,12,14,11,6,13,13,12,7,13,10,4,14,11,9,14,15,12,8,14,9,7,2,2,3,2,1,3,1,1,1,2,1
"5824",43317730,"Salvatore Esposito","10/7/2000 (22 years old)","DM, M (C)","Spezia","Italian Serie B","ITA","Yes","6/15/2020","6/30/2025","$90K - $7.2M","Right","Reasonable","Very Strong","5'10""","154 lbs","146","14",124,157,12,12,12,8,12,15,12,11,9,13,13,12,13,13,12,13,12,12,13,11,18,10,12,11,12,12,13,13,13,13,12,9,17,12,13,12,12,16,12,15,12,9,4,9,10,11,13,16,10,1,1,1,3,3,1,2,1,1,1,4
"5825",43500510,"Fabio Miretti","8/3/2003 (19 years old)","M/AM (C)","Juventus","Italian Serie A","ITA","Yes","6/13/2022","6/30/2028","$44M - $66M","Right","Fairly Strong","Very Strong","5'11""","158 lbs","59","3",136,156,13,13,14,10,13,12,7,10,8,10,13,12,11,14,13,13,12,12,13,12,16,11,11,15,12,15,13,15,14,15,14,9,11,12,14,12,12,9,10,18,15,15,8,13,11,3,13,16,13,2,1,2,3,2,3,3,4,1,2,1
"5826",43066936,"Andrea Belotti","12/20/1993 (29 years old)","ST (C)","AS Roma","Italian Serie A","ITA","Yes","8/28/2022","6/30/2025","$8.2M - $12.5M","Right","Reasonable","Very Strong","5'11""","160 lbs","363","129",138,156,4,8,10,14,12,8,16,12,4,6,12,15,10,12,15,14,17,14,14,13,18,12,12,15,7,19,10,19,12,13,17,13,14,14,13,16,7,18,15,17,13,14,11,12,12,6,14,11,12,3,1,1,2,3,3,2,2,1,2,1
"5827",43390774,"Samuele Ricci","8/21/2001 (21 years old)","DM, M (C)","Torino","Italian Serie A","ITA","Yes","7/1/2022","6/30/2026","$48M - $73M","Right","Reasonable","Very Strong","5'11""","154 lbs","122","5",139,156,10,11,12,9,14,10,8,12,6,10,16,8,13,14,12,15,14,15,14,14,16,13,11,13,13,14,13,14,13,13,14,11,15,13,15,12,11,12,15,15,13,13,4,13,5,6,12,14,13,3,1,2,3,3,1,2,2,2,3,1
"5828",2000034865,"Cristian Volpato","11/15/2003 (19 years old)","AM (RLC)","AS Roma","Italian Serie A","ITA","Yes","1/21/2020","6/30/2028","$8.4M - $10M","Left","Very Strong","Reasonable","6'2""","171 lbs","10","2",121,156,14,12,15,12,16,11,7,12,5,5,14,12,5,16,9,13,11,12,10,11,10,17,4,12,5,13,14,10,12,14,13,10,12,13,12,11,10,12,11,11,12,12,5,11,4,8,8,12,15,3,3,2,2,2,2,3,1,1,2,1
"5829",2000024755,"Giacomo Faticanti","7/31/2004 (18 years old)","DM, M (C)","AS Roma","Italian Serie A","ITA","Yes","8/12/2022","6/30/2026","$10K - $110K","Right","Reasonable","Very Strong","6'1""","154 lbs","-","-",100,156,5,6,10,6,12,6,8,9,3,8,13,6,13,12,17,12,15,11,11,11,18,10,8,8,12,13,11,13,11,12,12,10,14,12,13,11,11,8,8,14,12,13,6,12,13,12,12,18,11,1,2,2,3,1,3,1,3,2,2,1
"5830",43093395,"Alessio Romagnoli","1/12/1995 (28 years old)","D (C)","Lazio","Italian Serie A","ITA","Yes","7/12/2022","6/30/2027","$30M - $38M","Left","Very Strong","Reasonable","6'2""","171 lbs","274","13",151,155,4,4,8,9,12,4,15,6,13,16,14,12,15,13,14,14,15,15,13,14,16,5,13,8,15,15,12,15,12,12,15,15,14,13,16,16,9,13,15,17,14,15,9,14,13,4,14,15,10,2,3,2,2,4,1,2,3,3,2,2
"5831",43270682,"Alessandro Buongiorno","6/6/1999 (24 years old)","D (C)","Torino","Italian Serie A","ITA","Yes","11/5/2021","6/30/2025","$7.6M - $11.5M","Left","Very Strong","Weak","6'3""","180 lbs","101","1",139,155,4,8,9,6,12,7,15,10,6,15,12,5,15,11,15,15,13,12,14,14,15,8,12,7,15,12,10,13,12,14,13,15,14,12,14,14,11,13,12,16,14,14,7,13,10,7,13,16,14,2,1,3,2,1,1,1,4,3,3,3
"5832",1400480,"Antonio Candreva","2/28/1987 (36 years old)","M (RC), AM (RLC)","Sampdoria","Italian Serie B","ITA","Yes","7/1/2021","6/30/2024","$130K - $1.3M","Right","Fairly Strong","Very Strong","5'11""","158 lbs","547","80",138,155,12,16,13,13,15,13,3,14,4,7,15,12,6,16,9,14,8,14,13,13,18,16,15,14,8,10,14,13,12,13,13,6,17,13,15,7,18,13,11,18,12,13,5,15,8,9,16,12,13,1,2,1,2,3,2,2,2,1,3,2
"5833",43091113,"Bryan Cristante","3/3/1995 (28 years old)","DM, M (C)","AS Roma","Italian Serie A","ITA","Yes","6/14/2021","6/30/2027","$39M - $48M","Right","Fairly Strong","Very Strong","6'2""","180 lbs","243","22",148,155,8,11,11,13,14,8,17,16,8,12,16,12,15,14,6,14,16,16,11,15,14,8,14,16,15,19,13,16,9,9,16,16,17,12,16,15,11,18,18,19,14,15,4,11,12,3,15,15,7,3,2,2,3,2,1,1,2,3,3,1
"5834",12066084,"Ramadan Sobhi","1/23/1997 (26 years old)","M (R), AM (RLC)","Pyramids","Egyptian Premier League","EGY","No","9/6/2020","7/31/2025","$6.2M - $9.4M","Right","Fairly Strong","Very Strong","6'0""","165 lbs","181","37",129,148,13,10,14,13,13,8,9,9,3,5,12,14,8,15,14,13,13,10,8,10,14,17,10,13,8,10,13,12,12,13,12,11,15,13,12,12,16,12,5,14,12,13,7,10,8,14,11,10,9,1,3,2,2,3,1,1,1,2,3,4
"5835",2000068791,"Marwan Hamdy","2/10/1993 (30 years old)","ST (C)","Al-Masry","Egyptian Premier League","EGY","No","9/12/2022","7/31/2026","$180K - $1.8M","Right","Reasonable","Very Strong","6'0""","178 lbs","98","28",116,135,6,6,13,13,11,12,13,10,6,4,11,13,7,11,11,10,12,13,13,12,14,11,6,13,13,14,9,11,11,12,10,14,12,12,11,13,6,14,14,13,9,13,5,12,8,7,14,12,11,2,3,4,3,1,3,1,1,1,2,2
"5836",43298002,"Marco Carnesecchi","7/1/2000 (22 years old)","GK","Atalanta","Italian Serie A","ITA","Yes","5/12/2022","6/30/2026","$7.4M - $11.5M","Right Only","Weak","Very Strong","6'3""","182 lbs","116","-",130,155,2,3,1,1,8,5,5,2,3,3,8,1,3,8,9,13,11,10,15,12,15,7,12,7,15,13,8,14,10,14,13,15,15,10,15,13,12,14,14,18,12,15,6,15,6,6,15,16,12,10,13,15,13,15,7,15,10,15,16,14
"5837",64016316,"Jan Oblak","1/7/1993 (30 years old)","GK","A. Madrid","Spanish First Division","SVN","Yes","7/20/2022","6/30/2028","$115M - $173M","Right","Weak","Very Strong","6'2""","185 lbs","391","-",171,178,4,2,3,2,12,9,3,3,2,3,16,12,2,10,8,11,13,16,15,15,15,15,15,2,16,12,8,12,11,13,13,13,9,13,13,13,18,14,15,10,16,13,5,15,9,7,15,19,14,14,15,19,9,16,16,18,4,15,15,15
"5838",29041284,"Josip Iličič","1/29/1988 (35 years old)","AM (RC), ST (C)","Maribor","Slovenian First League","SVN","Yes","10/5/2022","6/30/2025","Not for Sale","Left","Very Strong","Reasonable","6'3""","174 lbs","434","114",117,158,14,14,17,12,18,16,6,16,3,4,15,15,5,17,13,15,8,10,8,12,12,17,7,13,4,12,17,8,10,10,13,13,14,9,7,10,11,13,13,17,7,14,14,15,12,7,8,15,13,1,3,2,2,2,2,3,1,1,3,2
"5839",62246208,"Benjamin Šeško","5/31/2003 (20 years old)","ST (C)","FC RB Salzburg","Austrian Premier Division","SVN","Yes","6/13/2022","6/30/2027","$19.5M - $30M","Right","Reasonable","Very Strong","6'4""","187 lbs","99","43",135,158,3,7,13,13,13,10,13,9,6,6,12,13,7,14,12,13,13,12,11,12,13,13,9,15,6,12,11,13,15,13,13,17,13,16,13,14,8,13,12,12,12,13,7,12,8,8,12,14,10,2,2,1,3,3,3,3,3,3,1,1
"5840",62215974,"Jaka Bijol","2/5/1999 (24 years old)","D (C)","Udinese","Italian Serie A","SVN","Yes","7/14/2022","6/30/2027","$6M - $9.2M","Right","Weak","Very Strong","6'3""","187 lbs","173","12",136,150,4,7,8,9,12,6,18,10,7,13,11,7,13,10,13,13,15,14,15,12,15,7,14,9,13,16,9,16,12,11,15,16,17,12,13,16,13,12,11,15,14,14,4,11,10,5,14,15,12,2,3,3,2,3,3,2,2,3,2,2
"5841",91005023,"Kevin Kampl","10/9/1990 (32 years old)","DM, M (C)","RB Leipzig","Bundesliga","SVN","Yes","5/17/2022","6/30/2024","$9M - $11.5M","Right","Fairly Strong","Very Strong","5'10""","145 lbs","371","38",144,150,12,11,12,8,15,12,6,12,6,12,16,7,12,15,16,13,12,16,13,14,15,13,12,12,13,18,15,16,12,14,13,7,13,12,16,10,17,10,10,15,13,10,14,14,9,13,14,15,9,3,2,3,4,3,3,1,2,1,2,4
"5842",2000192599,"Marcel Lorber","4/26/2004 (19 years old)","DM, M (C)","Maribor","Slovenian First League","SVN","Yes","7/1/2021","6/30/2025","$24K - $240K","Right","Weak","Very Strong","6'0""","163 lbs","2","-",105,150,9,9,11,9,14,9,11,12,6,13,12,8,14,12,14,12,13,13,8,8,13,5,12,13,14,14,13,12,13,14,7,12,12,13,13,13,14,8,7,7,9,10,14,13,12,13,12,13,11,3,1,2,2,3,3,1,3,2,1,2
"5843",62248930,"Žan Vipotnik","3/18/2002 (21 years old)","ST (C)","Maribor","Slovenian First League","SVN","Yes","7/1/2022","6/30/2026","$500K - $9.2M","Right","Reasonable","Very Strong","6'1""","167 lbs","68","30",125,149,7,8,11,14,13,10,13,13,7,5,12,14,9,11,11,14,12,14,12,12,12,14,10,14,10,13,13,13,13,12,12,13,11,13,12,13,9,12,12,13,11,12,9,12,9,10,13,11,12,2,1,2,2,3,4,3,2,2,3,1
"5844",2000016418,"Tio Cipot","4/20/2003 (20 years old)","M (C), AM (RLC)","Spezia","Italian Serie B","SVN","Yes","1/9/2023","6/30/2026","$50K - $8M","Right","Weak","Very Strong","5'9""","163 lbs","50","4",109,146,11,11,12,10,12,10,11,8,12,7,10,13,9,14,10,12,13,10,11,11,12,13,10,13,11,12,13,12,13,13,9,9,12,13,11,11,12,12,12,13,11,12,10,13,10,6,13,12,12,2,2,1,1,2,3,2,1,2,1,3
"5845",62154498,"David Tijanić","7/16/1997 (25 years old)","M/AM (C)","Al-Adalah","Saudi First Division League","SVN","Yes","7/27/2021","6/30/2026","$500K - $5M","Right","Fairly Strong","Very Strong","5'9""","147 lbs","208","32",115,145,10,9,13,10,14,12,6,13,5,6,13,9,7,14,12,12,10,12,11,10,12,14,11,13,7,13,13,13,12,13,9,8,11,11,11,11,9,12,11,12,14,9,6,13,8,5,11,13,13,1,1,2,3,2,3,3,3,4,1,2
"5846",13217587,"Mohamed Mahmoud","5/7/1998 (25 years old)","DM, M/AM (C)","Al-Ittihad","Egyptian Premier League","EGY","No","12/3/2018","7/31/2027","$8K - $80K","Right","Reasonable","Very Strong","5'9""","149 lbs","35","2",105,135,5,8,13,10,14,8,8,13,3,10,10,4,11,14,11,10,9,10,10,13,19,13,11,12,10,9,10,13,12,9,14,7,5,11,14,4,10,12,8,10,10,11,18,12,6,8,14,11,19,3,1,4,4,1,1,4,1,2,3,1
"5847",62235081,"Svit Sešlar","1/9/2002 (21 years old)","M (C), AM (RC)","Olimpija","Slovenian First League","SVN","Yes","1/5/2022","6/30/2026","$2.7M - $5.4M","Left","Very Strong","Reasonable","6'1""","163 lbs","74","13",118,145,11,11,12,11,13,11,12,12,9,8,14,12,9,13,12,13,11,13,11,12,12,15,10,13,11,13,14,12,12,11,12,11,11,12,11,12,11,11,12,11,12,11,9,13,11,9,14,13,12,1,1,3,1,3,1,3,3,2,2,1
"5848",62248917,"Marcel Ratnik","12/23/2003 (19 years old)","D (C)","Olimpija","Slovenian First League","SVN","Yes","2/11/2022","6/30/2025","$1.5M - $3.2M","Right","Weak","Very Strong","6'1""","171 lbs","48","1",116,144,8,8,8,7,11,8,12,9,7,13,12,4,12,9,12,12,11,11,12,13,13,12,10,10,12,9,12,13,12,13,12,13,10,12,12,13,12,12,12,12,11,11,7,14,11,2,13,11,11,1,2,1,1,3,1,3,2,3,1,1
"5849",2000179700,"Beno Selan","1/2/2005 (18 years old)","M/AM (C)","Bravo","Slovenian First League","SVN","Yes","7/1/2020","6/30/2025","$140K - $1.4M","Right","Weak","Very Strong","5'11""","163 lbs","18","-",100,142,11,11,12,8,11,10,8,12,3,10,11,5,10,11,10,11,12,11,11,11,12,12,5,11,12,12,12,12,13,12,12,8,14,12,11,9,10,12,11,11,12,9,5,6,9,2,13,10,7,3,1,2,3,1,2,2,3,3,2,3
"5850",2000264561,"Luka Topalović","2/23/2006 (17 years old)","AM (C)","Domžale","Slovenian First League","SVN","Yes","6/13/2022","6/30/2025","$1.2M - $2.5M","Right","Reasonable","Very Strong","5'10""","156 lbs","10","1",103,142,11,11,13,12,11,12,8,14,5,5,12,12,7,13,11,14,11,12,12,10,12,14,9,12,8,10,13,10,12,11,10,9,11,12,12,11,9,12,11,12,12,11,10,12,10,9,12,11,7,3,2,1,1,2,3,1,3,1,1,3
"5851",64005065,"Jasmin Kurtič","1/10/1989 (34 years old)","DM, M/AM (C)","Parma","Italian Serie B","SVN","Yes","9/1/2020","6/30/2024","$40K - $120K","Right","Reasonable","Very Strong","6'1""","171 lbs","457","56",113,140,13,14,12,12,13,16,13,14,4,9,14,17,9,14,13,12,9,11,9,13,18,11,15,15,12,12,14,11,8,8,14,13,12,9,12,14,6,9,6,17,13,12,10,14,12,16,12,17,16,2,1,2,3,1,1,4,1,2,4,3
"5852",16135875,"Sandi Lovrić","3/28/1998 (25 years old)","DM, M/AM (C)","Udinese","Italian Serie A","SVN","Yes","7/1/2022","6/30/2027","$5.2M - $6.4M","Right","Fairly Strong","Very Strong","5'11""","165 lbs","225","19",134,140,8,10,13,9,14,8,9,13,8,10,14,12,11,14,13,12,11,12,12,13,12,11,9,14,12,14,13,14,13,13,12,13,14,14,14,12,3,13,11,12,9,13,3,11,9,8,13,9,14,1,2,3,3,1,2,1,1,2,2,3
"5853",2000029980,"Aljaž Antolin","8/2/2002 (20 years old)","M/AM (C)","Maribor","Slovenian First League","SVN","Yes","7/15/2021","6/30/2025","$240K - $2.4M","Right","Weak","Very Strong","5'10""","154 lbs","59","5",110,139,11,11,12,11,12,11,8,13,9,12,13,8,13,12,15,12,11,11,7,11,12,15,11,12,13,13,13,12,12,11,11,10,9,12,9,8,15,12,12,13,12,11,12,11,11,6,12,13,11,1,3,3,1,4,3,2,3,1,3,1
"5854",62222630,"Domen Gril","6/10/2001 (22 years old)","GK","Ac. Viseu","Portuguese Second League","SVN","Yes","7/9/2022","6/30/2026","$160K - $1.6M","Right","Weak","Very Strong","6'2""","180 lbs","86","-",112,138,2,1,1,1,10,5,5,2,1,1,10,2,3,9,12,11,13,10,12,10,12,10,6,10,13,8,10,9,11,13,10,13,12,11,13,10,12,12,11,12,12,12,10,13,5,1,13,8,20,13,11,15,13,13,12,13,8,10,12,13
"5855",2000120647,"Jošt Pišek","3/10/2002 (21 years old)","M/AM (C)","Domžale","Slovenian First League","SVN","Yes","5/20/2022","6/30/2024","$120K - $1.2M","Right","Weak","Very Strong","6'0""","163 lbs","46","8",105,137,10,11,12,11,13,10,10,12,6,12,11,6,11,13,9,12,7,10,11,10,12,10,4,11,12,12,13,13,12,11,11,7,8,11,12,12,14,13,12,11,11,11,11,16,13,2,19,12,20,3,4,3,2,2,3,2,4,3,1,1
"5856",2000179697,"Niko Kasalo","12/31/2005 (17 years old)","AM (L)","Mura","Slovenian First League","SVN","Yes","1/31/2023","12/31/2025","$950K - $2M","Left","Very Strong","Weak","5'9""","147 lbs","11","1",98,137,11,12,12,13,11,9,9,13,6,7,11,7,9,13,8,11,10,12,12,11,12,14,11,9,7,12,12,13,13,10,10,8,10,13,11,11,10,12,11,12,10,13,12,7,10,3,12,13,10,3,3,1,2,1,1,2,4,2,4,3
"5857",27037565,"Alexander Jakobsen","3/18/1994 (29 years old)","DM, M (C), AM (LC)","Dinamo Bt.","Georgian National League","EGY","Yes","1/1/2023","12/31/2024","$375K - $1.1M","Right","Fairly Strong","Very Strong","5'11""","160 lbs","144","11",107,135,11,13,15,10,14,10,5,9,5,5,13,8,3,14,7,11,5,12,8,7,6,17,5,11,6,9,13,7,13,13,9,8,10,12,11,9,6,8,6,7,6,7,13,5,2,15,8,11,7,1,1,3,1,1,3,1,2,2,3,3
"5858",2000293742,"Brin Horvat","3/5/2004 (19 years old)","DM, M (C)","Maribor","Slovenian First League","SVN","Yes","7/1/2020","6/30/2024","$130K - $1.3M","Right","Weak","Very Strong","6'1""","180 lbs","-","-",94,137,9,9,5,10,10,9,9,11,3,10,11,8,12,14,12,11,10,10,10,10,18,10,3,10,12,10,13,12,11,12,10,11,14,11,12,13,13,12,11,12,9,11,12,7,15,1,12,11,17,3,1,2,4,4,1,1,1,1,2,2
"5859",62203802,"Nik Prelec","6/10/2001 (22 years old)","AM (R), ST (C)","Cagliari","Italian Serie A","SVN","Yes","1/31/2023","6/30/2026","$180K - $1.8M","Left","Very Strong","Reasonable","6'1""","176 lbs","36","7",110,136,11,11,12,12,12,11,13,10,8,7,13,10,11,13,10,11,10,10,12,10,13,10,9,12,12,12,11,12,11,12,10,14,12,12,12,13,12,11,12,13,12,12,8,10,8,12,12,12,11,3,1,2,2,3,1,4,2,1,1,2
"5860",62248921,"Adrian Zeljković","8/19/2002 (20 years old)","D (C), DM","Tabor Sežana","Slovenian Second League","SVN","Yes","7/3/2021","6/30/2025","$0","Right","Weak","Very Strong","6'4""","178 lbs","41","1",100,136,5,7,8,3,11,7,12,9,7,13,11,6,10,8,12,10,9,9,10,13,14,5,8,10,12,8,9,9,11,10,11,14,10,10,10,12,14,12,11,13,12,9,11,8,11,7,10,12,17,3,3,3,2,1,2,1,2,3,2,1
"5861",62248972,"Kai Cipot","4/28/2001 (22 years old)","D (C)","Mura","Slovenian First League","SVN","Yes","1/5/2023","6/30/2026","$140K - $1.4M","Right","Weak","Very Strong","6'2""","171 lbs","101","10",110,135,10,10,11,12,13,5,12,11,11,13,10,9,12,12,15,11,12,12,13,11,12,13,10,13,12,11,11,12,12,13,10,12,10,12,11,13,14,11,12,11,12,13,14,3,7,7,12,11,12,1,3,2,1,1,1,3,3,2,1,3
"5862",62083371,"Petar Stojanović","10/7/1995 (27 years old)","D/WB (R)","Empoli","Italian Serie A","SVN","Yes","7/1/2022","6/30/2025","$1.1M","Right","Reasonable","Very Strong","5'10""","158 lbs","238","7",117,135,8,12,10,6,10,4,10,12,15,10,12,8,15,10,18,11,13,11,10,9,15,10,9,12,11,16,11,17,14,12,13,11,16,14,14,14,12,4,2,12,13,12,7,11,13,12,12,12,15,3,1,1,1,1,3,2,2,2,1,1
"5863",62115981,"Miha Zajc","7/1/1994 (28 years old)","DM, M (C)","Fenerbahçe","Turkish Super League","SVN","Yes","6/15/2020","6/30/2023","$350K - $1M","Right","Fairly Strong","Very Strong","5'11""","167 lbs","299","48",130,135,12,13,12,13,13,15,8,16,8,8,15,11,9,15,8,12,13,16,11,13,14,14,10,14,10,14,15,16,8,12,13,10,12,7,16,13,10,13,11,12,16,10,9,13,9,9,13,12,10,1,1,2,2,1,3,2,4,2,3,3
"5864",62193533,"Tomi Horvat","3/24/1999 (24 years old)","M/AM (LC)","SK Sturm Graz","Austrian Premier Division","SVN","Yes","7/1/2022","6/30/2025","$1.8M - $3.8M","Left","Very Strong","Reasonable","5'9""","152 lbs","159","18",118,135,11,12,13,12,11,11,9,12,7,8,14,11,9,14,12,11,12,12,11,11,13,14,12,10,9,14,14,13,13,13,11,12,11,13,11,10,15,12,11,12,11,12,9,15,10,2,13,13,12,1,2,1,3,1,1,3,2,2,1,3
"5865",64001505,"Tim Matavž","1/13/1989 (34 years old)","ST (C)","HNK Gorica","Croatian First League","SVN","Yes","1/16/2023","6/15/2024","$16K - $45K","Right","Fairly Strong","Very Strong","6'2""","180 lbs","373","131",105,135,6,8,9,13,14,8,15,10,4,5,10,12,5,12,8,14,12,13,13,9,10,10,7,14,6,10,10,8,8,10,10,14,13,9,11,14,6,15,6,14,11,13,7,11,6,8,10,15,15,3,1,1,2,1,3,2,1,3,1,2
"5866",2000296471,"Lukas Hempt","9/10/2005 (17 years old)","D (C)","Domžale","Slovenian First League","SVN","Yes","6/12/2023","6/30/2026","$75K - $750K","Right Only","Weak","Very Strong","6'3""","171 lbs","-","-",88,135,7,5,6,9,10,2,14,8,8,11,12,4,11,10,8,10,10,9,11,9,17,5,11,8,13,14,10,10,11,9,11,16,10,11,9,10,12,12,13,11,11,11,7,11,5,6,10,13,19,2,3,1,3,2,3,3,2,1,2,4
"5867",43609933,"Martin Turk","8/21/2003 (19 years old)","GK","Sampdoria","Italian Serie B","SVN","Yes","4/8/2022","6/30/2025","$1.6M - $3.3M","Left","Very Strong","Reasonable","6'3""","158 lbs","22","-",110,135,2,1,2,1,8,5,1,2,3,1,13,3,2,4,8,13,11,11,13,13,12,2,10,3,12,15,10,15,9,12,13,15,15,11,10,14,10,11,9,9,14,12,10,18,9,4,12,11,12,9,11,12,11,12,10,12,11,9,11,10
"5868",2000119286,"Ziad Tarek","9/6/2000 (22 years old)","AM (RLC)","Smouha","Egyptian Premier League","EGY","No","7/1/2018","6/30/2025","$180K - $1.8M","Left","Very Strong","Reasonable","5'9""","147 lbs","18","2",95,134,8,10,15,10,13,8,5,9,8,8,14,1,8,14,7,12,9,7,9,12,17,14,11,12,8,9,13,10,14,15,13,5,13,14,5,5,12,11,12,10,14,8,7,16,12,3,9,10,13,2,1,1,1,3,2,1,1,2,1,3
"5869",62220556,"Žan Zaletel","9/16/1999 (23 years old)","D (C)","Viborg FF","3F Superliga","SVN","Yes","2/16/2023","12/31/2027","$300K - $2.9M","Right","Reasonable","Very Strong","6'0""","169 lbs","163","7",117,135,8,7,7,5,11,5,13,10,7,13,11,7,13,11,13,11,12,12,13,13,11,5,14,11,12,11,12,12,10,12,13,12,14,10,13,14,16,13,13,14,13,12,5,9,11,9,13,13,12,1,2,3,3,3,2,2,2,1,1,4
"5870",62247412,"Luka Vešner Tičić","10/25/2000 (22 years old)","M (C)","Koper","Slovenian First League","SVN","Yes","3/23/2022","6/30/2024","$240K - $2.4M","Right","Weak","Very Strong","5'10""","152 lbs","111","6",109,135,10,7,12,11,12,10,10,12,9,12,12,7,13,13,5,11,11,12,11,13,12,9,14,11,13,10,13,10,12,11,10,6,14,12,12,11,14,12,11,13,12,11,12,13,12,3,12,11,12,2,2,1,4,4,1,3,1,1,4,2
"5871",62085786,"Benjamin Verbič","11/27/1993 (29 years old)","M (L), AM (LC)","Panathinaikos","Greek Super League 1","SVN","Yes","7/29/2022","6/30/2025","$450K - $4.5M","Right","Fairly Strong","Very Strong","5'10""","154 lbs","287","74",120,135,12,10,14,13,14,13,12,13,9,5,13,10,6,15,12,10,13,14,10,11,12,13,7,13,7,11,13,13,13,11,13,9,10,13,12,11,12,9,10,12,12,13,12,13,12,6,10,12,13,2,1,1,1,2,3,2,3,2,3,2
"5872",62083377,"Andraž Šporar","2/27/1994 (29 years old)","ST (C)","Panathinaikos","Greek Super League 1","SVN","Yes","7/27/2022","6/30/2026","$7.6M - $9.2M","Right","Fairly Strong","Very Strong","6'1""","180 lbs","310","140",125,135,6,9,10,13,13,9,13,11,6,4,10,14,6,12,11,13,12,13,11,13,12,13,6,14,7,11,12,11,13,12,15,13,13,14,13,14,7,10,12,13,10,15,12,12,7,9,10,15,12,2,1,1,1,1,3,2,2,2,3,2
"5873",62232365,"Emir Saitoski","5/8/2003 (20 years old)","AM (RLC)","Domžale","Slovenian First League","SVN","Yes","7/1/2018","6/30/2025","$300K - $850K","Left","Very Strong","Reasonable","5'9""","149 lbs","32","1",101,134,12,12,12,10,11,10,7,11,7,8,11,10,10,12,10,10,11,11,11,12,12,13,10,10,10,11,12,11,13,11,9,7,13,13,10,9,12,11,12,11,10,11,5,12,9,9,12,11,12,1,3,4,4,2,2,3,1,3,3,2
"5874",62189940,"Žan Celar","3/14/1999 (24 years old)","AM (L), ST (C)","Lugano","Swiss Super League","SVN","Yes","8/28/2021","6/30/2025","$22K - $5.6M","Right","Fairly Strong","Very Strong","6'1""","176 lbs","109","31",123,133,7,8,11,13,12,10,13,12,5,5,12,15,10,12,12,14,13,13,12,12,14,10,8,13,7,12,9,13,13,12,13,12,14,13,14,14,12,13,14,12,13,13,8,9,7,7,11,13,7,1,1,2,2,3,2,2,1,1,4,3
"5875",62218369,"Dušan Stojinović","8/26/2000 (22 years old)","D (C)","Jagiellonia","PKO Bank Polski Ekstraklasa","SVN","Yes","1/26/2023","6/30/2025","$950K - $2M","Right","Reasonable","Very Strong","6'2""","171 lbs","140","1",104,133,5,6,8,7,10,7,12,5,9,12,9,7,12,9,12,11,11,12,12,11,12,8,14,10,12,10,10,10,11,13,11,12,18,11,12,13,13,12,11,12,9,10,6,11,13,5,12,13,19,1,3,1,1,2,3,1,1,3,2,3
"5876",62179157,"Vanja Drkušić","10/30/1999 (23 years old)","D (C)","Sochi","Russian Premier League","SVN","Yes","8/27/2022","6/10/2025","$2.7M - $5.4M","Right","Weak","Very Strong","6'2""","176 lbs","106","5",123,133,8,7,8,7,9,10,15,10,2,13,13,11,13,11,13,13,12,13,14,13,12,12,12,11,13,11,11,11,10,12,10,16,10,10,11,13,12,12,11,12,12,14,10,9,15,8,12,8,10,3,3,1,3,3,2,1,1,3,3,1
"5877",64014208,"Robert Berić","6/17/1991 (31 years old)","ST (C)","Tianjin","Chinese Super League","SVN","Yes","12/23/2021","12/31/2023","$180K - $1.8M","Right","Weak","Very Strong","6'2""","185 lbs","411","138",119,133,8,9,11,14,12,11,15,10,10,7,11,7,9,13,14,14,10,13,14,11,14,10,10,14,10,13,10,13,12,11,15,14,12,12,9,15,5,12,13,14,12,12,13,13,8,8,9,15,8,2,2,1,1,2,1,2,2,2,2,1
"5878",2000268942,"Aldin Jakupović","6/4/2006 (17 years old)","AM (RL), ST (C)","Olimpija","Slovenian First League","SVN","Yes","5/15/2023","6/30/2026","$130K - $1.3M","Right","Weak","Very Strong","5'11""","158 lbs","-","-",85,133,8,12,11,10,11,8,12,9,1,6,14,3,8,11,13,10,10,10,4,13,11,8,9,15,7,8,5,10,12,10,9,12,9,12,11,8,9,12,11,13,12,8,12,15,10,8,10,8,18,2,1,2,3,3,2,3,3,3,3,3
"5879",2000067313,"Hossam Abdel Maguid","4/30/2001 (22 years old)","D (C)","Zamalek","Egyptian Premier League","EGY","No","7/1/2018","7/31/2023","$600K - $1.8M","Right","Reasonable","Very Strong","6'4""","185 lbs","13","2",110,134,6,5,11,11,11,5,14,6,1,13,13,4,13,13,14,13,12,8,10,12,7,5,5,11,16,11,8,12,12,13,12,14,9,12,13,8,14,12,2,9,11,9,8,5,12,3,14,13,20,3,3,3,3,3,3,3,3,1,1,3
"5880",2000119790,"Andraž Ruedl","1/20/2004 (19 years old)","AM (C)","Krško","Slovenian Third League East","SVN","Yes","9/2/2022","6/30/2024","$45K - $450K","Right","Reasonable","Very Strong","6'0""","160 lbs","37","4",101,133,10,10,12,11,11,8,10,12,6,9,11,4,11,12,16,12,15,12,10,8,5,14,7,14,10,8,10,9,12,11,11,11,13,12,13,13,12,5,7,9,13,13,6,10,15,15,15,13,8,3,2,3,3,3,3,4,3,2,3,2
"5881",62123746,"Jon Gorenc Stankovič","1/14/1996 (27 years old)","D (C), DM","SK Sturm Graz","Austrian Premier Division","SVN","Yes","10/19/2021","6/30/2025","$4.8M - $7.2M","Right","Weak","Very Strong","6'3""","171 lbs","207","13",130,131,4,6,10,6,13,4,16,6,11,13,13,7,13,11,14,12,14,14,13,14,13,6,14,12,14,13,11,13,12,12,15,15,14,12,12,12,12,10,11,14,4,10,6,12,8,4,14,10,9,1,2,4,3,3,1,3,1,1,2,4
"5882",62220061,"Nino Žugelj","4/25/2000 (23 years old)","AM (RLC)","Bodø/Glimt","Norwegian Premier Division","SVN","Yes","8/5/2022","12/31/2025","$950K - $2M","Left","Very Strong","Fairly Strong","6'1""","156 lbs","62","5",115,131,10,10,12,13,13,11,9,13,9,7,11,11,8,13,11,12,7,13,12,11,12,14,10,13,10,11,12,11,13,11,12,11,12,13,11,11,12,11,12,11,12,11,7,12,10,4,12,12,11,4,1,1,1,1,2,1,3,3,3,2
"5883",64001280,"Vid Belec","6/6/1990 (33 years old)","GK","APOEL","Cypriot First Division","SVN","Yes","6/27/2022","5/31/2025","Not for Sale","Right Only","Weak","Very Strong","6'4""","185 lbs","267","-",120,130,5,1,3,3,6,7,7,3,1,1,5,4,3,7,10,14,14,11,13,12,15,3,11,4,13,13,11,16,11,12,11,16,15,10,8,13,14,14,12,16,12,10,6,12,3,9,12,12,14,13,9,14,13,13,12,13,13,12,12,13
"5884",62154454,"Jon Šporn","5/22/1997 (26 years old)","DM, M (C)","Celje","Slovenian First League","SVN","Yes","9/30/2020","6/30/2025","$75K - $750K","Left","Very Strong","Reasonable","5'10""","163 lbs","160","13",110,130,11,11,11,9,12,10,8,11,8,11,13,11,12,12,10,11,11,11,12,12,13,12,9,12,11,13,12,14,12,12,10,9,13,12,11,9,10,12,11,12,12,13,6,12,7,12,15,11,13,2,1,2,3,1,1,1,1,3,1,1
"5885",2000296473,"Maj Blažič","1/25/2007 (16 years old)","M/AM (C)","Bilje","Slovenian Second League","SVN","Yes","7/1/2022","6/30/2026","$0","Right","Reasonable","Very Strong","6'0""","165 lbs","-","-",80,130,9,9,9,9,11,9,9,10,2,7,10,6,8,11,9,11,12,11,8,15,12,10,8,8,10,12,11,10,10,11,10,11,12,11,10,10,9,12,11,12,11,10,8,5,7,2,6,12,15,1,3,1,2,3,2,1,1,2,2,1
"5886",2000216690,"Nik Guberac","1/18/2005 (18 years old)","D (C)","Domžale","Slovenian First League","SVN","Yes","1/2/2022","6/30/2024","$130K - $1.3M","Right","Weak","Very Strong","6'0""","174 lbs","-","-",78,130,7,7,6,7,6,6,14,3,3,11,8,2,11,3,12,7,9,7,7,14,7,8,6,7,14,7,7,8,12,9,8,7,14,11,12,12,11,10,11,10,11,12,15,12,9,1,9,13,15,1,3,3,1,2,4,2,2,1,1,3
"5887",62086025,"Jure Balkovec","9/9/1994 (28 years old)","D (LC), WB (L)","Alanyaspor","Turkish Super League","SVN","Yes","7/5/2022","6/30/2024","$1.3M - $2.7M","Left Only","Very Strong","Weak","6'1""","163 lbs","291","20",115,130,13,15,7,8,12,15,8,15,8,12,14,9,10,13,12,13,12,12,14,12,13,8,10,10,12,12,13,10,10,12,12,10,15,11,15,13,12,12,12,12,11,12,7,12,11,9,13,12,10,3,1,3,3,1,2,2,4,2,2,2
"5888",62203784,"David Brekalo","12/3/1998 (24 years old)","D (C)","Viking","Norwegian Premier Division","SVN","Yes","8/9/2021","12/31/2025","$190K - $1.9M","Right","Weak","Very Strong","6'2""","180 lbs","166","16",125,130,10,11,10,6,11,6,15,6,10,13,13,6,13,12,14,13,14,11,13,13,14,8,13,6,13,14,10,12,12,12,13,14,12,14,10,14,12,4,7,15,12,11,11,11,12,9,13,13,13,4,3,2,3,3,4,3,3,2,3,1
"5889",62085565,"Leo Štulac","9/26/1994 (28 years old)","DM, M (C)","Empoli","Italian Serie A","SVN","Yes","7/26/2019","6/30/2025","$1.1M - $2.3M","Right Only","Weak","Very Strong","5'9""","154 lbs","250","21",119,130,14,10,12,10,13,14,9,14,4,8,15,10,12,14,13,14,10,12,13,13,13,11,12,12,14,13,13,13,12,12,11,10,15,11,12,12,13,11,12,12,11,12,10,13,7,9,12,12,12,2,2,1,1,3,3,1,3,2,2,3
"5890",13229564,"Nabil Dunga","4/6/1996 (27 years old)","DM, M (C)","Zamalek","Egyptian Premier League","EGY","No","9/15/2022","7/31/2025","$350K - $3.5M","Right","Reasonable","Very Strong","5'10""","160 lbs","125","4",117,134,11,8,12,12,16,11,11,11,8,13,15,8,11,16,10,16,11,10,13,16,14,5,10,12,15,9,15,13,11,10,11,6,12,10,8,7,17,17,6,10,12,12,8,12,5,5,12,10,20,3,1,1,3,1,1,4,2,3,1,1
"5891",62123347,"Domen Črnigoj","11/18/1995 (27 years old)","M (RC), AM (C)","Salernitana","Italian Serie A","SVN","Yes","11/3/2021","6/30/2025","$65K - $650K","Right","Weak","Very Strong","6'2""","160 lbs","291","16",115,130,6,10,11,12,13,7,12,13,4,10,13,10,13,13,15,12,14,12,12,13,16,11,10,13,12,14,10,15,12,11,12,12,14,12,13,14,12,12,14,14,10,14,9,11,14,10,13,15,15,1,3,1,3,1,3,1,1,3,3,3
"5892",59130638,"Khvicha Kvaratskhelia","2/12/2001 (22 years old)","AM (L)","Parthenope","Italian Serie A","GEO","No","7/1/2022","6/30/2027","$159M - $239M","Right","Strong","Very Strong","6'0""","154 lbs","143","34",164,177,8,14,19,15,19,12,11,14,4,4,16,17,7,18,11,12,12,16,12,15,17,19,10,13,5,11,15,12,15,18,14,9,16,14,11,10,13,14,13,16,17,12,7,14,8,4,13,16,19,1,2,2,3,1,2,1,1,2,3,1
"5893",59138294,"Giorgi Mamardashvili","9/29/2000 (22 years old)","GK","Valencia","Spanish First Division","GEO","No","9/19/2022","6/30/2027","$71M - $108M","Left","Very Strong","Weak","6'6""","207 lbs","113","-",145,161,4,3,1,3,11,7,2,1,2,3,11,2,2,8,8,12,14,12,14,11,14,3,12,1,13,13,12,12,10,12,13,15,13,11,13,15,17,10,10,12,10,12,5,14,14,7,15,14,16,12,14,16,10,12,15,15,12,16,16,15
"5894",58154551,"Saba Sazonov","2/1/2002 (21 years old)","D (C)","Dinamo Moscow","Russian Premier League","GEO","No","7/9/2021","6/10/2024","$350K - $3.5M","Right","Fairly Strong","Very Strong","6'4""","187 lbs","64","6",119,149,6,5,8,6,7,6,15,9,8,13,8,7,13,8,13,12,15,13,13,12,12,11,14,6,11,13,7,13,12,9,15,15,16,14,13,14,7,11,11,11,11,11,4,12,16,16,12,11,19,1,1,2,2,4,1,1,3,3,3,3
"5895",2000169199,"Gabriel Sigua","6/30/2005 (17 years old)","DM, M (C)","Dinamo Tb.","Georgian National League","GEO","No","6/13/2022","12/31/2025","$0","Right Only","Weak","Very Strong","6'3""","194 lbs","25","-",97,144,10,9,12,7,13,9,9,10,6,7,12,10,8,13,12,13,10,13,10,11,16,12,7,12,8,13,12,13,10,11,13,15,12,12,12,13,11,10,12,12,10,14,12,13,8,6,20,12,18,1,2,2,3,1,2,2,2,1,1,2
"5896",2000063176,"Luka Gagnidze","2/28/2003 (20 years old)","DM, M (C)","Dinamo Moscow","Russian Premier League","GEO","No","7/5/2021","6/30/2026","$550K - $10.5M","Right","Fairly Strong","Very Strong","5'9""","149 lbs","49","1",110,143,12,10,13,8,13,12,8,12,5,10,13,12,10,14,12,14,10,12,12,11,8,16,8,10,12,11,12,13,13,13,10,8,8,12,11,7,13,10,11,11,11,13,8,18,7,3,9,11,12,1,2,2,4,1,3,1,3,3,3,2
"5897",49043189,"Georges Mikautadze","10/31/2000 (22 years old)","AM (L), ST (C)","FC Metz","Ligue 1 Uber Eats","GEO","Yes","11/17/2022","6/30/2026","$18M - $22M","Right","Fairly Strong","Very Strong","5'9""","156 lbs","88","51",125,141,10,11,13,14,13,12,8,12,6,6,12,15,6,13,10,13,13,15,12,13,14,13,9,13,7,12,13,12,15,14,14,8,13,13,12,10,12,11,12,14,12,11,8,11,10,8,13,16,12,1,4,3,1,2,1,1,2,2,1,2
"5898",2000169191,"Luka Parkadze","4/6/2005 (18 years old)","M (C), AM (RLC)","Gagra","Georgian National League","GEO","No","1/1/2022","12/31/2024","$26K - $250K","Right","Reasonable","Very Strong","5'9""","147 lbs","11","2",88,140,12,10,13,9,12,12,5,9,4,5,12,10,5,13,6,8,7,9,8,8,11,14,4,10,5,10,12,9,14,13,8,7,11,14,9,7,10,16,14,12,9,12,8,5,2,5,10,12,8,3,2,2,2,4,2,1,2,1,2,2
"5899",59145965,"Irakli Azarovi","2/21/2002 (21 years old)","D/WB (L)","Crvena zvezda","Serbian SuperLeague","GEO","No","8/5/2022","6/30/2026","$3.2M - $6.4M","Left","Very Strong","Fairly Strong","5'10""","154 lbs","85","3",111,136,11,12,12,10,12,7,6,11,11,9,12,11,10,12,12,11,10,12,11,12,12,13,9,12,10,11,12,11,13,13,11,8,12,12,14,8,10,12,13,12,12,9,5,12,11,3,13,11,13,4,3,4,3,1,3,2,1,1,4,3
"5900",59123271,"Giorgi Chakvetadze","8/29/1999 (23 years old)","M (C), AM (LC)","AA Gent","Jupiler Pro League","GEO","No","6/15/2020","6/30/2024","$850K - $5.6M","Right","Fairly Strong","Very Strong","6'0""","169 lbs","126","13",125,135,11,11,14,12,13,11,8,11,8,7,14,11,6,15,9,12,14,10,13,13,12,14,11,11,7,12,14,10,14,14,9,10,13,14,12,10,11,17,11,11,10,14,3,12,6,8,12,18,8,3,1,2,1,1,1,2,3,1,1,3
"5901",36161869,"Ahmed Atef","3/21/1998 (25 years old)","AM (RL), ST (C)","Future","Egyptian Premier League","EGY","No","9/1/2022","6/30/2025","$1.7M - $3.6M","Right Only","Weak","Very Strong","6'0""","176 lbs","48","15",114,134,5,6,12,14,12,5,13,8,3,6,11,13,7,12,12,14,14,12,12,11,13,10,6,13,7,15,9,13,14,12,12,12,11,15,11,13,7,15,12,11,10,11,6,13,5,2,13,10,17,1,1,3,1,1,2,2,1,3,2,3
"5902",59133252,"Zuriko Davitashvili","2/15/2001 (22 years old)","M/AM (RL)","Dinamo Bt.","Georgian National League","GEO","No","4/6/2022","12/31/2024","$160K - $1.6M","Right","Fairly Strong","Very Strong","5'9""","138 lbs","147","19",118,135,9,8,16,8,14,9,7,12,5,4,12,10,6,15,11,11,12,10,11,11,15,12,7,13,8,11,12,13,14,14,13,7,12,14,12,7,8,16,14,13,11,10,8,14,4,8,13,14,11,1,1,3,1,2,4,2,3,1,3,3
"5903",1650090,"Jaba Kankava","3/18/1986 (37 years old)","DM, M (C)","Slovan Bratislava","Slovak First Division","GEO","No","5/10/2023","6/30/2024","$16K - $170K","Right","Reasonable","Very Strong","5'9""","165 lbs","390","19",120,135,7,8,8,6,15,10,10,12,10,13,12,12,14,13,16,13,15,14,13,12,16,8,14,8,12,15,10,15,10,11,14,10,16,11,14,13,15,12,12,15,12,10,5,12,12,10,14,13,8,3,2,3,3,1,3,3,1,2,3,3
"5904",58062031,"Solomon Kvirkvelia","2/6/1992 (31 years old)","D (C)","Neftçi","Azeri Premier League","GEO","No","7/4/2022","6/30/2025","Not for Sale","Right","Reasonable","Very Strong","6'5""","205 lbs","255","8",120,135,6,5,6,6,9,4,14,6,11,14,10,6,12,8,11,11,13,10,12,12,11,11,12,7,14,13,7,12,11,9,13,16,12,13,12,16,7,14,10,7,11,9,7,13,8,10,12,9,11,3,3,2,2,3,3,1,1,3,3,1
"5905",59093382,"Luka Lochoshvili","5/29/1998 (25 years old)","D (C)","Cremonese","Italian Serie B","GEO","No","8/10/2022","6/30/2026","$425K - $4.2M","Left Only","Very Strong","Weak","6'4""","187 lbs","144","4",123,134,7,9,10,7,10,9,15,10,13,14,10,10,14,8,15,14,14,12,11,12,8,5,10,10,14,14,10,13,11,11,15,15,14,12,14,13,12,14,10,11,13,11,6,14,8,7,14,12,11,3,3,2,1,1,1,3,3,1,1,3
"5906",59033608,"Valeri Qazaishvili","1/29/1993 (30 years old)","AM (RLC), ST (C)","Ulsan","Hana 1Q K LEAGUE 1","GEO","No","12/31/2020","12/31/2025","$210K - $2.1M","Right","Reasonable","Very Strong","5'9""","163 lbs","305","79",122,134,9,11,16,10,15,12,7,11,7,5,12,12,4,16,9,13,11,12,11,11,11,14,5,14,5,7,11,11,13,14,12,5,11,13,12,11,14,11,9,10,9,5,10,9,8,7,8,15,14,1,1,3,3,1,2,1,1,1,1,1
"5907",59075855,"Giorgi Kharaishvili","7/29/1996 (26 years old)","M (L), AM (RLC)","Dinamo Tb.","Georgian National League","GEO","No","2/16/2021","12/31/2023","$4K - $40K","Right","Reasonable","Very Strong","6'0""","160 lbs","195","77",107,133,13,12,13,12,13,14,8,14,6,8,13,9,8,13,11,12,10,13,11,10,11,12,7,12,8,11,12,11,12,12,10,10,11,11,12,10,8,11,11,11,11,6,7,9,7,6,12,12,13,2,1,1,3,2,3,2,2,1,3,3
"5908",59092399,"Otar Kiteishvili","3/26/1996 (27 years old)","M (LC), AM (C)","SK Sturm Graz","Austrian Premier Division","GEO","No","7/16/2021","6/30/2024","$5.4M - $6.8M","Right","Strong","Very Strong","5'8""","143 lbs","234","42",131,133,9,10,13,8,13,13,8,12,6,8,12,9,10,14,9,12,11,11,11,13,11,9,11,15,8,14,13,14,13,12,9,8,12,14,13,11,9,12,11,11,12,11,11,11,5,4,12,10,16,1,1,1,1,1,2,1,4,2,2,3
"5909",59115661,"Giorgi Kochorashvili","6/29/1999 (23 years old)","DM, M/AM (C)","Levante","Spanish Second Division","GEO","No","1/3/2020","6/30/2026","$950K - $2.1M","Right","Reasonable","Very Strong","5'9""","154 lbs","111","8",118,132,11,9,11,8,13,11,9,11,6,11,13,10,11,13,11,13,12,12,13,13,12,13,8,13,8,13,13,13,12,12,13,8,13,12,13,11,12,10,12,14,13,13,7,12,8,8,14,14,12,3,1,2,1,3,1,4,4,3,1,1
"5910",59094650,"Davit Kobouri","1/24/1998 (25 years old)","D (LC)","Dinamo Tb.","Georgian National League","GEO","No","7/2/2022","12/31/2023","$60K - $600K","Left","Very Strong","Reasonable","6'2""","174 lbs","150","2",107,132,4,10,4,8,7,1,14,7,8,14,8,5,14,2,7,11,10,9,7,14,12,5,4,8,14,8,8,9,14,14,9,11,16,14,14,10,17,14,14,10,12,11,13,11,7,2,11,11,10,1,1,2,3,1,3,1,2,1,2,1
"5911",59063380,"Budu Zivzivadze","3/10/1994 (29 years old)","ST (C)","Karlsruhe","Bundesliga 2","GEO","No","1/31/2023","6/30/2025","$65K - $650K","Left","Very Strong","Strong","6'2""","187 lbs","282","145",108,132,8,7,11,12,11,8,12,7,6,5,10,11,6,12,9,11,13,11,12,11,9,10,8,12,6,13,10,14,11,11,13,12,15,13,12,13,9,8,15,14,6,5,3,6,5,8,8,12,12,3,3,2,2,1,1,2,1,1,4,2
"5912",2000071446,"Abdelrahman Rashdan","6/1/2003 (20 years old)","D (C)","Al-Ahly","Egyptian Premier League","EGY","No","10/3/2022","7/31/2027","$170K - $1.7M","Right","Strong","Very Strong","6'1""","180 lbs","2","-",89,134,4,3,5,7,12,1,14,11,1,9,11,4,12,11,13,8,9,11,7,9,5,5,12,7,14,7,9,9,9,9,8,13,13,11,7,12,13,11,3,12,11,9,8,11,12,6,9,13,8,1,3,1,1,3,1,4,2,1,3,3
"5913",59038761,"Davit Khocholava","2/8/1993 (30 years old)","D (C)","FC København","3F Superliga","GEO","No","7/4/2021","6/30/2025","$4.3M - $8.2M","Right Only","Weak","Very Strong","6'4""","200 lbs","192","11",131,132,5,9,7,5,10,3,15,7,7,14,13,7,14,12,18,13,17,12,13,13,14,8,13,9,14,14,11,13,12,10,14,16,18,13,14,16,7,12,9,15,15,15,11,14,13,6,13,13,16,1,1,3,2,1,3,4,1,2,3,1
"5914",59138495,"Giorgi Gocholeishvili","2/14/2001 (22 years old)","D/WB/M/AM (R)","Shakhtar","Ukrainian Premier League","GEO","No","1/1/2023","12/31/2027","$275K - $2.6M","Right","Fairly Strong","Very Strong","5'10""","154 lbs","114","11",115,130,12,12,12,8,10,7,8,11,10,11,11,6,12,11,13,12,11,13,12,12,14,9,1,15,7,12,7,12,15,12,12,10,13,13,13,10,16,14,12,9,9,13,14,9,9,1,18,9,11,3,2,3,1,3,1,2,2,2,2,1
"5915",59128775,"Nikoloz Mali","1/27/1999 (24 years old)","D (R)","Dinamo Tb.","Georgian National League","GEO","No","1/1/2022","12/31/2024","$35K - $325K","Either","Very Strong","Very Strong","5'9""","154 lbs","133","9",104,130,7,14,6,7,13,5,10,7,9,12,9,4,13,10,12,9,11,5,11,15,9,8,13,9,11,10,7,10,12,13,10,6,12,12,10,10,17,11,10,10,10,13,11,14,11,5,8,10,11,1,1,1,2,3,1,3,3,2,3,1
"5916",59065573,"Saba Lobzhanidze","12/18/1994 (28 years old)","AM (RL)","Hatayspor","Turkish Super League","GEO","No","1/1/2022","6/30/2025","$1.6M - $3.4M","Right","Weak","Very Strong","5'9""","158 lbs","287","68",115,130,12,11,16,10,10,12,4,13,5,3,10,13,3,12,10,12,7,10,8,8,9,15,6,14,5,8,13,10,16,14,12,6,15,16,12,8,13,8,15,13,7,5,8,11,8,8,13,15,13,1,2,3,2,1,1,3,2,2,1,2
"5917",59048662,"Giorgi Kvilitaia","10/1/1993 (29 years old)","ST (C)","APOEL","Cypriot First Division","GEO","No","6/3/2021","5/31/2024","$400K - $3.9M","Right","Fairly Strong","Very Strong","6'4""","180 lbs","293","135",130,130,4,8,11,13,11,7,15,10,4,6,12,8,7,12,13,12,12,13,10,12,12,8,9,15,7,14,11,13,12,12,16,18,14,13,13,16,4,8,14,14,8,12,11,10,12,7,10,13,11,2,3,3,2,1,3,1,1,1,2,3
"5918",59138505,"Lado Chikhradze","9/3/2001 (21 years old)","ST (C)","Samgurali","Georgian National League","GEO","No","6/30/2022","12/31/2024","$300K - $850K","Right","Fairly Strong","Very Strong","5'9""","154 lbs","18","2",88,130,7,4,12,13,11,7,11,5,4,7,8,6,5,10,5,12,5,14,8,10,14,12,8,14,8,7,8,8,14,14,8,8,9,14,6,7,10,20,11,12,11,11,8,11,9,7,15,13,16,1,2,1,3,3,2,2,2,2,3,1
"5919",2000308459,"Aleksandre Peikrishvili","6/14/2006 (16 years old)","M (C)","Dinamo Tb.","Georgian National League","GEO","No","1/1/2023","12/31/2025","$14K - $140K","Right","Reasonable","Very Strong","5'10""","138 lbs","-","-",73,129,7,6,4,6,8,7,7,9,2,6,14,1,9,13,15,11,6,4,9,11,6,6,4,9,8,8,11,12,11,14,8,9,13,14,7,6,9,10,14,11,14,12,8,10,11,6,7,11,14,3,3,1,2,4,3,2,1,1,3,3
"5920",59094826,"Sandro Altunashvili","1/14/1997 (26 years old)","DM, M (C)","Dinamo Bt.","Georgian National League","GEO","No","1/1/2021","12/31/2023","$0","Right","Weak","Very Strong","5'7""","134 lbs","225","9",113,129,8,10,9,11,15,6,8,13,5,12,15,5,14,15,15,15,10,10,12,12,16,5,9,12,14,11,14,14,15,12,11,4,12,14,13,3,16,12,9,12,12,10,9,14,9,1,10,12,16,1,3,2,1,2,2,2,4,1,1,1
"5921",2000197052,"Jorge Karseladze","3/18/2005 (18 years old)","D/WB/M/AM (R)","Rio Ave","Portuguese Premier League","GEO","Yes","6/13/2022","6/30/2025","$160K - $1.6M","Right","Weak","Very Strong","5'10""","169 lbs","2","-",90,129,8,14,14,12,14,7,8,8,8,9,13,2,10,12,11,6,9,7,5,9,15,15,5,13,9,9,10,10,13,10,8,9,14,11,7,6,15,15,13,14,12,11,12,17,5,5,20,10,13,1,2,3,1,1,1,3,1,1,2,3
"5922",2000062393,"Anzor Mekvabishvili","6/5/2001 (22 years old)","DM","Dinamo Tb.","Georgian National League","GEO","No","1/1/2019","12/31/2024","$375K - $1.1M","Left","Very Strong","Reasonable","5'9""","154 lbs","75","6",95,128,6,7,6,8,14,8,8,9,1,10,14,5,14,14,7,12,9,9,4,14,11,6,4,8,13,9,8,12,8,11,9,6,14,8,7,8,13,16,11,12,14,12,7,4,5,5,8,12,19,1,1,2,3,2,3,2,2,1,1,1
"5923",13228614,"Ahmed Yasser Rayan","1/24/1998 (25 years old)","AM (L), ST (C)","Ceramica Cleopatra","Egyptian Premier League","EGY","No","9/12/2022","7/31/2026","$550K - $5.6M","Right Only","Weak","Very Strong","6'1""","178 lbs","98","33",118,134,12,10,12,13,12,9,14,11,9,8,12,14,7,13,10,14,11,12,11,12,12,12,5,14,12,13,11,11,13,13,14,15,13,13,16,14,11,14,6,12,13,10,11,17,8,6,11,11,19,3,2,2,3,3,2,3,3,2,1,3
"5924",29024419,"Giorgi Makaridze","3/31/1990 (33 years old)","GK","MRT","Portuguese Second League","GEO","No","1/11/2023","6/30/2024","$24K - $240K","Right Only","Weak","Very Strong","6'4""","198 lbs","210","1",116,128,4,1,3,1,8,8,8,3,3,1,13,13,2,8,12,9,13,7,13,8,13,6,8,2,10,11,10,9,13,12,13,15,13,12,12,14,1,13,5,9,15,11,8,15,7,16,12,15,13,12,12,14,14,12,13,13,9,15,14,15
"5925",59147473,"Giorgi Babunashvili","4/11/2000 (23 years old)","M/AM (R)","Samgurali","Georgian National League","GEO","No","6/15/2020","12/31/2025","$450K - $1.3M","Right","Fairly Strong","Very Strong","5'10""","156 lbs","-","-",111,127,8,13,14,10,14,6,9,10,9,7,12,5,10,9,13,12,5,11,10,14,15,14,10,14,9,10,9,13,14,14,10,9,15,14,8,7,14,15,10,11,12,10,9,9,9,1,14,12,18,2,3,3,2,2,2,3,3,3,3,1
"5926",59075835,"Gagi Margvelashvili","10/30/1996 (26 years old)","D (C)","Shkupi","North Macedonian First League","GEO","No","1/28/2022","6/30/2024","$0","Right Only","Weak","Very Strong","6'4""","198 lbs","244","20",100,127,7,6,3,9,12,5,12,8,8,9,10,5,11,8,15,11,7,11,15,10,17,5,12,10,13,11,8,10,14,11,11,16,7,10,11,12,17,19,11,15,10,12,8,11,4,1,18,13,10,3,1,3,2,1,3,1,2,2,2,2
"5927",59138503,"Tsotne Kapanadze","8/30/2001 (21 years old)","D (R)","Saburtalo","Georgian Liga 3","GEO","No","1/11/2023","12/31/2024","$40K - $400K","Right","Fairly Strong","Very Strong","5'5""","132 lbs","109","1",86,127,6,11,4,7,7,3,8,5,6,11,8,4,13,8,8,5,9,8,9,14,4,5,6,7,9,8,8,8,14,14,8,1,9,14,10,3,10,14,13,10,9,11,6,5,8,7,14,10,7,1,1,1,3,1,3,2,2,3,2,1
"5928",59117867,"Luka Lakvekheliani","10/20/1998 (24 years old)","D (L)","Dinamo Tb.","Georgian National League","GEO","No","3/13/2023","12/31/2023","$14K - $150K","Left","Very Strong","Reasonable","5'9""","152 lbs","107","2",106,127,12,11,9,7,10,10,11,4,8,12,10,5,13,10,9,12,12,8,14,12,12,5,8,9,13,12,10,12,12,12,12,11,12,14,12,7,6,11,12,11,12,14,6,13,4,3,14,16,10,3,3,4,2,4,2,2,1,2,3,2
"5929",59063389,"Giorgi Papunashvili","9/2/1995 (27 years old)","AM (RC)","Samtredia","Georgian National League","GEO","No","3/16/2023","12/31/2023","$0","Left","Very Strong","Weak","5'10""","167 lbs","173","27",103,127,11,10,13,11,13,12,6,16,4,5,12,11,6,13,8,11,12,11,10,9,13,16,11,13,4,5,12,12,13,12,15,8,8,11,8,11,13,8,15,8,6,11,13,13,5,6,10,18,14,2,2,3,1,1,2,2,3,2,1,3
"5930",1650111,"Gogita Gogua","9/4/1983 (39 years old)","DM, M (LC), AM (C)","Samegrelo","Georgian Regional League Group C","GEO","No","8/1/2022","12/31/2023","$0 - $2K","Left","Very Strong","Strong","5'9""","158 lbs","416","45",78,126,3,9,11,7,9,3,3,9,4,3,9,10,9,10,15,7,10,9,10,9,15,12,9,11,8,7,9,10,10,11,8,6,11,10,9,6,12,7,6,15,11,5,13,14,13,14,12,11,11,2,1,1,3,3,2,3,1,2,1,3
"5931",59094837,"Giorgi Kokhreidze","11/18/1998 (24 years old)","AM (LC), ST (C)","Saburtalo","Georgian National League","GEO","No","3/7/2023","12/31/2023","$170K - $500K","Right Only","Weak","Very Strong","5'7""","160 lbs","141","28",100,125,8,9,14,13,8,8,10,10,5,7,11,5,8,12,12,11,4,9,6,8,12,11,14,14,8,9,9,10,14,13,11,6,15,14,14,7,11,19,9,11,13,11,5,15,5,2,12,11,7,1,2,1,1,2,3,1,1,2,2,4
"5932",59028036,"Tornike Okriashvili","2/12/1992 (31 years old)","M (R), AM (RL)","Gagra","Georgian National League","GEO","No","2/19/2023","12/31/2023","$80K - $800K","Right","Fairly Strong","Very Strong","5'11""","156 lbs","230","34",112,125,9,10,13,11,13,9,6,10,7,8,13,12,9,13,7,12,9,13,10,11,8,16,14,11,6,12,11,11,12,13,15,9,10,11,11,9,13,4,8,4,8,10,14,14,10,4,10,14,3,3,2,3,2,2,2,2,3,4,2,3
"5933",59063384,"Otar Kakabadze","6/27/1995 (27 years old)","D/WB (R)","Cracovia","PKO Bank Polski Ekstraklasa","GEO","No","7/1/2021","6/30/2024","$140K - $1.4M","Right","Weak","Very Strong","6'1""","174 lbs","211","7",112,125,11,11,12,11,12,11,9,13,13,11,11,9,12,13,9,13,10,12,12,14,12,15,9,13,9,13,12,13,12,11,11,10,12,12,13,11,13,10,10,11,10,11,9,12,8,1,13,9,8,3,1,1,1,2,1,3,1,3,3,2
"5934",12034355,"Amr El Soleya","4/2/1990 (33 years old)","DM, M (C)","Al-Ahly","Egyptian Premier League","EGY","No","6/14/2021","7/31/2024","Not for Sale","Right Only","Weak","Very Strong","6'1""","154 lbs","314","34",124,134,4,7,8,9,13,8,14,15,7,12,14,12,16,12,16,13,15,12,10,10,15,8,15,10,13,16,13,16,11,11,13,14,15,12,15,14,8,13,15,12,8,12,7,13,8,7,15,12,8,3,3,1,2,3,3,3,1,2,2,3
"5935",59002636,"Guram Kashia","7/4/1987 (35 years old)","D (RC)","Slovan Bratislava","Slovak First Division","GEO","No","5/10/2023","6/30/2024","$18K - $180K","Right","Weak","Very Strong","6'1""","191 lbs","437","40",118,125,6,7,7,7,10,7,15,7,10,13,11,7,15,8,14,12,16,15,10,12,15,5,16,11,11,13,11,13,9,12,15,15,14,10,12,15,10,8,14,17,12,14,6,13,7,6,14,13,10,1,4,2,1,3,2,3,4,3,3,1
"5936",59074708,"Giorgi Beridze","5/12/1997 (26 years old)","M/AM (L), ST (C)","Ankaragücü","Turkish Super League","GEO","No","7/18/2022","6/30/2024","$0","Right","Reasonable","Very Strong","5'9""","156 lbs","200","45",115,125,11,13,14,13,12,10,11,12,8,4,14,12,5,14,7,10,11,8,10,13,9,12,7,12,12,10,12,9,14,14,5,10,14,15,9,9,11,12,12,9,10,11,4,6,5,7,12,7,10,2,3,3,1,1,3,1,1,1,1,1
"5937",59029284,"Davit Skhirtladze","3/16/1993 (30 years old)","AM (RLC), ST (C)","Dinamo Tb.","Georgian National League","GEO","No","8/31/2021","12/31/2023","$55K - $550K","Left","Very Strong","Strong","6'2""","178 lbs","231","43",109,125,9,10,12,11,12,9,10,8,8,3,12,8,3,13,6,11,5,12,8,10,13,16,2,8,6,10,13,8,12,13,14,14,11,12,11,13,10,13,12,6,6,7,14,8,8,7,11,13,13,1,1,1,1,3,3,2,2,3,2,2
"5938",71104584,"Giorgi Tsitaishvili","11/18/2000 (22 years old)","M (R), AM (RL)","Dynamo Kyiv","Ukrainian Premier League","GEO","No","6/15/2020","9/30/2025","$40K - $400K","Left Only","Very Strong","Weak","5'7""","138 lbs","64","4",105,125,13,13,16,10,13,10,6,7,5,6,12,9,7,14,14,8,14,10,6,5,16,16,5,10,8,11,13,15,14,15,10,6,11,14,11,9,17,7,8,8,5,12,15,10,10,8,5,12,19,2,2,3,3,1,1,4,1,1,2,2
"5939",59075836,"Jemal Tabidze","3/18/1996 (27 years old)","D (C)","Dinamo Tb.","Georgian National League","GEO","No","7/10/2022","12/31/2023","$100K - $1M","Left Only","Very Strong","Weak","6'2""","169 lbs","147","3",118,125,6,6,11,6,12,8,12,10,10,12,12,7,15,12,14,13,15,11,13,11,12,8,12,10,14,12,9,15,12,12,13,14,9,13,12,12,10,17,13,13,9,13,6,11,6,1,17,10,10,3,4,1,3,1,3,2,1,2,1,1
"5940",2000063179,"Saba Khvadagiani","1/30/2003 (20 years old)","D (C)","Dinamo Tb.","Georgian National League 2","GEO","No","1/1/2021","12/31/2024","$30K - $300K","Right","Reasonable","Very Strong","6'1""","171 lbs","50","1",85,125,5,3,3,3,6,4,14,3,4,14,8,2,14,2,10,10,9,8,8,14,9,5,1,7,13,7,7,8,10,13,8,9,11,9,6,7,9,14,11,11,11,11,10,12,11,4,10,12,18,1,1,1,2,2,3,3,3,2,2,1
"5941",59139122,"Giorgi Kvernadze","2/7/2003 (20 years old)","AM (LC), ST (C)","Kolkheti-1913","Georgian National League 2","GEO","No","1/11/2023","12/31/2024","$130K - $1.3M","Right","Fairly Strong","Very Strong","6'2""","147 lbs","36","3",112,123,8,11,14,9,12,11,12,9,11,5,10,11,7,11,12,9,13,9,12,12,13,12,12,13,7,12,11,12,10,13,14,13,16,14,13,13,12,12,12,13,12,12,3,12,13,4,12,13,12,3,1,1,2,2,1,2,3,3,3,3
"5942",59001398,"Giorgi Loria","1/27/1986 (37 years old)","GK","Anorthosi","Cypriot First Division","GEO","No","7/14/2019","6/30/2024","$24K - $240K","Right Only","Weak","Very Strong","6'6""","187 lbs","422","-",120,123,3,3,2,2,6,7,8,1,1,2,9,1,2,9,6,10,14,11,12,11,8,1,13,2,13,11,10,12,9,11,10,17,10,10,10,14,11,8,14,14,10,13,6,13,8,7,12,16,16,12,14,14,13,15,13,13,8,11,14,15
"5943",29024420,"Levan Kenia","10/18/1990 (32 years old)","M (LC), AM (C)","Uerdingen","German Div. Lower Rhine","GEO","Yes","6/28/2022","6/30/2024","$0 - $35K","Left","Very Strong","Reasonable","5'9""","154 lbs","162","16",80,123,12,11,14,7,14,13,4,9,5,6,13,7,4,14,17,10,3,13,3,12,16,17,4,11,5,9,13,7,11,11,11,5,6,9,9,5,10,15,8,5,14,10,15,9,15,5,10,14,10,2,3,3,3,2,1,3,3,3,1,3
"5944",2000098449,"Dachi Lortkipanidze","3/8/2005 (18 years old)","DM, M (C)","Cremonese","Italian Serie B","GEO","No","6/13/2022","6/30/2024","$250K - $750K","Right","Reasonable","Very Strong","6'1""","158 lbs","-","-",74,123,6,6,7,7,8,5,4,6,4,7,13,5,11,13,11,11,8,7,3,11,13,5,1,7,9,7,9,4,13,12,7,9,13,13,8,6,20,13,11,10,9,11,5,4,5,1,10,11,20,3,3,2,3,2,2,2,3,3,1,3
"5945",2000059773,"Ibrahim Adel","4/24/2001 (22 years old)","AM (RL), ST (C)","Pyramids","Egyptian Premier League","EGY","No","7/1/2018","7/31/2026","$7M - $8.6M","Right","Fairly Strong","Very Strong","5'10""","147 lbs","56","17",125,145,6,11,15,12,13,8,6,13,8,10,12,8,6,13,6,12,15,11,11,12,17,15,6,11,4,9,11,13,14,14,10,6,14,14,11,8,14,13,13,15,11,10,3,11,10,9,12,18,16,2,2,3,1,3,2,2,1,4,2,2
"5946",2000071480,"Ahmed Sherif","2/8/2003 (20 years old)","AM (L), ST (C)","Pharco","Egyptian Premier League","EGY","No","10/7/2021","7/31/2026","$230K - $2.3M","Right","Strong","Very Strong","6'0""","156 lbs","51","5",89,133,6,8,13,13,13,6,8,2,1,5,13,7,4,9,8,9,8,8,6,13,10,9,12,9,6,7,7,12,13,13,13,7,13,13,12,3,10,19,7,13,12,11,6,10,6,6,13,10,15,1,4,1,2,4,3,2,1,1,1,2
"5947",59141748,"Tornike Dzotsenidze","1/7/1999 (24 years old)","D (C)","Dila","Georgian National League","GEO","No","12/31/2021","12/31/2024","$55K - $550K","Right","Reasonable","Very Strong","6'2""","178 lbs","81","4",95,121,4,3,1,5,9,1,7,8,1,14,9,4,11,8,7,10,10,9,8,14,14,5,1,7,14,3,3,8,14,14,9,11,10,14,13,10,15,19,9,11,10,12,12,10,14,3,17,9,18,2,3,3,2,2,1,1,1,3,1,3
"5948",85100467,"Sadio Mané","4/10/1992 (31 years old)","AM (RLC), ST (C)","FC Bayern","Bundesliga","SEN","No","7/1/2022","6/30/2025","$24M - $30M","Right","Reasonable","Very Strong","5'9""","152 lbs","373","151",150,185,9,11,16,14,14,8,12,12,9,8,12,12,8,16,13,15,14,13,10,12,17,15,11,16,8,13,14,14,15,15,13,10,16,15,13,12,11,8,10,16,12,12,8,13,9,14,11,15,16,2,1,2,1,4,1,1,2,3,1,1
"5949",85051083,"Kalidou Koulibaly","6/20/1991 (31 years old)","D (C)","Chelsea","English Premier Division","SEN","Yes","7/16/2022","6/30/2026","Not for Sale","Right","Reasonable","Very Strong","6'1""","198 lbs","364","19",150,170,4,6,10,10,12,4,16,6,6,17,13,6,17,11,15,14,18,10,8,13,11,8,13,10,16,16,10,16,12,9,15,15,13,15,15,19,8,14,14,14,8,13,9,7,13,7,14,15,12,2,3,3,1,2,3,1,1,2,2,1
"5950",12080051,"Pape Matar Sarr","9/14/2002 (20 years old)","M (C)","Tottenham","English Premier Division","SEN","No","8/27/2021","6/30/2027","$88M - $111M","Right","Reasonable","Very Strong","6'0""","154 lbs","77","5",138,166,7,7,13,9,15,8,10,10,8,10,14,9,13,14,11,16,12,15,11,13,4,13,10,13,14,14,13,14,12,14,13,12,14,12,16,15,11,18,8,11,13,14,5,13,8,4,11,12,18,3,2,1,2,1,1,2,1,2,1,3
"5951",85121966,"Édouard Mendy","3/1/1992 (31 years old)","GK","Chelsea","English Premier Division","SEN","Yes","9/24/2020","6/30/2025","Not for Sale","Right","Weak","Very Strong","6'4""","207 lbs","213","-",150,165,3,2,3,2,10,6,8,3,3,2,12,5,1,11,10,14,12,13,13,14,12,8,10,2,15,13,8,10,12,16,14,17,15,11,14,16,14,14,13,14,12,14,6,15,5,7,15,14,10,12,12,14,8,14,13,14,14,13,13,18
"5952",12087972,"Nicolas Jackson","6/20/2001 (21 years old)","AM (RLC), ST (C)","Villarreal","Spanish First Division","SEN","No","6/13/2022","6/30/2028","$31M - $47M","Right Only","Weak","Very Strong","6'1""","171 lbs","75","18",146,162,8,9,16,14,13,8,13,11,6,8,12,13,9,16,13,12,12,12,12,11,12,13,7,9,11,9,13,12,17,14,8,12,12,17,15,12,13,18,11,9,12,11,13,13,9,2,20,10,13,3,2,1,4,3,2,2,3,1,3,3
"5953",49062287,"Arouna Sanganté","4/12/2002 (21 years old)","D (C)","Havre AC","Ligue 1 Uber Eats","SEN","Yes","7/1/2018","6/30/2026","$9.2M - $11.5M","Right","Weak","Very Strong","6'2""","167 lbs","68","4",123,155,5,8,6,6,10,6,12,7,8,15,11,6,12,8,14,14,14,13,12,12,9,6,8,9,15,12,7,12,13,13,13,13,14,13,13,13,12,10,12,15,13,14,4,10,5,4,10,12,10,2,3,2,2,1,2,1,1,1,1,2
"5954",48042766,"Ismaïla Sarr","2/25/1998 (25 years old)","AM (RL), ST (C)","Watford","Sky Bet Championship","SEN","No","6/14/2021","6/30/2024","$800K - $9.8M","Right","Weak","Very Strong","6'1""","167 lbs","218","51",132,153,10,11,13,13,12,10,8,13,6,6,12,14,7,12,11,11,11,11,11,11,12,14,6,14,7,10,11,12,14,13,14,11,15,18,14,12,13,11,10,14,10,13,8,14,11,7,11,13,12,4,1,2,3,3,4,2,2,3,3,3
"5955",85032335,"Idrissa Gueye","9/26/1989 (33 years old)","DM, M (C)","Everton","English Premier Division","SEN","No","9/1/2022","6/30/2024","$11.5M - $14M","Right","Reasonable","Very Strong","5'9""","145 lbs","375","14",143,152,8,9,10,6,13,9,11,12,9,14,11,8,18,13,14,15,16,13,14,13,16,8,12,9,14,17,13,16,14,14,12,8,15,13,16,13,8,15,15,15,13,10,9,14,12,6,13,16,14,3,4,3,1,1,3,3,2,1,2,2
"5956",2000047650,"Aliou Baldé","12/12/2002 (20 years old)","M/AM (RL)","Lausanne","Swiss Super League","SEN","No","1/31/2023","6/30/2026","$600K - $6M","Right","Reasonable","Very Strong","5'7""","130 lbs","40","13",120,152,7,10,14,8,13,6,5,9,3,4,11,9,6,13,11,12,9,10,10,11,12,14,6,11,4,12,10,13,17,15,11,6,14,15,13,6,11,11,6,13,14,13,6,11,5,5,10,15,15,1,2,3,2,2,2,2,3,1,3,3
"5957",13229209,"Emam Ashour","2/20/1998 (25 years old)","DM, M (C), AM (L)","FC Midtjylland","3F Superliga","EGY","No","1/31/2023","6/30/2024","$3.2M - $6.4M","Right","Reasonable","Very Strong","6'0""","167 lbs","113","18",127,145,11,13,14,12,14,11,10,15,9,11,14,6,12,13,13,11,14,11,12,12,15,14,8,12,10,13,14,14,12,13,13,9,13,13,13,10,14,4,5,10,13,5,8,12,10,15,14,16,8,1,1,1,2,2,3,1,1,1,3,3
"5958",89063107,"Iliman N'Diaye","3/6/2000 (23 years old)","AM (RLC), ST (C)","Sheff Utd","English Premier Division","SEN","Yes","10/1/2019","6/30/2027","$14.5M - $18M","Right","Fairly Strong","Very Strong","5'9""","152 lbs","83","22",135,150,8,11,15,14,14,9,12,12,6,5,12,10,7,14,6,11,11,13,13,14,15,16,9,14,8,12,13,13,14,16,13,8,12,13,12,12,10,11,11,14,13,13,5,12,8,8,13,13,11,1,2,2,3,1,1,3,1,2,1,3
"5959",43093942,"Keita Baldé","3/8/1995 (28 years old)","AM (RLC), ST (C)","Spartak Moscow","Russian Premier League","SEN","Yes","8/26/2022","6/30/2025","$375K - $7.6M","Right","Reasonable","Very Strong","5'11""","169 lbs","241","56",125,150,10,9,13,12,13,10,10,9,3,4,13,12,2,15,12,12,10,10,10,10,18,16,10,14,4,10,12,12,16,14,13,12,16,15,12,12,14,11,11,14,14,10,9,14,10,11,11,18,13,3,1,3,3,2,2,2,3,3,3,4
"5960",50065334,"Boulaye Dia","11/16/1996 (26 years old)","ST (C)","Villarreal","Spanish First Division","SEN","Yes","7/13/2021","6/30/2027","$13.5M - $20M","Right","Reasonable","Very Strong","5'11""","165 lbs","157","60",141,149,7,10,15,15,14,6,10,11,4,4,14,13,3,14,6,15,7,14,13,12,15,14,7,15,4,10,14,9,16,15,13,13,14,16,15,14,9,11,10,9,11,12,9,13,10,12,16,14,13,3,1,3,2,2,3,3,1,2,2,2
"5961",85051236,"M’Baye Niang","12/19/1994 (28 years old)","AM (RL), ST (C)","AJ Auxerre","Ligue 2 BKT","SEN","Yes","8/16/2022","6/30/2023","$70K - $700K","Right","Reasonable","Very Strong","6'2""","182 lbs","291","59",123,149,10,12,11,12,12,11,13,13,11,6,8,14,7,13,13,12,12,12,10,9,12,14,9,11,8,12,11,12,12,15,15,14,14,13,14,15,12,13,12,10,9,7,10,10,12,13,10,16,12,3,3,1,1,1,3,3,2,1,1,1
"5962",2000284569,"Fallou Diouf","3/25/2006 (17 years old)","D (C)","Génération Foot","Senegalese Ligue 1","SEN","No","6/12/2023","6/30/2026","$180K - $550K","Right Only","Weak","Very Strong","6'1""","174 lbs","-","-",88,147,6,6,8,5,10,2,11,2,9,12,11,10,11,8,12,11,11,8,10,9,18,5,11,8,16,8,8,10,10,8,8,13,10,11,8,12,8,8,8,12,8,12,1,16,11,8,16,12,14,1,1,2,2,1,3,2,1,3,3,3
"5963",2000163512,"Baba","6/10/2005 (18 years old)","M (R), AM (RL)","R. Madrid C","Spanish Federation Third Group 7","SEN","Yes","7/1/2021","6/30/2024","$75K - $750K","Right","Reasonable","Very Strong","5'9""","149 lbs","-","-",74,147,8,11,11,12,11,6,7,7,6,3,11,4,7,10,13,6,5,12,4,6,16,11,10,10,6,7,8,8,13,12,5,7,13,11,9,13,11,12,11,12,13,11,13,8,6,3,10,10,15,1,2,2,2,2,1,3,2,2,1,3
"5964",12093439,"Lamine Camara","1/1/2004 (19 years old)","M/AM (C)","FC Metz","Ligue 1 Uber Eats","SEN","No","2/10/2023","6/30/2026","$600K - $5M","Right","Weak","Very Strong","5'8""","143 lbs","4","-",115,146,11,12,11,11,12,12,8,12,9,10,13,12,11,11,12,13,14,11,12,12,15,12,12,14,12,14,13,14,11,14,12,7,13,12,13,11,12,9,10,14,12,12,5,13,9,8,13,14,13,2,4,4,3,1,1,2,3,1,2,1
"5965",2000243105,"Mamadou Sané","12/31/2004 (18 years old)","WB/M/AM (R)","Africa Promo Foot","Senegalese National 1 - Pool B","SEN","No","7/1/2021","6/30/2024","$0","Right Only","Weak","Very Strong","5'11""","167 lbs","-","-",97,146,5,10,13,10,11,5,5,12,10,8,11,11,12,12,16,11,14,10,8,9,12,8,7,8,8,8,6,12,16,12,8,11,15,11,13,14,16,8,10,14,12,10,10,12,11,4,8,12,11,3,1,2,3,3,1,1,1,2,3,1
"5966",48037362,"Moussa Niakhaté","3/8/1996 (27 years old)","D (LC)","Nottm Forest","English Premier Division","SEN","Yes","7/6/2022","6/30/2025","$18.5M - $28M","Left","Very Strong","Reasonable","6'3""","180 lbs","249","10",135,146,4,9,11,7,12,4,14,6,18,13,12,15,14,12,16,12,16,12,12,12,16,12,16,11,13,13,12,12,13,11,14,16,16,15,13,15,15,12,12,16,16,12,4,15,13,11,13,17,16,3,2,1,3,3,2,3,2,1,2,1
"5967",12092872,"Abdoulaye Ndiaye","4/10/2002 (21 years old)","D (C)","OL","French National 3 - Group K","SEN","No","10/2/2020","6/30/2026","$180K - $8M","Left Only","Very Strong","Weak","6'3""","169 lbs","28","1",110,146,6,10,6,6,13,10,14,12,4,12,11,5,12,9,13,13,14,14,13,9,14,5,10,12,14,12,10,13,11,10,14,15,13,11,14,16,7,11,11,9,9,10,7,5,13,1,12,11,9,3,4,2,1,1,1,1,3,1,3,3
"5968",2000067300,"Mohamed Abdelmonem","2/1/1999 (24 years old)","D (C)","Al-Ahly","Egyptian Premier League","EGY","No","6/15/2020","7/31/2025","$300K - $7.2M","Right","Reasonable","Very Strong","6'0""","176 lbs","54","2",131,145,4,8,11,5,13,4,15,5,6,14,13,12,14,13,14,14,12,13,13,12,15,6,11,7,16,11,12,13,12,11,11,13,12,14,13,13,10,17,12,15,15,13,6,14,10,7,14,14,15,1,1,2,3,2,2,1,2,3,4,3
"5969",48043484,"Pape Gueye","1/24/1999 (24 years old)","DM, M (C)","OM","Ligue 1 Uber Eats","SEN","Yes","7/1/2020","6/30/2024","$325K - $3.3M","Left","Very Strong","Reasonable","6'0""","143 lbs","129","4",125,145,11,8,11,6,13,10,10,14,3,12,14,9,14,13,12,13,11,7,8,12,13,13,12,13,14,15,12,14,14,11,14,10,14,14,14,14,9,10,11,7,8,7,12,10,11,13,11,15,13,3,1,2,1,1,2,3,3,3,2,3
"5970",8447172,"Papiss Cissé","6/3/1985 (38 years old)","ST (C)","Amiens SC","Ligue 2 BKT","SEN","Yes","9/1/2022","6/30/2024","$28K - $300K","Right","Strong","Very Strong","5'11""","158 lbs","504","218",110,145,5,10,11,12,13,7,12,10,5,4,12,14,5,12,9,14,11,8,12,13,12,13,10,14,8,12,10,11,12,11,12,11,14,12,11,10,5,7,9,13,13,12,8,13,6,6,13,12,13,2,4,3,1,3,1,3,1,1,3,1
"5971",12079003,"Dion Lopy","2/2/2002 (21 years old)","DM, M (C)","Reims","Ligue 1 Uber Eats","SEN","No","10/5/2020","6/30/2027","$7.6M - $9.6M","Right","Reasonable","Very Strong","6'1""","185 lbs","59","-",119,145,12,14,12,9,14,7,11,9,9,10,15,12,10,16,9,9,12,11,13,12,14,12,12,13,13,10,12,12,11,10,12,10,13,11,14,15,7,15,10,9,10,11,11,11,6,8,12,11,14,1,1,2,3,2,1,2,3,1,2,3
"5972",2000112210,"Mamadou Mbacke","11/21/2002 (20 years old)","D (C)","LAFC","Major League Soccer","SEN","No","6/4/2021","12/31/2024","$230K - $2.3M","Right","Reasonable","Very Strong","6'2""","163 lbs","46","7",110,145,2,6,8,7,11,6,14,6,6,13,11,7,12,11,14,11,12,12,10,11,14,7,7,8,12,11,9,13,13,11,11,16,14,14,11,12,8,9,10,12,10,13,6,12,12,8,12,14,12,2,1,2,3,2,3,3,3,3,2,1
"5973",67213756,"Amath N'Diaye","7/16/1996 (26 years old)","AM (RL), ST (C)","Mallorca","Spanish First Division","SEN","Yes","6/30/2021","6/30/2025","$475K - $10M","Right","Reasonable","Very Strong","5'9""","147 lbs","203","41",129,145,9,12,13,13,12,7,7,11,9,4,9,7,4,13,11,12,13,10,9,8,13,15,9,14,4,10,11,12,16,15,11,9,13,16,13,11,12,14,14,12,11,10,10,12,7,8,10,13,13,1,1,2,4,1,2,2,1,1,2,2
"5974",43317909,"Demba Seck","2/10/2001 (22 years old)","AM (RC), ST (C)","Torino","Italian Serie A","SEN","Yes","1/31/2022","6/30/2026","$5.4M - $10M","Left","Very Strong","Reasonable","6'3""","167 lbs","56","5",122,145,4,10,13,13,11,5,12,12,4,6,11,10,9,12,7,11,10,12,11,12,14,9,6,12,6,13,10,8,15,12,11,12,15,16,14,12,15,11,13,14,12,12,10,11,8,9,9,14,11,1,1,3,3,2,2,3,1,1,1,2
"5975",85120721,"Abdou Diallo","5/4/1996 (27 years old)","D (LC)","Paris SG","Ligue 1 Uber Eats","SEN","Yes","7/16/2019","6/30/2024","$16M - $19.5M","Left","Very Strong","Weak","6'2""","174 lbs","156","6",135,145,4,11,13,6,12,4,14,6,12,14,13,7,14,13,13,13,14,15,12,13,15,12,12,10,14,14,12,12,13,12,16,14,11,15,13,15,13,10,12,14,12,8,14,13,10,6,14,13,13,2,3,2,2,1,2,2,3,1,3,3
"5976",8440901,"Pape Diop","3/19/1986 (37 years old)","DM, M (C)","Ibiza","Spanish Federation First Division B","SEN","Yes","7/1/2021","6/30/2023","$8K - $24K","Right","Weak","Very Strong","5'11""","160 lbs","472","22",119,144,9,9,8,9,11,13,13,11,11,11,13,10,14,11,14,13,14,10,13,12,15,8,10,10,13,14,14,15,12,11,13,11,14,12,12,14,8,7,12,16,12,13,8,13,14,8,13,12,14,1,1,3,3,1,2,3,3,1,1,1
"5977",2000052135,"Abdallah Sima","6/17/2001 (21 years old)","AM (R), ST (C)","Brighton","English Premier Division","SEN","No","8/31/2021","6/30/2025","$8.6M - $11M","Right","Weak","Very Strong","6'2""","163 lbs","57","16",121,144,4,7,14,15,11,7,15,6,10,10,8,11,11,11,10,10,11,13,9,16,10,13,9,13,7,13,10,10,16,12,12,16,7,15,11,13,13,11,13,12,13,10,14,5,8,5,12,13,14,1,2,2,3,3,1,2,1,2,1,2
"5978",12079011,"Formose Mendy","1/2/2001 (22 years old)","D (RC)","Amiens SC","Ligue 2 BKT","SEN","No","7/1/2021","6/30/2026","$6.4M - $8M","Right","Weak","Very Strong","6'3""","167 lbs","75","2",116,143,8,9,11,8,12,8,13,8,10,12,11,8,15,12,13,12,14,12,11,9,13,5,8,8,11,11,10,12,14,13,12,15,14,14,13,12,8,15,9,12,10,12,7,9,7,1,12,12,12,3,4,2,1,3,2,3,2,2,3,2
"5979",13226670,"Ahmed Aboul Fotouh","3/22/1998 (25 years old)","D/WB (L)","Zamalek","Egyptian Premier League","EGY","No","6/15/2020","7/31/2025","$70K - $7.2M","Left Only","Very Strong","Weak","5'10""","158 lbs","113","1",123,144,8,12,14,8,13,4,12,10,11,14,12,9,12,14,13,9,13,11,12,11,14,12,5,13,11,13,11,16,14,13,12,9,12,15,15,10,11,9,12,10,13,11,7,12,12,5,15,12,10,1,2,1,4,2,2,1,1,1,1,2
"5980",12078293,"Issa Soumaré","10/10/2000 (22 years old)","AM (RL), ST (C)","Beerschot","Belgian Challenger Pro League","SEN","No","8/6/2021","6/30/2026","$425K - $1.3M","Right Only","Weak","Very Strong","6'0""","171 lbs","124","17",116,143,6,12,14,11,14,10,13,10,8,8,11,4,7,14,9,12,7,13,11,10,14,10,8,12,12,13,11,12,14,12,11,11,12,13,11,10,12,16,11,12,11,12,8,13,8,4,9,9,12,1,2,2,3,1,2,2,2,4,3,1
"5981",12088492,"Mika Faye","7/14/2004 (18 years old)","D (LC)","Kustošija","Croatian Third League","SEN","No","2/2/2023","6/30/2024","$475K - $4.8M","Left","Very Strong","Weak","6'1""","202 lbs","13","1",115,143,5,8,11,6,11,6,11,7,10,13,12,7,12,11,15,13,13,11,10,11,14,8,8,8,12,11,11,12,14,13,13,14,15,14,13,14,12,14,12,16,14,6,4,14,10,8,14,14,12,3,2,2,3,3,3,1,2,1,1,2
"5982",49048614,"Rassoul Ndiaye","12/11/2001 (21 years old)","DM, M (C)","FCSM","French National","SEN","Yes","6/13/2022","6/30/2024","$0","Right Only","Weak","Very Strong","5'10""","154 lbs","92","6",114,142,7,11,12,8,12,7,11,12,6,12,12,8,13,12,14,13,13,12,12,13,13,10,7,12,13,14,12,14,14,13,12,10,13,12,13,14,10,10,12,12,12,11,7,12,7,10,13,12,10,3,3,1,3,4,3,1,2,1,1,1
"5983",85032332,"Pape Souaré","6/6/1990 (33 years old)","D/WB (L)","Morecambe","Sky Bet League Two","SEN","No","3/17/2023","6/30/2024","$0 - $100K","Left","Very Strong","Reasonable","5'10""","149 lbs","160","3",94,142,9,10,10,7,11,7,11,9,9,10,11,10,12,10,14,11,12,11,11,12,16,6,10,12,11,12,10,14,11,9,11,11,13,12,8,14,11,17,17,14,13,13,16,12,12,5,12,15,13,2,1,4,1,1,3,3,1,2,2,3
"5984",18022052,"Cheikhou Kouyaté","12/21/1989 (33 years old)","D (C), DM, M (C)","Nottm Forest","English Premier Division","SEN","Yes","8/18/2022","6/30/2024","$90K - $7.6M","Right Only","Weak","Very Strong","6'4""","182 lbs","469","21",129,141,4,8,10,7,12,5,14,7,10,13,12,10,15,12,16,13,15,13,12,11,14,10,12,9,13,13,10,16,13,13,13,16,15,12,14,15,13,9,10,11,13,10,7,14,14,5,13,12,13,1,1,2,3,3,3,4,4,3,4,3
"5985",85057304,"Youssouf Sabaly","3/5/1993 (30 years old)","D/WB (R)","Real Hispalis","Spanish First Division","SEN","Yes","7/1/2021","6/30/2026","$9.6M","Right","Reasonable","Very Strong","5'9""","149 lbs","258","4",140,141,8,13,12,7,12,7,9,10,10,12,12,8,15,12,14,14,13,14,14,13,15,13,10,13,12,14,10,17,15,13,13,7,13,14,17,15,9,14,12,13,12,15,15,12,12,6,12,15,14,2,3,3,3,1,1,2,1,1,2,2
"5986",13181674,"Ibrahima N'Diaye","7/6/1998 (24 years old)","M/AM (RL)","Zamalek","Egyptian Premier League","SEN","No","8/31/2022","7/31/2025","$450K - $4.4M","Left Only","Very Strong","Weak","5'9""","143 lbs","192","41",117,140,9,11,12,12,13,8,12,9,3,8,12,10,9,14,9,12,14,12,14,11,10,13,8,12,10,14,11,13,13,14,12,15,12,14,13,12,10,12,11,12,10,10,8,13,8,5,10,11,8,2,1,3,3,3,2,3,3,3,1,3
"5987",12092876,"Bamba Dieng","3/23/2000 (23 years old)","AM (L), ST (C)","FC Lorient","Ligue 1 Uber Eats","SEN","No","1/27/2023","6/30/2027","$11.5M - $17.5M","Right","Weak","Very Strong","5'10""","158 lbs","68","23",125,140,6,10,13,12,12,7,11,10,5,6,11,10,7,14,8,13,14,13,11,11,13,14,10,12,8,12,11,13,16,14,13,9,13,15,13,11,8,17,13,12,10,12,11,12,10,6,11,15,19,3,3,2,2,1,3,2,1,2,1,3
"5988",85072773,"Bouna Sarr","1/31/1992 (31 years old)","D/WB/M/AM (R)","FC Bayern","Bundesliga","SEN","Yes","10/5/2020","6/30/2024","$550K - $1.7M","Right","Reasonable","Very Strong","5'10""","156 lbs","248","11",127,140,12,11,13,8,12,11,8,8,12,9,12,9,13,13,12,12,13,11,10,10,13,13,5,13,10,13,11,15,15,14,11,9,13,15,14,10,18,10,10,12,8,12,12,14,9,11,11,9,7,2,1,2,2,2,3,2,2,3,3,4
"5989",12083698,"Moussa N'Diaye","6/18/2002 (20 years old)","D (L)","RSC Anderlecht","Jupiler Pro League","SEN","No","8/25/2022","6/30/2025","$6.8M - $10.5M","Left","Very Strong","Weak","5'11""","145 lbs","30","-",115,140,6,11,12,9,11,6,12,9,12,12,13,8,13,12,13,12,12,11,12,11,12,12,8,11,12,13,11,12,13,14,12,12,15,14,12,12,15,17,12,12,10,10,7,12,8,8,12,11,18,3,2,3,3,3,3,3,2,1,3,1
"5990",91205962,"Omar Marmoush","2/7/1999 (24 years old)","AM (RL), ST (C)","VfL Wolfsburg","Bundesliga","EGY","No","6/15/2020","6/30/2026","$6.6M - $10M","Right","Weak","Very Strong","6'0""","178 lbs","133","28",134,142,13,10,16,12,12,14,11,12,6,7,11,12,8,15,13,12,11,12,10,11,13,16,4,13,7,11,11,11,16,15,11,11,13,16,11,11,16,12,12,12,12,11,7,12,9,8,12,14,16,3,3,3,2,3,2,3,3,2,1,2
"5991",53075287,"Badou Ndiaye","10/27/1990 (32 years old)","DM, M (C)","Adana D.S.","Turkish Super League","SEN","No","7/7/2022","6/30/2025","Not for Sale","Right","Weak","Very Strong","5'11""","167 lbs","362","71",130,140,7,10,14,11,13,8,10,13,8,11,13,12,12,13,14,13,17,13,13,13,14,13,12,14,10,15,12,16,14,13,15,10,14,12,15,14,15,16,15,17,12,12,9,13,14,10,12,16,16,2,3,2,2,3,3,2,1,4,3,1
"5992",34009062,"Alfred N'Diaye","3/6/1990 (33 years old)","DM, M (C)","Málaga","Spanish Federation First Division B","SEN","Yes","8/24/2022","6/30/2024","$100K - $1M","Right","Reasonable","Very Strong","6'2""","198 lbs","383","20",121,140,5,12,12,11,12,8,11,13,7,14,14,10,13,12,14,13,16,10,10,10,13,8,12,12,14,16,14,14,10,12,7,15,11,10,14,16,12,10,14,8,11,8,5,13,10,12,13,15,14,2,1,2,2,3,2,3,1,4,3,1
"5993",85010871,"Nampalys Mendy","6/23/1992 (30 years old)","DM, M (C)","Leicester","Sky Bet Championship","SEN","Yes","6/14/2021","6/30/2025","$12.5M - $15.5M","Right","Weak","Very Strong","5'6""","160 lbs","296","2",130,140,8,10,12,8,13,7,8,7,6,13,14,11,15,13,13,14,14,15,13,14,13,8,7,8,14,16,12,15,13,14,14,5,14,12,15,12,15,14,14,15,12,14,9,14,11,6,14,14,8,3,4,1,3,2,4,1,1,4,2,2
"5994",85140284,"Fodé Ballo-Touré","1/3/1997 (26 years old)","D/WB/M (L)","AC Milan","Italian Serie A","SEN","Yes","7/18/2021","6/30/2025","$600K - $5.8M","Left Only","Very Strong","Weak","6'0""","154 lbs","128","1",133,139,7,13,12,6,11,5,10,7,14,13,12,6,14,11,14,13,14,11,12,12,12,8,8,14,12,14,10,13,15,15,13,11,16,16,16,12,12,14,12,11,11,12,6,11,9,8,14,14,13,1,4,1,4,3,1,1,2,1,3,2
"5995",43043943,"Khouma Babacar","3/17/1993 (30 years old)","AM (RC), ST (C)","FC København","3F Superliga","SEN","No","1/9/2022","6/30/2025","$20K - $190K","Right","Reasonable","Very Strong","6'1""","187 lbs","288","75",110,139,4,7,14,12,15,6,14,10,6,5,13,12,5,13,12,12,14,13,9,13,7,15,4,12,5,7,13,6,10,12,12,12,11,13,11,13,10,11,14,13,12,13,5,15,10,3,9,10,12,1,2,2,3,2,1,1,2,1,4,4
"5996",2000206139,"Babacar N'Diaye","10/25/2004 (18 years old)","M/AM (C)","AS Douanes (SEN)","Senegalese Ligue 2","SEN","No","1/2/2022","6/30/2024","$7K - $75K","Right","Fairly Strong","Very Strong","6'1""","167 lbs","-","-",92,139,7,3,5,12,13,7,6,13,6,8,13,4,8,9,6,6,7,6,8,13,8,14,1,6,9,8,13,11,13,11,8,9,12,11,13,6,10,10,9,11,12,15,6,13,10,8,11,10,20,3,2,1,4,1,3,1,2,1,1,3
"5997",13181623,"Pathé Ciss","3/16/1994 (29 years old)","DM, M (C)","Vallecano","Spanish First Division","SEN","No","7/28/2021","6/30/2025","$450K - $4.4M","Right","Weak","Very Strong","6'0""","156 lbs","202","23",131,138,7,7,9,7,12,7,13,9,11,13,13,8,15,11,12,15,12,12,13,13,10,6,11,7,15,14,11,14,14,11,13,14,15,14,16,16,7,17,12,14,12,12,3,12,7,6,12,12,13,3,2,2,1,4,3,2,1,3,4,3
"5998",12083706,"Samba Diallo","1/5/2003 (20 years old)","AM (RL)","Dynamo Kyiv","Ukrainian Premier League","SEN","No","12/7/2021","6/30/2027","$450K - $4.6M","Right","Reasonable","Very Strong","5'6""","152 lbs","1","-",102,138,11,11,16,12,13,8,8,8,3,3,10,7,7,14,15,9,6,9,5,8,15,16,4,9,6,8,8,10,15,13,10,6,14,14,9,9,10,2,13,9,9,3,10,5,14,14,11,12,5,2,3,3,2,1,2,2,2,1,1,4
"5999",2000120236,"Lamin Jarjou","2/19/2002 (21 years old)","AM (RL)","Al-Hilal Omdurman","Sudanese Premier League","SEN","No","7/1/2022","6/30/2025","$0","Left","Very Strong","Reasonable","5'8""","145 lbs","20","6",102,138,6,10,13,13,12,8,5,12,2,2,11,9,3,15,6,10,6,12,11,13,18,10,8,13,6,11,13,13,13,12,10,8,12,12,12,6,12,18,14,12,10,15,8,14,5,2,10,16,12,2,2,3,3,1,3,3,1,1,2,2
"6000",13191648,"Pape Habib Guèye","9/20/1999 (23 years old)","ST (C)","KV Kortrijk","Jupiler Pro League","SEN","No","7/1/2020","6/30/2024","$130K - $1.3M","Right Only","Weak","Very Strong","6'2""","187 lbs","126","35",115,138,11,11,13,13,12,9,12,9,4,10,10,11,8,12,7,13,11,14,12,13,12,12,7,13,11,11,9,12,12,12,14,13,12,13,13,14,12,11,11,10,12,8,5,12,8,14,12,13,10,3,3,1,1,2,3,3,3,1,3,3
"6001",2000306023,"Xolani Gama","10/20/1999 (23 years old)","GK","Green Mamba","Premier League of Eswatini","SWZ","No","7/1/2022","6/30/2024","$2.5K - $26K","Right","Reasonable","Very Strong","6'1""","167 lbs","-","-",73,93,2,3,3,3,5,3,1,1,2,3,9,1,1,1,7,7,14,5,9,12,16,3,9,3,9,6,5,5,11,12,6,10,13,10,1,4,10,12,13,9,13,11,5,9,5,1,9,12,13,8,8,12,8,8,11,7,5,6,11,12
"6002",2000307875,"Siphephelo Philiso","11/11/2003 (19 years old)","D/WB (R)","Mbabane Swallows","Premier League of Eswatini","SWZ","No","2/12/2023","6/30/2025","$3K - $30K","Right Only","Very Weak","Very Strong","5'10""","156 lbs","22","-",76,90,6,12,8,5,10,4,10,6,5,9,10,1,15,7,8,10,10,7,10,13,5,6,12,8,10,9,6,9,13,10,9,6,12,10,7,8,14,15,11,12,9,13,12,11,8,1,12,12,17,1,1,3,2,3,2,2,2,2,2,2
"6003",11010414,"Cameron Hepple","5/19/1988 (35 years old)","M (C), AM (RLC), ST (C)","Renegades FC","Bahamian Senior League","BAH","No","6/14/2021","6/30/2024","$0","Right","Strong","Very Strong","5'9""","160 lbs","43","9",58,88,5,6,6,12,12,6,7,8,6,4,9,7,6,10,6,10,4,8,6,9,14,9,5,10,7,7,7,8,10,8,4,7,10,10,4,5,9,12,10,9,11,12,6,9,8,5,10,13,18,1,3,3,1,2,3,1,1,3,2,2
"6004",2000127842,"Kenaz Swain","4/16/2005 (18 years old)","D/WB (L)","Western Warriors","Bahamian Senior League","BAH","No","6/13/2022","6/30/2024","$0","Left","Very Strong","Reasonable","5'10""","149 lbs","-","-",62,82,5,12,2,1,7,2,8,5,1,4,9,5,10,9,14,7,9,3,6,13,4,5,12,4,6,8,7,8,15,11,8,5,12,13,10,5,10,12,10,10,11,10,14,7,8,4,8,8,13,2,3,2,1,3,1,1,3,2,2,3
"6005",2000129542,"Peter Julmis","5/28/2001 (22 years old)","AM (C), ST (C)","Dynamos (BAH)","Bahamian Senior League","BAH","No","7/1/2018","6/30/2024","$0","Right","Reasonable","Very Strong","5'11""","160 lbs","-","-",63,82,5,6,8,11,12,5,4,6,4,4,7,1,3,11,7,8,3,7,6,12,5,11,1,10,6,5,7,7,13,11,6,10,14,13,6,4,10,15,10,9,13,12,8,6,15,5,18,13,10,2,2,3,2,3,4,4,2,2,2,3
"6006",82064354,"Ambry Moss","11/2/1990 (32 years old)","D (RC), DM","Boston Bolts","USSL D2 - Northeast Division","BAH","No","4/1/2019","-","$0","Right","Weak","Very Strong","5'9""","176 lbs","23","-",55,82,3,6,5,1,7,6,8,3,1,7,8,1,10,7,9,9,6,5,9,14,9,5,9,6,13,7,6,6,8,7,7,9,8,7,11,7,13,15,11,9,10,10,13,10,6,1,19,10,20,2,3,2,3,2,3,2,3,2,1,1
"6007",2000129535,"Roen Davis","4/21/2004 (19 years old)","M/AM (C)","Western Warriors","Bahamian Senior League","BAH","No","6/13/2022","6/30/2024","$0","Right","Reasonable","Very Strong","5'10""","147 lbs","-","-",68,78,3,6,7,13,14,1,5,10,6,6,12,5,8,11,7,6,2,6,4,7,12,10,7,7,8,7,10,7,14,13,7,4,15,14,7,4,9,14,12,10,10,13,6,4,9,1,15,10,20,1,2,3,2,2,3,3,4,3,1,2
"6008",82072297,"Tre Barry","3/13/1996 (27 years old)","D (LC), WB (L)","United FC (BAH)","Bahamian Senior League","BAH","No","6/15/2020","6/30/2024","$0","Left","Very Strong","Weak","6'0""","169 lbs","-","-",60,78,1,7,5,2,4,1,7,3,3,7,7,2,11,5,9,9,8,6,6,11,7,5,12,5,5,6,4,7,13,10,6,9,12,13,12,10,9,19,12,10,12,10,11,5,9,8,16,11,15,2,1,1,3,4,2,3,3,3,3,3
"6009",2000205360,"Derrick Ferguson","10/4/2004 (18 years old)","D/WB (R)","Dynamos (BAH)","Bahamian Senior League","BAH","No","7/1/2021","6/30/2024","$0","Right","Reasonable","Very Strong","6'1""","165 lbs","-","-",63,78,6,11,3,4,11,2,8,3,1,9,9,2,12,9,12,5,8,6,6,10,3,5,10,5,5,8,7,8,15,14,8,9,9,13,8,7,10,15,9,9,9,14,12,8,8,7,12,13,20,2,2,2,1,3,1,1,1,1,2,3
"6010",2000123770,"Evens Julmis","9/10/1999 (23 years old)","D (LC), WB (L)","Dynamos (BAH)","Bahamian Senior League","BAH","No","7/1/2018","6/30/2024","$0","Left","Very Strong","Reasonable","6'4""","176 lbs","-","-",62,78,3,6,4,1,8,1,8,4,6,9,3,1,9,6,14,7,8,6,9,14,9,5,3,6,7,7,7,7,14,12,7,12,13,13,6,7,9,18,11,12,8,10,13,12,9,6,19,11,15,3,3,1,3,2,3,2,1,2,1,1
"6011",82072274,"Isiah Collie","4/22/1997 (26 years old)","D (C), DM, M (C)","Cavalier FC (BAH)","Bahamian Senior League","BAH","No","6/15/2020","6/30/2024","$0 - $5K","Right","Reasonable","Very Strong","6'2""","176 lbs","-","-",71,77,2,1,4,3,9,6,8,5,1,6,11,3,11,4,8,9,8,8,8,13,19,5,10,5,12,7,5,12,13,12,7,11,9,13,13,8,14,12,9,13,12,10,11,14,9,6,9,10,18,3,1,2,2,1,1,1,4,3,2,1
"6012",2000129414,"Nicolas Lopez","3/8/2003 (20 years old)","M (R), AM (RLC)","Renegades FC","Bahamian Senior League","BAH","No","7/1/2018","6/30/2024","$0","Right Only","Weak","Very Strong","5'9""","152 lbs","-","-",62,75,7,12,11,12,10,5,5,8,8,8,10,5,10,10,13,6,5,10,9,5,7,11,9,7,6,9,13,13,11,10,5,7,10,12,8,6,9,11,12,11,7,9,6,3,7,2,18,15,15,1,1,1,3,3,2,2,1,2,1,2
"6013",2000018025,"Sisekelo Matsenjwa","11/23/1999 (23 years old)","M/AM (C)","Mbabane Highlanders","Premier League of Eswatini","SWZ","No","9/1/2021","6/30/2025","$45K - $140K","Right Only","Weak","Very Strong","5'10""","145 lbs","-","-",73,90,8,8,9,10,13,8,5,10,7,8,11,8,10,11,13,10,9,12,9,15,5,9,1,12,10,14,8,10,9,12,9,10,7,10,6,5,12,20,10,13,10,12,11,12,7,5,20,10,17,2,3,3,3,2,1,1,3,3,2,1
"6014",2000205363,"Christopher Rahming","4/27/1999 (24 years old)","M/AM (C)","Western Warriors","Bahamian Senior League","BAH","No","1/1/2023","6/30/2024","$0","Right Only","Very Weak","Very Strong","6'5""","182 lbs","4","-",57,75,5,5,7,10,9,5,5,8,1,4,12,5,8,7,13,6,7,6,7,11,7,12,9,7,5,6,9,11,13,12,6,15,8,12,11,6,8,13,10,11,11,12,10,16,9,8,8,11,10,2,1,1,3,1,1,2,1,2,1,3
"6015",72009329,"Happy Hall","10/15/1987 (35 years old)","D (RLC)","Renegades FC","Bahamian Senior League","BAH","No","6/12/2023","6/30/2024","$0","Right","Strong","Very Strong","5'10""","160 lbs","36","1",55,75,4,7,1,1,6,3,8,6,6,10,7,1,13,3,5,10,6,7,6,10,13,5,12,3,12,7,4,7,9,7,10,9,14,6,6,10,12,11,9,12,11,11,5,4,6,4,20,13,16,1,2,1,1,3,1,1,2,2,2,3
"6016",2000127839,"Elijah Mitchell","2/23/2003 (20 years old)","D/WB/M/AM (L)","Renegades FC","Bahamian Senior League","BAH","No","6/30/2022","-","$0","Left","Very Strong","Reasonable","5'10""","158 lbs","22","4",65,75,7,12,6,7,6,7,7,2,7,7,10,1,9,7,7,6,7,8,9,10,14,12,1,13,9,8,9,9,15,14,8,5,12,11,8,6,12,14,12,12,9,10,5,9,5,7,9,11,15,2,3,1,3,1,1,1,2,1,3,2
"6017",2000123005,"Ian Lowe","8/29/2002 (20 years old)","GK","Dynamos (BAH)","Bahamian Senior League","BAH","No","7/1/2022","6/30/2024","$0","Right","Fairly Strong","Very Strong","6'1""","149 lbs","-","-",70,75,1,3,3,3,3,4,1,1,2,3,10,1,2,1,13,10,11,8,10,10,10,3,2,3,11,8,7,11,12,9,8,10,13,8,4,7,11,15,11,14,9,9,14,9,15,1,11,11,19,9,7,10,13,10,9,14,5,10,10,10
"6018",2000129081,"Marcel Joseph","3/30/1997 (26 years old)","AM (C), ST (C)","Side FC 92","United Premier Soccer League","BAH","No","1/1/2021","-","$0","Right","Weak","Very Strong","6'5""","185 lbs","-","-",70,75,6,6,9,13,7,6,9,8,3,6,8,8,3,9,5,6,6,8,6,13,4,13,13,12,7,7,6,5,13,11,5,16,13,13,10,8,11,11,10,10,14,10,12,6,5,7,12,12,14,1,3,3,2,2,2,2,3,3,3,2
"6019",2000123059,"Michael Butler","6/2/1999 (24 years old)","GK","UoB","Bahamian Senior League","BAH","No","6/15/2020","6/30/2024","$0","Right","Fairly Strong","Very Strong","6'1""","163 lbs","-","-",60,75,1,1,3,2,1,3,1,1,1,3,3,3,3,1,6,7,13,5,9,12,5,3,12,1,10,5,2,4,10,13,5,8,12,11,3,4,10,14,9,12,11,11,5,8,5,4,7,11,8,6,10,10,10,4,7,11,5,10,12,10
"6020",2000123296,"Troy Pinder","10/30/1997 (25 years old)","D (RC), DM","Western Warriors","Bahamian Senior League","BAH","No","7/1/2018","6/30/2024","$0","Right","Reasonable","Very Strong","6'4""","180 lbs","-","-",66,72,5,7,1,2,2,3,6,3,5,11,5,4,12,3,10,5,7,6,8,7,16,5,13,5,9,6,3,7,13,13,6,13,17,13,11,8,11,13,13,10,10,9,14,6,6,6,7,11,18,3,1,1,3,2,1,2,3,3,3,1
"6021",2000123870,"Cameron Kemp","2/22/1999 (24 years old)","D (R)","Dynamos (BAH)","Bahamian Senior League","BAH","No","6/15/2020","6/30/2024","$0","Right","Fairly Strong","Very Strong","5'9""","156 lbs","-","-",60,72,6,11,4,5,7,2,6,1,2,10,7,1,10,2,8,9,8,7,10,11,12,5,13,6,8,7,6,8,12,11,7,6,7,11,13,7,9,15,12,15,12,8,5,3,13,7,15,11,17,3,2,1,1,3,3,2,2,3,1,1
"6022",2000234470,"Vance Wheaton","4/4/2005 (18 years old)","GK","Renegades FC","Bahamian Senior League","BAH","No","7/1/2021","6/30/2024","$0","Right","Reasonable","Very Strong","6'4""","180 lbs","-","-",60,70,2,3,2,1,1,6,1,3,2,3,8,2,1,5,10,5,12,6,6,13,13,3,4,2,7,6,5,5,11,5,6,15,12,10,5,7,9,13,10,9,12,9,5,7,8,1,9,11,14,9,8,9,11,5,8,10,5,9,8,13
"6023",2000129546,"Jonathan Miller","6/11/1998 (25 years old)","D/WB (R)","Dynamos (BAH)","Bahamian Senior League","BAH","No","6/15/2020","6/30/2024","$0","Right","Reasonable","Very Strong","6'0""","163 lbs","-","-",60,70,5,9,4,1,9,1,6,4,4,8,6,3,12,8,12,9,8,7,6,12,10,5,4,4,5,7,4,7,14,11,6,9,13,12,8,5,10,20,10,10,9,10,10,5,12,6,9,13,11,1,1,2,4,1,2,3,3,1,1,3
"6024",2000291074,"Sibusiso Thabo Dlamini","10/10/2000 (22 years old)","GK","Nsingizini Hotspurs","Premier League of Eswatini","SWZ","No","7/1/2022","6/30/2024","$0 - $65K","Right","Strong","Very Strong","6'1""","163 lbs","-","-",70,90,3,3,3,1,1,8,1,3,1,3,9,2,2,4,14,7,12,7,8,13,4,3,11,2,11,7,6,5,13,6,7,8,12,10,1,7,12,10,9,9,11,13,13,12,8,3,14,11,7,9,11,13,12,8,12,13,5,6,8,9
"6025",82072177,"Christopher Godet","3/30/1998 (25 years old)","D (RC), DM","UoB","Bahamian Senior League","BAH","No","7/1/2021","6/30/2024","$0","Right","Reasonable","Very Strong","6'2""","196 lbs","-","-",66,70,3,8,1,2,8,6,8,2,1,9,7,3,10,7,15,8,8,6,11,10,4,5,14,6,10,7,7,8,14,14,7,9,13,14,8,5,11,12,12,10,8,11,7,5,5,2,9,10,15,3,3,2,3,3,2,1,1,1,1,1
"6026",2000129545,"Ethan Willie","2/21/1999 (24 years old)","M/AM (L)","Western Warriors","Bahamian Senior League","BAH","No","7/1/2018","6/30/2024","$0","Left","Very Strong","Reasonable","5'10""","152 lbs","-","-",60,70,4,8,8,6,7,5,1,5,3,2,10,4,5,6,14,6,5,8,6,7,11,6,3,8,5,7,6,11,13,13,6,6,15,13,9,6,11,19,10,12,12,9,5,17,6,4,9,9,14,1,1,1,2,3,2,4,1,3,2,2
"6027",82072241,"Jordan Farquharson","2/21/2000 (23 years old)","M/AM (LC)","Western Warriors","Bahamian Senior League","BAH","No","6/15/2020","6/30/2024","$0","Left","Very Strong","Reasonable","5'9""","134 lbs","5","-",58,70,5,4,11,10,12,5,1,6,5,5,7,3,7,8,5,6,7,8,5,12,17,9,4,8,5,7,10,12,8,11,6,4,15,13,7,3,15,14,11,12,14,13,7,11,5,3,11,8,19,1,2,2,1,1,2,3,1,2,2,3
"6028",2000205373,"Brandon Adderley","1/2/2002 (21 years old)","ST (C)","Bears","Bahamian Senior League","BAH","No","7/1/2020","6/30/2024","$0","Right","Reasonable","Very Strong","6'0""","165 lbs","-","-",63,70,2,2,10,14,10,6,7,5,1,5,7,7,4,10,13,8,7,14,7,9,5,9,9,5,7,6,5,7,13,11,7,8,9,9,4,6,10,17,11,12,11,12,7,5,5,2,11,10,12,2,3,1,2,2,3,1,1,4,2,1
"6029",29129358,"Christopher Larson","10/1/1991 (31 years old)","M/AM (R)","Renegades FC","Bahamian Senior League","BAH","No","7/1/2019","6/30/2024","$0","Right","Weak","Very Strong","6'0""","171 lbs","-","-",56,67,8,11,9,9,6,6,5,6,5,6,8,5,5,11,13,8,6,9,7,10,8,12,11,11,6,7,6,12,11,9,7,6,16,10,13,5,12,17,12,14,11,12,13,6,5,6,10,10,19,3,2,3,3,3,2,4,2,2,1,2
"6030",82072283,"Valin Bodie","5/9/1995 (28 years old)","GK","Side FC 92","United Premier Soccer League","BAH","No","11/2/2020","-","$0","Right","Fairly Strong","Very Strong","6'2""","194 lbs","-","-",58,65,2,2,1,2,1,6,1,1,2,1,4,3,2,5,13,5,7,5,12,12,14,3,9,2,6,5,6,5,9,11,5,12,15,11,4,6,11,18,12,9,10,11,5,12,11,3,9,12,15,5,10,8,13,5,3,6,5,6,6,10
"6031",2000129541,"Nathan Wells","10/7/2000 (22 years old)","M/AM (L)","Western Warriors","Bahamian Senior League","BAH","No","7/1/2018","6/30/2024","$0","Left","Very Strong","Weak","6'1""","169 lbs","-","-",60,65,6,9,10,9,7,6,5,7,2,5,8,5,3,6,13,10,7,9,7,8,16,13,6,14,6,7,4,9,13,10,3,14,8,12,10,5,11,18,11,10,11,10,14,8,6,1,10,11,15,3,3,4,1,1,1,3,2,2,2,2
"6032",82064345,"Terry Delancy","2/28/1994 (29 years old)","M (L), AM (LC), ST (C)","Cavalier FC (BAH)","Bahamian Senior League","BAH","No","6/15/2020","6/30/2024","$0","Right","Reasonable","Very Strong","5'11""","154 lbs","-","-",64,64,2,7,11,10,11,6,4,5,6,5,10,5,2,11,11,8,7,8,6,13,16,18,6,12,6,7,6,8,10,11,7,11,15,10,11,5,10,14,9,11,10,8,11,9,9,5,20,12,8,3,2,4,1,2,1,1,3,2,3,3
"6033",2000129548,"Julio Jemison","2/24/1994 (29 years old)","GK","UoB","Bahamian Senior League","BAH","No","7/1/2019","6/30/2024","$0","Right","Reasonable","Very Strong","6'1""","163 lbs","-","-",60,62,3,1,1,2,1,5,1,2,3,2,6,3,1,1,5,6,14,6,5,13,7,1,11,2,10,2,5,5,11,9,6,8,15,12,3,5,10,12,10,12,14,12,9,6,7,6,10,10,14,5,7,13,13,6,8,10,5,5,10,12
"6034",2000129534,"Jean Francois","12/13/1991 (31 years old)","M/AM (R)","Western Warriors","Bahamian Senior League","BAH","No","7/1/2018","6/30/2024","$0","Right","Reasonable","Very Strong","5'9""","149 lbs","-","-",62,62,6,10,6,8,12,6,1,7,6,6,9,5,3,7,14,9,4,9,7,11,4,9,10,12,6,8,6,12,12,9,5,6,9,10,13,4,9,11,10,10,12,9,8,6,6,1,6,12,15,2,2,1,2,1,1,1,1,2,1,2
"6035",13197612,"Mandla Palma","9/17/1983 (39 years old)","D (C)","Mbabane Highlanders","Premier League of Eswatini","SWZ","No","7/1/2022","6/30/2024","$0 - $12K","Right Only","Very Weak","Very Strong","6'0""","165 lbs","-","-",73,90,3,4,1,2,8,1,14,1,1,14,8,4,12,5,15,12,5,8,8,14,11,6,7,7,14,7,7,8,6,6,6,11,13,6,6,6,13,13,10,10,14,14,10,4,10,6,6,10,7,1,3,2,2,3,1,1,2,3,2,1
"6036",29129356,"Raymorn Sturrup","5/3/1992 (31 years old)","M (C)","Baha Jrs.","Bahamian Senior League","BAH","No","6/14/2021","6/30/2024","$0","Right","Reasonable","Very Strong","6'1""","169 lbs","-","-",57,62,6,6,2,5,7,6,2,8,3,10,11,3,8,10,5,7,6,11,7,10,17,6,12,9,6,8,7,12,7,11,7,8,12,10,14,6,9,20,10,10,11,12,15,15,6,5,20,13,12,1,1,2,2,3,1,2,1,1,2,2
"6037",2000287740,"Michael Massey","5/10/2005 (18 years old)","M (L)","Renegades FC","Bahamian Senior League","BAH","No","7/1/2020","6/30/2024","$0","Right","Reasonable","Very Strong","5'9""","147 lbs","-","-",57,61,9,12,5,7,6,6,6,7,6,6,10,6,6,7,6,8,5,13,7,6,15,5,4,4,5,8,5,13,11,13,7,8,12,10,8,4,13,12,11,10,11,10,10,11,12,6,8,10,16,3,3,2,1,1,2,3,3,1,3,2
"6038",29160164,"Kristoff Wood","8/12/1993 (29 years old)","M (C)","Renegades FC","Bahamian Senior League","BAH","No","6/15/2020","6/30/2024","$0","Right","Reasonable","Very Strong","6'1""","163 lbs","-","-",50,61,1,5,5,1,7,5,3,7,4,8,10,1,5,10,15,5,5,6,6,11,13,7,13,6,7,6,7,11,13,13,6,7,15,13,13,5,11,17,11,10,12,9,6,2,13,2,15,8,11,3,3,3,2,1,2,2,3,1,3,1
"6039",2000129538,"Alex Thompson","2/21/1991 (32 years old)","M (C)","Renegades FC","Bahamian Senior League","BAH","No","6/14/2021","6/30/2024","$0","Right","Weak","Very Strong","6'3""","182 lbs","-","-",58,60,4,1,2,4,10,6,4,7,6,7,14,2,7,10,11,11,2,8,7,8,7,5,9,7,5,7,11,12,9,10,3,16,10,11,13,9,11,19,10,9,11,11,7,7,12,5,9,13,19,1,4,2,3,2,1,3,1,1,3,2
"6040",2000129558,"Jamie Thompson","10/6/1996 (26 years old)","ST (C)","Dynamos (BAH)","Bahamian Senior League","BAH","No","7/1/2018","6/30/2024","$0","Right","Reasonable","Very Strong","5'11""","160 lbs","-","-",56,58,4,1,9,12,11,4,11,5,1,4,3,3,1,6,13,8,3,7,4,9,9,7,10,11,5,4,4,5,12,12,9,7,17,12,10,10,8,17,9,14,10,12,8,9,7,8,5,10,15,2,2,2,1,2,2,2,3,2,3,3
"6041",29129349,"Dwayne Forbes","1/20/1989 (34 years old)","D (C)","United FC (BAH)","Bahamian Senior League","BAH","No","6/14/2021","6/30/2024","$0","Right","Fairly Strong","Very Strong","6'4""","182 lbs","1","1",50,54,5,3,1,1,4,1,10,5,4,13,4,3,10,5,11,7,8,6,9,13,4,5,10,3,13,5,5,6,5,8,6,11,13,6,7,5,12,13,12,9,11,11,11,2,5,7,8,12,12,1,3,3,2,2,2,3,1,2,4,2
"6042",91121126,"Charmaine Häusl","1/27/1996 (27 years old)","D (RC), DM","Altglienicke","German Regional Division Northeast","SEY","Yes","7/1/2022","6/30/2023","$0 - $8K","Right Only","Weak","Very Strong","6'1""","169 lbs","111","3",94,99,3,8,7,4,8,7,13,7,1,12,9,1,13,3,5,10,10,8,8,13,13,5,12,7,13,7,8,9,13,13,8,12,14,13,9,8,14,14,14,14,14,13,5,13,6,6,14,13,7,2,2,1,2,2,2,2,1,3,3,3
"6043",2000010328,"Juninho Mathiot","2/9/2000 (23 years old)","D (C)","St. Louis Suns Utd","Seychellois First Division","SEY","No","7/1/2018","-","$0","Right","Weak","Very Strong","6'0""","158 lbs","-","-",62,80,1,1,1,1,4,1,13,4,5,13,6,3,11,5,11,12,8,6,11,13,15,6,5,5,13,5,5,6,12,11,6,6,16,9,4,3,8,11,13,11,13,10,8,7,5,4,11,9,10,2,1,1,3,3,3,3,1,1,1,2
"6044",5341300,"Kitson Cecile","5/5/1984 (39 years old)","GK","Foresters","Seychellois First Division","SEY","No","7/1/2020","-","$0","Right","Weak","Very Strong","6'5""","187 lbs","-","-",50,80,3,3,2,2,1,6,1,1,3,1,7,1,2,5,12,10,13,6,10,9,19,3,11,2,8,3,6,7,6,6,6,17,14,6,1,8,8,10,10,13,10,11,10,11,6,1,16,13,19,6,5,4,6,11,10,11,11,10,8,14
"6045",13117363,"Vincent Euphrasie","5/1/1980 (43 years old)","GK","La Passe","Seychellois First Division","SEY","No","6/14/2021","-","$0","Right","Reasonable","Very Strong","6'0""","163 lbs","-","-",50,80,4,3,1,2,4,5,1,2,2,3,9,1,3,2,13,7,9,7,12,14,18,1,11,1,6,7,6,6,4,9,4,10,16,4,1,4,9,13,11,11,10,13,7,1,5,4,16,12,19,11,13,4,11,6,10,14,8,7,9,12
"6046",2000085938,"Lindokuhle Mkhonta","4/10/1991 (32 years old)","D (RC), DM","Zesco United","Zambian Premier League","SWZ","No","1/31/2023","12/31/2024","$0 - $20K","Right","Reasonable","Very Strong","5'9""","156 lbs","-","-",88,88,9,10,6,9,5,9,11,10,9,11,8,5,16,9,12,10,10,8,11,11,2,5,12,8,16,10,10,11,6,9,7,11,10,7,6,6,12,16,11,13,12,13,11,12,8,3,10,13,18,3,1,3,1,3,2,3,1,1,2,1
"6047",13178036,"Carl Hopprich","3/7/1996 (27 years old)","DM, M (RLC), AM (C)","Zehlendorf","German Div. North East - North","SEY","Yes","6/12/2023","6/30/2024","$0 - $65K","Right","Reasonable","Very Strong","6'2""","169 lbs","109","3",71,76,5,7,7,10,12,5,5,7,3,7,8,6,9,12,7,6,7,7,7,9,5,13,11,7,7,6,9,11,12,12,7,12,10,12,6,5,12,12,11,12,10,9,11,10,6,2,11,11,19,3,3,3,2,1,3,2,2,3,2,2
"6048",13145150,"Benoit Marie","12/26/1992 (30 years old)","D (RC)","Côte d´Or","Seychellois First Division","SEY","No","6/14/2021","-","$0","Right","Reasonable","Very Strong","5'11""","152 lbs","-","-",68,75,5,8,6,2,7,1,14,3,4,6,7,1,11,2,13,11,8,5,7,14,3,5,3,5,10,6,3,7,14,14,7,11,15,14,7,5,12,20,11,11,10,12,13,10,5,3,8,10,14,2,3,2,4,2,2,4,4,1,1,2
"6049",2000070235,"Dean Mothé","8/1/2000 (22 years old)","M (R), AM (RC)","St. Louis Suns Utd","Seychellois First Division","SEY","No","7/1/2019","-","$0","Right","Reasonable","Very Strong","6'2""","169 lbs","-","-",58,75,5,10,10,12,11,2,5,7,5,5,9,5,7,7,11,3,4,13,6,13,9,9,1,9,6,7,9,11,9,12,6,12,14,10,6,5,16,18,11,11,9,11,10,11,6,4,11,10,9,3,1,3,1,1,3,1,1,1,2,3
"6050",2000039723,"Perry Monnaie","5/15/1997 (26 years old)","AM (R), ST (C)","Côte d´Or","Seychellois First Division","SEY","No","7/1/2020","-","$0","Right","Fairly Strong","Very Strong","5'10""","160 lbs","-","-",62,71,3,5,12,5,10,4,10,2,2,3,6,4,1,9,6,7,3,6,4,11,12,10,11,9,5,4,4,7,12,12,5,4,7,12,12,6,9,16,11,11,11,9,10,5,11,4,10,11,12,1,2,2,3,1,1,2,3,3,2,1
"6051",13117365,"Leroy Coralie","7/16/1989 (33 years old)","AM (L), ST (C)","Red Star DF","Seychellois First Division","SEY","No","7/1/2018","-","$0","Left","Very Strong","Reasonable","5'6""","134 lbs","-","-",57,70,7,11,9,7,12,5,6,4,5,5,9,5,3,9,10,7,7,7,6,13,16,9,13,9,5,6,5,7,9,11,5,1,12,10,7,1,10,14,11,12,11,13,11,7,10,7,14,12,9,1,3,1,1,1,2,3,2,2,2,2
"6052",2000039718,"Brandon Labrosse","3/11/1999 (24 years old)","AM (R), ST (C)","Foresters","Seychellois First Division","SEY","No","7/1/2019","-","$0","Right","Fairly Strong","Very Strong","6'0""","163 lbs","-","-",60,70,4,7,11,12,8,5,11,6,3,5,10,7,1,11,10,6,3,8,6,8,14,11,14,9,6,5,5,7,13,9,6,9,14,10,4,5,12,12,11,12,9,11,7,11,10,6,8,13,12,2,4,3,3,2,2,1,2,1,3,4
"6053",13158712,"Keiren Sinon","10/26/1990 (32 years old)","D (C)","Red Star DF","Seychellois First Division","SEY","No","7/1/2020","-","$0","Right","Fairly Strong","Very Strong","5'11""","165 lbs","-","-",60,70,3,3,1,1,5,1,11,1,5,14,5,1,14,2,10,12,8,5,9,11,6,5,6,3,14,6,6,4,7,7,7,11,15,5,7,8,17,10,11,11,12,10,14,6,14,4,9,11,8,1,3,3,1,1,3,1,1,3,2,1
"6054",13117364,"Gervais Waye-Hive","6/11/1988 (35 years old)","AM (R), ST (C)","St. Louis Suns Utd","Seychellois First Division","SEY","No","6/14/2021","-","$0","Right","Weak","Very Strong","5'10""","169 lbs","-","-",56,70,5,10,8,10,10,1,14,7,5,6,9,4,2,6,10,10,7,9,7,14,4,12,12,9,6,7,7,8,7,10,7,8,14,10,10,4,9,16,11,12,12,11,5,8,9,1,10,11,13,1,1,2,2,4,1,3,1,3,2,2
"6055",13187227,"Ryan Henriette","1/23/2000 (23 years old)","M/AM (R)","Foresters","Seychellois First Division","SEY","No","6/15/2020","-","$0","Right","Strong","Very Strong","5'10""","145 lbs","-","-",58,67,6,9,7,8,10,4,2,4,4,4,7,3,2,11,15,6,6,8,3,11,7,12,12,10,3,5,4,10,12,12,5,6,15,12,10,2,9,10,12,10,9,13,13,13,13,3,10,11,11,3,3,2,1,2,3,2,1,2,2,1
"6056",13187217,"Daryl Louise","8/12/1998 (24 years old)","GK","Abingdon Utd","English Hellenic Football League Division One","SEY","No","7/1/2021","6/30/2024","$7K - $22K","Right","Reasonable","Very Strong","6'0""","165 lbs","-","-",55,67,3,2,3,1,1,5,1,1,2,1,4,3,1,4,14,10,15,3,11,12,12,2,7,3,8,4,2,5,6,10,6,8,13,8,5,6,11,14,12,10,13,12,15,5,7,8,9,15,10,7,5,12,7,9,12,8,5,6,9,7
"6057",2000308619,"Delisa Gama","6/7/1998 (25 years old)","D/WB (L)","Mbabane Highlanders","Premier League of Eswatini","SWZ","No","7/1/2021","6/30/2025","$5K - $55K","Left Only","Very Strong","Weak","5'11""","156 lbs","-","-",80,88,6,9,7,2,12,2,9,5,8,10,10,8,12,10,6,10,3,7,12,11,11,11,10,6,8,9,9,10,15,12,8,12,11,14,10,12,14,20,7,10,12,10,5,9,11,5,14,11,12,2,2,1,2,2,1,1,3,1,1,2
"6058",2000070234,"Josip Ravighia","2/19/2001 (22 years old)","DM, M (C)","Real Maldive","Seychelles Second Division","SEY","No","7/1/2019","-","$0","Right Only","Weak","Very Strong","6'2""","165 lbs","-","-",50,66,4,2,4,5,9,5,2,4,2,7,8,4,9,7,11,9,7,7,7,12,15,5,7,5,4,7,6,11,13,13,6,11,12,13,6,3,15,18,13,12,10,12,7,16,14,3,10,11,8,2,2,4,3,3,3,1,2,2,1,1
"6059",2000085955,"Kenner Nourrice","6/10/1995 (28 years old)","DM","St. John Bosco (SEY)","Seychelles Second Division","SEY","No","11/12/2021","-","$0","Right","Reasonable","Very Strong","6'3""","174 lbs","4","-",60,66,3,2,3,6,5,5,5,6,1,7,7,4,13,7,7,9,7,7,7,10,5,5,8,5,12,7,8,11,12,13,6,12,12,12,10,5,9,20,10,8,12,11,9,5,9,1,11,11,17,1,1,1,1,2,1,2,3,3,1,2
"6060",13187226,"Ricky Pool","6/2/1998 (25 years old)","GK","St. Louis Suns Utd","Seychellois First Division","SEY","No","6/15/2020","-","$0","Right","Reasonable","Very Strong","6'4""","176 lbs","-","-",52,66,3,2,2,1,1,3,1,3,3,3,8,1,3,4,5,6,14,3,10,12,18,3,11,1,4,5,4,4,9,8,5,12,15,9,4,5,10,19,12,10,11,11,8,9,8,7,4,12,20,6,8,10,7,4,9,6,5,6,6,12
"6061",2000010324,"Stan Esther","2/12/2001 (22 years old)","D (RC)","Northern Dynamo","Seychellois First Division","SEY","No","7/1/2019","-","$0","Right","Reasonable","Very Strong","6'0""","158 lbs","-","-",59,66,6,8,1,3,8,6,6,4,6,6,6,1,12,7,9,6,8,7,7,9,2,5,1,6,12,7,7,7,13,13,4,8,13,14,6,4,13,11,11,10,10,10,7,3,9,3,9,11,11,3,3,3,2,1,3,2,3,1,1,2
"6062",13178038,"Elijah Tamboo","10/22/1993 (29 years old)","AM (L), ST (C)","St. Louis Suns Utd","Seychellois First Division","SEY","No","6/15/2020","-","$0","Left","Very Strong","Weak","5'7""","143 lbs","-","-",60,65,3,8,11,11,5,1,3,5,2,4,5,7,3,8,10,4,6,8,2,10,8,11,8,8,4,5,5,7,12,12,5,5,9,12,12,4,8,17,12,11,11,10,5,5,6,2,9,12,14,2,3,4,2,3,2,4,1,2,1,1
"6063",13206129,"Andy Brioche","11/28/1989 (33 years old)","D/WB (L)","Light Stars","Seychellois First Division","SEY","No","7/1/2020","-","$0","Left","Very Strong","Reasonable","5'7""","141 lbs","-","-",60,65,4,7,8,4,13,1,8,4,5,10,9,4,13,10,6,8,8,9,9,11,10,10,6,8,12,9,9,9,10,9,6,7,11,11,14,4,14,10,12,10,10,10,6,10,14,7,17,10,12,3,2,3,3,3,2,3,3,2,1,3
"6064",2000010335,"Brandon Molle","4/17/2000 (23 years old)","D (L)","Foresters","Seychellois First Division","SEY","No","7/1/2019","-","$0","Left","Very Strong","Fairly Strong","6'2""","167 lbs","-","-",56,65,3,8,1,1,5,1,7,4,5,6,3,1,11,5,11,7,8,5,9,11,10,8,1,3,9,7,5,7,14,12,4,11,14,12,7,5,9,13,10,13,11,10,5,12,6,4,17,11,20,4,1,2,1,1,4,2,1,1,2,2
"6065",2000123110,"Nigel Hoareau","3/3/1990 (33 years old)","D (C)","St. Michel Utd","Seychellois First Division","SEY","No","6/14/2021","-","$0","Right","Fairly Strong","Very Strong","6'2""","176 lbs","-","-",58,65,3,5,1,1,7,1,6,6,3,11,5,1,9,3,10,8,5,7,9,14,6,5,12,6,14,6,4,7,6,7,7,11,13,8,9,7,12,14,10,12,10,11,8,2,15,3,10,10,13,4,2,1,1,1,4,2,3,4,3,3
"6066",2000123109,"Norris Bibi","5/10/1998 (25 years old)","M (C)","Côte d´Or","Seychellois First Division","SEY","No","7/1/2019","-","$0","Right","Reasonable","Very Strong","5'4""","121 lbs","-","-",60,65,3,2,1,6,13,4,4,7,1,12,10,5,6,13,13,7,2,8,5,12,9,7,7,9,6,7,7,11,13,13,6,1,15,13,7,1,10,13,11,13,12,12,5,14,6,6,11,10,13,4,1,2,1,3,3,2,2,4,3,1
"6067",13104230,"Rashim Padayachy","2/3/1994 (29 years old)","DM, M (C)","Red Star DF","Seychellois First Division","SEY","No","7/1/2020","-","$0","Left","Very Strong","Reasonable","5'9""","145 lbs","-","-",60,64,4,4,2,4,12,5,5,7,1,7,10,1,10,8,10,7,5,7,7,12,11,5,13,4,10,7,5,12,13,13,6,4,13,11,10,5,11,13,12,11,11,11,12,9,5,3,20,12,19,1,1,3,1,1,1,1,1,2,2,2
"6068",65042649,"Justice Figuareido","7/28/1998 (24 years old)","ST (C)","Richards Bay","South African Premier Soccer League","SWZ","No","6/12/2023","6/30/2024","$18K - $55K","Right","Fairly Strong","Very Strong","6'2""","169 lbs","88","11",80,88,5,5,13,12,8,6,13,7,2,6,5,3,6,11,8,7,4,12,5,13,14,11,11,13,7,6,3,7,13,11,6,9,13,13,8,5,10,15,11,11,11,10,7,3,6,3,12,12,11,1,1,2,1,4,2,3,1,2,3,3
"6069",13158720,"Adrian Constance","12/21/1995 (27 years old)","D (C)","La Passe","Seychellois First Division","SEY","No","6/15/2020","-","$0","Right","Reasonable","Very Strong","6'3""","187 lbs","-","-",55,63,2,1,1,1,1,1,5,1,2,12,5,1,8,4,7,5,7,3,10,12,7,5,12,4,5,4,1,5,12,12,5,11,9,12,10,11,15,19,12,12,12,13,5,6,11,6,9,10,10,3,1,2,3,1,4,1,2,3,2,2
"6070",13187221,"Helton Monnaie","5/15/1997 (26 years old)","D (R)","La Passe","Seychellois First Division","SEY","No","1/2/2019","-","$0","Right Only","Weak","Very Strong","6'4""","182 lbs","-","-",57,62,4,9,1,1,6,1,5,4,4,12,6,1,11,2,8,8,5,6,9,12,15,10,6,3,11,6,4,6,12,9,5,11,5,11,7,5,11,20,11,13,9,13,12,2,12,6,16,9,14,3,1,2,2,2,3,2,2,3,3,1
"6071",13104226,"Alvin Michel","1/5/1990 (33 years old)","GK","St. Michel Utd","Seychellois First Division","SEY","No","6/14/2021","-","$0","Right","Reasonable","Very Strong","6'0""","160 lbs","-","-",61,62,1,3,2,1,1,4,1,1,2,3,7,2,2,1,7,9,11,5,12,13,9,1,4,2,9,6,5,5,10,11,5,9,12,11,4,4,12,17,10,11,8,9,9,6,11,8,9,12,20,4,5,6,5,4,7,10,5,7,9,12
"6072",13158707,"Yannick Manoo","7/7/1991 (31 years old)","D (C)","St. Michel Utd","Seychellois First Division","SEY","No","6/14/2021","-","$0","Right","Weak","Very Strong","6'1""","169 lbs","-","-",61,62,1,1,4,1,7,3,9,1,1,11,6,3,11,5,8,10,7,7,9,14,12,5,13,2,11,6,4,7,8,13,7,12,6,10,9,5,10,12,11,13,8,11,6,7,7,4,7,10,8,2,1,1,3,1,3,1,3,3,2,2
"6073",2000069488,"Martin Williams","7/22/1991 (31 years old)","M/AM (L)","Foresters","Seychellois First Division","SEY","No","6/14/2021","-","$0","Left","Very Strong","Weak","5'11""","156 lbs","-","-",59,62,5,10,7,7,8,4,5,7,5,5,8,2,5,13,8,8,3,7,6,11,3,13,13,10,4,6,4,10,11,11,6,8,12,10,12,4,11,11,10,11,11,14,5,8,12,8,8,12,14,3,2,3,1,3,2,1,1,3,2,1
"6074",2000039707,"Hubert Jean","7/26/1996 (26 years old)","ST (C)","St. Louis Suns Utd","Seychellois First Division","SEY","No","7/1/2019","-","$0","Right","Reasonable","Very Strong","6'2""","163 lbs","-","-",58,62,4,1,4,12,11,4,12,4,1,3,4,8,1,6,9,7,6,12,5,10,10,8,10,8,4,4,3,5,12,10,5,6,13,12,9,2,11,13,11,11,9,10,13,11,9,1,20,13,8,3,2,3,2,3,4,1,1,1,3,2
"6075",13117508,"Ian Ah Kong","11/2/1995 (27 years old)","GK","La Passe","Seychellois First Division","SEY","No","6/1/2021","-","$0","Right","Reasonable","Very Strong","6'1""","169 lbs","-","-",57,62,1,1,3,2,4,6,1,3,1,3,6,1,3,2,13,9,9,5,9,13,10,2,8,3,9,6,5,5,13,5,6,12,11,10,2,5,10,11,12,10,12,13,11,15,5,1,10,10,16,6,11,11,10,6,6,13,11,9,7,13
"6076",13160878,"Gino Agathine","7/6/1992 (30 years old)","M (C)","Red Star DF","Seychellois First Division","SEY","No","6/14/2021","-","$0","Right","Reasonable","Very Strong","6'1""","167 lbs","-","-",50,62,2,4,4,5,11,4,3,3,2,5,8,2,4,7,7,6,7,4,5,6,18,7,8,7,7,6,12,11,12,12,3,9,9,12,12,4,13,15,9,11,9,11,12,10,7,6,10,10,20,2,3,2,3,3,2,2,1,2,3,3
"6077",13208158,"Warren Mellie","10/1/1994 (28 years old)","D (C)","Foresters","Seychellois First Division","SEY","No","7/1/2020","-","$0","Right","Reasonable","Very Strong","6'0""","163 lbs","-","-",57,60,3,1,2,1,6,1,6,1,3,7,6,5,13,2,11,8,8,6,7,10,10,5,3,5,13,3,1,6,13,13,6,9,15,13,10,8,12,14,9,10,7,11,12,12,7,4,8,9,10,4,3,3,3,1,3,3,4,3,1,3
"6078",2000218365,"Gillio Suzette","7/16/1997 (25 years old)","D (R)","St. Michel Utd","Seychellois First Division","SEY","No","7/1/2020","-","$0","Right","Weak","Very Strong","5'10""","158 lbs","-","-",52,60,3,10,4,5,9,1,5,2,5,7,7,3,12,5,12,6,6,4,7,10,12,5,11,5,7,6,4,6,13,13,6,8,12,13,10,7,10,10,12,11,11,9,9,5,5,3,7,11,13,1,3,2,3,1,2,1,1,1,1,3
"6079",2000310142,"Sibusiso Masuku","11/13/2000 (22 years old)","DM, M (C)","Mbabane Swallows","Premier League of Eswatini","SWZ","No","6/12/2023","6/30/2025","$0 - $75K","Right Only","Very Weak","Very Strong","5'11""","147 lbs","-","-",63,86,8,8,8,9,10,5,9,10,6,8,10,3,13,8,15,10,14,10,8,10,9,5,7,9,10,15,10,14,7,11,9,10,15,10,9,6,14,14,12,11,12,9,5,7,7,4,12,8,16,2,2,1,1,3,2,4,2,2,2,1
"6080",13117362,"Jude Nancy","6/12/1984 (38 years old)","D (R)","St. Louis Suns Utd","Seychellois First Division","SEY","No","1/2/2019","-","$0","Right Only","Weak","Very Strong","5'9""","156 lbs","-","-",50,60,6,13,5,5,10,3,9,4,8,8,9,1,8,7,14,10,9,7,11,14,6,7,12,5,9,9,7,9,8,8,8,7,14,8,6,8,11,14,11,10,15,12,10,10,15,2,20,11,19,1,2,1,1,1,2,2,3,1,2,1
"6081",13187215,"Colyn Francourt","4/17/1998 (25 years old)","WB (L)","Red Star DF","Seychellois First Division","SEY","No","7/1/2020","-","$0","Left","Very Strong","Reasonable","6'2""","171 lbs","-","-",50,60,5,7,6,1,9,1,5,2,6,7,7,1,7,10,11,4,2,4,6,7,9,6,3,4,7,6,6,7,13,11,6,10,11,10,12,4,8,11,12,11,11,13,10,4,5,1,8,10,16,3,3,2,1,2,1,2,2,2,3,3
"6082",13145147,"Jean-Paul Lesperance","6/29/1990 (32 years old)","GK","Côte d´Or","Seychellois First Division","SEY","No","6/14/2021","-","$0","Right","Reasonable","Very Strong","6'6""","189 lbs","-","-",55,60,3,3,2,2,2,4,1,3,3,2,9,1,3,2,10,10,14,6,9,7,9,1,6,1,10,7,6,6,13,6,5,15,15,11,2,9,12,19,11,10,10,11,11,4,5,8,12,8,11,9,5,12,13,4,10,10,5,6,8,14
"6083",2000010326,"Fabio Lemiel","3/14/1995 (28 years old)","D (C)","Light Stars","Seychellois First Division","SEY","No","6/15/2020","-","$0","Right Only","Weak","Very Strong","6'1""","163 lbs","-","-",50,60,1,1,1,1,4,1,13,1,3,11,2,1,9,5,10,11,8,3,5,13,4,5,1,4,13,4,3,7,12,10,6,7,14,10,11,4,12,15,11,12,12,12,9,1,11,4,9,11,12,1,2,2,2,3,3,2,2,3,3,2
"6084",13187224,"Nick Labiche","7/8/1999 (23 years old)","D (RC)","Real Maldive","Seychelles Second Division","SEY","No","7/1/2019","-","$0","Right","Reasonable","Very Strong","5'11""","158 lbs","-","-",50,60,3,7,5,1,7,1,10,5,2,9,4,1,8,5,12,8,8,6,7,13,17,5,5,5,6,6,3,6,13,13,6,6,12,13,7,5,11,19,14,12,12,10,7,8,8,4,9,9,9,3,3,1,1,3,2,2,1,4,2,3
"6085",2000218371,"Jean-Yves Ernesta","2/10/1996 (27 years old)","M (C)","Foresters","Seychellois First Division","SEY","No","7/1/2020","-","$0","Right","Reasonable","Very Strong","5'9""","145 lbs","-","-",50,60,5,1,2,4,10,5,5,7,1,7,8,1,6,7,11,8,3,7,7,13,4,6,3,7,4,7,7,11,13,13,6,5,15,13,7,4,8,17,12,11,10,12,8,2,10,7,10,12,9,3,1,3,2,1,3,1,4,1,2,2
"6086",2000070450,"Randolph Elizabeth","10/29/1995 (27 years old)","ST (C)","St. John Bosco (SEY)","Seychelles Second Division","SEY","No","6/15/2020","-","$0","Right","Fairly Strong","Very Strong","6'2""","174 lbs","-","-",50,60,3,2,11,11,10,3,8,2,1,1,4,6,1,5,9,7,3,11,4,6,14,11,12,9,1,3,1,4,11,11,4,11,13,11,9,6,11,20,11,11,11,12,8,1,8,5,14,12,7,1,2,3,2,3,2,3,2,3,1,1
"6087",13208160,"Roddy Mélanie","7/13/1991 (31 years old)","D (C), DM","St. Louis Suns Utd","Seychellois First Division","SEY","No","6/14/2021","-","$0","Right","Weak","Very Strong","6'3""","178 lbs","-","-",53,60,4,5,1,1,8,5,6,7,5,8,9,3,13,7,6,9,7,7,8,13,9,5,9,5,10,7,6,10,7,7,6,13,13,6,5,6,11,13,11,11,12,12,10,12,5,1,7,11,14,2,3,2,1,1,3,4,2,1,1,4
"6088",2000218369,"Dean Balette","6/9/1995 (28 years old)","DM, M (C)","St. John Bosco (SEY)","Seychelles Second Division","SEY","No","7/1/2020","-","$0","Right","Reasonable","Very Strong","6'0""","163 lbs","-","-",55,60,4,1,3,6,8,4,5,6,2,7,11,1,11,10,15,8,4,5,7,13,4,5,9,5,9,7,7,11,13,10,6,8,11,12,6,5,9,15,12,12,11,12,9,1,13,8,20,10,19,1,2,2,3,1,1,2,2,3,1,2
"6089",13178037,"Colin Bibi","6/4/1995 (28 years old)","M/AM (C)","La Passe","Seychellois First Division","SEY","No","6/15/2020","-","$0","Right","Reasonable","Very Strong","6'4""","180 lbs","-","-",58,60,5,4,7,10,12,5,5,7,1,4,9,1,6,7,8,7,6,6,6,11,7,7,10,9,7,6,7,7,12,9,6,11,12,10,9,7,12,11,9,12,13,10,10,15,11,7,20,13,13,1,3,1,4,2,3,2,3,1,4,3
"6090",2000088342,"Mxolisi Mkhonto","9/8/1993 (29 years old)","AM (LC), ST (C)","Green Mamba","Premier League of Eswatini","SWZ","No","6/15/2020","6/30/2024","$14K - $140K","Right Only","Weak","Very Strong","5'10""","163 lbs","113","18",81,86,8,10,9,10,8,7,10,10,8,6,15,9,6,10,12,8,9,11,9,13,5,9,11,14,9,5,11,10,9,14,9,10,12,11,10,5,11,17,10,9,10,8,11,6,7,8,13,11,11,3,1,2,2,3,3,1,3,1,3,4
"6091",2000010332,"Julio Brown","8/30/1996 (26 years old)","D (L)","Côte d´Or","Seychellois First Division","SEY","No","7/1/2020","-","$0","Left","Very Strong","Reasonable","5'9""","147 lbs","-","-",52,60,4,8,2,2,7,1,8,2,1,8,7,3,5,2,11,10,8,4,7,12,18,5,5,5,9,7,4,8,13,14,7,6,12,12,13,4,9,10,11,10,11,10,7,8,10,7,11,10,10,1,3,1,1,1,1,2,3,1,3,2
"6092",13187223,"Neil Confiance","8/12/1997 (25 years old)","M/AM (L)","St. Michel Utd","Seychellois First Division","SEY","No","6/15/2020","-","$0","Left","Very Strong","Reasonable","5'10""","149 lbs","-","-",51,60,5,9,12,7,8,5,1,5,5,5,7,3,6,7,11,5,1,7,6,11,6,10,7,11,2,6,4,7,13,12,6,4,11,12,7,2,14,20,11,11,12,11,13,2,7,2,12,10,14,4,1,3,3,1,1,3,2,2,2,1
"6093",13145158,"Rennick Esther","4/5/1987 (36 years old)","AM (C), ST (C)","Light Stars","Seychellois First Division","SEY","No","6/14/2021","-","$0","Right","Reasonable","Very Strong","5'9""","156 lbs","-","-",51,58,3,6,6,9,14,6,8,4,1,6,7,1,6,12,6,9,6,6,6,11,10,11,9,10,6,7,8,8,9,7,7,4,8,9,8,7,10,10,10,10,11,8,12,1,9,7,11,13,18,4,2,3,3,1,2,2,2,1,1,3
"6094",2000218364,"Danny Madeleine","11/17/1996 (26 years old)","D (L)","St. Louis Suns Utd","Seychellois First Division","SEY","No","7/1/2018","-","$0","Left","Very Strong","Reasonable","5'9""","154 lbs","-","-",52,57,4,9,2,1,6,1,6,1,5,6,6,1,10,4,6,7,8,4,8,9,15,8,4,5,6,6,4,7,13,13,5,7,12,13,12,8,11,14,12,14,10,10,9,1,11,3,10,8,11,3,3,1,3,2,2,3,3,3,1,1
"6095",13104243,"Damien Maria","5/18/1990 (33 years old)","D (C)","St. Louis Suns Utd","Seychellois First Division","SEY","No","6/14/2021","-","$0","Right","Strong","Very Strong","5'11""","158 lbs","-","-",51,55,2,3,1,3,5,1,13,2,1,13,6,2,11,1,6,10,7,6,7,13,4,5,9,5,7,5,5,6,11,8,6,5,8,8,3,3,10,20,10,8,10,12,13,3,6,2,18,10,10,3,3,3,3,1,2,3,3,2,2,1
"6096",2000039713,"Darrel Damoo","9/22/1989 (33 years old)","ST (C)","Lions LMS FC","Seychelles Second Division","SEY","No","6/14/2021","-","$0","Right","Reasonable","Very Strong","6'0""","163 lbs","-","-",50,55,4,3,9,12,12,4,12,5,1,4,3,7,1,7,5,9,6,12,5,12,16,8,7,12,5,4,5,5,10,9,4,6,12,6,9,4,10,13,10,14,10,10,6,8,7,6,10,9,7,3,2,2,1,3,2,3,1,3,3,1
"6097",23298186,"Aung Thu","5/22/1996 (27 years old)","AM (RLC)","Lamphun","Thai League","MYA","No","12/20/2022","6/30/2024","$0","Right","Reasonable","Very Strong","5'6""","121 lbs","119","28",89,97,9,7,13,13,11,4,7,6,3,4,8,11,7,12,7,11,9,12,10,11,15,14,5,11,6,10,10,11,13,13,6,7,12,12,12,7,12,18,10,16,11,11,10,11,7,4,13,15,13,1,1,3,2,1,3,3,3,2,1,1
"6098",97206110,"Hein Htet Aung","10/5/2001 (21 years old)","AM (RL)","Selangor","Malaysian Super League","MYA","No","1/1/2023","11/30/2024","$0 - $95K","Right","Reasonable","Very Strong","5'9""","149 lbs","62","8",72,90,7,12,7,10,13,7,3,8,7,7,11,1,5,8,9,6,4,5,8,9,6,13,6,12,7,8,9,9,14,11,8,6,11,10,10,4,12,13,14,6,12,14,5,2,6,17,11,9,8,1,3,2,3,1,3,1,2,2,2,2
"6099",2000250873,"Oakkar Naing","11/18/2003 (19 years old)","AM (L)","Yangon Utd","Myanmar National League","MYA","No","6/13/2022","12/31/2023","$4.5K - $14K","Left","Very Strong","Strong","5'5""","125 lbs","-","-",55,88,7,10,12,6,12,4,5,4,2,1,7,2,3,7,8,2,1,2,3,6,5,12,1,7,3,5,6,6,11,12,5,1,12,12,8,1,7,10,13,13,10,8,11,11,9,4,10,10,12,3,2,1,3,1,1,1,2,2,3,1
"6100",97206284,"Ye Min Thu","2/18/1998 (25 years old)","D (C)","Shan Utd","Myanmar National League","MYA","No","1/1/2019","12/31/2023","$0","Right","Reasonable","Very Strong","5'8""","149 lbs","18","-",59,86,2,1,1,2,7,1,13,1,4,7,7,1,8,3,9,6,8,7,7,11,5,5,3,4,13,6,3,7,14,14,7,2,9,14,8,7,11,12,13,12,11,9,12,12,11,8,18,10,19,2,3,3,1,1,1,2,2,3,3,2
"6101",2000085929,"Mzwandile Mabelesa","4/21/1993 (30 years old)","DM, M (C)","Royal Leopards","Premier League of Eswatini","SWZ","No","7/1/2019","6/30/2024","$50K - $150K","Right Only","Very Weak","Very Strong","5'11""","165 lbs","-","-",82,86,6,6,7,9,12,8,9,8,1,8,11,4,11,10,15,10,9,8,11,15,17,6,4,9,11,14,10,14,6,10,9,12,5,10,9,8,14,19,10,8,9,12,6,10,6,6,13,11,18,1,2,1,3,1,1,2,1,2,2,3
"6102",2000060644,"Ta Eh Doe","6/16/2001 (21 years old)","M/AM (L)","Napier City Rovers","New Zealand Central League","MYA","No","1/1/2022","-","$0","Left","Very Strong","Reasonable","5'8""","149 lbs","103","15",62,85,7,7,12,6,10,9,3,6,8,3,6,3,4,12,12,10,7,7,5,5,10,14,9,5,3,9,5,6,12,12,14,4,12,12,7,8,11,14,11,11,14,11,9,1,14,4,11,7,11,1,2,2,2,3,2,3,2,1,1,2
"6103",23197375,"Kaung Si Thu","1/22/1993 (30 years old)","ST (C)","Myawady","Myanmar National League","MYA","No","1/1/2022","12/31/2023","$0 - $1.5K","Right","Reasonable","Very Strong","5'9""","154 lbs","18","9",63,85,5,4,11,13,12,3,10,1,2,5,6,7,2,7,14,9,6,11,6,10,10,8,12,12,6,5,5,7,12,7,6,4,14,12,12,5,10,18,13,12,10,12,10,8,7,5,11,11,16,1,2,2,2,1,3,4,4,2,3,1
"6104",53141911,"Bawi Mang","2/5/2000 (23 years old)","M (L), AM (RLC)","Ottestad","Norwegian Fourth Division Indre Østland 1","MYA","Yes","2/2/2023","-","$0","Right Only","Weak","Very Strong","5'10""","143 lbs","78","23",68,84,9,9,13,8,12,9,3,7,2,3,8,9,2,14,6,5,8,9,5,5,10,17,3,10,4,10,8,9,12,15,8,7,15,12,9,5,8,13,13,11,7,10,8,10,6,5,10,11,6,1,2,3,1,1,3,3,2,1,3,4
"6105",23405003,"Maung Maung Lwin","6/18/1995 (27 years old)","M (R), AM (RL)","Lamphun","Thai League","MYA","No","12/21/2021","6/30/2024","$5K - $50K","Right","Reasonable","Very Strong","5'11""","154 lbs","60","15",77,84,7,11,13,10,12,7,5,6,7,7,9,6,3,14,7,9,8,9,7,9,10,13,8,10,7,8,9,9,9,11,8,6,10,13,14,4,14,16,13,13,12,12,11,4,9,4,11,10,11,3,1,3,1,1,2,2,2,2,2,2
"6106",23405021,"Aung Kaung Man","2/18/1998 (25 years old)","AM (C), ST (C)","Chonburi","Thai League","MYA","No","1/16/2023","6/30/2024","$18K - $55K","Right","Reasonable","Very Strong","5'9""","154 lbs","79","19",69,84,2,5,12,12,12,4,10,6,1,4,6,2,1,10,10,7,2,8,5,9,12,11,11,11,4,4,6,6,12,12,5,6,8,12,11,6,10,17,9,13,11,12,5,4,6,8,10,11,10,4,2,1,1,4,3,3,2,2,3,3
"6107",23197376,"Kyaw Ko Ko","12/20/1992 (30 years old)","AM (L), ST (C)","Shan Utd","Myanmar National League","MYA","No","1/7/2023","12/31/2024","$0","Right","Reasonable","Very Strong","5'9""","141 lbs","45","3",79,83,5,7,12,12,10,5,7,8,5,3,7,11,6,11,10,10,11,11,8,11,8,13,8,10,4,7,8,12,13,12,6,8,12,11,11,7,12,18,10,10,10,10,6,11,8,3,11,6,19,3,3,1,1,1,4,1,3,4,3,2
"6108",23197366,"Zaw Min Tun","5/20/1992 (31 years old)","D (C)","Penang","Malaysian Super League","MYA","No","12/30/2022","11/30/2024","Not for Sale","Right","Reasonable","Very Strong","6'0""","147 lbs","87","1",75,83,3,3,8,6,10,3,12,4,10,11,8,5,8,7,14,11,12,9,10,10,10,5,14,3,11,12,5,10,11,10,7,11,13,11,11,8,13,19,10,9,12,10,13,8,5,5,11,12,9,2,4,2,1,3,1,2,1,4,3,1
"6109",23197370,"David Htan","5/13/1990 (33 years old)","D (RL)","Yangon Utd","Myanmar National League","MYA","No","6/17/2022","12/31/2023","$0","Right","Reasonable","Very Strong","5'4""","121 lbs","18","-",69,83,6,14,2,6,8,4,9,7,8,10,7,5,15,9,15,7,6,9,11,11,9,7,13,6,9,9,9,9,12,10,9,1,11,13,13,1,11,12,13,10,10,11,15,17,8,6,8,13,15,2,2,2,3,1,2,1,3,2,2,3
"6110",23298220,"Yan Naing Oo","3/31/1996 (27 years old)","AM (RL)","Yangon Utd","Myanmar National League","MYA","No","7/2/2020","12/31/2023","$0 - $6K","Right","Reasonable","Very Strong","5'4""","121 lbs","18","1",67,81,7,10,5,11,6,5,5,6,1,3,11,4,7,9,11,5,5,5,4,9,12,9,13,8,5,6,9,10,13,13,6,1,13,13,11,1,18,20,13,11,13,9,7,7,7,4,9,10,16,3,1,3,2,3,1,2,3,4,1,3
"6111",2000217220,"Hein Zeyar Lin","12/8/2000 (22 years old)","D (C)","Yangon Utd","Myanmar National League","MYA","No","6/6/2022","12/31/2023","$0 - $14K","Right","Reasonable","Very Strong","6'0""","165 lbs","-","-",69,80,2,1,1,2,6,1,13,2,5,11,6,1,13,2,15,5,8,3,11,12,12,5,14,5,13,5,2,6,13,11,6,10,12,12,4,6,13,20,12,10,10,12,10,10,5,8,20,12,19,2,3,4,1,1,3,3,3,2,2,1
"6112",2000307873,"Siphosethu Mabilisa","9/18/2000 (22 years old)","D/WB (L)","Mbabane Swallows","Premier League of Eswatini","SWZ","No","11/4/2021","6/30/2025","$50K - $160K","Left Only","Very Strong","Very Weak","5'10""","154 lbs","23","-",80,93,6,11,8,5,9,2,9,3,8,9,10,4,14,10,13,6,10,10,6,15,16,5,12,8,6,8,7,6,12,13,9,5,10,13,10,6,13,13,10,11,10,10,8,4,7,4,13,10,11,1,3,1,3,3,2,1,3,2,3,1
"6113",2000309490,"Lungelo Simelane","4/3/2004 (19 years old)","M/AM (L)","Royal Leopards","Premier League of Eswatini","SWZ","No","12/19/2022","6/30/2025","$0 - $35K","Left","Very Strong","Reasonable","5'9""","136 lbs","-","-",64,86,7,11,8,7,9,4,3,4,3,2,6,1,7,11,5,7,7,6,2,5,15,11,7,7,5,7,5,12,13,10,13,8,16,13,10,2,11,18,10,13,14,10,11,9,9,7,11,10,15,3,2,1,1,3,1,1,1,2,2,3
"6114",2000018192,"Wai Lin Aung","7/30/1999 (23 years old)","DM, M (C)","Dagon","Myanmar National League","MYA","No","12/31/2020","12/31/2023","$0 - $9K","Right","Fairly Strong","Very Strong","6'5""","185 lbs","-","-",66,80,6,5,2,7,9,6,6,7,3,9,12,3,14,10,5,11,6,7,7,11,9,5,9,7,10,7,5,11,12,10,7,15,14,13,6,9,19,12,11,9,12,14,15,14,5,5,10,12,7,1,1,1,2,3,3,1,3,2,3,2
"6115",23197467,"Hlaing Bo Bo","7/8/1996 (26 years old)","M (C)","Yangon Utd","Myanmar National League","MYA","No","1/14/2023","12/31/2024","$500 - $6K","Right","Reasonable","Very Strong","5'7""","143 lbs","54","12",70,80,6,2,3,2,9,6,2,7,1,11,11,2,8,13,9,8,8,7,5,13,4,7,8,10,8,7,12,10,13,13,7,6,8,13,13,7,15,14,10,10,11,13,13,1,5,1,17,9,8,3,4,2,3,1,1,1,3,2,2,2
"6116",23219839,"Thu Rein Tun","6/14/2003 (19 years old)","ST (C)","ISPE","Myanmar National League","MYA","No","1/1/2022","12/31/2023","$0 - $2K","Right","Reasonable","Very Strong","5'9""","152 lbs","-","-",65,79,2,1,9,12,12,4,12,6,1,3,5,6,1,7,14,10,6,9,4,9,10,14,1,11,5,4,4,6,12,12,5,2,9,12,11,5,7,14,10,8,12,11,5,7,5,2,9,10,19,2,1,1,3,3,2,1,1,1,1,3
"6117",97206389,"Win Naing Tun","5/3/2000 (23 years old)","ST (C)","Borneo","Indonesian League One","MYA","No","5/26/2023","5/31/2024","$35K - $110K","Right","Reasonable","Very Strong","6'0""","165 lbs","15","10",68,79,5,3,8,13,11,5,13,4,1,4,7,10,1,9,12,9,7,14,6,9,15,11,12,11,3,6,7,6,13,12,6,5,13,9,4,8,11,20,12,11,10,10,8,14,9,3,9,11,19,1,2,2,3,3,3,3,3,2,1,4
"6118",1025951,"Lal Ceu Luai","6/20/1982 (40 years old)","AM (C)","Manaw Myay","Myanmarnese Lower Division","MYA","No","6/14/2021","12/31/2023","$0","Right","Reasonable","Very Strong","5'10""","160 lbs","-","-",59,79,7,7,5,10,10,5,1,10,2,7,11,5,8,13,8,8,5,9,8,15,13,11,13,9,6,9,11,12,6,6,3,9,13,6,7,5,12,12,9,11,9,10,9,15,12,2,17,11,15,1,1,2,1,3,2,1,2,2,3,3
"6119",23151387,"Soe Kyaw Kyaw","2/16/1991 (32 years old)","ST (C)","Hantharwady Utd","Myanmar National League","MYA","No","6/14/2021","12/31/2023","$0","Right","Reasonable","Very Strong","5'5""","127 lbs","-","-",55,77,6,4,12,14,11,6,14,7,1,6,7,9,2,11,11,8,3,10,4,12,13,10,12,10,7,6,5,7,9,9,7,4,12,8,10,1,7,18,12,11,11,11,15,5,6,7,8,12,11,1,2,2,3,1,1,3,1,4,3,3
"6120",23298228,"Kyaw Zin Lwin","5/4/1993 (30 years old)","D (R)","Shan Utd","Myanmar National League","MYA","No","6/14/2021","12/31/2023","$0 - $4K","Right","Weak","Very Strong","5'9""","149 lbs","17","-",67,77,5,10,2,1,10,1,7,3,5,7,7,5,12,5,13,9,7,6,6,14,4,5,12,4,6,5,2,7,14,11,7,5,13,11,11,6,11,20,12,13,11,11,6,4,7,2,8,9,16,1,1,3,1,1,1,2,3,1,3,2
"6121",97206109,"Pyae Phyo Aung","11/15/1999 (23 years old)","GK","Hantharwady Utd","Myanmar National League","MYA","No","1/1/2019","12/31/2025","$3K - $9K","Right","Weak","Very Strong","6'1""","167 lbs","-","-",61,77,1,1,2,3,1,3,1,3,2,1,8,3,3,1,11,7,10,4,6,12,8,2,12,2,8,5,4,4,10,14,4,8,8,9,3,4,11,13,11,9,14,10,9,6,11,3,9,12,11,7,6,12,11,6,5,9,5,7,6,12
"6122",23151369,"Hein Thiha Zaw","8/1/1995 (27 years old)","D (RL)","Shan Utd","Myanmar National League","MYA","No","6/15/2020","12/31/2023","$0","Left","Very Strong","Fairly Strong","5'3""","119 lbs","14","1",63,77,5,8,3,6,7,1,7,5,4,8,3,1,9,7,9,7,8,7,8,14,11,5,12,6,8,7,6,7,14,11,7,1,14,13,9,1,13,12,11,12,11,9,13,14,9,4,20,10,17,2,2,2,1,1,3,2,2,1,2,1
"6123",23197413,"Nanda Lin Kyaw Chit","6/27/1991 (31 years old)","AM (RL)","Chin Utd","Myanmarnese Lower Division","MYA","No","12/1/2019","12/31/2023","$0","Left","Very Strong","Fairly Strong","5'9""","149 lbs","22","10",57,76,6,10,6,11,9,5,5,4,5,5,8,6,6,5,6,7,7,9,6,9,8,5,13,8,5,7,7,10,11,13,6,3,13,12,5,3,12,11,10,8,11,10,13,6,9,3,10,11,20,2,2,2,2,2,1,1,1,2,3,2
"6124",2000309103,"Melusi Magagula","7/17/1999 (23 years old)","D/WB (R)","Mbabane Highlanders","Premier League of Eswatini","SWZ","No","7/1/2021","6/30/2025","$4K - $40K","Right Only","Weak","Very Strong","6'0""","141 lbs","-","-",76,86,7,13,8,1,14,2,8,3,3,10,9,5,13,9,11,9,7,6,10,9,7,5,13,6,8,9,6,9,12,15,9,12,15,15,11,9,12,16,12,9,11,11,5,3,6,1,20,9,16,2,3,1,1,2,1,3,3,1,2,1
"6125",23486517,"Htike Htike Aung","2/1/1995 (28 years old)","D (C)","Mahar Utd","Myanmar National League","MYA","No","1/1/2022","12/31/2023","$0","Right","Reasonable","Very Strong","5'6""","138 lbs","5","-",59,76,1,1,1,1,3,3,7,4,1,13,5,1,12,3,14,10,7,6,6,13,6,5,12,5,9,5,2,7,13,13,6,2,14,13,12,6,11,18,10,10,10,10,10,6,11,7,10,11,17,3,2,1,1,1,2,2,2,1,2,3
"6126",23405004,"Lar Din Maw Yar","8/6/1992 (30 years old)","M (C)","Hantharwady Utd","Myanmar National League","MYA","No","6/14/2021","12/31/2023","$0 - $4.5K","Right","Reasonable","Very Strong","5'8""","141 lbs","-","-",68,75,6,6,2,5,10,6,1,7,1,8,12,4,9,12,5,10,6,8,6,11,16,5,9,7,7,8,9,12,14,14,7,5,14,14,7,4,13,11,10,13,13,11,6,9,14,4,10,10,14,1,3,2,4,2,2,1,2,3,2,1
"6127",23197355,"Kyaw Zin Phyo","2/1/1994 (29 years old)","GK","Shan Utd","Myanmar National League","MYA","No","12/31/2020","12/31/2023","$0","Right","Fairly Strong","Very Strong","5'10""","138 lbs","20","-",64,74,2,1,1,3,3,5,1,3,3,2,10,4,3,1,11,12,6,6,8,13,13,1,1,2,8,6,5,5,10,9,6,4,18,11,3,4,12,19,14,9,12,11,7,13,8,1,9,11,13,9,10,13,9,3,8,13,5,5,6,9
"6128",2000216577,"Pyae Phyo Thu","10/21/2002 (20 years old)","GK","Yadanarbon","Myanmar National League","MYA","No","6/13/2022","12/31/2023","$4.5K - $14K","Right","Reasonable","Very Strong","6'2""","169 lbs","-","-",63,74,3,3,3,2,1,6,1,2,3,3,9,3,2,4,11,6,13,5,7,12,14,2,8,3,12,7,6,6,12,8,2,11,14,12,5,5,8,16,13,11,10,11,8,7,9,7,10,11,9,4,7,14,8,11,12,14,5,6,4,8
"6129",23197585,"Maung Maung Soe","8/6/1995 (27 years old)","AM (R)","Rakhine Utd","Myanmar National League","MYA","No","1/1/2023","12/31/2023","$0","Right","Reasonable","Very Strong","5'5""","130 lbs","6","1",60,74,5,10,6,7,12,4,4,6,1,2,8,3,5,10,13,7,6,4,4,7,6,11,11,6,4,6,5,11,12,12,5,1,13,12,8,4,14,18,12,11,11,13,6,13,7,6,10,12,10,2,3,1,1,2,3,1,2,1,1,2
"6130",5636803,"Thet Naing","12/20/1992 (30 years old)","ST (C)","Mahar Utd","Myanmar National League","MYA","No","6/14/2021","12/31/2023","$0","Right","Reasonable","Very Strong","5'7""","134 lbs","14","-",60,73,4,1,10,12,8,4,12,4,2,3,2,5,1,4,5,6,1,6,2,10,8,5,12,12,5,4,4,6,12,12,5,5,6,12,11,5,9,20,13,13,12,12,8,5,10,8,18,13,16,1,2,3,2,1,2,3,1,1,3,1
"6131",97206388,"Ye Yint Aung","2/26/1998 (25 years old)","D (C), DM","Hantharwady Utd","Myanmar National League","MYA","No","1/1/2021","12/31/2023","$0 - $5K","Right","Reasonable","Very Strong","5'10""","156 lbs","12","-",65,73,1,3,3,4,7,3,7,5,1,8,10,1,13,6,10,11,7,6,6,13,6,5,9,5,8,6,7,11,13,13,6,4,12,13,13,8,10,10,11,14,10,11,7,1,5,4,10,10,17,2,3,1,3,2,2,2,2,2,3,4
"6132",2000184515,"Thang Thang Vanuk","2/15/1999 (24 years old)","AM (RL), ST (C)","North Wellington","New Zealand Central League","MYA","No","12/31/2021","-","$0","Right","Weak","Very Strong","5'6""","138 lbs","-","-",59,73,7,6,7,8,7,7,8,8,4,3,5,1,5,9,14,6,8,6,5,6,17,14,5,10,3,7,8,9,14,11,13,2,13,13,11,6,10,19,13,10,11,11,7,10,12,8,14,11,10,3,2,3,4,3,3,2,2,2,1,2
"6133",23298170,"Kyaw Min Oo","5/16/1996 (27 years old)","DM, M (C)","PDRM","Malaysian Super League","MYA","No","2/8/2023","11/30/2024","$0 - $55K","Right","Reasonable","Very Strong","5'10""","149 lbs","14","1",61,73,5,2,2,6,11,5,5,5,2,7,7,5,10,6,9,8,7,7,7,7,10,5,4,6,12,7,12,12,13,13,6,6,9,13,9,4,10,15,11,11,12,10,5,10,5,7,17,10,11,4,2,2,4,1,2,3,1,2,3,2
"6134",23298204,"Than Paing","12/6/1996 (26 years old)","AM (C), ST (C)","Chiangmai Utd","Thai League Two","MYA","No","6/12/2023","6/30/2024","$0 - $100K","Right","Reasonable","Very Strong","5'11""","158 lbs","29","18",66,72,3,4,9,10,12,5,6,6,1,5,7,4,1,7,12,8,7,7,6,6,12,8,11,13,6,5,5,8,13,13,6,10,8,13,12,4,10,12,12,10,9,9,6,5,5,5,19,11,14,3,1,3,2,2,3,2,3,3,3,2
"6135",13117544,"Xolani Sikhondze","11/5/1994 (28 years old)","M/AM (C)","Green Mamba","Premier League of Eswatini","SWZ","No","10/28/2020","6/30/2024","$12K - $130K","Right Only","Weak","Very Strong","5'9""","149 lbs","15","1",79,85,6,6,9,13,14,7,6,6,1,7,12,5,7,10,15,8,4,9,8,14,8,9,7,9,8,8,13,12,14,12,8,5,15,13,7,7,13,15,13,12,11,11,5,11,10,1,20,13,14,1,3,1,3,3,2,1,3,3,3,3
"6136",23197379,"Soe Min Oo","3/8/1988 (35 years old)","AM (C)","Myawady","Myanmar National League","MYA","No","8/1/2022","12/31/2023","$0","Right","Reasonable","Very Strong","5'7""","145 lbs","4","48",50,72,4,6,4,9,12,2,6,6,6,6,8,2,5,7,5,10,7,8,8,13,6,8,4,12,8,7,9,8,10,9,3,7,7,8,10,4,9,12,8,13,12,9,10,16,11,4,16,10,15,1,1,3,3,1,3,1,1,1,1,2
"6137",23197363,"Thein Than Win","2/25/1991 (32 years old)","D/WB/M (L)","Dagon","Myanmar National League","MYA","No","9/1/2022","12/31/2023","$0","Left","Very Strong","Reasonable","5'5""","130 lbs","15","2",63,71,8,13,10,5,11,7,4,5,9,11,10,8,11,11,8,10,9,11,11,10,18,5,7,10,8,10,6,9,9,11,5,6,9,10,9,2,14,10,10,12,13,10,10,7,9,1,10,11,13,2,3,2,3,3,1,1,2,3,3,2
"6138",23197571,"Soe Min Naing","7/1/1990 (32 years old)","AM (R), ST (C)","Mahar Utd","Myanmar National League","MYA","No","1/1/2022","12/31/2023","$0","Right","Fairly Strong","Very Strong","5'7""","136 lbs","9","4",56,71,6,11,9,7,9,4,7,6,5,4,6,1,3,10,10,9,5,10,4,9,14,10,15,13,5,6,6,7,11,12,4,3,10,10,8,1,7,20,11,10,9,10,8,5,11,1,6,10,11,1,1,1,3,2,2,2,3,2,1,1
"6139",23486511,"Nyein Chan","2/1/1994 (29 years old)","D (C)","Ranong Utd","Thai League Three Southern Region","MYA","No","7/22/2022","6/30/2025","$3K - $28K","Right","Fairly Strong","Very Strong","5'7""","141 lbs","37","1",60,71,3,1,4,1,7,1,10,4,3,8,5,1,10,6,7,11,8,7,10,12,7,5,13,5,10,6,3,7,14,14,7,3,12,14,12,5,12,14,10,12,11,13,5,9,6,7,10,13,18,3,3,4,3,3,2,1,1,2,1,1
"6140",23197362,"Naing Lin Oo","6/15/1993 (29 years old)","DM","Port FC (MYA)","Myanmar National League Two","MYA","No","2/1/2023","-","$0","Right","Reasonable","Very Strong","5'5""","134 lbs","16","1",54,71,5,4,5,5,9,6,6,9,5,10,5,2,14,7,12,14,6,6,11,6,16,5,10,4,11,7,6,10,14,13,6,4,13,11,6,1,13,18,8,12,11,11,7,10,12,8,16,10,11,2,3,2,2,3,2,2,2,3,1,3
"6141",23298214,"Myo Ko Tun","3/9/1995 (28 years old)","DM, M (C)","Shan Utd","Myanmar National League","MYA","No","1/27/2023","12/31/2023","$0 - $4.5K","Right","Reasonable","Very Strong","5'6""","132 lbs","3","-",64,71,5,5,4,7,9,6,7,8,1,7,10,4,11,9,10,10,5,7,7,14,8,5,9,7,11,7,6,11,14,14,4,1,12,14,6,1,8,19,9,10,11,13,9,11,9,6,8,13,7,1,1,3,2,2,2,1,1,1,4,2
"6142",23486529,"Aung Naing Win","6/1/1997 (26 years old)","M (C)","Ayeyawady Utd","Myanmar National League","MYA","No","12/20/2019","12/31/2023","$1.5K - $4.5K","Right","Reasonable","Very Strong","5'9""","149 lbs","6","-",61,70,4,1,5,5,9,6,5,9,2,9,13,3,5,8,11,9,3,10,5,14,5,7,7,9,8,7,9,11,13,11,7,8,10,11,12,4,14,12,13,12,11,11,11,11,6,8,9,14,11,3,2,1,3,2,1,2,3,1,3,2
"6143",23486497,"Win Moe Kyaw","2/1/1997 (26 years old)","D (C)","Hantharwady Utd","Myanmar National League","MYA","No","1/1/2021","12/31/2023","$0","Right","Reasonable","Very Strong","5'8""","145 lbs","8","-",60,70,3,2,1,1,6,1,10,1,5,14,7,2,13,2,7,11,8,5,8,9,16,5,2,6,7,6,4,7,14,14,7,5,11,14,12,6,12,16,11,11,10,11,5,13,14,3,17,13,8,1,2,4,2,3,2,1,2,3,2,3
"6144",2000216862,"Nyein Chan Soe","4/12/1999 (24 years old)","DM, M/AM (C), ST (C)","Yadanarbon","Myanmar National League","MYA","No","6/15/2020","12/31/2023","$0","Right","Weak","Very Strong","5'10""","154 lbs","-","-",55,70,5,2,6,8,8,5,6,7,1,6,8,5,11,7,7,8,4,7,7,9,15,11,13,7,6,7,6,12,13,11,6,3,13,12,8,5,9,13,11,13,11,11,6,5,11,8,20,10,11,2,1,3,1,3,1,3,1,4,2,2
"6145",97206387,"Myat Kaung Khant","7/15/2000 (22 years old)","M/AM (C)","Shan Utd","Myanmar National League","MYA","No","8/1/2022","12/31/2023","$500 - $3.5K","Right","Weak","Very Strong","5'7""","136 lbs","21","5",57,70,4,4,7,9,10,3,1,13,1,6,8,4,5,8,14,4,5,6,6,9,15,9,11,11,5,7,13,10,14,11,7,3,13,13,5,3,11,11,10,12,9,10,9,12,5,7,9,10,15,2,1,3,2,3,2,1,2,1,2,2
"6146",2000088260,"Siboniso Mamba","2/24/1991 (32 years old)","D (C)","Young Buffaloes","Premier League of Eswatini","SWZ","No","6/14/2021","6/30/2024","$0 - $65K","Right Only","Very Weak","Very Strong","6'0""","167 lbs","101","5",80,85,4,3,3,5,10,2,10,5,2,15,10,5,15,8,10,10,8,7,11,9,7,5,13,8,14,8,8,10,11,10,9,8,8,10,6,10,14,13,10,9,13,10,5,6,7,2,13,9,18,3,3,2,2,3,3,3,2,1,1,3
"6147",23197465,"Zin Min Tun","6/12/1993 (30 years old)","WB/M/AM (L)","Hantharwady Utd","Myanmar National League","MYA","No","1/1/2023","12/31/2023","$1.5K - $4K","Left","Very Strong","Reasonable","5'5""","125 lbs","13","3",62,70,4,8,5,9,7,4,4,6,5,2,10,1,5,12,6,7,6,6,5,7,9,11,7,9,3,6,6,7,13,13,6,1,16,13,12,2,13,20,11,10,12,9,10,3,15,1,9,10,7,2,1,2,1,3,3,2,1,1,1,2
"6148",23197412,"Nanda Kyaw","9/3/1996 (26 years old)","D (LC)","Shan Utd","Myanmar National League","MYA","No","1/1/2019","12/31/2023","$0","Left","Very Strong","Reasonable","5'8""","143 lbs","21","2",64,70,4,8,1,1,6,1,10,2,2,10,5,5,12,4,9,12,7,7,8,9,7,5,14,5,12,6,6,7,14,14,7,4,15,14,6,5,11,20,13,10,8,12,8,1,7,6,8,12,11,2,3,1,1,3,3,1,4,3,3,2
"6149",2000217248,"Zaw Win Thein","3/1/2003 (20 years old)","AM (RLC)","Yangon Utd","Myanmar National League","MYA","No","6/13/2022","12/31/2023","$0 - $10K","Left","Very Strong","Weak","5'5""","127 lbs","-","-",56,69,2,5,9,8,9,1,4,4,1,5,7,3,3,7,11,9,3,7,4,11,13,7,6,7,6,7,8,11,13,13,6,4,10,13,5,1,9,17,12,9,12,11,6,16,12,5,8,11,16,2,3,1,3,1,2,3,1,2,3,1
"6150",2000219831,"Tun Nanda Oo","8/14/1999 (23 years old)","GK","Myawady","Myanmar National League","MYA","No","6/15/2020","12/31/2023","$0 - $2K","Right","Weak","Very Strong","6'4""","171 lbs","-","-",57,69,3,1,1,2,1,6,1,2,2,2,8,3,2,3,6,10,12,6,6,8,6,2,12,1,8,5,5,4,10,14,6,14,18,11,1,5,11,13,9,11,12,10,14,6,12,5,18,11,16,6,12,9,11,5,11,13,5,8,8,13
"6151",23298207,"Thiha Htet Aung","3/13/1996 (27 years old)","D (C)","Rakhine Utd","Myanmar National League","MYA","No","1/1/2023","12/31/2023","$0 - $1.5K","Right","Reasonable","Very Strong","6'0""","163 lbs","4","-",63,68,1,1,1,1,6,1,10,4,1,13,5,1,10,4,6,8,8,6,9,13,12,5,10,5,8,5,1,7,13,12,6,7,7,13,11,4,15,11,11,11,13,13,5,1,6,1,11,9,19,2,2,1,3,1,4,1,2,2,3,2
"6152",97206290,"Htet Phyo Wai","1/21/2000 (23 years old)","M/AM (R)","Shan Utd","Myanmar National League","MYA","No","1/19/2023","12/31/2023","$0 - $5K","Right","Weak","Very Strong","5'6""","134 lbs","10","2",58,68,6,11,9,6,9,5,4,6,3,4,8,2,1,8,12,7,7,6,5,12,15,8,7,11,2,7,4,10,13,12,6,2,10,12,5,2,12,12,13,10,10,9,6,5,12,3,16,10,9,2,2,2,1,1,1,1,2,2,2,3
"6153",72026307,"Alex Lee","1/15/1990 (33 years old)","D (RC)","FC Frederick","NPSL East Region","GUM","No","5/1/2019","-","$0","Right","Reasonable","Very Strong","5'10""","160 lbs","123","2",86,92,6,9,6,4,8,6,11,9,9,9,9,2,12,8,7,10,11,10,11,10,15,2,12,5,9,12,9,13,11,12,11,11,12,11,14,8,12,17,11,12,14,10,12,11,15,8,8,11,16,2,1,3,2,1,2,1,2,3,2,1
"6154",23192894,"Travis Nicklaw","12/21/1993 (29 years old)","D (C), DM","Chattanooga","United States Soccer Leagues Division One","GUM","No","1/15/2020","11/30/2023","$16K - $160K","Right","Reasonable","Very Strong","6'3""","185 lbs","54","6",82,90,2,3,5,5,8,3,7,3,6,13,5,9,13,6,11,5,8,3,8,13,14,5,7,5,11,6,5,8,12,7,9,14,13,12,9,12,20,13,10,12,11,10,14,6,8,6,11,12,8,1,2,1,2,1,1,3,2,2,3,2
"6155",2000101736,"Justin Lee","1/15/1990 (33 years old)","D (C), DM","Christos FC","USSL D2 - Chesapeake Division","GUM","No","4/1/2022","-","$0","Right","Reasonable","Very Strong","5'10""","160 lbs","-","-",68,71,1,5,4,3,8,6,11,3,1,9,11,4,14,7,15,13,8,8,8,14,15,5,5,6,8,6,7,8,10,9,7,7,11,9,8,7,10,16,13,12,13,11,9,2,13,1,10,13,7,1,3,3,1,1,1,1,1,4,2,1
"6156",23192909,"Jason Cunliffe","10/23/1983 (39 years old)","AM (C), ST (C)","BOG Strykers","Guamese Soccer League","GUM","No","7/1/2018","-","$0","Right","Reasonable","Very Strong","5'10""","160 lbs","-","-",52,70,7,8,7,15,8,6,7,9,3,6,9,7,3,6,9,9,7,11,6,14,4,6,13,13,8,8,9,9,7,7,7,10,14,6,7,6,9,17,9,8,10,9,7,3,9,6,15,12,11,1,3,3,3,2,1,2,1,3,4,2
"6157",2000088347,"Philani Mkhonto","4/4/1995 (28 years old)","M (C), AM (RLC)","Mbabane Highlanders","Premier League of Eswatini","SWZ","No","7/1/2020","6/30/2024","$5K - $50K","Right Only","Weak","Very Strong","5'9""","149 lbs","-","-",79,85,4,6,12,12,13,6,2,5,1,5,9,3,7,13,6,6,8,7,7,13,13,13,12,9,5,7,10,8,13,13,5,7,13,13,13,4,13,11,9,12,12,10,6,9,12,4,10,14,12,2,3,2,2,1,3,2,1,3,1,2
"6158",2000087577,"Shawn Aguigui","8/13/1996 (26 years old)","DM, M (C)","Vacaville Elite","United Premier Soccer League","GUM","No","6/15/2020","-","$0","Right","Reasonable","Very Strong","5'5""","127 lbs","-","-",60,70,3,4,3,4,11,5,5,8,1,10,12,1,12,7,6,8,7,5,4,12,16,5,9,6,11,6,9,11,13,13,6,1,13,13,10,1,11,20,11,11,11,10,7,3,12,8,7,12,13,2,2,2,1,1,3,2,2,1,3,1
"6159",2000142604,"Ali Masoud","10/6/2000 (22 years old)","M/AM (C)","Mlandege FC","Zanzibari Premier Division","ZAN","No","7/1/2019","6/30/2024","$0","Right","Weak","Very Strong","5'7""","138 lbs","-","-",57,89,6,2,11,7,13,6,6,14,4,8,12,4,8,8,6,8,7,8,6,11,10,12,9,10,8,7,14,10,10,7,11,4,14,8,6,2,14,20,12,8,11,12,12,11,11,2,13,11,17,2,1,2,3,4,1,1,3,3,3,3
"6160",2000146707,"Shehe Issa","12/27/2000 (22 years old)","ST (C)","Chuoni","Zanzibari Lower Divisions","ZAN","No","7/1/2019","-","$0","Right Only","Very Weak","Very Strong","5'11""","158 lbs","-","-",51,89,5,5,10,13,12,4,5,6,1,4,9,6,1,7,12,11,6,10,6,8,7,7,6,10,6,6,4,11,13,13,13,7,14,13,7,3,12,18,9,11,12,9,6,8,7,5,10,9,20,3,3,2,1,1,2,1,2,3,4,3
"6161",2000146406,"Khatibu Kombo","10/25/1999 (23 years old)","D (RC)","Coastal Union","Tanzanian Mainland Premier Division","ZAN","No","7/27/2022","6/30/2024","$0","Right","Weak","Very Strong","5'10""","154 lbs","-","-",53,89,4,9,6,2,7,2,8,3,1,14,7,1,13,6,8,7,8,5,8,9,7,5,4,3,9,6,3,6,10,12,7,4,16,11,8,7,8,17,11,8,12,10,11,6,15,5,12,11,14,2,1,1,2,2,3,1,3,1,3,3
"6162",2000142432,"Abubakar Mwadini","2/18/2000 (23 years old)","D (LC)","Mlandege FC","Zanzibari Premier Division","ZAN","No","5/1/2021","6/30/2023","$0","Left","Very Strong","Weak","5'11""","156 lbs","-","-",53,89,5,9,1,1,7,3,12,2,1,10,7,1,8,6,7,6,8,6,6,9,9,5,8,5,13,5,5,6,13,8,6,6,11,11,6,6,12,10,11,8,10,13,12,1,7,7,12,12,14,1,1,2,2,3,3,3,1,1,2,3
"6163",2000117016,"Abdulswamad Kassim","5/20/1996 (27 years old)","M/AM (C)","Coastal Union","Tanzanian Mainland Premier Division","ZAN","No","6/12/2023","6/30/2025","$0","Right","Fairly Strong","Very Strong","5'9""","143 lbs","74","9",83,88,3,6,10,11,10,9,7,11,7,4,10,11,3,11,12,12,10,10,11,10,15,7,12,11,5,8,8,13,11,12,10,7,13,12,11,10,12,12,13,9,9,9,13,12,8,2,7,14,12,1,3,3,1,1,2,1,3,2,2,3
"6164",2000143355,"Abdulkadir Khamis","11/29/1999 (23 years old)","D (C)","Black Sailors","Zanzibari Lower Divisions","ZAN","No","1/12/2023","6/30/2025","$0","Right","Weak","Very Strong","5'11""","149 lbs","-","-",50,86,1,2,1,2,7,1,10,2,1,10,6,1,7,5,15,6,8,6,4,7,10,5,1,5,10,5,4,6,13,13,6,10,13,13,5,6,12,13,11,11,11,11,10,13,5,5,8,14,8,3,1,2,2,2,2,3,3,2,1,2
"6165",2000142428,"Hamad Ubwa","6/12/2000 (22 years old)","GK","Mlandege FC","Zanzibari Premier Division","ZAN","No","7/1/2020","6/30/2024","$0","Right","Weak","Very Strong","5'10""","154 lbs","-","-",50,86,2,1,3,3,1,7,1,3,3,2,10,3,2,1,7,9,11,3,7,12,8,1,10,2,7,5,4,4,9,14,5,5,6,8,1,4,9,19,8,8,8,12,7,13,10,3,8,11,8,7,5,11,13,8,4,10,13,9,7,7
"6166",2000115536,"Hassan Maulid","12/14/1994 (28 years old)","DM, M/AM (C)","Mbeya City","Tanzanian Championship","ZAN","No","7/7/2022","6/30/2024","$0","Right","Reasonable","Very Strong","6'1""","158 lbs","58","2",77,86,9,9,10,7,11,10,10,10,4,8,12,9,6,14,9,10,11,10,11,12,13,13,7,9,8,10,11,8,9,10,9,14,13,8,10,7,15,18,11,10,12,11,14,10,13,7,12,9,16,3,1,1,2,1,3,1,3,3,1,1
"6167",2000146688,"Mussa Othuman","7/26/2000 (22 years old)","D (C)","Chuoni","Zanzibari Lower Divisions","ZAN","No","7/1/2019","-","$0","Right","Weak","Very Strong","5'11""","158 lbs","-","-",50,86,2,1,2,5,6,1,10,2,1,13,6,1,11,2,9,13,5,4,4,11,13,5,9,4,12,5,1,6,8,10,6,8,10,9,5,6,12,15,10,10,9,12,9,3,5,6,14,12,18,2,3,2,1,1,3,2,3,2,2,1
"6168",2000241861,"Peter Dlamini","3/25/1997 (26 years old)","D (C)","Mbabane Highlanders","Premier League of Eswatini","SWZ","No","7/1/2018","6/30/2025","$0","Right","Fairly Strong","Very Strong","5'11""","165 lbs","-","-",78,85,2,1,1,3,7,1,9,1,4,13,7,1,11,4,12,13,9,7,12,13,2,5,12,6,13,6,3,7,11,11,7,8,15,10,12,8,20,16,9,11,11,12,5,9,8,1,9,9,18,3,4,3,2,3,2,1,3,3,3,3
"6169",29222299,"Matheo Simon","3/17/1995 (28 years old)","AM (C), ST (C)","KMC","Tanzanian Mainland Premier Division","ZAN","No","1/29/2021","6/30/2024","$0","Right","Reasonable","Very Strong","6'0""","165 lbs","70","20",80,85,6,7,12,9,12,6,13,6,4,6,8,3,5,7,11,8,8,8,7,12,10,14,7,9,6,7,4,8,13,13,4,5,15,13,13,6,11,13,12,9,10,13,6,10,14,1,10,12,9,3,2,2,3,3,2,3,3,3,1,1
"6170",2000115947,"Kassim Khamis","10/23/1995 (27 years old)","AM (RLC)","Ruvu Shooting","Tanzanian Championship","ZAN","No","7/1/2022","6/30/2025","$0","Right","Fairly Strong","Very Strong","5'10""","154 lbs","74","14",73,84,6,8,13,8,12,5,1,11,3,6,10,2,8,10,7,8,5,7,6,13,16,13,9,11,7,7,11,8,8,11,7,5,6,10,8,4,12,15,10,11,11,12,9,8,7,1,20,11,12,1,3,2,2,1,1,2,2,1,2,2
"6171",2000145576,"Dadi Mbarouk","11/29/1999 (23 years old)","M (RC), AM (C)","Polisi","Zanzibari Lower Divisions","ZAN","No","7/1/2018","6/30/2024","$0","Right","Weak","Very Strong","5'8""","145 lbs","-","-",50,82,4,6,13,6,10,5,5,7,3,5,10,3,6,12,13,9,7,7,3,12,2,13,5,8,6,7,10,9,12,8,13,4,14,8,6,2,11,17,11,12,11,11,12,6,8,7,9,10,13,2,1,2,3,2,3,3,1,1,4,1
"6172",2000115926,"Awadh Juma","5/2/1996 (27 years old)","M/AM (C)","Mbeya City","Tanzanian Championship","ZAN","No","7/1/2022","6/30/2024","$0","Right","Reasonable","Very Strong","5'9""","154 lbs","58","4",74,82,7,6,8,8,9,7,1,9,1,7,7,4,9,12,9,10,6,10,8,13,4,11,6,14,9,13,14,9,9,11,8,7,11,11,8,5,9,13,8,10,15,11,5,11,8,3,9,8,7,2,2,2,3,3,1,4,1,4,3,2
"6173",2000179478,"Rashid Ishaq","5/26/2000 (23 years old)","M (L), AM (RLC)","KVZ","Zanzibari Premier Division","ZAN","No","6/17/2022","6/30/2023","$0","Left Only","Very Strong","Very Weak","5'7""","134 lbs","51","8",62,78,4,9,12,9,15,3,6,9,7,7,11,3,8,12,15,9,8,9,7,10,3,10,11,9,7,8,6,9,9,12,8,6,11,12,5,3,9,18,12,13,11,11,13,13,11,7,10,13,8,2,1,3,2,1,1,1,2,4,2,3
"6174",2000139353,"Komanje Sandale","4/10/2002 (21 years old)","D (RC)","Tabora United","Tanzanian Mainland Premier Division","ZAN","No","7/1/2022","6/30/2025","$0","Right","Weak","Very Strong","5'10""","154 lbs","-","-",53,77,3,8,5,1,4,1,13,4,3,11,6,4,11,5,15,5,8,6,10,13,15,5,2,5,12,5,1,6,10,9,6,3,9,11,11,6,13,15,10,10,9,11,15,8,12,8,10,14,15,2,2,2,4,3,1,2,1,1,2,1
"6175",2000213630,"Idarous Seif","7/8/1998 (24 years old)","D (RC)","Coastal Union","Tanzanian Mainland Premier Division","ZAN","No","7/1/2022","6/30/2024","$0","Right Only","Very Weak","Very Strong","5'10""","154 lbs","19","-",64,76,3,8,1,2,7,1,12,4,5,11,6,2,9,3,5,8,8,5,5,13,9,5,4,5,8,6,1,7,13,13,6,7,12,13,12,6,20,18,10,10,10,10,13,11,10,3,10,11,13,2,2,2,2,3,3,2,3,3,2,3
"6176",2000142596,"Said Mwinyi","2/11/1999 (24 years old)","DM, M (RC)","Mlandege FC","Zanzibari Premier Division","ZAN","No","7/1/2020","6/30/2024","$0","Right","Weak","Very Strong","5'7""","138 lbs","-","-",53,76,5,7,4,5,11,5,5,4,3,6,11,4,11,11,8,5,5,6,7,11,15,5,8,7,7,6,7,11,13,13,6,5,8,13,12,1,13,20,12,11,11,10,9,5,9,5,12,13,19,3,3,2,2,1,3,1,2,1,3,2
"6177",2000137721,"Khalifa Zubeir","11/7/1998 (24 years old)","D (RC)","Mafunzo","Zanzibari Premier Division","ZAN","No","7/1/2020","6/30/2024","$0","Right","Weak","Very Strong","5'9""","154 lbs","-","-",50,75,4,9,2,1,7,4,7,2,1,8,6,4,9,3,5,10,8,5,6,6,11,5,5,4,8,5,4,7,13,13,6,7,13,13,12,6,11,12,10,11,10,11,9,13,5,6,11,12,10,1,1,1,1,2,3,2,3,1,3,3
"6178",2000138205,"Seif Said","2/3/1997 (26 years old)","M (R), AM (RC)","KVZ","Zanzibari Premier Division","ZAN","No","7/1/2020","6/30/2024","$0","Right","Reasonable","Very Strong","5'7""","143 lbs","-","-",63,75,5,8,6,7,13,5,5,7,5,5,12,1,6,9,10,6,5,4,6,5,12,10,5,9,4,7,5,11,13,13,13,2,6,13,6,2,10,14,9,11,10,12,11,1,7,5,11,10,12,1,4,1,3,1,1,1,2,1,3,1
"6179",2000085931,"Siboniso Ngwenya","5/3/1994 (29 years old)","DM, M (C)","Young Buffaloes","Premier League of Eswatini","SWZ","No","6/15/2020","6/30/2024","$4.5K - $45K","Right Only","Very Weak","Very Strong","5'8""","154 lbs","-","-",78,85,7,5,5,7,9,6,6,9,4,9,10,4,14,10,13,10,8,8,9,10,7,5,6,7,12,7,10,12,14,13,5,6,11,14,14,7,14,14,13,12,12,11,15,17,6,5,9,13,18,3,3,1,3,3,3,4,3,1,2,2
"6180",2000146558,"Mukrim Madai","12/25/1998 (24 years old)","D/WB/M (R)","KVZ","Zanzibari Premier Division","ZAN","No","8/16/2022","8/16/2024","$0","Right Only","Very Weak","Very Strong","5'8""","145 lbs","-","-",58,75,6,7,8,2,8,5,6,5,2,7,8,3,9,7,9,8,6,8,7,12,12,6,10,7,8,13,8,13,13,12,14,7,18,10,13,3,11,19,9,10,11,10,7,8,6,1,6,10,8,2,3,2,1,1,3,1,3,2,2,2
"6181",2000137732,"Kassim Ali","10/23/2000 (22 years old)","D/WB/M (L)","Mafunzo","Zanzibari Premier Division","ZAN","No","7/1/2018","6/30/2024","$0","Left","Very Strong","Reasonable","5'5""","132 lbs","-","-",64,75,7,9,8,6,9,7,6,2,6,9,9,4,12,9,10,8,8,8,9,10,9,6,5,8,4,14,9,14,13,12,10,1,14,10,10,2,17,10,12,13,8,12,12,13,7,1,11,12,19,1,4,2,2,2,2,2,3,4,2,3
"6182",2000146598,"Mohamed Suleiman","10/31/1999 (23 years old)","AM (RL), ST (C)","Black Sailors","Zanzibari Lower Divisions","ZAN","No","7/1/2020","6/30/2024","$0","Right","Weak","Very Strong","5'10""","145 lbs","-","-",50,75,4,6,11,12,10,4,5,3,1,3,9,3,2,5,7,8,4,8,5,9,6,11,8,7,3,4,3,6,12,12,3,7,6,12,3,5,9,13,12,10,12,11,6,9,7,7,10,10,15,3,1,2,3,2,4,3,3,3,1,2
"6183",2000138036,"Seleman Mwalimu","12/7/1998 (24 years old)","DM, M (C)","Fountain Gate Academy","Tanzanian Championship","ZAN","No","7/1/2021","6/30/2023","$0","Right","Reasonable","Very Strong","5'10""","154 lbs","-","-",62,74,5,2,5,5,6,5,4,9,1,7,10,3,12,8,11,8,4,7,7,13,4,5,3,4,11,6,6,11,13,13,6,7,10,13,13,4,15,14,11,8,10,11,13,4,13,6,11,12,20,1,2,2,1,2,1,1,3,3,1,2
"6184",2000137806,"Mussa Said","6/15/1995 (27 years old)","D (C)","Coastal Union","Tanzanian Mainland Premier Division","ZAN","No","7/1/2021","6/30/2023","$0","Right Only","Very Weak","Very Strong","5'11""","154 lbs","70","1",67,74,2,1,1,4,5,1,13,3,1,12,5,5,12,3,9,11,8,3,5,12,19,5,4,2,12,5,1,6,12,12,5,8,15,13,11,6,9,20,10,10,10,8,8,16,12,5,8,11,16,2,2,2,3,3,1,3,2,2,3,3
"6185",2000137729,"Abdul-Aziz Khatib","5/1/1998 (25 years old)","D/WB (R)","Mafunzo","Zanzibari Premier Division","ZAN","No","7/1/2020","6/30/2024","$0","Right","Reasonable","Very Strong","5'3""","123 lbs","-","-",61,73,4,11,2,1,9,1,8,5,2,9,5,3,11,6,13,7,9,7,11,8,6,5,13,6,7,8,8,8,14,14,8,1,13,13,12,3,11,13,11,12,10,9,7,3,5,8,8,13,8,1,2,1,2,3,1,2,2,1,2,2
"6186",2000138223,"Mohamed Dolla","12/15/1998 (24 years old)","AM (C), ST (C)","KVZ","Zanzibari Premier Division","ZAN","No","7/1/2019","6/30/2024","$0","Right","Weak","Very Strong","5'9""","143 lbs","-","-",54,73,4,5,10,12,11,4,6,6,1,4,8,6,4,12,5,6,6,8,7,11,14,13,5,6,5,5,6,10,12,12,7,4,14,12,12,1,10,13,11,12,10,10,12,9,10,4,8,11,19,3,3,1,3,3,2,2,2,1,1,1
"6187",2000121725,"Abdulhalim Humoud","3/13/1987 (36 years old)","DM, M/AM (C)","Fountain Gate Academy","Tanzanian Championship","ZAN","No","7/1/2021","6/30/2024","$0","Right","Reasonable","Very Strong","5'8""","149 lbs","-","-",69,73,3,6,4,13,14,7,7,6,5,10,12,7,15,11,9,8,8,6,9,9,4,11,11,9,10,9,14,12,6,5,4,4,12,7,7,7,12,19,10,10,9,12,7,12,15,4,8,11,15,2,3,1,1,3,1,2,1,4,3,1
"6188",2000142424,"Isihaka Hassan","4/2/1996 (27 years old)","GK","Mlandege FC","Zanzibari Premier Division","ZAN","No","6/15/2020","6/30/2024","$0","Right","Reasonable","Very Strong","5'11""","158 lbs","-","-",63,72,4,3,2,3,3,5,1,1,2,1,7,4,3,1,14,4,13,6,10,13,11,2,5,2,7,6,5,5,13,5,6,10,9,9,1,6,8,17,10,11,12,11,13,15,5,3,7,13,9,6,5,13,5,5,8,12,5,12,8,8
"6189",2000137720,"Muhammad Abdallah","12/17/1997 (25 years old)","D (C)","Mafunzo","Zanzibari Premier Division","ZAN","No","7/1/2020","6/30/2024","$0","Right","Weak","Very Strong","5'9""","160 lbs","-","-",56,72,1,1,1,1,5,1,4,2,3,11,5,1,12,4,11,10,7,4,7,12,4,5,6,4,12,4,1,6,12,12,5,4,14,12,11,6,11,15,11,9,12,12,10,7,15,3,11,11,12,1,1,3,1,1,3,1,3,1,2,3
"6190",13117543,"Banele Sikhondze","6/28/1996 (26 years old)","M (R), AM (RC)","Mbabane Swallows","Premier League of Eswatini","SWZ","No","7/1/2021","6/30/2024","$5K - $50K","Right","Reasonable","Very Strong","5'8""","141 lbs","8","-",80,85,8,11,11,10,12,6,3,8,5,5,6,2,6,7,12,6,3,10,7,12,14,11,10,9,6,7,9,12,13,13,7,4,17,13,13,4,12,19,13,12,10,12,9,13,10,7,17,12,16,2,1,3,3,2,4,4,3,2,2,1
"6191",2000115558,"Mohamed Mmanga","6/22/1992 (30 years old)","DM","Polisi Tanzania","Tanzanian Championship","ZAN","No","7/1/2019","6/30/2024","$0","Right","Reasonable","Very Strong","5'10""","163 lbs","38","1",65,71,1,5,1,4,8,5,6,7,1,6,8,1,12,7,12,10,7,4,9,11,16,5,11,4,9,7,4,12,13,13,6,5,11,11,8,10,10,14,10,10,9,14,13,11,5,4,9,12,9,3,3,4,1,1,1,1,2,1,1,2
"6192",2000142876,"Salum Hamis","7/14/1998 (24 years old)","D (C)","Green Warriors","Tanzanian Championship","ZAN","No","7/1/2019","6/30/2024","$0","Right","Weak","Very Strong","6'1""","158 lbs","-","-",55,71,4,6,3,2,4,2,9,4,1,7,5,3,13,7,12,9,9,7,9,6,8,5,15,5,15,7,7,8,9,7,8,11,15,9,9,6,9,14,10,8,13,9,10,6,7,8,9,11,10,3,1,1,2,3,3,1,3,1,1,3
"6193",2000137710,"Ali Badru","11/6/1995 (27 years old)","D (C)","Mafunzo","Zanzibari Premier Division","ZAN","No","7/1/2018","6/30/2024","$0","Right","Reasonable","Very Strong","5'11""","158 lbs","-","-",62,71,2,1,5,1,6,1,9,1,4,13,6,1,8,1,6,7,8,6,8,12,7,5,4,4,13,5,1,6,13,13,5,7,14,13,9,5,10,20,11,13,9,11,9,11,5,4,19,13,11,1,1,3,3,3,1,3,3,1,1,3
"6194",2000146670,"Mohamed Abdalla","4/25/1998 (25 years old)","M/AM (C)","Taifa Ya Jang'ombe","Zanzibari Lower Divisions","ZAN","No","7/1/2020","6/30/2024","$0","Right","Weak","Very Strong","5'5""","127 lbs","-","-",53,71,5,1,7,8,8,5,1,8,3,6,7,1,5,13,15,6,3,9,4,5,11,13,13,9,7,6,10,11,13,13,6,3,12,13,12,1,11,10,11,11,12,12,9,4,10,1,10,10,20,3,2,3,3,2,2,2,2,1,3,1
"6195",2000137766,"Abubakar Khamis","4/5/1999 (24 years old)","M/AM (C)","Mafunzo","Zanzibari Premier Division","ZAN","No","7/1/2018","6/30/2024","$0","Right","Weak","Very Strong","5'7""","138 lbs","-","-",54,70,4,2,4,9,8,4,4,7,2,5,8,4,6,7,11,7,6,8,4,12,8,8,3,8,6,5,8,8,12,11,5,4,14,11,12,1,13,19,11,10,9,11,7,7,10,2,8,11,17,2,2,2,2,2,3,2,3,1,3,3
"6196",2000139413,"Amour Janja","11/1/1986 (36 years old)","ST (C)","Malindi","Zanzibari Premier Division","ZAN","No","7/1/2019","6/30/2024","$0","Right","Reasonable","Very Strong","6'0""","154 lbs","-","-",60,70,6,4,4,14,14,6,8,5,6,4,7,9,1,11,6,11,5,10,7,10,2,12,4,13,4,3,2,7,9,9,7,7,14,6,8,9,10,10,10,12,12,15,10,7,11,2,20,13,17,1,3,1,1,3,4,1,2,2,1,4
"6197",2000146676,"Anuwar Faki","5/11/1999 (24 years old)","M (RC), AM (C)","Taifa Ya Jang'ombe","Zanzibari Lower Divisions","ZAN","No","7/1/2021","6/30/2024","$0","Right","Weak","Very Strong","5'9""","141 lbs","-","-",50,70,5,7,8,6,13,5,5,5,1,6,7,1,5,8,13,7,6,7,5,13,4,9,10,9,5,6,4,11,12,9,13,6,10,7,13,3,8,13,10,12,14,10,6,9,13,4,11,10,8,2,4,4,3,3,3,1,1,3,2,1
"6198",2000146559,"Ali Sagafu","9/12/2000 (22 years old)","D (RC)","Black Sailors","Zanzibari Lower Divisions","ZAN","No","2/6/2021","6/30/2024","$0","Right","Weak","Very Strong","5'9""","152 lbs","-","-",50,70,6,9,4,3,9,3,12,7,5,10,8,3,10,5,15,11,8,10,11,5,17,5,7,6,14,15,7,10,7,4,10,10,7,6,6,8,14,15,12,11,12,10,9,2,14,8,11,10,11,1,3,2,1,2,4,2,3,3,1,3
"6199",2000146553,"Mussa Ridhwan","12/30/1998 (24 years old)","D (C)","Black Sailors","Zanzibari Lower Divisions","ZAN","No","7/1/2020","6/30/2024","$0","Right","Weak","Very Strong","5'11""","154 lbs","-","-",50,70,2,2,1,1,3,1,8,4,1,11,5,1,11,2,14,5,6,5,8,12,14,5,13,2,6,4,1,5,12,12,5,6,12,12,8,5,13,14,14,12,10,13,15,17,14,5,20,10,20,2,1,3,2,4,3,2,1,4,2,2
"6200",2000146681,"Joshua Bosco","8/21/1999 (23 years old)","AM (RL), ST (C)","Taifa Ya Jang'ombe","Zanzibari Lower Divisions","ZAN","No","7/1/2020","6/30/2024","$0","Right","Weak","Very Strong","5'10""","154 lbs","-","-",50,70,6,10,13,10,8,5,9,2,1,5,12,3,1,6,11,7,1,6,3,9,6,6,11,9,4,5,5,7,13,10,6,5,12,13,3,4,10,20,13,13,11,12,9,8,5,7,10,11,16,3,1,1,3,1,2,1,1,2,1,4
"6201",13158443,"Sifiso Mabila","1/2/1986 (37 years old)","D (RC)","Mbabane Swallows","Premier League of Eswatini","SWZ","No","6/14/2021","6/30/2024","$0 - $2K","Right Only","Very Weak","Very Strong","5'11""","160 lbs","-","-",72,85,7,11,4,3,9,2,10,8,8,10,10,5,14,8,13,11,9,10,6,15,16,5,5,7,13,9,8,10,9,9,7,9,12,9,9,8,11,10,10,11,14,10,13,3,12,1,9,13,20,2,1,3,1,3,4,1,2,2,1,1
"6202",2000137279,"Nassor Abdullah","5/29/1991 (32 years old)","GK","KMKM","Zanzibari Premier Division","ZAN","No","7/1/2018","6/30/2024","$0","Right","Reasonable","Very Strong","5'9""","154 lbs","-","-",61,70,3,2,3,1,1,3,1,1,1,1,7,2,2,3,9,7,13,6,9,13,8,2,5,2,10,6,5,5,7,9,6,7,15,6,5,4,11,11,11,12,10,10,8,6,6,2,12,11,12,6,13,6,7,6,13,13,5,6,7,8
"6203",2000137772,"Ali Juma","2/27/1999 (24 years old)","AM (RL), ST (C)","Mafunzo","Zanzibari Premier Division","ZAN","No","7/1/2022","6/30/2024","$0","Right Only","Very Weak","Very Strong","6'0""","160 lbs","-","-",61,70,1,5,11,8,12,5,7,6,2,5,8,5,1,8,12,9,5,11,6,10,13,8,11,8,5,6,6,11,13,12,13,8,12,12,11,3,8,14,11,10,10,11,13,10,5,7,8,9,12,3,3,1,1,1,2,2,2,2,2,1
"6204",2000113261,"Alex Mwambisi","6/16/1988 (34 years old)","GK","Pan-African","Tanzanian Championship","ZAN","No","7/1/2021","6/30/2024","$0","Right Only","Weak","Very Strong","6'0""","158 lbs","18","-",62,70,2,3,2,2,1,6,1,3,2,3,10,3,2,3,12,9,12,6,8,13,3,2,13,3,9,6,5,2,10,14,6,7,17,10,4,4,10,14,9,11,13,12,13,6,10,4,8,12,15,9,6,8,6,8,10,13,5,5,7,9
"6205",2000142516,"Abdulhamid Juma","7/3/1999 (23 years old)","AM (C)","Mlandege FC","Zanzibari Premier Division","ZAN","No","7/1/2022","6/30/2024","$0","Right Only","Very Weak","Very Strong","5'9""","147 lbs","-","-",57,69,5,6,11,10,14,8,8,9,1,8,14,5,8,9,15,8,6,11,6,13,5,8,4,11,10,8,9,10,5,8,9,11,8,6,5,9,9,12,12,11,10,12,13,9,7,3,5,10,14,1,1,2,3,3,1,1,2,1,1,3
"6206",2000137768,"Ahmed Amour","10/31/1993 (29 years old)","AM (RLC)","Mafunzo","Zanzibari Premier Division","ZAN","No","7/1/2018","6/30/2024","$0","Right","Reasonable","Very Strong","5'4""","127 lbs","-","-",64,68,7,10,10,11,5,5,6,4,5,3,8,4,5,8,6,8,1,6,6,10,9,8,6,7,6,6,6,7,13,13,6,1,12,13,11,4,10,12,11,11,14,13,12,9,9,2,8,12,15,1,3,1,3,3,2,4,2,2,1,2
"6207",2000138222,"Said Salim","4/26/1993 (30 years old)","M/AM (RL)","KVZ","Zanzibari Premier Division","ZAN","No","7/1/2019","6/30/2024","$0","Right","Reasonable","Very Strong","5'7""","138 lbs","-","-",60,68,4,9,8,6,11,5,4,5,5,5,8,3,5,13,6,6,7,7,4,6,8,13,12,11,5,6,6,11,12,13,12,6,14,13,8,1,13,18,11,13,12,9,9,12,11,8,10,12,15,2,2,3,1,2,4,1,1,3,3,4
"6208",2000139370,"Nassor Azzan","1/2/2002 (21 years old)","D/WB (L)","Malindi","Zanzibari Premier Division","ZAN","No","7/1/2019","6/30/2024","$0","Left","Very Strong","Weak","5'7""","138 lbs","-","-",57,68,6,9,5,1,7,2,6,7,7,10,9,1,14,6,9,13,9,8,9,9,16,6,11,7,8,9,6,12,10,10,8,8,11,12,7,4,10,17,10,11,11,12,6,9,6,1,9,11,11,2,1,1,1,2,1,2,2,4,1,2
"6209",2000137758,"Hassan Abdallah","7/9/1993 (29 years old)","DM, M (RC)","Mafunzo","Zanzibari Premier Division","ZAN","No","7/1/2020","6/30/2024","$0","Right","Reasonable","Very Strong","5'6""","138 lbs","-","-",61,68,5,7,4,5,11,4,3,2,1,7,13,2,12,8,13,4,4,7,7,13,11,5,8,6,6,7,5,11,13,13,6,1,12,13,12,5,14,17,13,12,11,11,13,2,8,4,10,13,9,1,2,3,2,2,1,2,3,4,2,3
"6210",2000145550,"Shauri Suleiman","5/23/1998 (25 years old)","D (C)","Polisi","Zanzibari Lower Divisions","ZAN","No","7/1/2021","6/30/2024","$0","Right","Weak","Very Strong","5'11""","163 lbs","-","-",50,67,2,1,5,1,7,1,11,2,1,13,7,1,11,5,7,7,8,5,8,7,2,6,3,5,11,5,1,7,9,13,6,9,6,13,11,7,13,11,9,14,10,13,5,11,7,5,9,9,19,2,1,1,2,2,3,3,2,4,3,3
"6211",2000137775,"Abdulhalim Mabrouk","5/9/1998 (25 years old)","AM (LC), ST (C)","Mafunzo","Zanzibari Premier Division","ZAN","No","7/1/2020","6/30/2024","$0","Right","Weak","Very Strong","5'10""","147 lbs","-","-",58,67,4,7,10,14,6,6,8,10,3,6,5,7,2,10,13,8,7,6,7,7,4,15,1,9,7,8,5,12,14,12,11,6,14,11,9,3,8,11,10,10,10,10,13,2,5,1,11,9,10,2,2,3,3,1,2,2,3,2,3,3
"6212",2000291097,"Simanga Masangane","5/9/1997 (26 years old)","D (RL)","Royal Leopards","Premier League of Eswatini","SWZ","No","7/1/2022","6/30/2024","$22K - $65K","Right Only","Weak","Very Strong","5'9""","147 lbs","-","-",72,85,7,12,7,3,6,3,8,7,7,8,6,4,14,9,13,9,8,9,8,14,7,5,8,7,12,9,6,9,14,14,9,8,13,12,6,7,14,17,12,13,10,10,14,13,12,6,8,13,7,3,1,1,2,2,4,3,4,2,2,4
"6213",2000144453,"Seif Juma","10/30/1997 (25 years old)","AM (LC), ST (C)","Zimamoto","Zanzibari Premier Division","ZAN","No","7/1/2020","6/30/2024","$0","Right","Weak","Very Strong","5'9""","145 lbs","-","-",53,67,4,6,9,8,5,4,4,9,1,4,8,1,2,5,8,4,5,9,5,6,12,10,11,6,5,5,4,10,12,12,12,3,12,12,9,1,11,15,7,11,13,13,11,4,7,6,7,11,9,3,3,1,1,2,1,1,1,2,1,1
"6214",88024860,"Darcy Knight","2/18/2000 (23 years old)","D/WB/M/AM (R)","Onehunga-Mangere","New Zealand NRFL Championship","SAM","No","1/1/2019","-","$0","Right Only","Very Weak","Very Strong","6'4""","176 lbs","7","1",52,77,7,6,6,5,6,7,3,8,8,5,5,5,4,7,14,5,8,5,9,5,14,12,13,8,5,9,5,9,15,10,12,16,14,14,6,6,10,19,12,12,11,9,7,7,8,1,10,9,7,2,4,3,2,1,3,3,1,2,1,2
"6215",88029097,"Willie Sauiluma","7/12/2000 (22 years old)","D (L), M (LC)","Goulburn Valley Suns","National Premier Leagues - Victoria 3","SAM","No","6/1/2023","9/30/2023","$0","Left","Very Strong","Reasonable","5'11""","154 lbs","7","-",52,75,5,7,7,3,9,5,3,5,5,7,8,1,7,7,14,7,6,2,3,13,3,9,11,7,7,6,8,7,13,13,6,7,11,13,7,3,15,11,10,12,11,11,10,14,8,1,20,10,11,1,2,2,2,1,1,1,3,1,1,3
"6216",15090593,"Dauntae Mariner","1/25/2000 (23 years old)","ST (C)","Brisbane Strikers","Football Queensland Premier League","SAM","No","6/1/2023","9/30/2023","$0","Right","Reasonable","Very Strong","5'10""","154 lbs","49","4",65,70,5,2,13,10,13,5,13,4,3,5,6,3,1,8,13,6,1,5,4,11,12,8,1,9,4,5,6,6,13,11,6,6,15,12,8,7,11,17,11,10,10,10,9,8,12,3,9,10,20,3,1,3,3,2,4,2,4,1,2,3
"6217",88028407,"Fetuao Belcher","5/1/2003 (20 years old)","D (C)","Napier City Rovers","New Zealand Central League","SAM","No","1/1/2021","-","$0","Right","Reasonable","Very Strong","6'2""","171 lbs","32","1",58,68,3,5,1,1,7,1,12,4,1,10,7,4,9,2,5,7,8,7,9,11,11,5,8,6,11,6,6,7,11,14,7,10,11,13,11,5,13,20,13,11,12,12,13,4,7,6,16,10,17,1,3,3,1,1,1,3,1,3,2,2
"6218",88023530,"Faitalia Hamilton-Pama","5/17/1993 (30 years old)","D (C), DM","Western Springs","New Zealand Northern League","SAM","No","7/2/2021","-","$0","Right","Fairly Strong","Very Strong","6'2""","182 lbs","45","-",62,62,1,4,2,1,7,1,8,1,1,11,7,1,12,4,10,8,8,6,10,11,4,5,9,3,13,5,6,7,11,6,6,9,14,11,5,11,10,16,12,10,10,10,12,6,6,7,11,12,9,3,2,1,2,1,2,1,2,3,3,2
"6219",28097986,"Faiq Bolkiah","5/9/1998 (25 years old)","AM (RL)","Ratchaburi","Thai League","BRU","No","3/16/2023","6/30/2024","$50K - $500K","Right Only","Weak","Very Strong","5'10""","165 lbs","34","2",88,95,9,10,12,6,5,9,7,10,9,9,6,5,4,11,6,5,7,10,10,7,16,14,4,7,6,5,9,8,16,13,7,7,12,14,13,5,13,14,11,10,12,12,10,14,5,3,3,12,15,2,3,1,1,2,1,1,4,1,2,1
"6220",23494370,"Muhd Hakeme Yazid Said","2/8/2003 (20 years old)","AM (L), ST (C)","DPMM","Singaporean Premier League","BRU","No","1/1/2023","11/30/2025","$18K - $170K","Right","Fairly Strong","Very Strong","5'8""","145 lbs","34","19",64,73,5,8,8,10,7,11,10,6,2,7,8,5,5,8,13,10,6,6,6,9,13,10,9,7,7,6,6,10,12,11,6,5,15,12,9,6,9,10,12,11,10,14,8,12,15,7,12,13,18,2,3,2,2,1,2,2,1,4,2,2
"6221",1015789,"Mohd Shah Razen Said","12/14/1985 (37 years old)","AM (C), ST (C)","Kasuka","Bruneian Super League","BRU","No","1/1/2023","12/31/2023","$0","Right","Weak","Very Strong","5'10""","156 lbs","163","38",57,72,7,7,8,12,12,7,7,7,1,7,5,4,8,15,6,8,8,10,8,11,2,13,10,14,7,8,8,9,9,6,8,9,17,9,7,7,11,18,9,10,7,9,12,13,11,8,9,11,8,3,2,1,2,1,2,2,1,2,1,3
"6222",1019242,"Mohd Helmi Zambin","3/30/1987 (36 years old)","M (R)","DPMM","Singaporean Premier League","BRU","No","1/1/2023","11/30/2024","$0 - $6K","Right","Weak","Very Strong","5'7""","138 lbs","187","6",53,69,6,10,8,6,9,7,5,8,2,7,7,1,5,13,6,9,6,10,8,12,16,7,6,8,4,9,7,13,10,10,8,5,13,7,10,3,10,16,14,12,11,14,7,9,10,3,9,11,8,3,3,2,1,1,1,1,1,1,1,1
"6223",2000085925,"Sandile Gamedze","12/3/1994 (28 years old)","AM (RL), ST (C)","Young Buffaloes","Premier League of Eswatini","SWZ","No","6/15/2020","6/30/2024","$80K - $230K","Right Only","Weak","Very Strong","5'9""","160 lbs","61","41",87,92,6,8,12,11,11,6,8,4,4,6,10,4,5,10,10,8,7,8,7,10,10,10,4,12,6,7,7,12,13,13,13,4,12,13,12,4,12,18,10,12,12,12,9,10,9,4,11,9,9,1,1,2,2,2,2,2,4,2,3,3
"6224",2000085924,"Muzi Tsabedze","9/23/1998 (24 years old)","ST (C)","Sea Birds","Premier League of Eswatini","SWZ","No","6/15/2020","6/30/2024","$0 - $90K","Right","Reasonable","Very Strong","6'1""","163 lbs","-","-",72,85,6,3,10,13,10,5,13,7,2,4,6,6,1,13,9,7,8,6,7,9,10,13,9,12,7,6,5,7,13,12,7,10,13,13,11,5,12,20,12,11,12,11,6,6,15,5,9,11,8,2,1,2,1,3,2,2,2,2,1,2
"6225",23223095,"Muhd Azwan Ali Rahman","1/11/1992 (31 years old)","AM (C)","DPMM","Singaporean Premier League","BRU","No","1/1/2023","11/30/2024","$2K - $20K","Right","Fairly Strong","Very Strong","5'5""","127 lbs","172","22",54,68,6,4,8,6,10,5,4,8,1,4,6,5,5,8,14,9,3,10,6,6,6,12,9,13,5,8,8,13,10,10,7,1,13,8,13,1,16,13,13,10,10,9,9,7,7,2,8,10,11,1,3,3,1,2,4,3,1,1,3,4
"6226",2000059223,"Muhd Hanif Farhan Azman","11/2/2000 (22 years old)","M (C)","DPMM","Singaporean Premier League","BRU","No","1/1/2023","11/30/2025","$5K - $50K","Right","Reasonable","Very Strong","5'10""","158 lbs","33","1",57,67,6,3,4,7,9,6,1,7,2,9,8,2,5,9,8,8,5,12,7,9,6,5,6,8,9,7,14,12,9,13,7,4,8,11,7,6,13,14,13,13,11,13,14,11,8,4,10,11,13,2,3,1,2,3,2,1,3,2,3,4
"6227",1038457,"Mohd Najib Tarif","2/5/1988 (35 years old)","M (L)","DPMM","Singaporean Premier League","BRU","No","1/1/2023","11/30/2024","$3K - $9K","Left","Very Strong","Reasonable","5'7""","143 lbs","123","1",58,66,8,11,7,9,13,7,3,9,7,6,8,6,6,10,9,11,5,8,9,10,11,5,15,8,7,9,7,14,5,11,9,5,5,9,11,3,14,10,12,12,10,11,13,1,8,4,11,11,15,1,2,1,2,2,1,1,1,3,2,2
"6228",23181641,"Adi Said","10/15/1990 (32 years old)","ST (C)","Kasuka","Bruneian Super League","BRU","No","11/30/2022","5/31/2024","$0","Right","Fairly Strong","Very Strong","6'0""","171 lbs","132","34",61,66,6,4,7,13,6,5,13,6,1,5,6,4,1,9,6,11,5,8,7,14,7,10,13,14,5,6,6,8,11,8,7,9,7,8,8,6,7,11,12,14,12,10,9,3,6,1,17,13,15,3,1,4,1,3,3,2,1,1,1,1
"6229",23181616,"Mohd Fakharrazi Hassan","7/15/1989 (33 years old)","D/M (R)","DPMM","Singaporean Premier League","BRU","No","1/1/2023","11/30/2024","$0 - $20K","Left","Very Strong","Reasonable","5'6""","134 lbs","84","4",54,66,8,10,9,6,8,8,6,6,1,9,7,5,10,10,8,9,8,10,9,9,13,5,13,9,10,9,10,10,9,11,5,3,11,9,13,3,9,18,10,11,12,12,8,6,8,6,19,10,17,3,2,3,1,2,2,1,1,3,2,4
"6230",23045429,"Mohd Hanafizal Helman Hanafiah","6/30/1986 (36 years old)","M (R)","Najip-BAKES","Bruneian Super League","BRU","No","6/14/2021","12/31/2023","$0","Right","Reasonable","Very Strong","5'7""","141 lbs","12","1",51,65,8,11,6,7,8,8,8,8,8,6,9,2,9,10,11,10,5,11,8,11,15,5,12,9,8,9,9,14,11,9,7,5,12,6,10,3,12,11,13,11,10,10,5,6,6,4,10,10,14,1,2,2,2,1,2,3,1,3,1,2
"6231",23342389,"Muhd Haimie Nyaring","5/31/1998 (25 years old)","GK","DPMM","Singaporean Premier League","BRU","No","1/1/2023","11/30/2024","$6K - $18K","Right Only","Weak","Very Strong","5'8""","145 lbs","40","-",50,63,4,1,3,1,1,6,1,3,1,1,6,3,1,1,11,6,9,5,6,12,18,2,7,1,9,5,2,4,10,10,5,1,14,9,4,4,8,19,12,11,9,8,12,9,7,8,20,10,10,3,10,9,10,7,6,12,5,12,5,7
"6232",23342656,"Hanif Hamir","2/22/1997 (26 years old)","D (C)","DPMM","Singaporean Premier League","BRU","No","1/1/2021","11/30/2024","$0 - $75K","Right","Weak","Very Strong","6'0""","163 lbs","52","1",53,63,1,2,1,2,3,1,13,1,1,13,5,1,8,4,15,8,8,6,6,7,8,5,14,5,5,5,3,6,13,13,6,6,10,12,9,5,11,16,11,11,13,12,9,6,9,5,10,11,13,2,1,2,1,3,3,1,3,1,3,1
"6233",23342646,"Abang Hazim Abang Hadzman","3/19/1995 (28 years old)","AM (R)","Tabuan Muda","Bruneian Lower Division","BRU","No","6/15/2020","12/31/2023","$0","Right","Weak","Very Strong","5'9""","145 lbs","-","-",55,62,5,8,12,4,12,3,1,5,4,3,4,1,2,9,13,7,4,5,3,11,9,10,12,10,4,5,5,10,12,12,5,6,9,12,11,2,10,19,11,11,12,12,13,9,5,4,9,11,7,2,3,3,2,3,4,3,2,3,1,2
"6234",23342586,"Abdul Azizi Ali Rahman","1/17/1987 (36 years old)","ST (C)","DPMM","Singaporean Premier League","BRU","No","1/1/2023","11/30/2024","$0 - $8K","Right","Fairly Strong","Very Strong","5'7""","145 lbs","61","11",54,61,1,3,9,14,8,2,8,7,2,5,7,10,5,10,11,13,4,12,6,11,13,12,13,14,6,6,4,7,9,9,4,3,9,9,7,5,7,14,11,10,11,13,6,15,8,6,10,12,19,2,2,1,3,1,1,3,2,1,3,3
"6235",2000309068,"Siyabonga Mkhonto","8/31/2001 (21 years old)","M (RC), AM (C)","Mbabane Highlanders","Premier League of Eswatini","SWZ","No","7/1/2022","6/30/2025","$0 - $80K","Right","Fairly Strong","Very Strong","5'8""","134 lbs","7","-",64,85,6,8,8,11,14,6,6,7,5,7,10,5,6,9,5,6,2,6,3,8,11,8,6,8,4,8,8,13,13,10,7,6,11,11,8,4,14,10,11,11,13,13,5,1,13,8,10,13,14,2,3,2,4,1,3,1,4,2,3,2
"6236",23320330,"Yura Indera Putera Yunos","3/25/1996 (27 years old)","D (C), DM","DPMM","Singaporean Premier League","BRU","No","1/1/2023","11/30/2024","$0 - $75K","Right","Reasonable","Very Strong","6'0""","165 lbs","100","3",55,61,5,5,2,1,9,3,8,6,3,6,3,1,11,6,6,10,8,7,8,9,1,5,9,5,12,5,6,3,13,13,6,9,10,12,9,6,12,12,11,13,11,10,10,8,5,5,9,14,18,1,2,3,1,3,2,1,3,4,2,1
"6237",23342550,"Kamarul Ariffin Zaini","4/24/1996 (27 years old)","AM (R), ST (C)","Najip-BAKES","Bruneian Super League","BRU","No","1/1/2023","12/31/2023","$0","Right","Reasonable","Very Strong","5'7""","143 lbs","-","-",56,60,4,5,12,11,10,1,10,1,2,3,9,5,4,7,5,8,2,5,4,8,4,8,3,9,5,4,5,6,12,12,5,5,9,12,11,5,9,10,12,10,13,11,10,10,13,4,8,12,12,1,1,1,1,1,2,3,1,4,1,2
"6238",23342660,"Muhd Hanif Omar Ali","5/31/1995 (28 years old)","D (C)","Wijaya","Bruneian Super League","BRU","No","6/15/2020","12/31/2023","$0","Right","Reasonable","Very Strong","6'3""","176 lbs","-","-",58,60,3,1,3,3,5,1,7,2,1,13,4,1,13,4,14,8,8,5,8,13,16,6,3,5,9,3,1,6,12,9,6,11,12,11,11,7,9,18,10,13,10,10,8,1,7,4,15,10,7,2,2,1,3,1,3,3,1,3,3,1
"6239",23342653,"Mafazi Helmi Mohamad","7/31/1996 (26 years old)","AM (C)","Tabuan Muda","Bruneian Lower Division","BRU","No","6/15/2020","12/31/2023","$0","Right","Weak","Very Strong","6'1""","160 lbs","-","-",50,59,2,4,7,9,9,4,4,6,1,4,4,2,4,8,10,7,1,6,5,12,12,9,9,8,5,6,5,11,11,12,5,6,8,12,12,2,13,13,12,13,11,13,6,5,10,8,17,11,12,3,1,3,1,2,1,1,3,1,1,3
"6240",23342662,"Sumardi Mastani","7/4/1979 (43 years old)","AM (C)","Wijaya","Bruneian Super League","BRU","No","6/14/2021","12/31/2024","$0","Right","Reasonable","Very Strong","5'7""","147 lbs","-","-",55,59,6,7,6,8,16,8,7,10,5,7,10,4,4,13,7,10,5,12,9,16,15,10,1,12,9,8,11,12,6,6,6,5,6,6,7,4,11,11,9,10,12,9,5,8,9,2,8,13,15,1,2,3,1,1,4,3,2,1,1,2
"6241",23342502,"Hazwan Hamzah","9/9/1991 (31 years old)","D (C)","Kasuka","Bruneian Super League","BRU","No","2/5/2023","5/31/2024","$0","Right","Reasonable","Very Strong","5'6""","138 lbs","25","-",55,59,5,2,5,5,9,1,9,5,1,14,5,2,16,6,6,12,9,8,7,11,13,5,5,7,11,8,8,9,11,10,9,2,6,12,10,3,13,16,10,12,10,8,8,7,5,8,10,13,13,2,1,3,1,3,3,2,4,2,2,3
"6242",23342645,"At-Tawwab Ali Rahman","1/5/1993 (30 years old)","D (L)","Indera","Bruneian Super League","BRU","No","1/1/2023","3/31/2024","$0","Left Only","Very Strong","Weak","5'11""","156 lbs","-","-",54,58,4,8,4,1,9,2,6,1,2,10,6,1,7,6,11,7,8,6,5,12,13,7,11,5,8,6,5,7,13,13,6,7,16,13,12,6,8,14,13,10,11,9,12,4,12,6,11,9,16,3,2,1,3,1,3,1,4,1,2,1
"6243",23342581,"Tommy Tony","7/18/1987 (35 years old)","M (L)","ABDB","Bruneian Super League","BRU","No","6/14/2021","12/31/2024","$0","Left","Very Strong","Reasonable","5'7""","138 lbs","-","-",57,58,7,11,11,5,8,7,7,8,4,7,7,4,7,9,9,9,7,13,7,14,7,5,5,8,7,8,10,13,10,9,8,4,11,9,10,3,10,13,10,11,13,13,10,10,7,7,9,12,20,3,1,1,3,3,1,1,3,1,1,3
"6244",23342673,"Yazrul Azwin Yusrin","8/11/1997 (25 years old)","GK","Wijaya","Bruneian Super League","BRU","No","6/15/2020","12/31/2024","$0","Right","Reasonable","Very Strong","6'4""","180 lbs","-","-",53,58,3,2,3,1,1,7,1,2,2,2,7,2,1,2,14,6,13,5,7,12,16,1,4,1,5,4,4,4,10,12,5,9,10,10,3,7,11,17,10,12,9,12,5,13,8,5,11,13,14,3,9,12,11,6,5,12,7,7,7,12
"6245",23342639,"Khairil Shahme Suhaimi","4/16/1993 (30 years old)","D (C)","Kasuka","Bruneian Super League","BRU","No","2/1/2023","5/31/2024","$0","Right","Reasonable","Very Strong","6'1""","169 lbs","-","-",54,58,1,2,1,1,6,1,6,5,1,9,7,3,11,5,9,8,8,6,6,10,19,5,13,5,8,5,4,7,13,13,6,12,16,13,11,9,15,13,12,8,13,11,9,6,8,5,11,11,7,3,1,3,3,2,3,3,1,1,2,1
"6246",13117541,"Mthunzi Mkhonto","6/28/1994 (28 years old)","AM (RLC), ST (C)","Green Mamba","Premier League of Eswatini","SWZ","No","6/15/2020","6/30/2024","$45K - $140K","Right Only","Very Weak","Very Strong","5'8""","143 lbs","-","-",78,85,4,7,13,13,9,6,7,8,2,6,5,7,2,13,14,8,5,4,7,10,12,13,7,11,4,7,9,8,13,13,7,2,13,13,11,4,9,13,12,8,10,12,5,6,6,1,20,12,18,3,1,1,3,3,4,3,1,1,3,2
"6247",23047402,"Abdul Aziz Tamit","9/7/1989 (33 years old)","D (C)","Kasuka","Bruneian Super League","BRU","No","2/1/2023","12/31/2023","$0","Right","Reasonable","Very Strong","5'11""","152 lbs","64","2",56,58,3,1,3,1,6,1,11,1,3,12,4,1,10,5,13,7,8,6,7,13,13,5,6,2,12,5,2,6,11,11,6,5,10,10,4,7,13,11,12,10,10,14,10,7,5,6,10,12,17,2,2,2,1,3,3,1,2,4,3,1
"6248",23342674,"Mohd Jalani Tuah","10/7/1980 (42 years old)","ST (C)","Wijaya","Bruneian Super League","BRU","No","6/14/2021","12/31/2024","$0","Right","Reasonable","Very Strong","5'8""","147 lbs","-","-",51,56,7,6,5,15,9,5,12,8,2,5,8,5,2,10,5,8,8,9,8,15,9,8,13,12,6,7,8,8,5,5,5,4,14,5,5,5,8,16,12,10,11,10,6,4,11,3,10,14,16,3,3,2,4,1,1,2,1,3,1,2
"6249",23342349,"Haziq Kasyful Azim Mohd Hasimulabillah","12/24/1998 (24 years old)","M (C)","Kasuka","Bruneian Super League","BRU","No","11/30/2022","5/31/2024","$0","Right","Reasonable","Very Strong","5'8""","143 lbs","-","-",50,55,4,1,3,3,6,5,1,6,5,8,12,1,6,5,15,5,5,5,6,11,8,8,8,10,5,7,10,12,7,12,6,5,15,12,13,5,11,17,14,13,12,11,10,4,15,8,6,12,18,1,1,1,2,2,3,1,3,2,3,2
"6250",1037658,"Anaqi Sufi Omar Baki","7/22/1990 (32 years old)","AM (C), ST (C)","Wijaya","Bruneian Super League","BRU","No","6/14/2021","12/31/2023","$0","Right Only","Weak","Very Strong","5'9""","158 lbs","-","-",53,55,5,6,9,8,7,12,7,7,2,4,10,7,5,9,5,8,6,12,7,12,4,8,4,12,7,7,8,8,12,8,7,8,15,9,5,11,10,13,13,9,8,12,13,18,7,5,9,10,17,1,2,3,3,2,2,2,2,1,3,1
"6251",2000064016,"Jerry Wiltshire","2/4/1996 (27 years old)","D/WB (R)","Hayes & Yeading","English Southern League Premier South","VGB","No","7/1/2022","6/30/2024","$0 - $35K","Right","Weak","Very Strong","6'4""","185 lbs","75","5",65,72,5,8,7,4,9,5,10,6,11,8,6,5,11,8,15,10,6,5,12,7,4,4,11,6,11,6,7,9,11,10,11,16,9,11,10,12,9,14,11,12,13,12,7,6,12,6,7,11,11,2,3,1,1,1,1,1,1,1,4,1
"6252",2000097322,"Charley McMillan López","3/27/1996 (27 years old)","M (R), AM (RL), ST (C)","College '75","Gibraltar Football League","VGB","No","1/20/2023","6/30/2023","$0","Right","Fairly Strong","Very Strong","5'9""","156 lbs","2","-",50,70,5,5,7,8,9,5,7,5,5,5,7,2,3,4,15,8,10,5,7,10,14,5,13,7,5,12,2,12,9,10,13,6,10,10,10,11,8,20,11,11,10,11,7,9,13,1,10,13,7,2,2,2,2,3,2,2,1,2,1,3
"6253",82050239,"Troy Caesar","5/13/1994 (29 years old)","D (C), DM, M (C)","Islanders FC","BVI Premier League","VGB","No","5/1/2022","-","$0","Left","Very Strong","Weak","6'2""","167 lbs","27","2",56,70,3,2,5,2,8,5,3,6,4,9,8,1,13,7,6,10,5,6,6,8,16,5,15,6,10,6,4,7,13,13,6,7,14,13,12,5,12,15,12,11,12,10,15,2,8,8,9,12,12,3,1,3,3,1,1,2,1,1,3,3
"6254",2000094763,"Luca Reich","7/29/2003 (19 years old)","M (C)","Wolues","BVI Premier League","VGB","No","6/13/2022","-","$0","Right","Weak","Very Strong","6'1""","171 lbs","15","-",50,70,8,8,5,9,7,7,8,8,7,10,10,2,8,8,12,10,3,7,8,12,3,9,14,9,5,9,10,10,10,10,9,14,5,10,10,6,13,20,9,10,10,11,8,1,5,5,20,11,17,3,1,2,2,1,3,1,1,2,4,3
"6255",2000100560,"William Butler","6/4/2004 (19 years old)","GK","Poole","English Southern League Premier South","VGB","No","7/1/2021","6/30/2024","$0 - $8K","Right","Weak","Very Strong","6'0""","154 lbs","9","-",50,69,1,1,1,2,1,5,1,2,1,3,5,2,2,5,5,9,6,7,6,10,12,1,8,2,8,7,6,6,8,8,7,9,14,8,5,3,7,13,12,10,9,9,10,2,11,8,7,13,11,7,11,14,7,9,6,12,5,8,14,12
"6256",2000094798,"Daniel Gilford","3/3/2001 (22 years old)","GK","Virgin Gorda","BVI Premier League","VGB","No","6/15/2020","-","$0","Right","Reasonable","Very Strong","6'1""","165 lbs","-","-",50,65,3,2,2,2,3,5,1,3,2,3,3,2,1,1,9,7,8,5,7,12,13,1,13,1,7,5,4,4,6,9,5,9,13,6,1,3,12,15,11,12,11,12,15,5,5,8,10,9,11,5,12,12,12,5,8,12,5,8,7,8
"6257",2000241862,"Bongwa Matsebula","11/27/1997 (25 years old)","AM (RLC)","Young Buffaloes","Premier League of Eswatini","SWZ","No","7/1/2020","6/30/2024","$0 - $90K","Right Only","Weak","Very Strong","5'9""","138 lbs","23","7",76,84,8,12,9,12,14,7,7,9,2,4,12,1,8,10,6,11,8,5,8,13,4,9,12,11,7,8,8,9,13,12,8,8,6,14,5,6,9,12,9,10,11,12,8,2,8,2,9,10,20,3,3,3,2,1,1,2,3,3,1,2
"6258",2000094719,"Phillip Nelson","4/14/1988 (35 years old)","D/WB/M (L)","Wolues","BVI Premier League","VGB","No","6/14/2021","-","$0","Left","Very Strong","Weak","5'5""","127 lbs","19","10",59,65,8,9,5,3,8,5,8,3,8,10,9,3,10,9,7,10,8,10,10,13,1,6,10,9,10,9,8,10,5,10,9,2,12,10,12,1,14,10,12,11,13,12,6,1,10,7,10,9,11,2,1,4,3,1,1,2,1,4,2,1
"6259",2000094284,"Ikyjah Williams","4/14/2003 (20 years old)","D/WB/M (R)","Rebels (VGB)","BVI Premier League","VGB","No","1/1/2020","-","$0","Right","Reasonable","Very Strong","6'2""","171 lbs","-","-",50,65,6,11,8,4,10,2,6,6,6,7,6,1,7,9,12,10,3,4,6,9,12,5,1,7,6,7,5,8,12,9,7,13,9,11,9,5,9,12,11,11,13,11,13,7,14,6,20,11,14,2,1,3,3,3,3,2,3,1,1,2
"6260",2000094752,"Noel Maxwell","11/19/1997 (25 years old)","ST (C)","Wolues","BVI Premier League","VGB","No","6/15/2020","-","$0","Right","Weak","Very Strong","6'1""","176 lbs","15","10",54,62,4,3,8,6,9,4,10,2,1,3,5,4,2,7,13,12,1,11,4,8,10,8,10,8,5,4,4,5,12,12,5,8,9,12,7,9,8,13,12,11,11,11,8,6,11,1,8,12,9,1,2,3,3,3,2,1,1,2,1,1
"6261",2000094289,"Giovanni Grant","12/28/2002 (20 years old)","D (RC)","Old Madrid","BVI Premier League","VGB","No","1/1/2019","-","$0","Right","Weak","Very Strong","5'11""","158 lbs","-","-",50,62,4,7,1,5,6,1,7,3,6,14,3,5,9,5,13,8,8,7,7,12,9,6,9,5,8,6,4,7,6,10,7,10,12,11,4,6,8,18,13,10,10,10,8,12,8,3,8,10,10,3,2,1,4,2,1,4,1,3,1,3
"6262",82050241,"Carlos Septus","6/16/1991 (31 years old)","ST (C)","One Caribbean","BVI Premier League","VGB","No","1/1/2020","-","$0","Right","Reasonable","Very Strong","6'1""","165 lbs","-","-",56,60,5,2,6,9,14,5,10,8,2,2,6,4,1,11,5,11,7,8,7,10,6,10,14,12,7,6,6,8,10,6,7,8,13,9,11,4,11,14,12,12,13,9,9,13,6,7,19,11,9,3,4,2,1,1,3,2,1,2,2,1
"6263",82087827,"Richard Morgan","8/21/1991 (31 years old)","ST (C)","One Love","BVI Premier League","VGB","No","6/14/2021","-","$0","Right","Reasonable","Very Strong","5'11""","160 lbs","12","15",55,58,7,4,15,12,9,7,13,3,1,7,8,6,4,7,13,7,5,10,8,11,2,6,4,14,6,7,5,8,7,6,8,7,10,7,6,5,11,19,12,9,12,10,14,18,13,3,10,10,10,3,2,2,1,3,1,3,3,1,3,2
"6264",2000094794,"Justin Smith","8/12/2003 (19 years old)","DM, M (C)","One Love","BVI Premier League","VGB","No","1/1/2021","-","$0","Left","Very Strong","Reasonable","5'10""","149 lbs","-","-",50,58,6,6,6,4,8,6,6,5,1,5,9,2,8,12,5,5,7,6,7,14,6,5,2,7,4,8,8,12,8,11,7,4,13,11,7,5,9,15,12,12,14,11,10,14,14,4,7,10,19,3,3,2,3,2,1,2,1,2,3,3
"6265",2000094283,"Kristian Javier","4/6/1996 (27 years old)","D (R)","AC Commonwealth","United Premier Soccer League","VGB","No","1/1/2020","-","$0","Right Only","Weak","Very Strong","5'10""","160 lbs","3","-",55,56,3,7,1,1,6,2,6,3,4,6,6,2,6,3,8,6,8,6,6,11,13,5,12,5,8,6,6,7,13,13,6,7,7,13,12,7,14,10,13,12,9,9,7,10,11,6,10,11,10,1,3,3,1,2,1,3,1,1,1,3
"6266",2000094285,"Liam Blok","9/10/2001 (21 years old)","M/AM (C), ST (C)","Wolues","BVI Premier League","VGB","No","1/1/2022","-","$0","Right","Reasonable","Very Strong","6'3""","163 lbs","-","-",50,55,6,6,8,8,13,6,7,5,1,7,9,3,5,8,6,7,3,7,7,7,11,7,11,8,8,7,7,8,13,10,4,12,13,11,6,4,12,17,11,12,12,10,12,1,12,2,11,12,15,4,1,1,2,2,2,1,3,2,3,2
"6267",50059685,"Eddy Kaspard","5/27/2001 (22 years old)","M/AM (R)","Pouzauges Bocage FC","French Regional 1 - Pays de la Loire - Group A","TAH","No","12/1/2022","-","$0","Right","Reasonable","Very Strong","6'1""","160 lbs","11","1",65,95,5,9,13,7,7,5,6,2,5,5,13,2,2,12,15,7,7,4,6,13,3,13,7,7,5,6,7,7,13,13,6,10,10,13,5,3,16,11,11,10,10,12,9,2,14,4,15,10,9,2,3,1,2,3,2,1,2,2,2,1
"6268",2000307868,"Bongiswa Dlamini","1/9/1999 (24 years old)","GK","Mbabane Swallows","Premier League of Eswatini","SWZ","No","6/12/2023","6/30/2025","$0","Right Only","Weak","Very Strong","6'2""","160 lbs","14","-",61,83,3,1,3,2,1,4,1,3,3,1,7,1,2,3,8,7,14,4,9,13,8,1,13,2,9,6,3,5,10,6,6,8,11,9,5,6,9,20,10,11,10,10,5,8,9,7,9,12,12,4,6,10,14,8,10,11,12,6,10,5
"6269",49047178,"Teraï Bremond","5/16/2001 (22 years old)","DM, M (C)","AS Vénus","Tahitian First Division","TAH","Yes","7/1/2021","6/30/2025","$0 - $5K","Right Only","Weak","Very Strong","6'0""","167 lbs","28","1",69,87,5,2,6,3,9,3,6,6,3,8,9,1,14,14,12,13,12,12,10,13,7,5,6,7,8,7,9,10,10,8,7,8,8,8,7,14,10,15,12,13,13,11,12,8,6,1,12,11,18,3,4,3,1,1,2,1,3,1,3,3
"6270",23214131,"Teaonui Tehau","9/1/1992 (30 years old)","ST (C)","AS Vénus","Tahitian First Division","TAH","Yes","6/14/2021","6/30/2025","$500 - $3K","Right","Weak","Very Strong","5'8""","138 lbs","154","223",80,81,9,8,13,15,12,12,11,6,4,8,8,15,3,10,14,10,6,12,10,10,16,7,9,9,8,8,8,10,11,11,9,4,18,12,10,9,11,10,12,8,11,12,10,4,7,2,10,6,5,1,4,2,1,1,3,1,1,4,1,1
"6271",97100690,"Viritua Tiaiho","1/23/1992 (31 years old)","D/WB/M/AM (L)","AS Tefana","Tahitian First Division","TAH","Yes","6/14/2021","6/30/2025","Not for Sale","Left","Very Strong","Weak","6'1""","174 lbs","59","31",60,81,8,12,9,9,8,7,7,7,7,8,9,1,6,11,9,7,7,9,6,15,16,9,5,15,9,8,6,9,8,11,4,11,10,8,8,8,18,12,11,12,13,14,14,6,11,1,19,10,9,1,1,2,3,3,4,2,1,1,2,1
"6272",30053630,"Yann Pennequin-Le Bras","1/10/1994 (29 years old)","M (RC)","AS Vénus","Tahitian First Division","TAH","Yes","6/15/2020","6/30/2025","$0 - $4.5K","Right","Fairly Strong","Very Strong","6'0""","158 lbs","54","8",70,80,6,6,6,4,13,6,1,6,4,8,8,3,8,12,5,8,1,8,8,9,11,7,9,5,8,7,10,12,13,13,7,10,13,13,9,4,14,10,12,11,11,13,13,11,5,7,12,13,16,1,3,1,3,3,1,1,1,3,2,2
"6273",2000095433,"Roonui Tinirauarii","3/14/1997 (26 years old)","ST (C)","AS Dragon","Tahitian First Division","TAH","Yes","4/7/2022","6/30/2025","$1.5K - $5K","Left","Very Strong","Reasonable","5'10""","145 lbs","58","102",69,80,5,3,13,13,13,5,11,6,3,5,5,4,1,11,12,9,5,9,6,8,16,11,12,10,6,5,3,7,13,13,6,8,15,13,10,3,9,19,10,12,10,13,7,2,5,7,9,12,15,1,2,1,2,1,1,3,1,1,1,3
"6274",2000095455,"Louis Gitton","4/2/2002 (21 years old)","M/AM (C)","AS Piraé","Tahitian First Division","TAH","Yes","7/1/2020","6/30/2026","$0","Right","Reasonable","Very Strong","5'10""","149 lbs","45","14",69,79,4,4,8,8,11,6,6,8,6,8,8,1,6,6,14,6,6,6,6,14,6,7,5,13,8,7,10,12,12,14,7,5,10,14,8,4,10,17,14,11,13,12,7,6,8,7,11,12,19,1,2,3,2,1,3,1,2,2,1,3
"6275",49039884,"Mickael Roche","12/24/1984 (38 years old)","GK","AS Tefana","Tahitian First Division","TAH","Yes","7/1/2020","6/30/2024","$0","Right Only","Very Weak","Very Strong","6'3""","189 lbs","69","-",54,77,3,1,1,1,5,6,1,1,3,3,7,2,1,5,9,8,14,7,9,8,9,1,8,1,9,7,6,6,5,7,12,13,15,4,2,12,11,14,11,12,11,11,12,8,10,4,10,10,10,6,5,10,11,8,6,14,5,9,11,10
"6276",2000279945,"Hirinai Vahirua","2/24/2006 (17 years old)","M (C)","Gaz. Ajaccio","French Regional Divisions","TAH","Yes","7/1/2022","-","$0","Right","Reasonable","Very Strong","5'8""","141 lbs","-","-",60,76,6,3,5,7,14,6,1,7,6,6,11,3,5,9,11,5,4,4,2,10,12,6,6,4,7,8,8,13,9,14,7,6,11,12,8,5,14,10,10,12,12,12,6,4,7,4,10,11,12,2,2,2,2,1,3,3,3,3,2,2
"6277",2000246160,"Vaitea Seguy","1/7/2006 (17 years old)","DM, M (C)","US Colomiers","French National 3 - Group B","TAH","Yes","7/1/2022","6/30/2023","$0","Right","Reasonable","Very Strong","5'8""","138 lbs","-","-",50,76,3,4,2,6,7,5,4,5,1,7,6,2,13,12,10,3,6,3,6,13,4,5,9,7,7,7,8,11,13,10,5,1,11,13,7,5,11,19,12,10,12,11,10,10,13,6,8,12,18,2,3,1,3,3,1,3,2,4,3,4
"6278",97100858,"Jean-Claude Paraue","5/24/1989 (34 years old)","D (RL)","AS Vénus","Tahitian First Division","TAH","Yes","7/1/2019","6/30/2024","$0","Right","Fairly Strong","Very Strong","5'9""","152 lbs","51","1",54,75,6,12,1,2,9,3,8,6,6,9,8,3,13,7,11,9,8,8,11,9,6,5,11,4,9,8,8,8,8,7,4,6,14,7,12,5,9,11,11,14,10,7,7,14,9,2,15,11,11,3,1,2,3,2,3,3,2,2,3,4
"6279",13101109,"Sandile Hlatjwako","2/14/1988 (35 years old)","ST (C)","Mbabane Swallows","Premier League of Eswatini","SWZ","No","6/14/2021","6/30/2024","$5K - $14K","Right Only","Very Weak","Very Strong","5'11""","165 lbs","-","-",80,83,7,7,10,11,15,5,15,9,1,7,9,9,8,15,7,13,7,13,9,11,4,13,14,11,8,8,7,9,10,9,6,8,8,9,8,10,13,18,13,10,11,11,12,13,6,8,10,13,19,1,1,3,1,1,3,3,1,1,2,3
"6280",2000154798,"François Hapipi","3/10/1999 (24 years old)","D (C)","Pouzauges Bocage FC","French Regional 1 - Pays de la Loire - Group A","TAH","Yes","7/12/2022","-","$0","Right","Reasonable","Very Strong","5'11""","163 lbs","20","1",66,75,4,1,1,2,5,5,8,4,1,11,3,2,13,1,12,9,8,4,10,13,6,5,13,5,13,3,5,7,13,13,6,5,9,13,12,8,16,10,12,8,9,14,10,4,5,4,9,12,12,3,2,3,3,3,1,3,3,1,2,3
"6281",97100855,"Kévin Barbe","9/2/1997 (25 years old)","D (C)","AS Vénus","Tahitian First Division","TAH","Yes","6/15/2020","6/30/2025","$0","Right","Reasonable","Very Strong","6'4""","178 lbs","63","18",68,75,1,1,1,1,5,5,9,1,1,10,6,1,9,5,9,10,8,6,12,13,8,5,5,5,6,5,4,7,13,11,6,15,13,11,12,7,12,17,12,11,10,11,9,9,8,3,13,10,8,1,3,2,3,2,3,3,1,1,3,1
"6282",49039939,"Matatia Paama","10/3/1992 (30 years old)","D (LC)","AS Piraé","Tahitian First Division","TAH","Yes","7/1/2021","6/30/2025","$0","Left","Very Strong","Strong","6'2""","209 lbs","59","20",68,73,3,7,4,1,6,6,10,2,2,7,8,1,10,2,5,9,8,7,11,8,11,5,8,6,10,7,7,7,14,10,7,14,12,13,6,12,14,11,10,11,10,11,10,10,11,3,12,12,15,2,3,3,1,2,3,3,3,3,3,1
"6283",97100878,"Roonui Tehau","12/15/1999 (23 years old)","M/AM (C), ST (C)","AS Vénus","Tahitian First Division","TAH","Yes","7/1/2021","6/30/2025","$0 - $5K","Right","Fairly Strong","Very Strong","6'1""","165 lbs","61","43",69,72,2,4,11,7,12,5,6,3,5,4,12,3,7,8,9,8,2,10,5,11,5,9,7,8,7,6,6,6,13,12,4,7,7,13,10,4,10,11,12,10,10,12,11,6,7,7,17,13,10,2,1,3,4,2,1,2,2,1,3,1
"6284",2000173587,"Franck Papaura","4/6/2005 (18 years old)","AM (RL)","AS Pueu","Tahitian First Division","TAH","Yes","7/1/2020","6/30/2024","$0","Left","Very Strong","Reasonable","6'0""","154 lbs","45","39",62,71,3,8,12,8,13,1,3,4,5,3,7,1,6,11,13,4,7,3,6,11,18,11,11,9,5,6,5,7,13,13,6,6,7,13,5,3,11,10,12,13,12,12,6,10,9,3,7,11,9,4,3,1,3,1,2,1,2,3,2,3
"6285",2000154790,"Tevaitini Teumere","4/2/2003 (20 years old)","D (C)","AS Piraé","Tahitian First Division","TAH","Yes","1/2/2023","6/30/2025","$0","Right","Reasonable","Very Strong","6'1""","167 lbs","50","-",67,71,4,1,6,3,5,1,10,4,6,11,5,3,12,3,6,8,6,7,9,9,17,5,5,6,14,6,5,8,12,10,7,9,12,12,5,6,13,11,12,10,10,10,11,9,6,4,9,11,15,3,2,2,3,1,2,1,2,2,1,1
"6286",2000202342,"Nohoarii Laux","5/12/1992 (31 years old)","DM, M (C)","AS Punaruu","Tahitian First Division","TAH","Yes","7/1/2021","6/30/2024","$0","Left","Very Strong","Reasonable","5'11""","167 lbs","39","5",62,71,6,1,8,4,9,7,6,9,2,10,13,1,13,13,15,7,4,8,7,8,12,5,7,7,7,8,10,13,8,12,8,10,7,10,8,7,8,17,12,11,12,10,7,6,6,8,11,10,8,1,1,2,2,1,2,3,3,3,4,3
"6287",49039947,"Heimano Bourebare","5/15/1989 (34 years old)","DM, M (C)","AS Piraé","Tahitian First Division","TAH","Yes","7/1/2021","6/30/2024","$0","Right Only","Weak","Very Strong","5'11""","167 lbs","113","10",69,71,4,6,5,6,13,6,6,5,3,8,14,5,8,14,10,8,7,8,8,8,16,5,4,8,9,7,11,12,11,11,7,9,12,9,9,10,13,18,11,11,10,10,7,4,14,2,10,11,16,1,3,3,3,2,2,1,2,3,1,4
"6288",2000095512,"Manuarii Shan","2/23/2004 (19 years old)","AM (RL)","AS Vénus","Tahitian First Division","TAH","Yes","7/1/2021","6/30/2025","$0","Left","Very Strong","Weak","6'1""","163 lbs","37","14",60,70,5,9,8,7,10,5,4,2,2,4,5,3,6,8,5,4,6,7,4,8,17,10,3,9,2,6,5,7,13,13,6,10,9,13,8,4,13,19,11,11,11,10,11,16,7,4,16,13,11,3,1,3,1,3,2,2,3,2,3,2
"6289",2000254279,"Hitimoana Teuira","6/20/2006 (16 years old)","D (C)","AS Vénus","Tahitian First Division","TAH","Yes","7/1/2022","6/30/2026","$0","Right","Reasonable","Very Strong","5'11""","147 lbs","7","-",50,69,3,1,1,1,6,3,6,4,4,12,7,1,9,3,12,9,8,4,8,14,13,5,9,3,12,6,1,7,7,6,7,7,13,6,4,5,7,11,12,14,10,12,13,12,14,3,16,11,19,2,2,3,3,4,1,1,3,1,1,3
"6290",2000309470,"Kelvin Kunene","3/16/2003 (20 years old)","DM, M (C)","Royal Leopards","Premier League of Eswatini","SWZ","No","7/1/2022","6/30/2025","$0 - $35K","Right","Fairly Strong","Very Strong","6'0""","165 lbs","-","-",66,83,6,6,2,7,11,4,6,9,2,7,10,6,13,10,15,8,7,6,6,11,13,5,7,7,8,8,12,11,9,9,7,7,11,12,6,6,12,11,12,9,10,12,6,8,10,7,10,12,7,1,3,2,1,2,2,3,1,2,4,3
"6291",2000162285,"Avearii Bennett","11/20/1999 (23 years old)","D (R), DM, M (C)","AS Tefana","Tahitian First Division","TAH","Yes","4/7/2022","6/30/2025","$0","Right","Fairly Strong","Very Strong","5'10""","154 lbs","29","3",57,68,3,8,5,4,9,6,6,3,4,8,5,1,8,5,14,9,7,7,6,14,15,5,10,7,12,7,7,8,12,11,3,8,13,9,9,6,12,12,13,10,10,10,10,10,12,7,10,10,9,1,3,3,3,1,3,1,1,1,3,4
"6292",97100852,"Tevaearai Tamatai","1/15/2001 (22 years old)","GK","AS Punaruu","Tahitian First Division","TAH","Yes","7/1/2021","6/30/2024","$0","Right","Fairly Strong","Very Strong","5'10""","154 lbs","38","-",57,68,3,2,1,3,1,8,1,1,3,1,5,1,3,4,12,10,9,1,8,13,10,1,12,2,8,6,5,5,10,5,1,3,14,11,1,5,9,20,12,9,9,11,12,4,5,5,11,11,12,5,5,13,10,6,6,13,5,7,9,6
"6293",2000302641,"Maitere Tanerii","4/14/2000 (23 years old)","ST (C)","AS Central Sport","Tahitian First Division","TAH","No","9/1/2021","6/30/2025","$0","Right","Reasonable","Very Strong","5'10""","156 lbs","18","10",55,68,5,4,7,10,12,4,12,4,1,3,4,1,2,8,10,8,7,9,5,8,3,9,13,13,4,4,4,6,13,13,6,6,10,12,5,7,7,19,10,12,8,12,14,11,6,6,10,10,12,1,1,2,2,1,1,1,3,3,3,4
"6294",2000095514,"Honoura Maraetefau","2/27/2002 (21 years old)","M (R)","AS Tefana","Tahitian First Division","TAH","Yes","7/1/2019","6/30/2025","$0","Right","Fairly Strong","Very Strong","5'7""","136 lbs","58","13",59,68,6,11,10,5,7,6,3,4,6,6,6,3,5,11,14,8,4,11,3,10,3,5,8,2,6,8,8,11,12,13,7,2,7,13,6,1,12,14,13,13,12,12,12,14,12,2,9,11,15,2,2,1,3,1,4,2,2,3,1,2
"6295",97100704,"Raimana Li Fung Kuee","4/10/1985 (38 years old)","M (C), AM (RLC)","AS Dragon","Tahitian First Division","TAH","Yes","7/1/2021","6/30/2024","$0","Right","Fairly Strong","Very Strong","5'8""","147 lbs","55","20",67,68,7,11,7,8,12,8,8,8,1,8,10,5,9,11,7,10,6,8,7,15,16,8,7,8,9,9,12,10,9,9,9,4,13,9,9,6,10,13,11,11,10,10,8,9,6,6,9,11,14,2,1,2,1,2,1,2,3,4,2,2
"6296",97100741,"Yohann Tihoni","7/20/1994 (28 years old)","M/AM (RL)","AS Piraé","Tahitian First Division","TAH","Yes","7/1/2021","6/30/2025","$0","Right","Reasonable","Very Strong","5'10""","154 lbs","66","40",63,68,6,10,11,9,5,5,1,2,5,5,7,2,5,10,10,6,3,5,6,13,5,10,10,8,5,5,5,7,13,12,6,4,14,11,12,6,8,18,12,11,11,11,8,13,7,6,20,9,18,1,1,2,1,1,3,3,2,2,3,2
"6297",2000298621,"Tahiarii Teriitemataua","1/9/2006 (17 years old)","D (L)","AS Central Sport","Tahitian First Division","TAH","Yes","7/1/2022","6/30/2025","$0","Left","Very Strong","Reasonable","5'5""","127 lbs","1","-",50,68,4,11,4,5,8,2,3,3,5,7,5,1,12,7,8,6,8,5,13,11,12,10,6,5,6,7,7,8,12,9,2,5,12,11,13,3,12,16,12,11,14,8,5,1,11,2,10,10,20,2,1,1,3,1,3,2,3,3,3,2
"6298",97101451,"Kitin Maro","5/1/1999 (24 years old)","M (C)","AS Tefana","Tahitian First Division","TAH","Yes","4/7/2022","6/30/2025","$0","Right","Reasonable","Very Strong","5'11""","149 lbs","38","4",59,68,5,3,3,3,12,5,5,11,1,8,10,2,6,7,5,8,6,4,6,7,8,5,2,10,5,6,9,11,13,13,6,9,15,13,13,4,13,15,13,13,10,11,11,5,12,4,11,10,12,4,3,3,2,2,2,2,1,2,1,2
"6299",30053611,"Teave Teamotuaitau","4/17/1992 (31 years old)","GK","AS Vénus","Tahitian First Division","TAH","Yes","7/1/2018","6/30/2025","Not for Sale","Right","Fairly Strong","Very Strong","6'0""","163 lbs","64","-",66,68,3,2,1,3,1,7,1,3,1,3,12,2,2,6,8,12,8,8,11,15,17,3,11,3,9,8,7,7,11,11,8,7,15,10,7,5,7,19,9,11,11,11,14,1,14,8,8,11,8,6,14,6,7,9,9,12,5,8,8,9
"6300",97101447,"Yann Vivi","6/7/2000 (23 years old)","M/AM (R)","AS Temanava","Tahitian First Division","TAH","Yes","1/2/2022","6/30/2024","$0","Right","Reasonable","Very Strong","5'9""","141 lbs","56","19",56,67,5,9,7,7,9,5,4,6,4,5,10,4,2,5,15,4,7,6,6,8,12,8,12,9,5,6,7,11,13,13,6,8,15,13,8,3,10,12,12,10,12,11,12,4,5,6,8,13,15,2,3,3,2,3,3,1,3,2,1,1
"6301",2000087856,"Sihlangu Mkhwanazi","9/28/1989 (33 years old)","D (C)","Young Buffaloes","Premier League of Eswatini","SWZ","No","6/14/2021","6/30/2024","$0 - $40K","Right Only","Very Weak","Very Strong","5'10""","163 lbs","-","-",81,83,4,3,2,7,6,6,15,2,8,13,9,4,14,7,12,9,9,6,9,15,18,6,11,8,13,8,4,7,9,11,9,8,15,9,6,9,15,14,9,10,10,11,9,11,14,5,10,13,16,3,3,2,4,1,2,2,3,2,1,1
"6302",49039990,"Tamatoa Tetauira","4/17/1996 (27 years old)","AM (LC), ST (C)","AS Piraé","Tahitian First Division","TAH","Yes","7/1/2020","6/30/2024","$0","Right","Reasonable","Very Strong","5'9""","152 lbs","37","31",60,67,3,7,9,10,10,5,7,7,3,5,7,5,4,8,14,6,4,8,7,7,6,8,7,9,5,6,6,7,13,13,7,3,13,13,4,7,10,10,10,12,11,11,10,11,11,6,20,11,12,1,3,3,3,1,2,3,3,3,3,1
"6303",49039857,"Stéphane Faatiarau","3/13/1990 (33 years old)","D (L)","AS Tefana","Tahitian First Division","TAH","Yes","7/1/2019","6/30/2024","$0","Left","Very Strong","Reasonable","5'10""","165 lbs","48","-",55,67,5,10,4,4,5,1,8,4,7,8,8,4,10,7,12,11,9,8,7,15,11,5,12,6,8,8,8,8,9,7,8,6,11,7,9,9,12,19,10,10,10,11,7,5,6,6,10,6,16,2,2,1,3,2,4,1,3,3,3,3
"6304",2000173348,"Haumau Tanetoa","11/18/2004 (18 years old)","D (RL)","AS Piraé","Tahitian First Division","TAH","Yes","7/1/2020","6/30/2025","$0","Left","Very Strong","Reasonable","5'9""","145 lbs","27","1",58,67,5,8,6,4,8,4,8,5,4,7,8,3,7,4,10,4,8,4,12,7,5,5,6,3,6,7,2,8,13,14,8,8,12,14,9,6,12,20,10,11,12,12,13,8,8,7,7,12,13,3,1,2,3,2,3,2,3,3,2,2
"6305",97101159,"Farearii Tuteina","5/12/1998 (25 years old)","D (R)","AS Tefana","Tahitian First Division","TAH","Yes","7/1/2019","6/30/2025","$0","Right","Strong","Very Strong","5'9""","147 lbs","62","13",61,66,4,10,4,5,5,1,1,1,2,6,4,3,6,7,8,6,7,6,7,8,5,6,13,4,9,6,5,7,13,13,6,7,12,13,12,4,13,16,10,11,11,10,7,5,5,5,10,10,19,2,3,2,2,3,1,2,2,4,4,3
"6306",97101440,"Rainui Nordman","2/9/1999 (24 years old)","AM (R), ST (C)","AS Tohiea","Tahitian Second Division","TAH","Yes","1/2/2022","6/30/2024","$0","Right","Reasonable","Very Strong","6'1""","163 lbs","24","6",53,66,3,8,11,10,9,1,6,2,2,3,8,1,1,6,6,6,6,6,5,9,10,7,3,6,3,4,6,7,12,9,5,9,8,12,12,3,9,14,13,9,10,10,6,9,9,4,10,10,7,2,4,2,3,1,1,3,2,3,3,1
"6307",97101088,"Teiki Kananou","1/8/1998 (25 years old)","D (L)","AS Central Sport","Tahitian First Division","TAH","Yes","7/1/2018","6/30/2025","$0","Left","Very Strong","Weak","6'1""","167 lbs","53","2",54,66,4,8,2,1,8,1,1,3,1,6,5,1,8,6,8,10,8,6,7,13,13,5,12,3,7,6,5,6,13,13,6,8,15,13,11,8,10,15,11,10,10,14,9,4,10,7,7,11,16,1,2,2,2,2,1,4,2,1,3,1
"6308",97101425,"Etienne Nanuaiterai","9/7/1999 (23 years old)","D (C)","AS Excelsior (TAH)","Tahitian Second Division","TAH","Yes","7/1/2020","6/30/2024","$0","Right","Reasonable","Very Strong","6'3""","174 lbs","30","6",51,65,1,1,1,3,6,5,12,3,1,7,4,1,8,5,10,8,8,3,8,13,16,5,12,5,13,5,1,6,10,13,6,10,9,11,6,4,12,10,11,11,11,12,6,12,9,5,10,14,8,2,2,2,3,1,1,1,1,3,1,2
"6309",97101165,"Tauatua Lucas","11/23/1994 (28 years old)","ST (C)","AS Tefana","Tahitian First Division","TAH","No","10/1/2022","6/30/2025","$0","Right","Fairly Strong","Very Strong","5'11""","158 lbs","36","24",61,65,4,3,7,13,13,5,12,3,1,2,7,5,3,9,12,4,7,8,6,11,6,9,11,10,6,5,5,7,12,9,6,10,11,9,7,5,11,20,12,12,10,9,8,3,12,4,11,12,18,3,3,2,2,2,1,1,3,1,2,2
"6310",2000059056,"François Mu","8/11/1995 (27 years old)","AM (RL), ST (C)","AS Dragon","Tahitian First Division","TAH","No","7/1/2020","6/30/2025","$0","Left","Very Strong","Reasonable","6'2""","167 lbs","54","46",62,65,5,10,12,11,12,3,7,5,5,5,8,2,3,7,5,7,5,8,5,7,5,10,11,10,5,6,5,7,13,10,6,7,10,12,6,4,8,20,8,13,12,12,8,4,10,5,10,11,19,3,1,2,1,1,2,3,4,2,1,2
"6311",49039915,"Moana Pito","1/25/2000 (23 years old)","GK","AS Tefana","Tahitian First Division","TAH","Yes","6/15/2020","6/30/2025","$0","Right","Weak","Very Strong","5'10""","202 lbs","40","-",56,65,4,1,2,3,4,6,1,2,3,1,6,2,3,1,8,4,9,6,11,13,11,3,13,1,5,6,5,5,11,5,6,5,12,11,1,5,9,17,12,10,10,12,14,10,13,2,9,11,16,7,9,10,11,7,9,13,5,6,9,6
"6312",13211540,"Fanelo Mamba","1/15/1992 (31 years old)","AM (R), ST (C)","Young Buffaloes","Premier League of Eswatini","SWZ","No","6/14/2021","6/30/2024","$10K - $110K","Right Only","Weak","Very Strong","5'11""","163 lbs","-","-",78,83,5,10,11,14,8,5,12,8,7,6,13,5,4,8,5,10,6,10,6,11,17,9,2,9,7,8,8,9,14,12,8,9,15,12,6,7,13,17,12,13,10,12,15,8,9,5,11,14,16,1,3,3,3,2,1,2,2,3,1,3
"6313",97100735,"Gervais Chan Kat","1/1/1993 (30 years old)","D/WB/M/AM (R)","AS Dragon","Tahitian First Division","TAH","Yes","7/1/2021","6/30/2025","$0","Right","Reasonable","Very Strong","5'11""","154 lbs","58","23",62,65,6,10,6,5,10,4,4,4,4,5,6,2,6,6,11,7,5,5,3,10,13,7,14,9,5,5,3,6,12,12,5,5,12,12,11,3,11,20,12,11,11,10,13,3,10,5,8,13,14,1,3,2,2,1,2,3,2,3,2,3
"6314",2000203281,"Moanahau Lai","10/12/2000 (22 years old)","DM, M (C)","AS Temanava","Tahitian First Division","TAH","Yes","7/1/2021","6/30/2024","$0","Right","Reasonable","Very Strong","5'9""","149 lbs","38","-",55,65,6,6,2,6,9,6,6,5,1,9,10,1,9,10,8,6,7,3,3,14,13,6,1,7,9,7,9,7,7,14,7,9,13,11,4,6,10,19,12,13,11,14,9,11,5,8,10,12,16,1,3,3,1,1,4,1,2,3,1,2
"6315",97101429,"Kavai'ei Morgant","10/8/2001 (21 years old)","M (C)","AS Tefana","Tahitian First Division","TAH","Yes","7/1/2018","6/30/2025","$0","Left","Very Strong","Reasonable","5'10""","158 lbs","20","4",60,65,3,6,5,3,14,6,1,5,2,9,10,1,6,11,5,6,2,10,7,11,13,5,1,4,5,8,8,13,10,9,7,9,12,8,14,6,12,12,10,11,15,12,5,9,9,5,9,13,17,2,2,1,1,1,2,1,1,1,1,2
"6316",97100738,"Rainui Alexis Tze-Yu","2/26/1992 (31 years old)","M/AM (RL), ST (C)","AS Temanava","Tahitian First Division","TAH","Yes","7/1/2022","6/30/2024","$0","Right","Weak","Very Strong","5'10""","149 lbs","56","48",63,65,7,10,8,9,8,7,8,8,7,5,10,6,8,8,12,10,8,11,8,13,9,11,12,12,7,8,6,5,10,7,8,6,13,9,9,6,9,17,12,9,10,8,10,9,7,8,16,10,19,2,3,1,3,1,3,3,2,1,3,1
"6317",30054015,"Etienne Tave","5/4/2000 (23 years old)","D (R)","AS Piraé","Tahitian First Division","TAH","Yes","4/14/2022","6/30/2025","$0","Right","Reasonable","Very Strong","5'11""","154 lbs","52","3",61,65,6,10,6,3,5,1,5,1,6,9,6,3,6,6,15,5,8,5,14,13,17,5,6,5,7,7,6,7,14,12,7,7,9,13,6,4,11,16,13,7,11,11,13,10,10,8,11,9,19,1,1,3,1,1,2,1,1,1,1,4
"6318",2000095513,"Anapa Debruyne","9/22/2003 (19 years old)","GK","AS Dragon","Tahitian First Division","TAH","Yes","7/1/2022","6/30/2025","$0","Right","Weak","Very Strong","6'2""","176 lbs","14","-",56,65,3,1,1,3,1,6,1,1,3,3,6,2,3,1,8,8,11,6,11,13,4,1,9,1,10,6,5,4,6,10,6,12,13,5,1,5,8,10,11,10,11,12,6,11,13,7,7,10,7,5,11,13,12,7,12,13,5,3,7,13
"6319",2000154909,"Eranio Yakeula","7/19/1993 (29 years old)","D (C)","AS Central Sport","Tahitian First Division","TAH","Yes","7/1/2019","6/30/2025","$0","Right","Fairly Strong","Very Strong","5'11""","160 lbs","46","-",54,64,2,1,1,1,2,2,7,2,1,7,4,2,10,1,9,11,6,3,7,12,12,5,11,4,12,4,4,6,12,12,5,5,14,12,11,7,16,15,11,10,10,11,12,8,6,7,9,11,16,1,2,1,1,3,1,3,1,3,3,2
"6320",2000095524,"Nick Tauotaha","4/30/1993 (30 years old)","D (C), DM, M (C)","AS Piraé","Tahitian First Division","TAH","Yes","7/1/2022","6/30/2025","$0","Right","Reasonable","Very Strong","6'2""","169 lbs","60","8",60,64,3,5,2,5,5,5,6,6,3,12,10,4,13,5,12,8,7,7,6,13,4,5,7,5,12,6,5,11,13,11,6,8,6,12,8,4,8,19,11,13,9,11,13,9,7,7,17,13,7,3,2,2,1,2,4,2,3,4,1,2
"6321",97100861,"Marcel Tihoni","12/28/1985 (37 years old)","D (C)","AS Pueu","Tahitian First Division","TAH","Yes","1/1/2019","6/30/2024","$0","Right Only","Weak","Very Strong","6'2""","178 lbs","59","4",53,64,1,1,1,2,5,3,5,4,1,8,7,1,14,6,6,9,8,4,7,14,4,6,12,6,14,6,1,7,5,8,7,9,9,8,7,8,9,16,12,10,12,11,9,13,12,3,4,10,16,3,1,2,3,3,4,1,1,2,1,1
"6322",88023714,"Ben Mata","8/10/1998 (24 years old)","D (C)","Wellington Olympic","New Zealand Central League","COK","No","1/1/2021","-","$0","Right","Weak","Very Strong","6'1""","216 lbs","69","16",85,94,3,5,7,7,10,5,12,6,7,11,11,12,12,10,14,12,12,11,12,8,14,11,15,9,11,14,10,9,8,5,11,12,13,9,13,17,10,14,12,14,11,8,7,16,5,4,12,11,15,2,3,2,2,1,1,2,3,1,3,2
"6323",2000307898,"Manqoba Vilakati","6/1/2001 (22 years old)","AM (RL), ST (C)","Mbabane Swallows","Premier League of Eswatini","SWZ","No","6/12/2023","6/30/2025","$0 - $75K","Right Only","Very Weak","Very Strong","5'10""","147 lbs","-","-",61,83,4,8,13,8,12,4,6,7,4,5,8,1,4,10,9,9,3,4,4,8,8,12,13,11,5,6,5,7,13,12,3,6,13,13,9,3,11,19,11,8,12,12,12,8,10,8,12,12,18,4,3,3,2,3,1,2,3,3,3,1
"6324",88021025,"Keegan Inia","3/20/1997 (26 years old)","GK","South Auckland Rangers","New Zealand NRF League One","COK","No","3/31/2023","-","$0","Right","Weak","Very Strong","6'1""","194 lbs","29","-",55,79,2,2,1,1,1,2,1,1,1,1,5,2,3,1,14,8,11,3,7,12,11,3,8,2,10,5,4,3,11,4,5,9,10,10,1,6,10,16,12,10,11,12,8,10,8,5,19,11,15,8,7,12,8,7,9,12,5,6,5,12
"6325",88021026,"Maro Bonsu-Maro","2/26/1997 (26 years old)","AM (R), ST (C)","Westvale","Victorian State League 2 North-West","COK","No","2/3/2023","-","$0","Right Only","Very Weak","Very Strong","5'10""","171 lbs","76","23",64,75,3,5,7,6,6,5,5,5,3,2,5,6,5,6,13,11,11,5,5,13,6,17,5,6,2,5,6,9,14,12,10,7,11,15,8,6,11,13,11,10,12,13,11,11,14,8,8,10,18,3,1,2,2,2,3,3,3,3,3,3
"6326",2000184350,"Ngereine Maro","3/20/2005 (18 years old)","GK","Western Suburbs","New Zealand Central League","COK","No","1/1/2021","-","$0","Right","Reasonable","Very Strong","6'4""","176 lbs","15","-",57,71,1,2,1,1,2,3,1,1,1,2,6,3,3,1,13,5,15,6,11,14,14,2,10,3,8,7,6,6,11,7,7,13,12,12,5,6,9,19,11,10,8,14,8,3,15,8,7,10,18,6,6,12,6,8,7,7,9,8,6,11
"6327",2000204781,"Zachary Scott","7/15/1998 (24 years old)","M/AM (R)","Sunset","Cayman Islands Premier League","CAY","No","6/15/2020","-","$0","Right","Reasonable","Very Strong","5'11""","152 lbs","-","-",65,85,4,10,9,11,8,1,5,6,5,4,9,6,4,10,5,6,7,5,6,11,18,11,13,10,4,7,7,10,13,13,6,7,12,13,5,4,11,16,10,11,10,9,5,7,11,8,12,9,17,2,3,1,1,4,2,2,1,2,3,1
"6328",2000204658,"Joshwa Campbell","1/22/2006 (17 years old)","D/WB/M (R)","Academy (CAY)","Cayman Islands Premier League","CAY","No","6/13/2022","-","$0","Right","Reasonable","Very Strong","6'0""","152 lbs","-","-",56,83,7,11,7,5,7,7,3,5,5,5,9,5,11,7,12,5,7,9,10,13,13,5,7,8,7,9,9,9,10,7,9,15,14,9,13,6,8,18,11,12,12,12,10,8,10,2,7,13,7,1,4,2,3,2,2,4,2,2,2,1
"6329",2000204798,"Miles Baillas-Thompson","7/21/2003 (19 years old)","M (C), AM (RC)","Academy (CAY)","Cayman Islands Premier League","CAY","No","7/1/2020","-","$0","Right","Weak","Very Strong","6'0""","171 lbs","-","-",58,80,8,10,9,11,9,10,8,9,5,8,12,6,10,9,11,6,5,16,8,8,10,11,9,9,10,7,10,10,9,9,9,12,16,9,8,7,13,15,11,12,11,12,11,3,5,2,5,13,12,1,1,1,1,2,3,1,2,2,2,3
"6330",2000204650,"Albertini Holness","3/6/2000 (23 years old)","GK","Cayman Athletic","Cayman Islands Division One","CAY","No","6/15/2020","-","$0","Right","Fairly Strong","Very Strong","6'1""","160 lbs","-","-",60,80,3,3,2,3,1,4,1,3,2,3,7,1,3,1,13,8,9,3,9,12,12,2,1,1,10,5,4,4,9,13,5,12,8,4,1,4,7,12,11,10,13,14,7,13,8,3,8,8,14,5,14,12,9,8,11,12,5,9,8,12
"6331",2000204868,"Syrus Conolly","6/21/2003 (19 years old)","ST (C)","Academy (CAY)","Cayman Islands Premier League","CAY","No","7/1/2020","-","$0","Right","Reasonable","Very Strong","6'1""","171 lbs","-","-",58,78,3,5,8,12,10,6,14,5,1,4,5,5,3,6,7,8,5,10,7,8,9,6,10,11,7,6,5,7,10,9,7,8,13,8,5,6,7,19,10,10,13,12,9,13,11,1,8,8,19,2,2,1,3,4,2,2,1,3,3,1
"6332",2000095489,"D'Andre Rowe","1/5/2001 (22 years old)","D (RC), DM, M (C)","Scholars","Cayman Islands Premier League","CAY","No","7/1/2019","-","$0","Right","Strong","Very Strong","5'9""","156 lbs","-","-",65,72,6,7,4,4,9,6,8,6,4,12,9,1,14,5,14,8,14,4,7,10,18,5,12,6,9,7,4,8,11,11,8,7,15,10,6,5,14,17,11,11,13,12,5,8,7,7,12,11,9,4,3,3,3,4,1,1,3,3,2,2
"6333",90051202,"Mark Ebanks","12/26/1990 (32 years old)","M/AM (C), ST (C)","Academy (CAY)","Cayman Islands Premier League","CAY","No","7/1/2020","-","$0","Right","Reasonable","Very Strong","5'10""","152 lbs","14","12",70,71,5,7,9,11,11,4,9,7,1,7,8,8,4,12,15,11,2,12,8,14,12,13,9,8,8,8,10,8,11,12,8,4,17,8,13,6,13,13,10,12,10,10,8,10,7,4,11,11,19,3,2,2,2,1,1,2,3,3,3,3
"6334",2000310808,"Bandile Shabangu","5/11/2002 (21 years old)","AM (RLC)","Young Buffaloes","Premier League of Eswatini","SWZ","No","7/1/2021","6/30/2025","$0 - $85K","Right Only","Very Weak","Very Strong","5'8""","141 lbs","-","-",68,91,5,8,13,5,13,1,4,7,1,5,12,1,5,9,12,6,5,3,5,7,14,9,8,12,4,7,6,12,13,13,13,5,12,13,8,3,12,19,10,12,13,9,11,8,8,5,20,9,7,2,1,3,2,3,1,1,1,3,3,1
"6335",2000309487,"Wandile Simelane","10/9/1996 (26 years old)","AM (RLC), ST (C)","Royal Leopards","Premier League of Eswatini","SWZ","No","7/1/2021","6/30/2024","$2K - $22K","Right Only","Weak","Very Strong","5'9""","147 lbs","56","27",73,82,6,11,12,9,12,4,6,4,5,3,8,3,6,10,7,5,3,5,6,10,11,11,12,11,5,6,9,7,12,12,3,5,14,12,12,8,9,20,10,11,12,8,8,8,7,7,11,12,18,3,2,1,1,1,3,3,2,1,1,1
"6336",82087196,"Jonah Ebanks","5/7/1996 (27 years old)","M/AM (C), ST (C)","Scholars","Cayman Islands Premier League","CAY","No","7/1/2020","-","$0","Right","Fairly Strong","Very Strong","6'2""","165 lbs","13","33",62,70,5,4,8,7,10,5,7,4,1,6,5,1,5,7,9,7,2,10,6,13,8,7,3,9,7,6,11,7,13,12,6,8,14,13,12,4,9,16,11,10,11,9,8,1,12,7,5,10,17,3,3,3,2,1,3,1,1,4,2,3
"6337",2000204860,"Kymani Bowens","6/27/2000 (22 years old)","ST (C)","East End (CAY)","Cayman Islands Premier League","CAY","No","7/1/2020","-","$0","Right","Weak","Very Strong","5'9""","149 lbs","-","-",61,70,2,3,6,13,13,2,13,3,3,5,6,2,1,8,7,7,5,6,5,13,3,8,3,10,6,5,6,6,13,8,6,4,13,11,5,6,9,13,10,11,9,10,13,8,8,2,9,8,9,3,1,3,2,1,4,1,2,3,2,3
"6338",82087188,"Christopher Reeves","2/27/1997 (26 years old)","ST (C)","Latinos","Cayman Islands Division One","CAY","No","7/1/2020","-","$0","Right","Reasonable","Very Strong","6'0""","156 lbs","13","22",66,70,6,2,8,11,11,5,12,7,4,4,4,6,1,7,6,7,5,7,6,7,14,6,9,13,6,3,7,8,14,13,7,6,15,14,13,4,8,12,10,10,12,10,5,12,6,4,11,12,8,1,1,3,2,1,2,2,2,1,2,3
"6339",2000086469,"Kion Parchmont","1/28/2000 (23 years old)","AM (RLC), ST (C)","Gloria Băneasa","Romanian Third League Group 3","CAY","No","4/18/2022","-","$0","Right","Fairly Strong","Very Strong","6'0""","132 lbs","-","-",58,70,4,7,12,9,5,4,6,6,4,4,6,4,1,9,14,5,6,7,4,6,10,11,8,7,5,5,5,6,12,12,5,6,14,12,5,3,9,16,12,10,10,12,6,6,12,6,10,12,7,2,1,2,1,2,3,1,2,4,1,1
"6340",90049319,"Jermaine Wilson","2/5/1995 (28 years old)","DM, M (C)","Academy (CAY)","Cayman Islands Premier League","CAY","No","6/15/2020","-","$0","Right","Weak","Very Strong","5'7""","145 lbs","-","-",58,70,6,6,3,6,9,6,6,6,5,7,7,4,10,6,9,12,4,7,7,10,14,5,12,7,13,7,4,7,14,14,6,6,14,14,12,9,12,16,9,10,12,10,10,8,10,6,19,11,16,2,3,1,2,3,1,2,3,3,2,1
"6341",2000095003,"Ackeem Hyde","11/3/1999 (23 years old)","D (C)","Future (CAY)","Cayman Islands Premier League","CAY","No","7/1/2018","-","$0","Right","Reasonable","Very Strong","6'0""","165 lbs","-","-",53,70,3,1,1,1,3,4,5,1,1,10,5,1,12,2,12,6,7,3,7,12,5,5,9,4,11,4,2,5,12,10,5,9,8,12,3,5,13,13,13,10,10,12,8,4,13,7,9,13,13,1,3,1,2,3,2,1,4,3,2,3
"6342",2000172113,"Oladapo Bailey","3/30/2000 (23 years old)","AM (RLC)","Dubai City","UAE First Division","CAY","No","7/1/2021","-","$0","Left","Very Strong","Reasonable","5'8""","145 lbs","-","-",52,70,5,6,7,11,11,5,5,7,3,5,6,2,6,7,6,7,3,7,7,12,6,7,7,8,7,6,5,10,13,13,6,5,14,13,5,3,15,15,8,10,10,11,5,1,5,4,17,11,12,1,2,2,1,2,1,1,2,4,2,2
"6343",2000204656,"Jabari Campbell","6/23/2000 (22 years old)","D/WB (L)","Academy (CAY)","Cayman Islands Premier League","CAY","No","6/15/2020","-","$0","Left","Very Strong","Reasonable","6'0""","165 lbs","-","-",60,66,6,10,6,4,8,5,8,4,7,9,9,1,13,9,11,11,3,8,9,10,11,5,6,6,7,8,8,8,12,8,8,10,14,8,13,7,10,17,11,13,11,12,12,2,13,2,10,13,20,2,2,2,2,3,1,3,1,3,3,1
"6344",82075085,"Wesley Robinson","9/7/1993 (29 years old)","D (LC), DM, M (C)","Future (CAY)","Cayman Islands Premier League","CAY","No","7/1/2020","-","$0","Left Only","Very Strong","Weak","6'1""","171 lbs","-","-",65,65,5,9,1,3,5,3,7,4,1,10,5,5,9,7,9,6,7,7,7,11,4,5,4,2,13,6,7,7,10,13,6,11,6,12,12,7,13,10,12,14,11,10,6,11,8,2,9,13,13,1,1,1,2,2,3,3,3,1,2,2
"6345",82075132,"Martin Webb","9/7/1995 (27 years old)","ST (C)","Cayman Athletic","Cayman Islands Division One","CAY","No","6/15/2020","-","$0","Either","Very Strong","Very Strong","6'0""","176 lbs","-","-",60,65,4,1,8,12,6,3,12,1,1,1,5,5,1,4,7,8,3,8,5,8,7,5,8,11,4,4,1,6,12,9,3,8,13,10,11,12,11,10,11,11,10,10,7,7,11,1,11,10,18,3,3,1,3,2,3,3,3,3,2,2
"6346",2000217978,"Vimal Yoganathan","1/31/2006 (17 years old)","M (C)","Barnsley","Sky Bet League One","SRI","No","7/1/2022","6/30/2024","$0 - $45K","Right","Fairly Strong","Very Strong","5'7""","127 lbs","-","-",50,100,3,4,5,5,12,2,5,5,1,4,13,1,5,10,8,8,4,6,3,12,10,5,1,5,4,6,10,11,12,9,5,6,14,11,9,1,12,18,12,13,10,8,5,12,6,2,10,10,17,1,2,1,2,3,2,2,3,2,3,2
"6347",90051189,"Jermaine Brown","3/22/1985 (38 years old)","GK","Scholars","Cayman Islands Premier League","CAY","No","6/14/2021","-","$0","Right","Weak","Very Strong","6'5""","185 lbs","-","-",55,64,4,2,2,3,1,7,1,3,3,1,5,3,2,1,11,6,8,6,11,13,12,3,13,3,9,6,5,5,6,11,6,12,8,6,5,5,9,15,10,13,10,19,8,4,14,6,9,13,7,8,9,6,13,7,9,6,5,10,10,10
"6348",82075136,"Andrew Browning","10/22/1995 (27 years old)","M/AM (C), ST (C)","East End (CAY)","Cayman Islands Premier League","CAY","No","6/15/2020","-","$0","Right","Fairly Strong","Very Strong","6'0""","158 lbs","-","-",60,63,3,4,8,8,13,5,6,5,3,6,8,1,3,10,8,6,7,8,5,13,15,13,6,9,5,6,6,7,13,13,6,7,12,13,6,4,9,18,10,12,9,11,10,13,6,3,7,10,7,3,3,1,1,1,2,1,1,1,2,3
"6349",90051230,"Ramon Sealy","4/22/1991 (32 years old)","GK","Bodden Town","Cayman Islands Premier League","CAY","No","6/14/2021","-","$0","Right","Reasonable","Very Strong","6'2""","189 lbs","-","-",61,63,3,1,3,1,1,6,1,1,1,2,6,2,3,1,8,9,11,5,9,13,19,1,4,1,9,6,5,6,11,12,4,9,12,8,5,5,12,17,12,12,12,18,12,15,12,3,19,13,11,6,5,12,9,8,6,13,5,8,7,12
"6350",2000204850,"Romario Dixon","9/19/1996 (26 years old)","M (C), AM (RLC)","Academy (CAY)","Cayman Islands Premier League","CAY","No","6/15/2020","-","$0","Right","Weak","Very Strong","5'11""","165 lbs","-","-",60,63,4,6,10,9,8,6,6,4,6,6,9,10,5,6,14,11,5,9,5,10,4,6,5,10,7,8,6,13,11,10,7,7,6,10,14,6,14,10,8,10,9,11,11,17,9,7,10,12,13,2,2,1,2,1,2,2,1,2,2,3
"6351",82075144,"David Lee","12/26/1997 (25 years old)","GK","Academy (CAY)","Cayman Islands Premier League","CAY","No","6/15/2020","-","$0","Right Only","Weak","Very Strong","6'0""","165 lbs","-","-",58,60,3,3,1,3,2,5,1,3,2,3,8,3,3,1,5,8,13,4,11,13,17,1,3,1,6,6,5,4,12,5,6,9,11,12,1,8,9,15,12,10,12,13,13,2,7,6,12,13,13,3,9,13,7,5,7,10,9,9,10,6
"6352",94018143,"Theron Wood","2/7/1990 (33 years old)","AM (R), ST (C)","Bodden Town","Cayman Islands Premier League","CAY","No","6/14/2021","-","$0","Right","Weak","Very Strong","5'10""","156 lbs","34","35",55,59,7,7,13,9,10,7,7,8,1,7,13,2,5,10,6,8,6,10,8,12,9,8,11,11,7,7,10,9,6,8,8,5,10,8,13,6,9,14,9,11,11,9,7,9,9,3,10,9,18,1,3,1,1,1,2,1,1,2,1,3
"6353",90051227,"Raheem Robinson","7/30/1992 (30 years old)","AM (R), ST (C)","Elite (CAY)","Cayman Islands Premier League","CAY","No","6/14/2021","-","$0","Right","Weak","Very Strong","5'11""","160 lbs","-","-",51,55,9,7,10,12,11,4,8,5,1,1,6,1,4,6,8,9,6,8,5,10,7,7,6,6,5,4,5,6,12,12,5,9,6,12,10,5,11,12,13,13,9,8,7,13,9,2,10,9,12,1,2,1,3,2,1,1,1,1,3,3
"6354",2000095004,"Tyler Lee","9/5/1994 (28 years old)","D (C)","Future (CAY)","Cayman Islands Premier League","CAY","No","6/15/2020","-","$0","Right","Reasonable","Very Strong","6'0""","156 lbs","-","-",55,55,1,4,5,2,5,2,9,3,1,13,6,1,8,5,6,11,8,3,7,13,9,5,9,4,8,5,2,6,13,10,6,8,14,12,10,3,11,16,10,13,10,12,11,2,5,7,7,11,20,1,2,3,3,4,1,2,2,1,3,3
"6355",90051237,"Tex Whitelocke","7/12/1990 (32 years old)","M/AM (R), ST (C)","George Town (CAY)","Cayman Islands Division One","CAY","No","6/14/2021","-","$0","Right","Weak","Very Strong","6'0""","163 lbs","-","-",52,53,9,10,6,9,9,13,9,3,7,7,8,3,5,7,14,8,6,7,7,12,13,5,14,11,7,8,7,9,10,11,8,11,15,11,9,8,10,11,12,11,10,13,8,3,10,4,20,11,10,1,3,2,3,2,3,2,4,2,4,3
"6356",90051201,"Jedd Ebanks","2/2/1988 (35 years old)","D/WB (R), M (RC), AM (R)","Elite (CAY)","Cayman Islands Premier League","CAY","No","6/14/2021","-","$0","Right","Weak","Very Strong","5'9""","152 lbs","-","-",51,52,7,8,7,9,10,7,7,8,7,9,11,5,10,7,11,8,7,9,9,11,7,6,9,11,9,8,5,9,7,9,8,8,7,9,9,5,11,17,12,9,11,9,14,8,13,2,11,9,9,1,2,1,3,1,2,2,1,4,1,3
"6357",15016525,"Jack Hingert","9/26/1990 (32 years old)","D (RL), WB (R)","Brisbane Roar","Isuzu UTE A-League","SRI","No","1/23/2020","6/30/2024","$120K - $375K","Right","Weak","Very Strong","5'7""","149 lbs","285","4",99,99,5,10,10,4,10,6,10,6,8,10,10,10,13,10,13,10,11,12,10,10,14,12,7,10,14,12,11,13,12,12,11,9,14,13,13,11,13,13,12,13,15,12,15,10,9,6,15,13,11,1,2,2,1,3,1,1,3,1,2,3
"6358",90051199,"Derrin Ebanks","12/16/1988 (34 years old)","M/AM (C)","Elite (CAY)","Cayman Islands Premier League","CAY","No","6/14/2021","-","$0","Right","Reasonable","Very Strong","6'1""","171 lbs","26","11",50,52,7,7,6,11,9,6,5,8,2,9,8,5,7,8,12,10,4,7,6,9,14,12,13,12,6,8,9,13,7,11,8,15,11,10,12,7,9,13,11,11,10,7,5,6,12,2,9,11,13,1,2,1,2,3,1,1,3,2,3,2
"6359",90051196,"Benjamin Cupid","3/18/1988 (35 years old)","D (C)","Elite (CAY)","Cayman Islands Premier League","CAY","No","6/14/2021","-","$0","Right","Weak","Very Strong","5'11""","163 lbs","-","-",50,51,3,1,1,4,6,4,8,3,1,9,6,1,10,5,15,11,8,6,7,13,12,6,11,2,11,5,2,6,7,9,6,9,12,5,6,6,11,16,10,11,9,11,6,4,11,7,10,12,15,4,2,3,3,2,1,1,2,1,1,3
"6360",90051205,"Leighton Elliott","10/23/1984 (38 years old)","D (RC), M (C)","George Town (CAY)","Cayman Islands Division One","CAY","No","6/14/2021","-","$0","Right","Reasonable","Very Strong","6'1""","165 lbs","-","-",51,51,2,6,6,7,9,6,7,7,6,7,8,2,11,8,11,8,8,5,7,14,7,5,7,8,9,7,4,8,6,7,7,11,15,7,7,5,11,10,10,13,11,11,5,11,7,4,9,12,20,2,1,1,1,2,3,1,3,3,3,2
"6361",90051228,"Jairo Sanchez","12/10/1987 (35 years old)","M/AM (L)","Elite (CAY)","Cayman Islands Premier League","CAY","No","6/14/2021","-","$0","Left","Very Strong","Reasonable","6'1""","163 lbs","-","-",51,51,5,10,4,9,10,4,5,7,6,5,6,6,3,8,10,6,3,7,7,13,4,8,5,12,6,8,6,13,10,8,5,13,18,9,10,4,14,6,7,10,12,11,7,12,8,8,15,11,17,4,1,2,3,2,1,3,3,2,1,3
"6362",94046862,"Leighton Thomas","2/13/1999 (24 years old)","M (R), AM (RC), ST (C)","Dorchester","English Southern League Premier South","CAY","No","5/23/2023","-","$0","Right","Weak","Very Strong","5'9""","171 lbs","150","67",50,51,5,8,7,9,9,4,4,3,1,2,9,5,6,6,6,5,7,8,5,8,17,12,5,5,4,6,5,7,12,11,4,7,14,10,11,5,9,11,11,11,11,12,5,14,5,5,10,12,7,3,3,3,2,4,3,1,3,3,2,1
"6363",23116179,"David Kong","12/13/1994 (28 years old)","DM, M (C)","Fabril do Barreiro","Portugal Championship - Group D","MAC","Yes","11/26/2022","6/30/2024","$500 - $3K","Right Only","Weak","Very Strong","6'0""","174 lbs","67","3",76,90,5,6,7,5,8,5,11,8,8,11,10,4,12,10,12,10,13,8,8,9,13,5,6,8,9,13,7,13,9,9,13,12,14,10,11,13,8,13,14,14,8,12,4,8,3,4,10,5,16,2,3,2,1,1,3,2,4,2,1,3
"6364",8874617,"Filipe Duarte","3/30/1985 (38 years old)","D (C)","Benfica (MAC)","Macanese First Division","MAC","Yes","1/1/2022","12/31/2023","$0","Right","Reasonable","Very Strong","5'11""","167 lbs","168","31",62,79,2,2,1,1,6,1,6,5,1,12,5,1,13,4,9,9,7,5,11,14,15,5,13,6,14,6,4,7,7,7,7,10,10,6,7,7,11,15,12,11,9,10,10,4,5,6,8,11,14,1,3,1,1,4,1,3,3,2,2,3
"6365",23078521,"Leong Ka Hang","11/22/1992 (30 years old)","ST (C)","Chao Pak Kei","Macanese First Division","MAC","No","3/2/2023","12/31/2023","$0","Left Only","Very Strong","Weak","5'11""","167 lbs","106","61",50,73,5,1,6,11,6,5,5,6,1,5,6,7,2,7,7,11,10,11,6,10,13,13,10,11,4,5,6,7,13,13,6,8,13,13,12,4,9,16,11,13,11,11,16,5,5,5,12,14,8,4,3,4,2,2,3,3,3,1,3,2
"6366",2000302358,"Mariojouls Sébastien","6/22/1996 (26 years old)","AM (R)","Bombarralense","Portuguese Leiria First Division","MAC","Yes","6/12/2023","-","$0","Right","Reasonable","Very Strong","6'0""","154 lbs","-","-",55,70,7,10,10,8,10,4,2,4,3,3,8,1,3,8,5,4,6,5,5,5,12,9,10,7,4,5,4,7,12,12,5,8,15,12,12,2,9,10,13,12,11,10,6,5,6,4,10,12,9,3,2,3,1,3,3,4,2,1,3,2
"6367",2000075571,"Pereira Nuno","11/22/1997 (25 years old)","DM, M (C)","Imortal","Portugal Championship - Group D","MAC","Yes","5/31/2023","6/30/2024","$0","Right Only","Weak","Very Strong","5'9""","160 lbs","41","-",53,68,6,6,3,5,6,6,6,7,2,7,11,2,11,10,12,8,4,6,8,10,6,5,12,8,7,7,7,10,14,14,7,6,9,13,14,5,10,10,11,12,11,12,5,7,10,8,7,12,11,1,2,2,1,1,1,2,2,3,3,3
"6368",93031684,"Adhavan Rajamohan","2/21/1993 (30 years old)","AM (RC), ST (C)","Paradiso","Swiss Promotion League","SRI","Yes","2/21/2023","6/30/2025","$0","Right","Reasonable","Very Strong","6'0""","174 lbs","215","53",85,94,7,10,10,9,10,9,9,8,6,6,10,9,5,11,10,9,10,9,10,9,9,11,7,11,10,11,10,13,11,10,12,9,10,12,11,11,7,10,10,11,10,8,9,8,9,5,12,7,18,2,2,4,2,1,1,4,2,3,3,3
"6369",23136650,"Nicholas Torrão","11/18/1987 (35 years old)","ST (C)","Chao Pak Kei","Macanese First Division","MAC","Yes","1/1/2021","12/31/2023","$0","Right","Reasonable","Very Strong","5'11""","167 lbs","183","188",58,66,3,3,10,10,8,5,11,7,6,6,7,7,1,9,5,11,7,12,4,10,12,9,6,12,7,6,4,7,10,8,7,6,11,10,6,9,8,10,12,13,9,12,8,4,14,7,10,10,8,1,1,2,3,3,1,3,2,3,2,3
"6370",23295513,"Tiago Saokham","5/5/1997 (26 years old)","DM, M (C)","Monte Carlo","Macanese First Division","MAC","Yes","12/31/2021","12/31/2023","$0","Right","Weak","Very Strong","5'11""","156 lbs","15","1",50,65,5,5,1,2,12,5,5,11,1,8,5,1,7,7,10,4,7,6,7,13,5,5,14,5,4,6,6,11,13,13,4,5,14,13,13,6,13,16,10,9,11,14,12,6,6,6,13,12,11,1,3,2,3,1,3,2,3,2,2,4
"6371",23189935,"Matos Alexandre","5/31/1995 (28 years old)","ST (C)","Canas de Senhorim","Portuguese Viseu First Division","MAC","Yes","7/1/2022","-","$0","Left","Very Strong","Reasonable","6'4""","185 lbs","121","36",57,61,4,4,10,12,6,3,12,5,3,4,5,5,1,5,8,10,4,9,4,9,15,10,12,12,5,3,5,5,12,9,5,13,18,11,9,4,8,11,7,9,11,10,5,2,8,1,15,11,8,2,3,3,3,3,2,3,3,3,3,3
"6372",2000063974,"Jordan Maufroy","9/11/2002 (20 years old)","M/AM (C)","RWD Molenbeek","Jupiler Pro League","ASA","No","7/1/2022","6/30/2026","$0 - $22K","Right Only","Weak","Very Strong","5'3""","123 lbs","-","-",64,89,9,8,11,11,11,6,9,11,2,8,11,6,11,14,9,9,5,11,6,11,10,10,1,11,9,10,10,11,9,7,5,3,14,8,9,2,11,12,9,13,14,12,9,2,11,5,9,12,12,1,2,3,1,1,2,3,1,1,2,1
"6373",37054116,"Jan-Willem Tesselaar","10/21/1997 (25 years old)","ST (C)","ADO '20","Dutch Tweede Divisie","AIA","Yes","7/1/2020","-","$0","Right Only","Weak","Very Strong","5'11""","165 lbs","136","23",78,88,8,5,14,5,12,8,15,9,5,4,8,7,4,8,14,11,3,6,5,14,13,5,10,13,4,8,8,14,13,10,10,9,13,14,8,11,9,18,9,11,12,13,8,17,10,8,12,11,19,1,1,1,3,2,1,2,1,2,2,1
"6374",2000181396,"Varian Carty","6/3/2003 (20 years old)","M/AM (R)","Lymers","Anguillan FA Senior Male League","AIA","No","11/1/2022","-","$0","Right","Weak","Very Strong","5'10""","132 lbs","23","4",50,78,6,10,8,8,7,6,4,4,2,6,10,3,7,6,11,7,3,6,7,6,3,10,1,6,6,8,7,11,11,13,14,8,12,12,6,4,12,14,11,12,9,11,5,14,15,5,4,8,17,1,1,1,2,3,2,1,4,2,2,2
"6375",90051047,"Germain Hughes","11/15/1996 (26 years old)","D (LC), WB (L), DM","Cunupia","TT Premier Football League Tier 1","AIA","No","5/12/2023","6/30/2025","$0","Left","Very Strong","Reasonable","6'0""","138 lbs","34","4",68,75,4,8,8,2,9,6,9,7,7,9,11,1,11,9,9,9,8,11,9,9,12,5,13,7,15,8,11,9,9,9,8,9,9,9,9,5,13,10,13,11,11,12,6,6,11,5,9,13,13,4,1,3,2,1,1,1,2,2,1,3
"6376",82072780,"Jonathan Guishard","7/2/1996 (26 years old)","AM (R), ST (C)","Doc's Utd","Anguillan FA Senior Male League","AIA","No","1/1/2021","-","$0","Right","Reasonable","Very Strong","6'1""","198 lbs","30","74",55,60,4,7,12,11,12,4,4,4,1,3,10,3,4,7,14,5,3,10,5,11,7,11,13,9,4,4,1,6,10,12,5,6,10,10,4,12,8,15,12,9,12,14,8,5,13,7,8,11,11,2,3,2,2,1,2,1,3,3,1,2
"6377",2000046375,"Tyrique Lake","1/4/1999 (24 years old)","M (RC)","Roaring Lions (AIA)","Anguillan FA Senior Male League","AIA","No","6/1/2020","-","$0","Right","Weak","Very Strong","6'4""","191 lbs","19","6",53,60,6,8,9,6,8,7,6,6,7,8,9,2,8,8,14,9,8,11,8,11,9,7,8,9,8,8,7,9,9,6,8,15,6,8,10,9,14,20,11,12,11,10,14,13,8,2,8,12,13,2,1,1,3,1,1,4,3,1,3,3
"6378",37054613,"Brian-Paul Tesselaar","12/24/1989 (33 years old)","D/WB/M (L)","ADO '20","Dutch Tweede Divisie","AIA","Yes","6/14/2021","-","$0","Right","Weak","Very Strong","5'8""","143 lbs","18","6",53,56,6,9,8,4,8,7,7,3,7,9,7,1,8,9,15,8,6,8,9,7,9,5,11,8,9,8,6,9,8,11,8,3,15,13,13,6,11,10,11,8,10,13,8,2,10,6,9,12,17,1,1,3,1,1,3,2,2,1,1,2
"6379",83111646,"Regize Canistan","3/25/1997 (26 years old)","M/AM (L)","Amical Saint-Prex","Swiss Second League Interregio Gr 1","SRI","Yes","2/22/2023","6/30/2024","$0 - $18K","Right","Reasonable","Very Strong","5'7""","154 lbs","17","5",67,81,6,11,10,10,12,5,4,6,5,4,7,1,1,10,15,5,7,6,5,11,13,10,11,10,5,6,9,11,13,13,6,1,10,13,11,1,8,17,13,14,11,11,9,5,8,3,7,14,17,2,2,3,3,1,2,2,3,1,4,1
"6380",2000088584,"Andros Bowens","12/19/1984 (38 years old)","D (LC)","Doc's Utd","Anguillan FA Senior Male League","AIA","No","2/1/2022","-","$0","Left Only","Very Strong","Weak","5'11""","163 lbs","24","3",54,55,5,8,5,4,9,2,10,5,7,11,10,2,10,8,9,11,9,11,10,11,9,5,12,9,8,9,9,10,6,9,10,10,11,8,10,7,12,16,10,10,12,13,8,12,12,3,17,12,17,3,1,1,2,1,2,3,1,1,2,3
"6381",148754,"Ali Ashfaq","9/6/1985 (37 years old)","ST (C)","Super United","Maldivian Dhivehi League","MDV","No","4/17/2023","12/31/2023","$0","Left","Very Strong","Strong","5'10""","152 lbs","114","124",65,85,3,6,8,12,12,4,7,3,1,2,3,1,2,9,11,9,11,10,4,9,17,12,14,10,4,4,9,6,7,9,3,6,15,7,9,9,8,17,11,5,13,4,9,12,10,5,14,15,13,1,3,3,2,3,1,1,1,3,1,3
"6382",2000261820,"Hassan Raif","1/30/1998 (25 years old)","AM (R)","Maziya SRC","Maldivian Dhivehi League","MDV","No","2/5/2023","12/31/2025","$0 - $3.5K","Right","Fairly Strong","Very Strong","5'10""","154 lbs","-","-",55,75,6,9,9,8,11,4,4,1,4,1,9,4,5,6,13,6,6,8,5,9,16,7,2,8,4,5,5,10,12,10,2,5,7,12,11,3,13,11,11,13,10,12,9,5,5,1,9,9,15,2,2,2,1,3,3,2,2,2,4,2
"6383",23033688,"Mohamed Arif","8/11/1985 (37 years old)","M (C)","Eagles (MDV)","Maldivian Dhivehi League","MDV","No","6/14/2021","12/31/2023","$0","Right","Fairly Strong","Very Strong","5'9""","134 lbs","73","5",55,70,4,5,4,4,10,7,7,6,4,11,15,4,7,9,6,6,5,11,8,12,13,5,12,9,7,8,9,8,9,9,8,7,10,9,6,6,9,15,10,9,10,9,8,11,15,8,18,11,11,2,3,1,1,1,4,3,1,1,1,1
"6384",23033500,"Mohamed Umair","7/3/1988 (34 years old)","D/WB (L), M/AM (LC)","Valencia (MDV)","Maldivian Dhivehi League","MDV","No","1/1/2023","12/31/2023","$0","Left Only","Very Strong","Weak","5'5""","121 lbs","77","28",58,67,7,9,6,9,10,7,7,6,7,8,8,1,9,10,14,8,8,9,8,13,18,13,14,12,9,7,8,9,10,7,7,5,13,8,7,1,15,16,12,9,9,11,7,7,13,6,11,11,7,1,2,2,2,1,2,3,3,4,2,2
"6385",23214192,"Ibrahim Waheed Hassan","11/15/1995 (27 years old)","DM, M (C)","Valencia (MDV)","Maldivian Dhivehi League","MDV","No","6/15/2020","12/31/2023","$0","Right Only","Weak","Very Strong","5'8""","143 lbs","22","-",50,63,3,5,2,3,8,5,5,5,5,7,7,3,12,7,14,9,5,7,6,13,11,5,9,6,8,6,8,13,9,12,6,4,13,11,13,5,9,13,10,11,9,8,11,1,8,4,9,11,19,1,3,1,1,3,2,3,3,2,1,2
"6386",23093092,"Asadhulla Abdulla","10/19/1990 (32 years old)","AM (RL), ST (C)","Maziya SRC","Maldivian Dhivehi League","MDV","No","6/14/2021","12/31/2023","$0","Right","Reasonable","Very Strong","5'9""","152 lbs","116","73",50,58,4,8,6,5,8,5,6,7,1,5,3,1,3,9,7,6,7,7,4,12,4,8,8,5,5,6,4,13,9,8,6,6,11,11,11,11,8,11,12,10,12,13,9,5,15,8,20,12,17,1,1,3,2,2,3,4,1,1,2,1
"6387",23033605,"Akram Abdul Ghanee","3/19/1987 (36 years old)","D (C), DM","United Victory","Maldivian Dhivehi League","MDV","No","1/1/2022","12/31/2023","$0","Right Only","Weak","Very Strong","5'7""","132 lbs","80","10",56,57,3,4,2,2,10,5,10,8,1,12,7,3,7,9,10,10,9,8,14,9,16,3,17,7,10,7,8,9,7,5,8,6,12,7,13,12,13,10,12,11,11,12,10,8,5,7,11,10,15,2,3,1,1,2,1,1,1,1,1,3
"6388",23097889,"Rilwan Waheed","2/14/1991 (32 years old)","D (R)","Green Streets","Maldivian Dhivehi League","MDV","No","1/1/2019","12/31/2023","$0","Right","Reasonable","Very Strong","5'10""","130 lbs","88","11",55,55,5,11,5,4,10,1,3,4,6,6,4,5,9,6,12,9,6,6,9,10,1,5,13,4,10,7,3,8,12,8,7,5,12,7,13,6,8,14,11,11,12,9,9,11,15,5,11,12,17,1,3,2,1,3,3,3,1,1,4,1
"6389",23093091,"Ali Fasir","9/4/1988 (34 years old)","AM (R), ST (C)","Maziya SRC","Maldivian Dhivehi League","MDV","No","2/6/2023","12/31/2023","$0","Right","Reasonable","Very Strong","5'6""","130 lbs","58","31",50,55,5,5,12,12,10,5,6,3,5,5,8,3,1,11,10,7,5,9,5,11,15,12,12,10,5,6,4,7,10,10,6,1,13,13,8,1,9,18,12,10,12,13,5,1,6,7,8,11,10,3,2,2,4,1,4,1,2,3,1,3
"6390",2000048283,"Oliver Kelaart","4/16/1998 (25 years old)","AM (RL), ST (C)","Njarðvík","Icelandic First Division","SRI","No","1/19/2023","11/16/2023","$1K - $10K","Right","Reasonable","Very Strong","5'10""","143 lbs","34","15",74,80,4,8,9,9,13,7,10,6,7,7,9,2,6,8,7,9,5,11,7,8,7,11,11,12,7,8,8,9,13,9,8,4,15,12,14,5,13,11,10,12,9,12,10,14,6,2,11,11,17,2,1,3,3,2,3,2,1,2,3,2
"6391",23033545,"Ismail Easa","12/19/1988 (34 years old)","M/AM (C)","Eagles (MDV)","Maldivian Dhivehi League","MDV","No","12/1/2021","12/31/2023","$0","Right Only","Weak","Very Strong","5'3""","123 lbs","53","7",51,55,6,6,11,4,12,6,3,8,1,7,7,3,8,7,13,10,5,10,8,7,15,9,11,10,5,7,5,8,14,10,8,1,13,14,7,3,14,20,11,11,10,9,6,9,7,7,7,10,9,1,3,2,3,3,1,2,2,4,2,1
"6392",23093098,"Mohamed Faisal","8/4/1988 (34 years old)","GK","Maziya SRC","Maldivian Dhivehi League","MDV","No","1/1/2023","12/31/2023","$0","Right Only","Weak","Very Strong","5'7""","163 lbs","54","-",50,53,3,3,3,1,2,8,1,2,3,1,9,2,2,1,9,9,8,7,10,8,9,2,7,3,12,8,7,7,10,10,8,7,15,12,4,6,11,12,9,11,11,13,10,9,10,4,18,12,12,7,6,8,14,8,6,9,8,9,12,10
"6393",23033510,"Ashad Ali","9/14/1986 (36 years old)","ST (C)","Valencia (MDV)","Maldivian Dhivehi League","MDV","No","12/1/2021","12/31/2023","$0","Right","Reasonable","Very Strong","5'11""","132 lbs","68","34",50,53,6,3,5,11,9,3,11,5,2,4,7,8,3,10,7,9,2,10,6,13,6,12,6,14,6,6,5,7,9,8,6,10,15,8,6,9,8,20,9,13,12,8,6,8,7,8,12,9,14,3,2,1,1,2,1,2,3,3,1,3
"6394",40010251,"Rohit Chand","3/1/1992 (31 years old)","M (C)","Persik","Indonesian League One","NEP","No","5/22/2022","5/31/2024","$2.5K - $24K","Left","Very Strong","Fairly Strong","5'8""","156 lbs","214","15",77,81,9,6,8,8,10,6,8,9,6,7,10,1,8,8,15,12,7,10,11,12,15,5,7,11,12,9,12,9,11,12,8,8,13,11,12,7,12,19,12,11,12,11,12,6,15,8,11,10,18,1,3,1,1,3,2,1,3,1,1,3
"6395",2000076113,"Aashish Rai","2/3/2001 (22 years old)","AM (C), ST (C)","Coastal Spirit","New Zealand Southern League","NEP","No","12/31/2021","-","$0","Right Only","Weak","Very Strong","5'10""","143 lbs","-","-",59,77,7,6,13,7,12,8,7,7,4,3,8,7,4,10,13,8,8,9,8,5,7,16,6,7,3,4,8,7,13,11,11,10,13,12,11,6,13,16,12,14,10,12,14,15,10,3,10,13,16,1,1,3,1,1,2,3,3,2,2,2
"6396",2000095161,"Sulav Maskey","2/14/1993 (30 years old)","M/AM (R)","Darwin Hearts FC","Norzone Premier League","NEP","No","1/3/2022","-","$0","Right","Fairly Strong","Very Strong","5'8""","138 lbs","122","78",61,70,4,7,9,8,13,1,3,6,5,5,5,2,6,8,7,7,4,5,6,7,15,8,9,9,5,6,6,11,13,13,5,1,10,13,9,6,7,11,11,12,9,13,14,2,11,7,8,11,18,3,2,2,1,3,2,3,4,2,2,3
"6397",54200452,"Anjan Bista","5/15/1998 (25 years old)","AM (R), ST (C)","Church Boys United","Nepali A-Division League","NEP","No","6/1/2023","12/31/2023","$0","Right Only","Weak","Very Strong","5'8""","136 lbs","8","1",51,70,4,7,11,11,9,4,7,5,2,3,9,7,2,7,5,9,6,10,4,7,5,10,8,8,4,5,2,6,12,12,5,1,9,12,10,3,12,19,10,11,10,10,7,3,13,7,12,10,15,3,3,3,2,1,2,2,3,1,2,2
"6398",2000229024,"Aryan Rai","1/23/2001 (22 years old)","AM (L), ST (C)","Kowloon City","Hong Kong First Division","NEP","No","10/11/2022","6/30/2024","$0","Right Only","Weak","Very Strong","5'7""","149 lbs","64","54",54,67,7,8,7,11,7,7,4,4,7,7,9,2,5,6,11,8,7,8,12,9,12,7,14,11,7,6,5,10,12,10,11,6,10,12,9,10,6,20,11,12,12,12,8,3,7,1,12,13,19,2,2,2,3,1,1,4,3,1,1,1
"6399",18087913,"Bimal Gharti Magar","1/26/1998 (25 years old)","ST (C)","Machhindra FC","Nepali A-Division League","NEP","No","1/1/2020","12/31/2023","$0","Right Only","Weak","Very Strong","6'0""","158 lbs","12","4",55,65,6,5,12,7,12,6,3,5,1,1,12,2,1,12,13,10,3,9,7,9,14,14,12,7,7,6,2,10,16,12,4,8,16,15,5,5,10,15,11,9,11,11,5,4,14,8,7,16,13,3,3,4,2,2,1,1,1,3,4,3
"6400",2000287454,"Manish Dangi","9/17/2001 (21 years old)","M (R), AM (RLC)","Sankata Boys","Nepali A-Division League","NEP","No","1/12/2023","12/31/2023","$0","Right","Weak","Very Strong","5'7""","134 lbs","-","-",53,60,5,8,9,8,6,5,5,4,5,5,5,1,4,9,6,6,7,7,6,13,18,12,4,10,5,6,5,7,13,10,6,1,18,11,8,2,12,20,11,10,11,10,10,9,6,3,8,10,20,3,1,2,2,1,3,4,2,1,2,1
"6401",2000090522,"Mushakir Razeek","2/19/1999 (24 years old)","M (C), AM (RC)","Zehlendorf","German Div. North East - North","SRI","Yes","7/1/2021","6/30/2025","$0","Right Only","Weak","Very Strong","5'11""","160 lbs","97","8",68,80,4,6,8,11,11,2,6,4,2,7,8,3,8,7,15,11,7,8,8,11,17,10,4,11,7,7,14,12,14,11,7,8,12,12,9,9,10,14,13,10,13,10,9,6,7,1,7,12,9,1,1,2,1,2,1,1,1,2,2,1
"6402",23036227,"Biraj Maharjan","9/18/1990 (32 years old)","D/WB (L)","Chyasal Youth","Nepali B-Division League","NEP","No","11/1/2021","12/31/2023","$0","Left","Very Strong","Reasonable","5'9""","143 lbs","7","-",50,52,6,13,7,1,8,4,7,5,7,8,8,4,10,7,7,9,8,6,10,7,12,8,14,6,8,8,7,9,9,6,8,7,15,7,13,6,9,14,11,12,12,12,12,9,14,5,10,13,20,2,4,1,2,2,3,2,1,3,1,1
"6403",2000090182,"Niraj Basnet","7/7/1994 (28 years old)","ST (C)","Nomads","New Zealand Southern League","NEP","No","3/22/2023","-","$0","Right","Reasonable","Very Strong","5'11""","171 lbs","7","-",50,50,2,3,9,12,11,4,11,5,1,4,5,7,1,8,12,5,6,8,5,4,11,9,11,9,5,4,7,5,12,12,5,8,13,12,10,8,12,14,13,10,11,9,5,5,10,3,10,10,8,1,2,3,2,1,3,1,2,3,1,1
"6404",23228819,"Chencho","5/10/1996 (27 years old)","AM (RL), ST (C)","Machhindra FC","Nepali A-Division League","BHU","No","4/1/2023","12/31/2023","$0","Right","Reasonable","Very Strong","5'8""","143 lbs","184","99",62,71,8,7,6,7,6,6,10,7,6,5,7,1,4,9,7,8,1,10,9,6,7,15,11,8,5,9,7,13,13,11,7,6,13,13,11,9,12,12,8,10,10,11,15,3,8,7,8,11,7,3,2,2,3,3,1,1,2,3,2,2
"6405",23218296,"Tshering Dorji","9/11/1995 (27 years old)","M/AM (LC)","Queanbeyan City","Capital Premier League","BHU","No","2/1/2022","-","$0","Right","Weak","Very Strong","5'7""","145 lbs","18","11",50,55,3,3,8,6,9,4,4,3,4,4,7,1,3,7,7,6,6,6,6,12,17,9,5,7,6,6,7,11,12,10,5,5,15,11,11,1,10,20,12,12,12,11,5,4,5,2,11,14,8,3,2,1,1,2,4,2,2,2,4,1
"6406",82085986,"Peter Beniseau","1/12/1995 (28 years old)","DM, M/AM (C)","Diables Rouges","Saint Barthélemy Ligue","BLM","Yes","7/1/2018","-","$0","Right","Weak","Very Strong","6'1""","167 lbs","4","-",55,65,5,4,6,5,6,5,6,7,1,5,5,1,8,10,13,9,6,6,5,13,17,11,13,7,9,6,4,6,13,13,6,10,13,12,10,5,9,19,10,15,11,13,9,5,5,7,13,14,17,2,2,1,3,2,4,1,2,1,3,2
"6407",82085982,"Anthony Maxor","1/2/1997 (26 years old)","AM (R), ST (C)","Team FWI","Saint Barthélemy Ligue","BLM","Yes","6/15/2020","-","$0","Right","Reasonable","Very Strong","5'8""","152 lbs","-","-",51,60,4,7,7,9,5,2,7,4,4,4,7,4,3,7,10,6,6,7,4,10,12,8,5,6,3,4,4,6,12,12,5,4,12,12,8,10,10,12,12,9,11,10,5,16,8,6,10,13,16,2,1,2,3,2,2,3,1,3,2,3
"6408",82085966,"Rui Pedro Quintela","11/23/1995 (27 years old)","D/WB/M/AM (L)","Gustavia","Saint Barthélemy Ligue","BLM","Yes","6/15/2020","-","$0","Left","Very Strong","Weak","5'6""","132 lbs","-","-",50,55,5,9,8,8,6,2,3,3,4,5,7,3,6,7,9,7,6,4,4,7,18,8,3,9,5,5,6,7,12,12,4,1,9,12,11,1,13,13,11,12,10,13,11,10,9,4,8,10,14,3,4,3,1,2,4,3,3,3,4,4
"6409",82085976,"Luciano Freitas","12/22/1993 (29 years old)","M (C)","ASPSB","Saint Barthélemy Ligue","BLM","Yes","6/15/2020","-","$0","Right","Reasonable","Very Strong","6'2""","171 lbs","-","-",53,55,5,1,6,6,13,1,1,5,1,7,9,1,8,9,5,7,2,6,3,7,13,5,14,6,6,6,6,6,13,12,6,12,16,13,7,9,12,13,12,11,11,12,8,8,7,7,9,13,17,2,2,2,3,2,3,3,1,1,2,1
"6410",82086008,"Raoul Richardson","3/4/1990 (33 years old)","ST (C)","Gustavia","Saint Barthélemy Ligue","BLM","Yes","6/14/2021","-","$0","Left","Very Strong","Fairly Strong","5'9""","160 lbs","-","-",50,53,5,2,9,10,10,5,13,5,1,3,4,3,1,7,6,6,4,8,4,7,15,7,7,7,6,5,5,6,8,8,6,3,8,9,11,8,10,14,7,12,9,12,12,6,5,3,8,12,9,1,4,3,3,2,4,1,1,3,2,3
"6411",82085952,"Ze Gato","10/21/1991 (31 years old)","D/WB/M/AM (L)","Gustavia","Saint Barthélemy Ligue","BLM","Yes","6/14/2021","-","$0","Left","Very Strong","Weak","6'0""","189 lbs","-","-",50,50,7,7,9,9,10,5,4,2,7,8,11,4,6,6,7,8,6,9,7,7,5,12,13,8,9,8,5,9,12,10,8,9,11,9,8,5,9,18,11,12,12,12,12,12,8,6,10,10,12,1,2,3,1,3,1,2,1,1,1,3
"6412",29218346,"Dillon De Silva","4/18/2002 (21 years old)","AM (RL)","QPR","Sky Bet Championship","SRI","No","7/1/2018","6/30/2026","$0 - $20K","Right","Fairly Strong","Very Strong","5'9""","147 lbs","19","3",64,79,5,6,10,7,6,4,5,6,4,6,7,4,5,7,13,9,8,5,6,7,4,12,5,6,4,9,8,9,14,11,8,7,15,12,7,5,8,16,12,13,9,12,6,6,6,6,6,10,8,2,2,2,1,3,1,2,3,3,4,3
"6413",82085995,"Bruno Guimaraes","1/21/1987 (36 years old)","M/AM (L)","Gustavia","Saint Barthélemy Ligue","BLM","Yes","6/14/2021","-","$0","Left Only","Very Strong","Weak","5'11""","158 lbs","-","-",50,50,7,10,6,11,11,5,7,7,7,4,8,5,6,9,15,8,4,8,8,12,14,10,10,9,7,8,7,9,10,8,8,10,11,7,10,5,11,18,9,10,9,12,12,1,6,3,20,10,7,3,1,2,2,2,4,3,2,2,2,2
"6414",88026016,"Kina Likiliki","12/19/1999 (23 years old)","AM (R), ST (C)","Christchurch United","New Zealand Southern League","TGA","No","6/15/2020","-","$0","Right Only","Weak","Very Strong","5'9""","167 lbs","-","-",54,63,8,6,8,10,9,8,8,8,4,4,8,5,6,10,5,8,9,7,8,6,18,8,12,8,3,9,8,12,11,8,9,8,8,11,11,14,9,17,12,10,12,10,13,17,14,8,10,11,17,1,2,1,2,3,2,2,3,2,3,2
"6415",2000013888,"AJ Inia","4/25/2000 (23 years old)","AM (RL)","Chainat Hornbill","Thai League Two","TGA","No","6/12/2023","6/30/2025","$0 - $95K","Right","Reasonable","Very Strong","6'0""","165 lbs","52","3",60,62,9,11,7,9,9,7,7,8,4,7,6,2,6,7,14,8,6,6,8,6,5,5,10,10,7,9,9,12,12,12,5,11,13,11,7,6,12,14,9,7,13,11,5,5,12,8,9,13,9,1,1,3,1,2,1,2,1,1,1,3
"6416",2000133909,"Dagsan Vigneswaran","2/5/2004 (19 years old)","D (C)","Concordia LS","Swiss Second League Interregio Gr 2","SRI","Yes","6/12/2023","-","$0","Right","Weak","Very Strong","6'1""","165 lbs","2","-",58,71,2,1,1,1,4,1,13,5,4,13,3,1,8,3,13,4,8,6,4,12,5,5,8,2,10,5,2,6,13,12,6,8,6,11,6,3,13,14,12,10,11,9,8,7,15,2,9,13,7,1,1,1,1,1,3,2,1,3,1,1
"6417",92063499,"Ahmed Razeek","9/19/1994 (28 years old)","WB (R), M (RL), AM (R)","Eastern District","Hong Kong First Division","SRI","Yes","1/6/2023","6/30/2024","$1.5K - $18K","Right Only","Weak","Very Strong","5'10""","149 lbs","131","31",60,65,2,5,6,5,9,1,3,4,2,4,9,1,3,12,6,4,2,5,5,11,11,13,9,6,4,5,5,7,12,12,5,7,11,12,12,6,19,6,11,12,9,11,5,11,8,8,9,13,6,2,2,2,2,2,1,2,2,1,1,1
"6418",2000307869,"Sizolwethu Shabalala","8/5/1996 (26 years old)","M (C), AM (LC)","Mbabane Swallows","Premier League of Eswatini","SWZ","No","6/15/2020","6/30/2024","$55K - $160K","Right Only","Weak","Very Strong","5'10""","147 lbs","-","-",83,91,7,10,6,8,13,11,6,11,1,4,7,2,8,12,13,8,4,11,7,10,13,13,8,12,7,7,5,12,13,13,13,5,7,13,12,3,13,11,12,11,11,9,9,9,10,4,11,10,13,3,2,3,1,1,3,3,1,1,1,3
"6419",23159803,"Kanagaraja Sudarshan","6/20/1997 (25 years old)","D/WB (L)","Navy Sea Hawks","Sri Lankan Super League","SRI","No","6/15/2020","12/31/2024","$0","Left Only","Very Strong","Weak","5'9""","145 lbs","-","-",54,58,1,7,4,3,4,1,3,4,5,6,5,1,5,7,8,8,7,6,7,11,18,5,4,4,8,6,4,7,13,13,6,3,15,13,12,5,13,18,11,11,14,11,7,2,13,7,10,12,11,1,2,1,3,3,1,2,3,2,2,2
"6420",23161164,"Kumara Sirisena","3/27/1999 (24 years old)","M/AM (R)","Defenders","Sri Lankan Super League","SRI","No","6/15/2020","12/31/2024","$0","Right","Weak","Very Strong","5'8""","138 lbs","-","-",51,57,6,9,6,9,10,4,3,5,1,3,9,4,3,5,9,6,6,8,5,9,6,9,10,9,4,5,3,10,12,12,5,3,14,12,12,2,12,11,12,9,10,9,9,1,9,8,13,11,16,2,2,2,3,2,3,3,2,2,3,3
"6421",23161165,"Yamanalage Lakshitha Jayathunga","8/7/1996 (26 years old)","M/AM (R)","Defenders","Sri Lankan Super League","SRI","No","6/15/2020","12/31/2024","$1.5K - $4K","Right","Reasonable","Very Strong","5'9""","141 lbs","-","-",54,57,5,9,6,9,13,3,3,2,3,5,5,8,4,10,13,8,6,12,4,8,9,10,10,9,4,7,4,10,13,11,6,8,17,11,5,3,9,13,14,12,11,13,5,13,8,5,10,10,19,2,1,3,1,4,2,1,2,3,3,2
"6422",29008510,"Marvin Hamilton","10/8/1988 (34 years old)","D (RC), WB/M (R)","Hythe","English Isthmian League South East Division","SRI","No","7/1/2022","6/30/2024","$0","Right Only","Weak","Very Strong","6'0""","156 lbs","254","11",51,55,5,7,3,4,12,4,7,5,8,6,7,5,8,8,15,7,8,7,8,8,10,7,6,9,7,7,5,12,11,9,8,11,12,11,11,8,14,19,11,11,9,10,5,7,16,7,10,11,15,1,3,2,1,3,3,1,3,1,2,2
"6423",23398932,"Asikur Rahuman Alawadeen","12/31/1993 (29 years old)","D (C), DM","Defenders","Sri Lankan Super League","SRI","No","7/1/2019","12/31/2023","$0","Right","Reasonable","Very Strong","5'8""","143 lbs","-","-",51,55,4,1,1,1,6,1,6,3,1,10,8,1,8,6,9,9,2,3,3,12,14,5,10,4,9,6,7,11,12,12,5,4,13,12,10,5,9,16,14,10,11,12,6,10,9,7,13,14,11,1,1,2,2,1,3,1,3,3,2,2
"6424",23401684,"Arubishan Daniel","10/20/1997 (25 years old)","M (C)","Solid (SRI)","Sri Lankan Premier League","SRI","No","6/15/2020","12/31/2024","$0","Right","Reasonable","Very Strong","5'5""","125 lbs","-","-",50,53,5,5,2,5,4,5,5,5,1,9,13,2,6,8,6,9,7,5,5,10,9,7,14,10,4,6,11,11,13,13,6,4,14,13,11,1,10,11,11,10,10,9,7,2,7,8,16,10,14,2,1,2,2,3,1,1,3,3,2,3
"6425",2000256980,"Mehedi Hasan","1/2/2004 (19 years old)","GK","Bashundhara Kings","Bangladeshi Premier League","BAN","No","7/1/2022","12/31/2023","$0 - $7K","Right","Fairly Strong","Very Strong","5'11""","160 lbs","-","-",70,95,2,3,2,1,6,6,1,1,1,3,8,2,2,1,13,8,14,8,7,14,5,3,4,3,6,8,5,7,10,8,8,8,12,9,4,7,8,12,13,9,13,11,13,18,8,6,18,9,10,6,9,10,10,8,10,14,11,9,10,7
"6426",2000057217,"Mohammed Rimon Hossain","7/1/2005 (17 years old)","D/WB (L)","Bashundhara Kings","Bangladeshi Premier League","BAN","No","9/29/2021","8/31/2023","$1.5K - $4.5K","Left","Very Strong","Fairly Strong","5'10""","143 lbs","40","-",52,86,4,13,7,1,8,3,5,2,6,5,8,2,11,8,5,8,7,6,7,8,8,5,9,6,5,7,3,8,13,10,7,8,8,10,9,4,10,12,11,11,11,13,12,11,10,4,7,10,17,3,3,2,3,2,3,3,4,3,3,3
"6427",1000601,"Rakib","11/18/1998 (24 years old)","M (L), AM (RL)","Bashundhara Kings","Bangladeshi Premier League","BAN","No","10/8/2022","12/31/2023","$2K - $6K","Left","Very Strong","Reasonable","5'8""","147 lbs","45","11",70,85,6,11,8,6,10,6,4,5,3,5,8,2,5,12,15,10,2,6,6,10,13,12,13,8,6,7,8,8,13,13,7,1,7,13,4,5,11,15,10,12,12,11,8,1,10,1,12,10,20,3,1,1,1,4,2,1,3,3,2,1
"6428",23331743,"Tutul Hossain Badsha","8/12/1999 (23 years old)","D (C)","Bashundhara Kings","Bangladeshi Premier League","BAN","No","10/8/2022","12/31/2023","$0 - $1.5K","Right","Weak","Very Strong","5'9""","158 lbs","75","-",68,85,3,2,2,1,9,1,14,1,3,14,5,3,14,7,12,10,9,8,10,9,11,5,4,7,12,7,4,8,9,9,8,5,8,12,8,8,11,18,11,11,12,11,13,5,6,1,10,11,9,3,1,3,3,4,1,2,2,4,3,2
"6429",2000311253,"Thubelihle Mavuso","10/5/2001 (21 years old)","M (L), AM (RL)","Nsingizini Hotspurs","Premier League of Eswatini","SWZ","No","7/1/2021","6/30/2024","$18K - $55K","Left Only","Very Strong","Weak","5'6""","138 lbs","26","5",67,91,6,8,13,6,12,6,6,14,1,6,13,2,6,12,15,11,2,10,7,14,12,14,8,10,4,4,9,8,11,13,7,4,13,14,5,3,14,20,10,12,9,11,5,13,11,3,18,12,8,1,1,2,2,3,2,2,2,1,2,2
"6430",2000053907,"Mahamudul Hasan Kiron","9/1/2001 (21 years old)","D/WB (R)","Bashundhara Kings","Bangladeshi Premier League","BAN","No","10/11/2022","12/31/2024","$0 - $1.5K","Right","Fairly Strong","Very Strong","5'9""","149 lbs","-","-",60,82,3,8,7,5,7,1,4,3,6,8,4,4,13,7,8,6,7,8,8,9,12,6,14,7,7,7,6,8,9,13,7,7,6,13,10,5,10,15,12,10,13,12,12,15,5,8,6,13,14,3,3,4,2,2,1,1,2,1,4,2
"6431",54200761,"Bishwanath Ghosh","5/30/1999 (24 years old)","D (RL), WB (R)","Bashundhara Kings","Bangladeshi Premier League","BAN","No","9/29/2021","8/31/2023","$0","Right","Reasonable","Very Strong","5'6""","130 lbs","87","-",57,80,4,8,1,1,7,1,5,5,15,7,11,3,7,11,12,9,8,7,8,11,4,5,12,9,8,7,7,10,13,13,5,4,15,13,10,1,15,19,11,11,11,10,5,9,13,2,11,10,15,3,3,1,2,2,3,1,2,1,1,2
"6432",54200759,"Anisur Rahman","8/10/1997 (25 years old)","GK","Bashundhara Kings","Bangladeshi Premier League","BAN","No","9/28/2021","8/31/2023","$0","Right","Weak","Very Strong","5'11""","160 lbs","79","-",70,80,2,2,2,2,2,5,1,1,2,1,7,3,3,4,6,6,14,6,9,12,8,2,8,1,8,6,5,5,10,9,6,8,10,6,1,5,10,15,14,10,11,11,7,12,15,7,13,14,18,13,10,12,12,10,9,8,12,11,9,12
"6433",54200760,"Biplu Ahmed","5/5/1999 (24 years old)","M (C), AM (RL)","Bashundhara Kings","Bangladeshi Premier League","BAN","No","9/30/2021","8/31/2023","$0","Right","Fairly Strong","Very Strong","6'1""","167 lbs","39","2",60,80,4,2,13,12,10,4,4,4,1,3,6,1,4,11,6,6,4,1,5,8,11,12,13,11,6,6,9,11,12,11,3,10,12,13,12,6,10,14,11,11,9,12,5,11,11,8,10,11,9,1,2,2,2,2,2,3,1,3,3,1
"6434",54200765,"Masuk Miah Zoni","1/16/1998 (25 years old)","DM, M (C)","Bashundhara Kings","Bangladeshi Premier League","BAN","No","9/30/2021","8/31/2023","$0","Left","Very Strong","Reasonable","6'0""","176 lbs","60","-",62,80,5,5,6,4,5,5,4,4,3,7,14,3,8,7,13,9,7,7,6,10,16,5,9,6,9,6,8,11,13,13,6,9,10,11,13,11,12,10,11,8,14,10,11,11,6,6,19,13,10,3,2,2,2,3,2,2,3,2,2,2
"6435",2000053913,"Enamul Islam","10/12/2001 (21 years old)","M (R), AM (RL)","Rahamatganj MFS","Bangladeshi Premier League","BAN","No","7/1/2018","12/31/2023","$0","Right","Reasonable","Very Strong","5'10""","152 lbs","-","-",55,79,6,11,9,7,12,3,1,2,4,5,8,1,2,8,10,5,3,3,6,9,5,13,4,11,5,6,4,11,13,13,6,7,10,13,9,3,12,18,11,13,10,13,10,8,13,7,10,12,19,2,3,3,3,1,1,3,2,1,2,3
"6436",33070085,"Tariq Kazi","10/6/2000 (22 years old)","D/WB (R)","Bashundhara Kings","Bangladeshi Premier League","BAN","Yes","11/12/2019","8/31/2023","$0","Right Only","Weak","Very Strong","5'10""","174 lbs","76","-",55,76,6,6,6,4,7,3,7,7,9,7,7,5,6,7,8,11,15,10,11,12,13,8,12,11,7,9,6,10,11,12,5,7,17,11,9,6,13,8,12,11,11,13,11,10,12,3,16,14,12,1,1,1,4,3,3,3,1,1,2,2
"6437",54200116,"Motin Mia","12/20/1998 (24 years old)","AM (RL), ST (C)","Bashundhara Kings","Bangladeshi Premier League","BAN","No","7/1/2018","8/31/2023","$0","Right","Reasonable","Very Strong","5'11""","149 lbs","62","14",52,75,1,5,13,13,10,3,4,5,1,3,6,8,3,6,6,6,5,11,2,8,8,8,10,8,2,4,4,5,12,11,4,3,14,12,10,2,10,20,11,10,14,13,9,8,8,2,11,12,17,1,3,3,1,3,1,1,4,3,2,3
"6438",54200770,"Mahbubur Rahman","9/10/1999 (23 years old)","AM (RL), ST (C)","Mohammedan SC (D)","Bangladeshi Premier League","BAN","No","10/26/2022","12/31/2024","$0 - $5K","Right","Reasonable","Very Strong","5'5""","125 lbs","52","1",55,75,7,13,9,8,9,5,6,3,3,2,7,1,5,5,5,6,1,4,3,12,8,13,13,10,1,5,4,6,12,12,5,1,14,13,3,1,12,13,12,12,13,11,12,8,11,5,14,10,7,1,2,4,1,1,1,2,3,2,2,2
"6439",2000054175,"Mohamed Shadhin","12/18/1999 (23 years old)","M/AM (R)","Rahamatganj MFS","Bangladeshi Premier League","BAN","No","10/1/2021","12/31/2023","$0","Right","Reasonable","Very Strong","5'8""","138 lbs","39","1",50,70,6,9,6,7,6,5,4,4,5,5,9,2,6,11,11,7,7,6,6,10,10,11,12,9,5,6,6,7,11,12,6,5,15,11,9,2,12,19,12,11,11,12,5,10,6,8,10,9,10,2,1,3,1,2,3,1,2,3,3,4
"6440",13104291,"Sabelo Gamedze","12/26/1993 (29 years old)","M (R), AM (RC)","Sea Birds","Premier League of Eswatini","SWZ","No","2/11/2023","6/30/2024","$6K - $60K","Right","Fairly Strong","Very Strong","6'0""","156 lbs","-","-",82,90,6,11,10,10,12,5,2,5,1,5,8,2,3,12,10,10,1,8,6,12,3,13,5,13,5,6,6,9,12,12,7,5,14,12,12,4,12,11,10,14,13,10,8,14,9,2,18,9,15,3,2,3,1,4,3,1,4,3,2,2
"6441",23193733,"Kingsley Eleta","10/29/1989 (33 years old)","ST (C)","Bashundhara Kings","Bangladeshi Premier League","BAN","No","4/1/2021","12/31/2024","$0","Right","Fairly Strong","Very Strong","5'10""","156 lbs","46","23",52,70,4,4,5,13,9,5,11,6,1,5,2,10,3,8,8,13,5,13,6,13,9,12,4,12,3,2,6,6,10,7,6,3,12,11,7,5,10,12,13,13,10,8,6,1,9,7,9,15,17,1,1,3,3,2,1,3,3,2,1,1
"6442",23331689,"Mohammad Jewel Rana","12/25/1995 (27 years old)","AM (RC)","Abahani KC (D)","Bangladeshi Premier League","BAN","No","10/25/2021","8/31/2023","$0","Right","Fairly Strong","Very Strong","5'7""","134 lbs","80","25",62,70,4,10,12,8,10,5,7,8,1,5,9,5,5,8,6,6,5,9,7,13,15,12,12,11,6,7,7,8,10,14,7,7,12,12,7,1,12,18,12,12,12,11,14,10,8,3,20,13,8,3,1,4,2,3,2,3,3,3,3,2
"6443",23194007,"Sohel Rana","3/27/1995 (28 years old)","DM, M (LC)","Bashundhara Kings","Bangladeshi Premier League","BAN","No","10/1/2021","12/31/2023","$0 - $1.5K","Left","Very Strong","Reasonable","5'7""","145 lbs","78","3",62,70,15,14,13,12,6,14,6,7,3,7,7,3,9,13,10,9,7,4,5,10,2,5,11,6,11,6,5,7,9,11,7,1,10,9,9,6,14,17,9,9,12,13,12,10,7,1,12,11,20,2,1,3,2,2,1,2,3,1,1,3
"6444",23188453,"Topu Barman","12/20/1994 (28 years old)","D (RC)","Bashundhara Kings","Bangladeshi Premier League","BAN","No","10/6/2019","8/31/2023","$0","Right","Reasonable","Very Strong","6'0""","165 lbs","52","5",68,70,5,5,4,1,5,1,8,6,1,12,8,2,14,6,5,11,8,8,9,10,13,5,7,6,8,7,6,9,13,10,8,6,9,13,13,6,8,17,9,11,12,10,12,1,6,7,9,12,16,3,3,1,2,2,2,3,1,2,2,3
"6445",23193644,"Sahidul Alam","5/1/1992 (31 years old)","GK","Abahani KC (D)","Bangladeshi Premier League","BAN","No","6/14/2021","12/31/2024","Not for Sale","Right","Reasonable","Very Strong","6'1""","167 lbs","21","-",65,70,3,3,2,2,2,5,1,3,1,2,7,3,3,3,11,7,14,7,12,6,17,1,7,3,11,7,6,6,12,15,4,13,12,9,6,5,9,14,11,10,6,9,15,6,11,7,9,13,15,12,13,9,9,4,9,7,4,14,14,10
"6446",54200768,"Mohammad Ibrahim","8/7/1997 (25 years old)","M (LC), AM (RC)","Sheikh Russell KC (D)","Bangladeshi Premier League","BAN","No","9/27/2021","8/31/2023","$0","Left","Very Strong","Reasonable","5'6""","130 lbs","77","8",62,70,9,14,13,7,8,12,2,5,2,5,8,1,5,10,14,3,1,6,6,8,3,11,1,7,4,5,7,7,12,11,5,1,14,12,11,1,10,20,11,11,9,11,10,12,9,2,10,11,14,2,3,3,2,3,2,3,1,2,3,3
"6447",23331682,"Mohammed Nayeem","3/9/1996 (27 years old)","GK","Sheikh Jamal","Bangladeshi Premier League","BAN","No","10/1/2021","12/31/2024","$0 - $4.5K","Right","Reasonable","Very Strong","6'2""","167 lbs","60","-",60,65,3,2,1,3,1,5,1,1,2,1,4,2,3,4,9,8,13,6,10,13,17,3,9,3,10,6,4,5,10,7,6,10,14,10,5,4,11,18,10,11,13,9,10,8,5,4,18,10,11,6,9,9,15,6,9,8,5,8,10,12
"6448",23194162,"Raihan Hasan","9/10/1994 (28 years old)","D (RLC)","Sheikh Jamal","Bangladeshi Premier League","BAN","No","10/1/2021","12/31/2024","$0 - $5K","Left","Very Strong","Reasonable","5'7""","134 lbs","87","-",60,65,6,9,1,2,6,4,8,4,16,13,3,2,7,7,12,7,1,7,10,14,12,5,8,6,9,7,4,6,9,14,7,2,14,14,9,2,9,20,12,11,9,11,8,6,13,3,12,12,19,3,1,3,2,3,2,1,2,1,3,3
"6449",23035366,"Mamun Khan","10/20/1985 (37 years old)","GK","Muktijoddha SKC","Bangladeshi Premier League","BAN","No","7/1/2022","12/31/2023","$0","Right","Reasonable","Very Strong","6'5""","189 lbs","17","-",50,65,3,2,3,2,1,4,1,1,1,3,4,2,2,1,5,11,15,6,12,8,15,3,6,2,9,6,5,5,7,13,6,14,12,7,3,7,9,15,12,12,11,12,12,8,12,5,10,10,12,8,12,7,7,10,10,4,5,7,6,13
"6450",23034990,"Zahid Hossain","6/15/1988 (34 years old)","M (R), AM (RC)","Abahani KC (CTG)","Bangladeshi Premier League","BAN","No","7/1/2022","12/31/2024","Not for Sale","Right","Reasonable","Very Strong","5'7""","149 lbs","64","6",55,65,5,10,10,6,10,5,4,3,5,2,8,1,3,9,13,7,7,5,6,11,5,7,11,12,6,6,4,8,12,8,1,2,12,12,7,1,12,14,10,13,13,10,13,12,10,8,9,11,19,1,1,2,1,1,1,1,2,1,1,1
"6451",2000291078,"Sibongakonke Silenge","3/1/2000 (23 years old)","D (C)","Green Mamba","Premier League of Eswatini","SWZ","No","7/1/2022","6/30/2024","$0 - $90K","Right Only","Very Weak","Very Strong","5'10""","167 lbs","-","-",73,90,3,1,4,4,2,1,13,4,2,13,7,3,12,5,12,10,9,5,10,13,5,5,12,6,12,6,1,7,13,13,7,6,13,13,4,12,11,13,13,14,10,12,14,1,5,5,14,8,11,2,2,1,2,2,1,3,2,2,3,4
"6452",23188438,"Karim Razaul","7/1/1987 (35 years old)","D (C)","Abahani KC (D)","Bangladeshi Premier League","BAN","No","11/25/2021","12/31/2024","$0","Right","Fairly Strong","Very Strong","5'7""","152 lbs","-","-",60,65,4,4,1,5,8,1,10,2,5,13,5,5,11,4,6,13,8,8,9,15,3,5,15,6,7,7,7,8,7,10,8,3,9,8,9,2,14,13,11,12,13,11,12,19,12,5,8,10,20,3,3,1,1,1,3,1,3,1,3,1
"6453",23193649,"Rony","10/8/1991 (31 years old)","AM (R), ST (C)","Fortis","Bangladeshi Premier League","BAN","No","10/8/2022","12/31/2023","$0","Right","Reasonable","Very Strong","5'10""","160 lbs","-","-",55,65,4,7,7,14,8,6,8,5,1,3,6,4,3,11,10,9,2,10,7,12,8,11,9,13,7,6,5,8,10,7,5,7,10,9,13,7,10,12,10,11,12,12,12,12,11,2,11,14,17,1,2,1,1,1,4,1,1,2,2,3
"6454",27013292,"Jamal Bhuyan","4/10/1990 (33 years old)","DM, M (C)","Sheikh Russell KC (D)","Bangladeshi Premier League","BAN","Yes","10/19/2022","12/31/2024","Not for Sale","Right","Reasonable","Very Strong","5'8""","147 lbs","91","4",63,64,7,9,6,6,13,8,7,8,5,9,10,5,10,9,11,9,8,11,10,8,13,9,15,5,10,11,7,15,10,8,9,9,12,11,10,6,11,18,10,5,5,11,8,5,8,5,11,11,15,1,3,3,3,1,1,2,2,1,3,3
"6455",23331711,"Yeasin Khan","9/16/1994 (28 years old)","D (C)","Sheikh Russell KC (D)","Bangladeshi Premier League","BAN","No","10/26/2022","8/31/2023","$0","Right","Reasonable","Very Strong","5'8""","152 lbs","57","1",55,60,1,1,3,1,5,1,9,1,1,12,5,1,13,1,12,10,7,4,9,8,6,5,6,4,7,4,2,6,12,12,5,4,10,12,11,8,12,18,10,13,13,11,12,2,9,4,12,12,10,4,1,2,3,3,2,1,1,4,1,2
"6456",23035471,"Mamunul Mamun","12/12/1988 (34 years old)","DM, M (C)","Rahamatganj MFS","Bangladeshi Premier League","BAN","No","7/1/2022","12/31/2023","$0","Left","Very Strong","Weak","5'6""","143 lbs","56","5",50,60,10,9,4,6,11,13,4,12,4,4,11,9,4,9,8,10,7,9,9,12,14,5,12,7,6,8,10,6,8,11,8,4,11,9,5,6,4,5,5,8,12,11,10,14,5,3,6,14,18,2,2,1,1,2,1,3,1,2,1,4
"6457",2000043240,"Mannaf Rabby","6/6/1997 (26 years old)","M/AM (R), ST (C)","Sheikh Russell KC (D)","Bangladeshi Premier League","BAN","No","7/1/2022","12/31/2023","$0","Right Only","Weak","Very Strong","5'11""","163 lbs","71","14",50,60,4,8,7,10,4,4,4,5,1,3,10,6,1,7,13,6,3,8,5,12,11,8,6,9,2,5,3,6,12,12,5,5,12,12,11,10,9,13,10,12,11,12,13,13,12,7,15,12,8,1,2,2,2,2,3,1,2,2,3,2
"6458",2000057205,"Hamidur Rahman Remon","10/20/1990 (32 years old)","GK","Bashundhara Kings","Bangladeshi Premier League","BAN","No","7/1/2020","8/31/2023","$0","Right Only","Weak","Very Strong","6'1""","167 lbs","9","-",50,60,3,2,1,2,1,7,1,3,3,3,7,1,2,2,14,7,12,5,8,13,11,1,10,1,8,6,5,5,9,13,6,9,12,7,3,5,9,13,12,8,8,11,13,6,5,6,8,12,7,4,12,10,12,8,8,8,5,10,6,11
"6459",2000049683,"Nurul Absar","5/1/1995 (28 years old)","ST (C)","Sheikh Jamal","Bangladeshi Premier League","BAN","No","7/1/2019","12/31/2024","$0 - $1.5K","Right Only","Weak","Very Strong","5'9""","152 lbs","-","-",55,60,4,3,8,12,4,4,12,2,1,3,3,7,1,7,15,11,2,12,3,12,12,11,13,7,4,4,4,5,12,12,5,6,8,12,9,6,8,16,12,10,13,9,12,11,5,6,8,10,15,2,3,3,1,2,3,1,1,2,1,1
"6460",23194281,"Kasto Kumar Bosh","4/16/1992 (31 years old)","D (C)","Bashundhara Kings","Bangladeshi Premier League","BAN","No","7/1/2022","12/31/2024","$0","Right","Reasonable","Very Strong","5'11""","167 lbs","40","-",55,55,3,5,3,5,7,1,8,2,2,13,6,2,8,4,11,11,8,7,7,11,15,5,10,5,14,6,1,7,6,8,7,7,8,9,4,7,11,16,10,13,10,10,7,10,13,3,10,10,16,3,3,1,3,3,1,1,1,1,1,4
"6461",23331748,"Atiqur Rahman Fahad","9/15/1995 (27 years old)","DM, M (C)","Bashundhara Kings","Bangladeshi Premier League","BAN","No","10/1/2021","8/31/2023","$0","Left Only","Very Strong","Weak","5'8""","147 lbs","46","-",50,55,5,4,2,4,5,5,5,11,1,5,8,4,10,9,11,6,7,5,3,10,11,5,10,7,10,7,6,12,13,13,7,5,8,13,13,5,9,19,9,13,12,9,13,4,14,7,9,12,11,1,2,3,1,1,1,1,2,3,1,2
"6462",2000291106,"Mpendulo Tfomo","3/17/2000 (23 years old)","M/AM (C)","Mbabane Highlanders","Premier League of Eswatini","SWZ","No","7/1/2022","6/30/2025","$0 - $100K","Right Only","Weak","Very Strong","6'1""","176 lbs","-","-",74,90,8,6,10,13,15,8,8,10,4,10,13,2,13,11,5,8,5,9,8,14,9,15,3,10,12,9,9,12,11,11,9,11,7,7,7,6,11,15,14,11,13,7,8,6,5,4,10,13,9,2,1,3,3,3,2,4,1,3,2,2
"6463",23034989,"Mohammed Waly Faisal","3/1/1985 (38 years old)","D/WB (L)","Rahamatganj MFS","Bangladeshi Premier League","BAN","No","7/1/2022","12/31/2023","$0","Left","Very Strong","Reasonable","5'7""","147 lbs","65","-",55,55,10,10,3,3,6,6,9,1,6,8,6,5,10,8,5,9,4,7,5,10,11,5,15,6,6,7,3,8,13,11,7,6,7,12,13,5,11,12,8,14,12,14,12,3,6,7,7,11,10,3,1,3,3,2,1,4,3,3,2,3
"6464",2000139054,"Ziaurahman Hossain","4/5/1985 (38 years old)","GK","Rahamatganj MFS","Bangladeshi Premier League","BAN","No","7/1/2022","12/31/2023","$0","Right Only","Weak","Very Strong","6'0""","165 lbs","44","-",55,55,3,2,1,2,3,4,1,1,3,2,7,1,3,6,5,11,15,6,8,9,6,2,5,1,10,7,6,6,7,11,3,7,6,7,4,4,11,13,10,13,11,8,5,6,8,1,9,9,8,8,9,7,6,10,12,7,9,10,7,10
"6465",2000139111,"Mehedi Hasan Mithu","4/26/1995 (28 years old)","D (LC)","Bashundhara Kings","Bangladeshi Premier League","BAN","No","10/1/2021","12/31/2024","$0","Left","Very Strong","Reasonable","5'9""","154 lbs","37","-",50,55,3,8,1,1,6,4,5,2,3,12,5,1,8,1,5,8,7,5,7,8,12,5,7,3,8,5,1,7,12,12,6,3,12,12,12,10,13,19,11,11,12,11,9,7,10,7,8,10,19,1,3,1,1,3,1,2,1,3,3,2
"6466",23331731,"Ashraful Islam Rana","5/1/1988 (35 years old)","GK","Sheikh Russell KC (D)","Bangladeshi Premier League","BAN","No","8/30/2021","12/31/2024","$0","Right","Reasonable","Very Strong","6'6""","189 lbs","91","-",50,52,3,3,3,1,3,3,1,1,1,1,7,3,1,4,10,6,10,6,9,13,3,2,7,3,6,6,5,5,7,10,2,14,12,6,3,6,11,10,11,10,10,12,8,14,14,3,18,9,8,6,14,8,7,5,10,11,10,6,10,13
"6467",23035053,"Omar Faruq Babu","8/4/1987 (35 years old)","DM, M (C)","Sheikh Jamal","Bangladeshi Premier League","BAN","No","7/1/2020","12/31/2024","$0","Right","Reasonable","Very Strong","5'7""","136 lbs","-","-",50,50,5,2,5,7,9,3,6,6,6,9,10,6,10,6,13,8,7,6,8,14,6,5,3,8,11,7,12,11,10,9,7,2,13,8,6,2,13,15,13,11,10,12,7,15,6,4,20,11,13,3,2,1,2,1,2,3,2,2,3,1
"6468",2000053912,"Shahedul Alam Jr.","7/1/1993 (29 years old)","DM, M (C)","Police (BAN)","Bangladeshi Premier League","BAN","No","7/1/2022","12/31/2023","$0","Left","Very Strong","Reasonable","5'8""","149 lbs","48","-",50,50,3,5,2,4,9,5,5,5,1,6,8,1,10,9,11,10,7,7,5,13,10,5,13,6,7,6,9,11,11,11,6,6,15,8,13,7,9,20,10,12,11,12,7,9,8,2,18,12,7,2,1,1,1,3,3,2,3,2,3,2
"6469",72022275,"Lesly St. Fleur","3/21/1989 (34 years old)","WB (R), M (RL), AM (R)","Bears","Bahamian Senior League","BAH","No","1/1/2020","6/30/2024","$0","Right Only","Weak","Very Strong","5'9""","152 lbs","153","45",66,99,7,7,7,8,7,8,8,8,8,7,7,5,8,7,10,7,9,7,7,6,12,14,8,8,7,8,8,9,13,11,9,9,14,12,9,10,18,13,12,11,11,12,2,10,6,7,10,12,15,1,3,3,2,1,3,3,1,2,1,2
"6470",2000123765,"Evelt Julmis","9/10/1999 (23 years old)","D (C), DM, M (C), ST (C)","Dynamos (BAH)","Bahamian Senior League","BAH","No","6/15/2020","6/30/2024","$1.5K - $4K","Right","Reasonable","Very Strong","6'0""","171 lbs","-","-",70,95,5,4,4,8,5,6,8,6,1,8,7,1,8,8,11,11,8,9,6,14,10,13,13,6,8,7,8,7,11,11,12,8,13,11,8,10,20,10,11,11,9,13,5,15,8,3,9,13,8,1,4,2,3,3,3,3,1,1,2,2
"6471",2000234471,"Jordin Wilson","7/19/2005 (17 years old)","ST (C)","Western Warriors","Bahamian Senior League","BAH","No","6/13/2022","6/30/2024","$0","Right","Reasonable","Very Strong","5'10""","147 lbs","-","-",55,93,6,6,11,14,8,5,7,5,2,6,7,2,1,12,8,7,1,7,4,11,3,11,11,8,5,6,5,7,14,12,2,8,14,12,6,7,7,13,12,12,10,7,7,5,8,4,9,13,14,2,4,3,1,3,1,3,3,1,1,1
"6472",2000046213,"Quinton Carey","11/26/1996 (26 years old)","AM (RLC), ST (C)","Gold Star FC","National Independent Soccer Association","BAH","No","1/1/2023","11/30/2023","$50K - $150K","Right","Reasonable","Very Strong","5'10""","158 lbs","16","-",75,90,3,5,10,10,12,5,6,7,3,4,9,7,4,12,6,10,5,9,6,11,16,13,8,12,6,6,7,7,12,12,6,3,9,12,12,3,10,19,13,10,11,11,10,7,9,5,11,12,12,2,1,2,2,2,3,4,4,1,1,1
"6473",2000164850,"Ben Doak","11/11/2005 (17 years old)","AM (R)","Liverpool","English Premier Division","SCO","No","11/14/2022","6/30/2026","$54M - $82M","Right Only","Weak","Very Strong","5'7""","152 lbs","9","1",115,176,10,13,15,9,13,6,5,8,3,7,13,7,8,14,15,10,13,14,11,12,18,14,6,13,5,13,13,14,15,15,15,4,12,14,7,9,6,10,10,12,12,8,6,13,8,4,12,18,12,2,2,2,1,3,3,2,2,1,1,2
"6474",61093823,"Josh Doig","5/18/2002 (21 years old)","D/WB (L)","Hellas Verona","Italian Serie A","SCO","No","7/13/2022","6/30/2026","$9.4M - $11.5M","Left","Very Strong","Reasonable","6'2""","156 lbs","91","3",130,155,7,14,12,10,11,4,11,11,9,11,12,6,13,12,12,12,13,12,8,12,15,12,5,14,12,15,12,15,15,13,12,15,14,16,13,13,11,14,13,15,12,14,3,10,8,6,15,14,13,1,4,1,1,3,3,2,2,1,2,2
"6475",76045265,"Anderson Arroyo","9/27/1999 (23 years old)","D (RLC)","Liverpool","English Premier Division","COL","No","7/9/2022","6/30/2024","$800K - $1.7M","Left","Very Strong","Fairly Strong","5'9""","156 lbs","111","1",117,142,9,12,11,7,10,8,7,8,12,12,12,8,12,12,12,12,11,10,11,12,12,5,7,11,13,12,11,13,13,13,13,10,12,13,14,12,15,11,10,11,10,11,12,5,11,5,11,11,7,2,1,2,2,1,3,1,3,3,3,2
"6476",75000273,"Arturo Vidal","5/22/1987 (36 years old)","DM, M/AM (C)","FLA","Brazilian National First Division","CHI","No","7/13/2022","12/31/2024","Not for Sale","Right","Reasonable","Very Strong","5'11""","165 lbs","498","81",130,176,7,10,11,13,14,11,14,13,5,13,15,15,14,15,20,12,19,14,12,11,18,13,15,12,13,16,12,17,10,11,15,13,15,10,12,13,14,10,7,8,17,10,12,16,14,20,12,18,12,2,1,2,4,1,1,3,2,1,3,2
"6477",75000261,"Alexis Sánchez","12/19/1988 (34 years old)","ST (C)","OM","Ligue 1 Uber Eats","CHI","No","8/10/2022","6/30/2024","$1.7M - $3.6M","Right","Reasonable","Very Strong","5'7""","154 lbs","551","172",139,175,12,13,15,13,17,14,14,13,4,4,15,13,4,17,13,13,15,12,12,14,15,16,12,16,5,12,15,15,15,16,12,10,16,14,10,8,12,13,13,14,15,8,14,15,8,6,14,18,18,1,3,3,2,3,2,3,1,3,2,1
"6478",5251774,"Claudio Bravo","4/13/1983 (40 years old)","GK","Real Hispalis","Spanish First Division","CHI","Yes","4/5/2022","6/30/2024","$750K","Right","Weak","Very Strong","6'0""","185 lbs","456","1",139,167,3,1,8,1,13,7,6,2,3,1,15,8,2,14,12,13,15,13,16,13,14,10,18,4,11,16,15,7,10,11,11,11,15,11,12,11,14,12,13,17,8,17,13,10,8,12,14,14,12,14,10,13,10,12,16,15,10,15,14,11
"6479",75045691,"Marcelino Núñez","3/1/2000 (23 years old)","M (C), AM (RC)","Norwich","Sky Bet Championship","CHI","No","8/2/2022","6/30/2026","$14M - $17.5M","Right","Reasonable","Very Strong","5'8""","160 lbs","101","11",120,155,13,13,14,10,14,14,6,14,8,6,15,15,8,16,9,11,11,16,11,10,16,16,7,13,10,13,15,12,11,13,13,7,14,11,12,8,12,16,15,16,13,15,6,12,6,6,10,16,18,2,2,2,3,3,1,1,3,2,4,1
"6480",75000560,"Gary Medel","8/3/1987 (35 years old)","D (C), DM, M (C)","Bologna","Italian Serie A","CHI","Yes","6/14/2021","6/30/2024","$65K - $650K","Right","Weak","Very Strong","5'7""","167 lbs","461","27",127,152,5,12,6,5,11,5,12,8,10,14,14,4,14,12,18,16,18,13,16,12,20,5,15,9,16,18,11,18,10,11,17,9,15,9,11,14,14,7,8,19,15,14,12,16,16,12,14,19,14,2,1,2,1,2,1,2,1,1,1,2
"6481",14003946,"Pablo Hernández","10/24/1986 (36 years old)","DM, M (C), AM (LC)","O'Higgins","Chilean First Division","CHI","No","7/1/2021","6/30/2023","$0 - $26K","Left","Very Strong","Weak","6'1""","178 lbs","356","53",123,151,14,12,12,10,15,13,12,13,8,8,14,14,7,15,13,12,12,14,15,14,14,15,13,13,11,16,15,10,9,9,12,13,14,10,13,13,12,8,13,13,9,10,14,15,11,8,13,15,12,3,1,2,2,3,2,2,1,2,3,2
"6482",75031046,"Sebastián Vegas","12/4/1996 (26 years old)","D (LC)","Monterrey","Mexican First Division","CHI","No","7/1/2021","6/30/2025","$700K - $9.4M","Left","Very Strong","Reasonable","6'0""","176 lbs","247","13",133,150,8,8,6,5,10,4,14,9,15,13,12,8,13,14,14,14,10,13,12,13,14,10,13,12,13,12,12,14,12,13,12,13,15,13,15,13,14,13,14,14,11,9,8,11,9,7,13,14,12,2,3,1,3,1,2,2,1,1,2,2
"6483",2000061580,"Jordhy Thompson","8/10/2004 (18 years old)","AM (RL)","Colo Colo","Chilean First Division","CHI","No","6/13/2022","12/31/2023","$350K - $3.6M","Left","Very Strong","Weak","5'7""","127 lbs","16","-",108,150,12,12,15,9,13,10,5,13,6,3,13,7,4,14,9,11,11,7,7,11,1,16,5,14,4,10,12,10,14,15,8,4,12,14,11,6,8,6,7,5,6,10,8,13,9,16,8,7,5,1,2,1,4,2,2,2,2,1,3,3
"6484",75020180,"Brayan Cortés","3/11/1995 (28 years old)","GK","Colo Colo","Chilean First Division","CHI","No","7/10/2022","12/31/2025","$240K - $2.4M","Right","Fairly Strong","Very Strong","6'1""","180 lbs","155","-",125,150,4,1,1,2,7,7,2,3,2,2,7,2,3,8,12,11,14,10,10,11,12,3,12,3,13,12,11,11,11,12,12,14,10,13,8,12,12,18,10,13,9,12,10,8,8,1,12,11,12,10,8,13,9,12,12,13,16,14,15,12
"6485",2000180381,"Daniel Kelly","10/3/2005 (17 years old)","M/AM (C)","Celtic","cinch Premiership","SCO","No","3/24/2022","5/31/2025","$11M - $13M","Right","Reasonable","Very Strong","5'10""","152 lbs","14","-",94,154,8,6,12,14,14,8,8,12,8,6,14,7,12,11,15,9,7,9,10,11,15,10,1,12,7,8,9,13,13,11,14,5,14,12,13,7,13,15,11,13,12,9,9,6,5,5,17,12,14,1,1,3,2,2,2,3,4,2,3,2
"6486",75001932,"Charles Aránguiz","4/17/1989 (34 years old)","DM, M (C)","INT","Brazilian National First Division","CHI","No","4/2/2023","6/30/2025","Not for Sale","Right","Reasonable","Very Strong","5'7""","152 lbs","449","53",138,150,12,13,11,8,14,13,10,11,8,12,15,17,13,15,14,15,12,15,14,15,16,10,12,12,13,18,13,17,10,13,14,7,15,11,14,10,17,15,12,15,17,14,14,18,12,6,17,13,10,3,2,2,3,3,3,2,3,2,1,2
"6487",29159400,"Ben Brereton Díaz","4/18/1999 (24 years old)","AM (RL), ST (C)","Blackburn","Sky Bet Championship","CHI","No","6/14/2021","6/30/2027","$16M - $24M","Right","Fairly Strong","Very Strong","6'1""","176 lbs","212","54",138,145,5,9,14,15,12,11,12,12,3,5,11,13,4,13,10,12,12,13,11,12,13,10,7,12,5,15,10,15,15,12,12,13,15,15,14,15,12,15,6,16,14,14,3,11,3,1,11,15,13,3,1,4,2,2,1,3,1,1,3,3
"6488",2000060949,"Lucas Assadi","1/8/2004 (19 years old)","AM (LC)","Univ. de Chile","Chilean First Division","CHI","No","3/10/2022","12/31/2025","$2.8M - $5.8M","Right","Reasonable","Very Strong","5'6""","138 lbs","48","2",112,145,5,11,15,9,14,13,5,10,6,5,13,12,4,14,8,14,8,12,8,13,14,16,6,13,5,10,14,11,14,15,7,7,14,12,11,8,9,14,13,14,14,13,5,12,5,5,9,12,14,3,1,3,2,1,3,1,3,3,3,3
"6489",8825999,"Carlos Villanueva","2/5/1986 (37 years old)","M/AM (C)","Magallanes","Chilean First Division","CHI","No","6/5/2022","12/31/2024","Not for Sale","Left","Very Strong","Reasonable","5'11""","156 lbs","461","115",104,145,14,14,14,13,14,16,7,14,3,5,15,17,4,16,6,11,5,15,12,14,16,17,11,14,6,14,16,9,8,8,11,6,14,9,9,8,8,12,15,17,8,14,5,7,4,5,11,13,10,3,2,1,2,1,3,3,2,1,3,4
"6490",75015974,"Fernando de Paul","4/25/1991 (32 years old)","GK","Colo Colo","Chilean First Division","CHI","No","11/15/2022","12/31/2024","Not for Sale","Right Only","Weak","Very Strong","6'0""","182 lbs","251","-",122,145,2,3,3,3,5,5,2,2,1,3,9,6,3,10,6,12,14,14,12,12,13,3,14,2,14,12,11,11,8,11,12,11,10,9,6,13,11,13,13,14,13,13,13,1,6,11,12,14,15,12,12,13,11,14,13,14,7,12,13,13
"6491",75055394,"Vicente Pizarro","11/5/2002 (20 years old)","DM, M (C)","Colo Colo","Chilean First Division","CHI","No","12/31/2021","12/31/2024","$475K - $9.6M","Left","Very Strong","Fairly Strong","5'8""","147 lbs","63","-",120,144,9,6,11,6,13,8,6,10,6,11,13,7,12,12,12,13,11,15,14,15,14,9,8,8,14,16,13,14,11,11,12,7,14,11,15,10,6,16,16,15,16,15,6,10,6,7,16,15,18,3,1,2,2,1,1,3,4,1,3,2
"6492",75041011,"Angelo Araos","1/6/1997 (26 years old)","M/AM (C)","ATG","Brazilian National Second Division","CHI","No","11/15/2021","12/31/2024","$130K - $1.3M","Right","Weak","Very Strong","5'9""","138 lbs","136","7",116,144,12,13,13,11,13,9,9,11,12,6,14,11,9,14,14,13,14,11,11,12,14,13,9,13,7,14,13,14,13,13,10,9,14,13,13,10,10,15,13,15,13,12,10,12,6,6,12,13,8,3,2,3,3,3,2,1,2,3,3,2
"6493",75003107,"Eduardo Vargas","11/20/1989 (33 years old)","AM (RLC), ST (C)","ATM","Brazilian National First Division","CHI","No","4/11/2022","12/31/2024","Not for Sale","Right","Reasonable","Very Strong","5'9""","156 lbs","393","82",129,143,9,11,13,12,15,10,12,14,5,6,12,13,8,14,16,13,15,13,12,11,12,16,7,15,9,12,13,16,13,14,13,10,13,12,11,12,13,8,8,10,14,10,4,17,8,16,9,16,7,2,1,3,1,4,3,2,3,3,3,2
"6494",75018971,"Martín Rodríguez","8/5/1994 (28 years old)","M (L), AM (RLC)","D.C. United","Major League Soccer","CHI","No","6/23/2022","12/31/2023","$130K - $1.3M","Right","Fairly Strong","Very Strong","5'7""","149 lbs","227","21",125,143,13,14,14,12,14,12,7,12,8,7,13,13,7,14,6,14,7,11,11,12,13,15,6,14,8,12,14,10,13,15,11,7,15,13,11,9,12,15,15,13,13,12,6,9,6,8,9,12,13,3,2,2,4,3,3,2,3,2,3,2
"6495",75039726,"Marcelo Allende","4/7/1999 (24 years old)","M/AM (RLC)","Sundowns","South African Premier Soccer League","CHI","No","7/26/2022","6/30/2024","$475K - $4.7M","Right","Fairly Strong","Very Strong","5'5""","141 lbs","155","24",131,143,14,14,14,13,15,13,5,12,11,9,13,15,9,15,14,11,10,10,10,10,13,15,12,13,8,12,13,13,15,15,10,5,6,11,13,5,17,13,10,13,8,13,6,14,7,2,10,8,8,1,2,3,1,1,3,2,2,2,1,1
"6496",61078132,"Lewis Ferguson","8/24/1999 (23 years old)","DM, M/AM (C)","Bologna","Italian Serie A","SCO","No","7/12/2022","6/30/2028","$7.4M - $11.5M","Right","Reasonable","Very Strong","5'11""","165 lbs","177","33",139,151,8,9,12,12,13,10,14,13,7,10,14,15,13,13,16,13,15,12,12,12,16,10,10,15,13,15,11,17,13,13,14,12,17,13,18,14,15,14,11,15,15,11,2,15,14,7,14,15,14,1,3,2,3,3,3,3,2,2,3,3
"6497",75030974,"Diego Valdés","1/30/1994 (29 years old)","AM (C)","América","Mexican First Division","CHI","No","12/15/2021","6/30/2026","$800K - $11M","Right","Fairly Strong","Very Strong","5'10""","156 lbs","337","66",131,142,13,12,14,14,13,12,9,11,6,7,15,12,11,15,11,13,10,14,13,14,14,13,11,14,10,14,15,13,12,14,13,9,15,12,14,11,9,14,15,14,13,15,4,13,5,10,13,13,13,2,3,4,1,2,2,3,4,1,3,1
"6498",75049650,"Nicolás Díaz","5/20/1999 (24 years old)","D (LC)","Tijuana","Mexican First Division","CHI","No","6/30/2022","6/30/2025","$350K - $3.5M","Left","Very Strong","Reasonable","5'10""","165 lbs","121","6",120,142,6,12,10,5,13,6,13,6,9,14,12,5,14,12,13,13,14,11,13,9,14,7,11,12,14,14,6,15,13,10,12,12,10,13,12,11,5,5,8,13,12,9,5,10,13,8,11,12,13,2,3,1,1,3,1,2,3,2,1,1
"6499",75016346,"Felipe Mora","8/2/1993 (29 years old)","ST (C)","Portland","Major League Soccer","CHI","No","1/19/2021","12/31/2024","$450K - $8.4M","Right","Fairly Strong","Very Strong","5'9""","152 lbs","303","100",127,142,9,10,11,14,13,9,14,9,5,6,12,13,7,12,11,14,13,12,13,12,14,11,8,14,6,12,12,13,13,13,13,11,16,13,15,13,6,10,13,13,13,15,13,13,5,13,12,15,15,2,1,1,1,1,3,1,2,2,2,1
"6500",75030706,"Erick Pulgar","1/15/1994 (29 years old)","DM, M (C)","FLA","Brazilian National First Division","CHI","No","7/29/2022","5/31/2025","$6.4M - $9.6M","Right","Reasonable","Very Strong","6'2""","163 lbs","274","27",128,142,14,13,11,10,13,15,12,13,4,13,15,17,14,14,14,13,15,13,12,13,18,12,9,14,13,13,14,13,10,11,14,14,13,11,13,12,11,8,12,14,14,8,12,10,13,12,13,15,15,1,3,3,1,3,2,3,4,4,3,3
"6501",2000129380,"Darío Osorio","1/24/2004 (19 years old)","AM (LC)","Univ. de Chile","Chilean First Division","CHI","No","1/1/2021","12/31/2025","$425K - $7.6M","Left","Very Strong","Fairly Strong","6'0""","160 lbs","61","11",110,141,12,12,13,8,12,11,6,9,8,6,13,8,6,13,7,10,8,9,9,12,14,15,7,12,7,12,13,9,14,14,8,7,13,13,10,8,12,15,14,13,8,14,6,11,7,7,9,14,10,1,2,1,3,1,1,2,3,3,1,1
"6502",127959,"Jaime Valdés","1/11/1981 (42 years old)","M/AM (C)","Stgo Wanderers","Chilean First Division B","CHI","No","5/16/2022","12/31/2023","$500 - $3K","Right","Fairly Strong","Very Strong","5'9""","156 lbs","621","86",97,140,15,12,13,10,14,14,7,12,7,7,14,13,7,15,8,12,8,14,11,13,14,15,14,12,8,11,14,8,8,8,10,7,12,7,8,10,14,13,12,13,11,13,14,14,14,11,13,16,14,3,3,3,1,3,1,2,3,1,3,2
"6503",2000129389,"Renato Cordero","4/16/2003 (20 years old)","AM (RC)","Univ. de Chile","Chilean First Division","CHI","No","12/28/2022","12/31/2024","$375K - $1.1M","Right","Reasonable","Very Strong","5'9""","138 lbs","4","-",80,140,6,5,13,13,13,6,6,8,2,6,12,5,7,13,12,9,7,7,5,6,6,13,11,4,7,6,11,8,13,13,7,6,12,13,8,5,11,17,12,11,12,13,12,20,14,2,11,8,12,2,3,3,3,2,2,2,1,3,3,1
"6504",75030680,"Guillermo Maripán","5/6/1994 (29 years old)","D (C)","AS Monaco","Ligue 1 Uber Eats","CHI","No","9/29/2022","6/30/2025","$700K - $8.6M","Right","Reasonable","Very Strong","6'4""","182 lbs","202","15",131,140,6,5,7,7,10,6,15,8,7,14,12,4,15,10,14,14,15,12,13,12,14,5,10,7,15,14,9,13,11,11,13,16,15,11,15,15,8,9,9,13,12,14,4,13,12,6,12,13,11,2,1,4,3,1,1,2,2,2,2,3
"6505",14000828,"Gabriel Arias","9/13/1987 (35 years old)","GK","Racing Club","Argentine Premier Division","CHI","No","10/2/2020","12/31/2023","$130K - $1.3M","Right","Weak","Very Strong","6'2""","185 lbs","241","-",130,140,6,2,3,1,8,8,3,3,3,2,10,2,3,11,12,13,13,14,14,13,11,10,15,10,14,12,11,12,10,14,11,14,11,9,11,10,11,11,14,12,9,15,11,15,11,5,13,8,12,11,10,16,12,14,11,13,8,14,12,13
"6506",75014702,"Felipe Gutiérrez","10/8/1990 (32 years old)","DM, M/AM (C)","Al-Wasl","UAE Professional League","CHI","No","2/7/2023","6/30/2025","Not for Sale","Left","Very Strong","Reasonable","5'9""","152 lbs","299","54",119,140,13,13,14,11,14,13,7,12,8,10,13,14,11,16,11,14,6,15,11,14,14,13,10,10,12,14,15,10,11,10,13,8,15,11,10,10,14,12,14,15,14,14,13,8,5,6,8,12,13,3,4,4,1,3,4,1,2,1,1,3
"6507",2000126248,"Ethan Laidlaw","1/2/2005 (18 years old)","ST (C)","Hibernian","cinch Premiership","SCO","No","7/1/2020","5/31/2026","$140K - $1.4M","Right","Reasonable","Very Strong","5'9""","152 lbs","-","-",85,151,6,7,13,13,13,6,8,7,3,5,7,9,3,11,12,13,2,13,7,10,4,11,8,13,7,6,2,7,13,13,7,8,13,13,4,9,10,12,11,11,12,13,8,6,10,4,9,10,8,2,1,1,3,2,2,1,2,3,4,2
"6508",75015381,"Óscar Opazo","10/18/1990 (32 years old)","D/WB (RL)","Racing Club","Argentine Premier Division","CHI","No","12/31/2022","12/31/2024","$600K - $1.8M","Right","Fairly Strong","Very Strong","5'6""","158 lbs","322","8",119,140,10,14,11,8,11,8,8,9,12,12,11,5,12,11,12,12,11,10,11,10,13,6,12,12,12,14,10,14,13,13,12,8,15,13,13,12,12,12,13,14,13,15,10,12,8,7,14,11,8,3,3,1,2,1,2,3,3,3,3,1
"6509",2000059106,"Jonathan Villagra","3/28/2001 (22 years old)","D (C)","U. Española","Chilean First Division","CHI","No","1/5/2022","12/31/2024","$240K - $2.4M","Right Only","Weak","Very Strong","6'0""","156 lbs","57","3",106,140,11,7,8,8,12,9,14,11,10,13,10,9,12,11,12,12,12,10,13,12,12,5,10,8,13,10,8,12,10,10,12,14,11,13,14,14,15,18,12,13,11,12,6,15,5,3,14,11,17,3,3,1,3,4,1,2,1,1,4,2
"6510",75036365,"Víctor Dávila","11/4/1997 (25 years old)","AM (LC)","León","Mexican First Division","CHI","No","1/1/2021","12/31/2023","$5.4M - $10M","Left","Very Strong","Reasonable","5'8""","154 lbs","188","47",127,140,12,12,14,13,13,11,8,14,13,9,13,12,9,15,13,11,13,13,11,14,12,13,11,15,13,11,13,16,14,15,13,7,10,13,11,8,13,8,13,7,11,7,11,10,14,6,9,14,13,2,3,3,3,1,3,2,2,2,4,2
"6511",75000522,"Cristopher Toselli","6/15/1988 (34 years old)","GK","Univ. de Chile","Chilean First Division","CHI","No","1/5/2023","12/31/2023","$35K - $350K","Right Only","Weak","Very Strong","6'2""","167 lbs","311","-",112,140,3,1,1,3,6,8,6,1,2,1,5,1,3,8,11,13,12,12,13,10,15,3,14,5,14,14,5,14,12,13,12,11,14,12,13,12,12,12,17,15,13,16,6,10,3,9,13,14,14,9,7,14,13,15,6,13,4,14,12,13
"6512",75037516,"Francisco Sierralta","5/6/1997 (26 years old)","D (C)","Watford","Sky Bet Championship","CHI","Yes","11/1/2021","6/30/2027","$550K - $5.2M","Right","Reasonable","Very Strong","6'4""","182 lbs","95","5",117,139,6,6,7,6,10,5,17,7,6,13,10,6,13,9,15,10,16,11,13,10,12,5,13,10,11,12,10,12,11,12,15,15,15,11,14,15,6,10,12,8,10,13,4,13,11,8,12,12,15,2,2,1,1,3,2,4,1,2,3,3
"6513",75000732,"Sebastián Ubilla","8/9/1990 (32 years old)","AM (RL), ST (C)","D. Antofagasta","Chilean First Division B","CHI","No","1/20/2023","12/31/2023","$14K - $150K","Right","Reasonable","Very Strong","5'8""","154 lbs","311","76",107,139,11,12,13,10,11,8,8,10,6,5,11,10,7,13,9,13,9,9,9,10,12,12,7,13,6,13,10,10,13,13,9,6,13,13,11,9,8,10,11,11,10,13,17,9,4,8,9,12,8,3,1,3,1,3,3,2,1,2,2,1
"6514",14010532,"Leonardo Gil","5/31/1991 (32 years old)","DM, M/AM (C)","Colo Colo","Chilean First Division","CHI","No","2/1/2022","12/31/2024","Not for Sale","Left","Very Strong","Reasonable","5'7""","152 lbs","361","22",123,139,14,13,11,9,13,15,8,13,8,10,14,9,10,13,14,12,16,12,12,13,13,11,14,12,7,16,13,15,12,13,13,8,16,12,14,12,10,11,13,15,9,11,5,15,10,7,13,13,8,4,3,3,1,3,1,2,3,3,2,3
"6515",2000050929,"Joan Cruz","4/4/2003 (20 years old)","AM (LC)","Oviedo B","Spanish Federation Second Group 1","CHI","No","4/5/2023","6/30/2027","$300K - $900K","Left","Very Strong","Reasonable","5'9""","152 lbs","27","-",92,139,8,10,13,8,13,10,5,12,3,4,12,8,5,13,8,12,8,9,8,11,7,15,7,11,4,8,13,8,13,13,9,7,12,12,11,7,8,9,12,7,7,8,4,11,6,13,7,7,9,2,3,1,3,3,1,1,3,1,2,2
"6516",75039728,"Ignacio Saavedra","1/12/1999 (24 years old)","DM, M (C)","Univ. Católica","Chilean First Division","CHI","No","6/15/2020","12/31/2023","$70K - $700K","Right","Reasonable","Very Strong","5'9""","149 lbs","115","-",111,139,6,8,12,6,13,5,8,6,4,12,14,5,12,13,11,12,13,10,13,13,12,11,10,7,14,16,13,13,11,13,13,8,14,11,13,10,7,20,12,12,12,12,7,8,8,6,13,10,18,2,3,1,2,2,3,3,3,3,3,2
"6517",75054809,"Gonzalo Tapia","2/18/2002 (21 years old)","AM (RL), ST (C)","Univ. Católica","Chilean First Division","CHI","No","12/1/2022","12/31/2023","$1.2M - $2.5M","Right","Reasonable","Very Strong","5'10""","171 lbs","50","5",101,138,5,11,12,12,11,5,11,9,3,3,11,8,6,11,7,12,12,8,8,8,13,13,11,12,4,12,12,13,13,12,12,12,15,12,13,11,5,19,11,13,10,9,13,7,5,4,12,12,17,2,3,2,1,2,4,2,3,1,1,2
"6518",61028448,"Stuart Armstrong","3/30/1992 (31 years old)","M/AM (C)","Southampton","Sky Bet Championship","SCO","No","1/1/2021","6/30/2024","$5.8M - $8.8M","Right","Fairly Strong","Very Strong","6'0""","149 lbs","374","58",132,150,14,12,16,14,14,14,10,15,5,6,14,12,11,14,11,14,12,12,14,14,14,12,14,14,10,16,14,14,12,10,10,10,12,12,12,12,14,7,8,15,9,5,14,10,9,4,15,15,20,1,3,2,2,1,3,3,2,3,2,1
"6519",75058257,"Marcelo Morales","6/6/2003 (20 years old)","D/WB (L)","Univ. de Chile","Chilean First Division","CHI","No","6/13/2022","12/31/2025","$1.2M - $2.6M","Left","Very Strong","Reasonable","5'8""","121 lbs","55","-",97,138,9,13,10,6,11,8,9,9,10,11,9,5,11,11,11,12,12,8,12,11,13,7,7,7,10,14,11,13,13,12,10,8,12,13,12,8,12,16,10,11,11,12,8,8,9,4,15,11,10,2,1,3,4,1,4,1,3,2,4,1
"6520",75050715,"Bastián Yáñez","6/27/2001 (21 years old)","AM (LC)","U. Española","Chilean First Division","CHI","No","6/13/2022","12/31/2024","$300K - $3M","Left","Very Strong","Reasonable","5'10""","169 lbs","82","4",111,138,7,12,14,8,13,8,8,11,7,5,13,8,5,14,6,13,9,11,10,11,12,14,7,12,6,11,13,11,13,13,10,9,12,14,11,9,12,10,12,12,9,11,8,10,5,7,8,11,16,1,2,2,2,3,4,1,1,3,3,1
"6521",75044474,"Víctor Méndez","9/23/1999 (23 years old)","DM, M (C)","CSKA Moscow","Russian Premier League","CHI","No","7/1/2022","6/30/2025","$300K - $9M","Right","Fairly Strong","Very Strong","5'8""","154 lbs","142","3",120,138,10,10,12,7,12,8,10,11,5,13,13,9,10,13,12,14,14,13,16,14,12,10,12,10,13,15,12,14,12,12,12,7,13,12,14,8,10,15,14,12,12,13,6,12,10,7,13,12,13,1,1,2,3,3,3,2,1,2,3,2
"6522",75055397,"Alexander Aravena","9/6/2002 (20 years old)","AM (RL), ST (C)","Univ. Católica","Chilean First Division","CHI","No","1/2/2023","12/31/2024","$4.2M - $8.2M","Right","Fairly Strong","Very Strong","5'9""","145 lbs","49","15",123,138,14,14,14,13,14,12,8,12,6,4,12,12,6,14,11,14,9,13,13,13,15,14,8,13,5,14,12,13,13,13,12,5,8,12,12,9,8,15,15,16,14,15,6,13,6,4,14,14,19,2,2,3,3,3,1,3,1,4,3,2
"6523",75029821,"Claudio Baeza","12/23/1993 (29 years old)","D (C), DM, M (C)","Toluca","Mexican First Division","CHI","No","12/23/2020","12/31/2024","$4.3M - $8.2M","Right","Reasonable","Very Strong","5'7""","141 lbs","301","6",131,138,7,10,12,7,14,6,9,12,6,15,15,5,14,12,14,15,13,13,13,12,14,6,13,11,14,15,12,16,13,13,11,8,12,13,15,12,11,11,12,13,12,12,4,12,12,6,13,13,14,3,3,1,2,4,3,3,3,1,4,1
"6524",75017685,"Igor Lichnovsky","3/7/1994 (29 years old)","D (C)","Tigres","Mexican First Division","CHI","Yes","1/19/2022","12/31/2025","$300K - $950K","Right","Reasonable","Very Strong","6'2""","174 lbs","285","14",124,137,6,6,8,7,10,5,14,8,7,13,11,4,14,11,13,14,13,11,14,12,13,8,11,8,14,13,8,13,11,13,13,14,14,12,14,13,8,9,10,13,11,14,6,10,12,12,12,13,8,2,2,1,1,3,3,3,3,1,3,3
"6525",75007714,"Eugenio Mena","7/18/1988 (34 years old)","D/WB/M/AM (L)","Univ. Católica","Chilean First Division","CHI","No","12/14/2022","12/31/2024","Not for Sale","Left Only","Very Strong","Very Weak","5'9""","152 lbs","377","12",133,137,11,14,13,11,13,9,10,10,15,12,13,9,12,12,15,15,15,12,15,15,14,11,6,14,15,15,13,13,13,13,13,8,16,13,14,13,13,13,13,14,12,13,5,12,13,8,13,11,13,2,4,1,2,2,1,1,2,2,3,3
"6526",75014499,"Bryan Carrasco","1/31/1991 (32 years old)","M/AM (RL)","Palestino","Chilean First Division","CHI","No","1/1/2020","12/31/2024","Not for Sale","Right","Fairly Strong","Very Strong","5'7""","141 lbs","346","82",115,137,9,13,13,10,11,9,6,10,13,7,11,15,9,12,9,13,11,11,8,9,11,13,10,14,9,11,12,11,13,13,7,6,14,13,15,10,14,8,5,11,10,12,4,8,13,10,9,12,11,2,3,2,3,3,2,1,1,3,3,2
"6527",75058374,"Tomás Ahumada","9/24/2001 (21 years old)","GK","Audax","Chilean First Division","CHI","No","2/3/2022","12/31/2024","$220K - $2.2M","Right","Reasonable","Very Strong","5'11""","171 lbs","22","-",104,137,4,3,3,2,6,9,1,2,3,1,11,4,3,1,13,11,15,9,11,11,6,3,11,2,11,9,7,8,12,6,9,10,11,11,7,7,14,14,11,11,12,13,8,17,10,7,10,12,11,14,9,12,8,12,11,14,5,13,14,9
"6528",75000744,"Esteban Pavez","5/1/1990 (33 years old)","DM","Colo Colo","Chilean First Division","CHI","No","11/15/2021","6/30/2023","$0 - $85K","Right","Reasonable","Very Strong","5'11""","167 lbs","335","17",123,137,6,10,9,8,13,6,12,12,9,14,12,7,14,11,15,13,15,9,13,12,14,4,9,9,14,14,11,15,13,12,13,12,15,12,16,13,9,9,8,13,14,15,4,12,7,13,12,14,8,1,2,4,2,1,2,2,2,3,3,2
"6529",61036775,"Ryan Fraser","2/24/1994 (29 years old)","M/AM (RL)","Newcastle","English Premier Division","SCO","No","9/7/2020","6/30/2025","$425K - $4.2M","Right","Reasonable","Very Strong","5'4""","154 lbs","274","26",127,150,13,13,13,13,13,12,2,12,2,6,14,6,7,12,7,13,13,12,10,12,13,12,10,15,10,13,11,17,15,13,14,3,12,13,12,11,16,8,13,12,9,12,13,10,5,3,11,12,11,2,2,3,3,2,3,4,1,2,2,1
"6530",75041769,"Tomás Alarcón","1/19/1999 (24 years old)","DM, M (C)","Cádiz","Spanish First Division","CHI","No","7/1/2021","6/30/2026","$1.2M - $2.6M","Right","Reasonable","Very Strong","5'11""","174 lbs","109","8",123,136,11,10,8,6,13,12,11,10,7,13,14,13,14,9,14,14,14,12,12,13,12,8,12,9,15,16,12,14,11,11,13,12,14,11,15,13,8,12,15,14,8,13,6,12,12,5,8,14,9,3,4,3,3,3,3,3,1,2,3,3
"6531",13158205,"Victor Osimhen","12/29/1998 (24 years old)","ST (C)","Parthenope","Italian Serie A","NGA","No","6/14/2021","6/30/2025","$107M - $129M","Right","Reasonable","Very Strong","6'1""","171 lbs","155","79",170,175,4,7,13,18,14,5,18,12,4,4,12,14,7,14,15,15,12,15,13,13,15,14,10,20,5,12,11,13,17,15,15,16,15,19,13,15,10,9,9,12,16,10,10,14,13,12,16,16,15,3,1,3,2,2,1,1,4,3,2,2
"6532",2000136420,"Victor Eletu","4/1/2005 (18 years old)","DM, M (C)","AC Milan","Italian Serie A","NGA","No","12/7/2022","6/30/2025","$650K - $8.4M","Left","Very Strong","Weak","5'10""","156 lbs","-","-",93,167,5,6,9,7,13,4,6,12,5,8,13,6,11,14,11,13,12,9,11,10,15,7,11,7,12,14,13,12,13,12,8,7,16,12,10,8,11,12,13,15,13,11,6,10,13,4,13,16,15,3,1,2,3,3,2,2,4,1,2,2
"6533",18091791,"Wilfred Ndidi","12/16/1996 (26 years old)","DM, M (C)","Leicester","Sky Bet Championship","NGA","No","6/15/2020","6/30/2024","$15.5M - $19.5M","Right","Weak","Very Strong","6'0""","163 lbs","255","11",133,163,10,10,13,10,13,10,13,13,10,13,13,12,15,13,13,15,13,13,13,11,13,11,11,12,13,15,13,16,12,13,11,15,11,12,14,13,12,14,12,14,14,14,12,13,10,5,12,16,14,2,1,2,2,3,1,3,2,1,3,1
"6534",43195181,"Umar Sadiq","2/2/1997 (26 years old)","ST (C)","Real San Sebastián","Spanish First Division","NGA","No","8/31/2022","6/30/2028","$30M - $37M","Right","Fairly Strong","Very Strong","6'4""","165 lbs","159","69",142,159,6,6,14,14,11,8,13,12,7,6,11,11,5,13,16,14,12,12,12,12,14,16,11,15,5,10,12,12,16,13,12,16,16,16,14,14,4,7,12,12,11,9,8,14,8,11,13,13,12,2,2,2,2,3,1,1,1,1,2,2
"6535",67269484,"Samuel Chukwueze","5/22/1999 (24 years old)","M (R), AM (RL)","Villarreal","Spanish First Division","NGA","No","6/14/2021","6/30/2028","$16.5M - $25M","Left Only","Very Strong","Weak","5'8""","154 lbs","169","23",146,157,9,14,17,12,14,8,10,12,7,8,13,11,9,15,12,12,13,11,9,12,16,16,8,14,9,11,12,11,17,14,13,8,12,17,15,10,8,17,15,14,14,12,6,13,5,6,10,18,16,3,2,3,2,1,1,2,3,3,2,2
"6536",29141828,"Ademola Lookman","10/20/1997 (25 years old)","AM (RLC), ST (C)","Atalanta","Italian Serie A","NGA","No","8/10/2022","6/30/2026","$22M - $34M","Right","Fairly Strong","Very Strong","5'9""","156 lbs","194","39",149,155,9,12,16,14,14,11,8,13,4,4,12,13,5,15,13,13,8,12,11,12,15,14,8,14,4,11,13,14,17,15,14,7,14,15,12,10,12,15,13,12,12,10,10,14,3,10,14,17,11,3,3,2,3,3,3,3,2,1,3,4
"6537",13136621,"Kelechi Iheanacho","10/3/1996 (26 years old)","AM (C), ST (C)","Leicester","Sky Bet Championship","NGA","No","4/3/2021","6/30/2024","$26M - $31M","Left Only","Very Strong","Weak","6'1""","180 lbs","196","42",135,155,6,7,12,16,14,3,13,14,5,5,14,14,7,15,11,13,11,16,12,11,15,12,6,15,6,15,12,15,14,15,13,13,14,13,15,14,7,11,8,14,14,14,5,13,10,5,11,14,18,3,2,1,3,3,3,1,1,2,1,1
"6538",28084930,"Alex Iwobi","5/3/1996 (27 years old)","DM, M/AM (C)","Everton","English Premier Division","NGA","No","6/14/2021","6/30/2024","$20M - $31M","Right","Weak","Very Strong","5'11""","180 lbs","221","17",139,155,9,14,16,11,13,9,8,13,4,8,13,11,11,14,9,13,10,13,13,15,15,15,8,14,14,15,13,15,14,13,15,12,13,14,16,12,15,15,14,15,13,12,7,13,8,7,12,13,14,2,1,2,2,2,3,3,3,3,2,3
"6539",2000180227,"Nathaniel Nwosu","1/10/2006 (17 years old)","GK","Water F.C. (NGA)","-","NGA","No","6/13/2022","-","$0","Right","Reasonable","Very Strong","6'0""","163 lbs","-","-",97,153,5,2,3,2,8,6,1,2,2,3,13,3,2,7,12,11,14,7,10,14,7,3,8,1,7,8,8,3,11,13,4,9,7,11,2,7,10,11,11,10,9,9,11,3,7,7,11,12,17,11,5,14,6,10,14,14,9,7,11,14
"6540",61043070,"John McGinn","10/18/1994 (28 years old)","M/AM (RLC)","Aston Villa","English Premier Division","SCO","No","12/11/2020","6/30/2025","$36M","Left","Very Strong","Reasonable","5'11""","169 lbs","362","32",144,150,11,13,14,13,13,10,12,13,9,10,14,10,13,15,15,14,14,12,13,11,16,13,10,13,13,16,14,17,14,13,14,9,16,14,17,15,10,15,15,17,13,17,5,15,14,4,14,13,12,3,1,2,1,3,2,1,1,1,3,3
"6541",2000232157,"Daniel Daga","1/10/2007 (16 years old)","DM, M (C)","Enyimba Aba","Nigerian Premier League","NGA","No","6/12/2023","6/30/2026","$160K - $475K","Right","Reasonable","Very Strong","5'9""","145 lbs","1","-",86,153,7,6,4,8,14,7,7,14,3,6,14,2,12,11,13,10,8,9,9,12,11,5,11,8,7,8,14,12,14,10,4,9,10,9,7,9,12,16,10,11,11,11,5,16,7,5,6,11,8,3,1,1,2,3,1,3,1,4,3,1
"6542",53174131,"Victor Boniface","12/23/2000 (22 years old)","ST (C)","Union SG","Jupiler Pro League","NGA","No","8/3/2022","6/30/2027","$15.5M - $19M","Right","Reasonable","Very Strong","6'3""","200 lbs","86","22",136,152,4,8,15,14,13,10,14,12,8,7,11,14,7,15,13,13,14,12,10,12,16,15,8,13,7,12,11,13,13,13,16,14,11,15,12,17,10,15,12,13,12,10,12,14,10,5,12,15,16,2,2,1,2,1,1,1,1,3,1,1
"6543",47079007,"Terem Moffi","5/25/1999 (24 years old)","ST (C)","OGC Nice","Ligue 1 Uber Eats","NGA","No","10/1/2020","6/30/2028","$24M - $31M","Left","Very Strong","Weak","6'2""","196 lbs","160","70",140,149,7,8,13,14,13,9,12,11,7,7,12,13,7,13,12,13,13,12,12,11,14,14,7,13,13,13,13,13,17,12,16,13,15,17,13,17,10,12,14,14,12,14,7,14,10,7,14,13,14,3,1,3,2,1,3,2,1,2,2,3
"6544",2000143936,"Nduka Junior","8/1/2001 (21 years old)","D (C)","Remo Stars","Nigerian Premier League","NGA","No","1/1/2019","9/1/2023","$170K - $1.7M","Right","Reasonable","Very Strong","5'11""","160 lbs","60","5",112,148,11,9,6,5,12,14,13,8,2,10,12,3,14,11,7,11,12,11,11,14,17,5,8,9,11,10,11,9,14,15,11,8,15,12,10,9,17,19,9,13,13,13,10,18,9,5,11,12,8,2,2,1,3,3,2,3,2,1,3,1
"6545",2000183736,"Gift Orban","7/17/2002 (20 years old)","AM (R), ST (C)","AA Gent","Jupiler Pro League","NGA","No","1/31/2023","12/31/2026","$15.5M - $23M","Right","Fairly Strong","Very Strong","5'9""","174 lbs","42","35",123,148,10,10,15,14,14,8,11,10,6,4,10,9,6,14,7,10,8,11,9,11,12,16,6,12,10,10,10,10,15,14,12,11,13,12,12,14,10,10,12,8,11,8,13,15,5,13,9,17,16,2,3,3,3,1,1,3,3,1,3,2
"6546",2000263055,"Adiele Eriugo","10/31/2006 (16 years old)","AM (RC), ST (C)","Enyimba Aba","Nigerian Premier League","NGA","No","7/1/2022","6/30/2026","$45K - $475K","Right","Reasonable","Very Strong","5'11""","143 lbs","11","1",86,148,7,6,12,14,14,6,14,9,3,5,7,2,6,13,11,9,8,7,4,8,13,13,10,7,7,8,9,9,14,12,8,7,12,14,7,6,9,20,13,10,13,10,14,7,10,8,7,11,13,3,3,2,2,2,1,2,3,1,3,3
"6547",5007466,"Victor Moses","12/12/1990 (32 years old)","WB/M/AM (R)","Spartak Moscow","Russian Premier League","NGA","No","2/10/2022","6/30/2024","$550K - $5.4M","Right","Reasonable","Very Strong","5'10""","176 lbs","362","44",133,146,8,13,13,12,13,9,10,10,13,8,12,12,8,13,11,12,8,12,7,12,12,11,5,14,9,11,10,11,16,13,14,8,14,16,12,12,15,12,8,13,11,10,12,11,13,7,12,13,12,1,3,2,1,3,4,1,1,2,1,3
"6548",63029733,"Samuel Kalu","8/26/1997 (25 years old)","AM (RL), ST (C)","Watford","Sky Bet Championship","NGA","No","1/26/2022","6/30/2025","$1.4M - $3M","Right","Weak","Very Strong","5'10""","163 lbs","165","23",118,146,13,14,15,11,12,12,6,11,5,6,11,12,5,13,8,10,12,12,8,10,10,15,4,13,4,7,10,8,15,13,12,6,13,15,13,10,13,20,12,7,8,10,14,12,14,13,7,17,12,3,2,4,1,1,1,4,3,1,1,3
"6549",71099020,"Emmanuel Dennis","11/15/1997 (25 years old)","M (R), AM (RL)","Nottm Forest","English Premier Division","NGA","No","8/13/2022","6/30/2026","$8.2M - $12.5M","Right Only","Weak","Very Strong","5'9""","145 lbs","170","37",127,145,9,11,13,13,11,9,9,10,5,6,12,14,8,12,14,12,16,13,10,8,11,14,8,10,5,10,7,10,17,15,12,7,13,18,13,13,10,9,8,7,11,8,5,12,12,8,8,16,12,3,2,2,3,1,1,1,4,1,1,1
"6550",53160749,"Igoh Ogbu","2/8/2000 (23 years old)","D (C)","Slavia Prague","Czech First Division","NGA","No","1/6/2023","6/30/2027","$3.5M - $7M","Right","Weak","Very Strong","6'2""","171 lbs","142","8",119,145,6,8,7,6,11,6,13,11,9,13,9,5,13,9,14,13,14,11,10,11,15,12,10,9,11,14,11,13,14,13,14,15,16,14,13,15,6,12,13,13,14,12,4,15,12,8,13,14,13,3,4,2,2,1,1,1,4,2,3,3
"6551",61036844,"Callum McGregor","6/14/1993 (29 years old)","DM, M (C)","Celtic","cinch Premiership","SCO","No","6/14/2021","5/31/2025","$18.5M - $28M","Left","Very Strong","Strong","5'10""","147 lbs","314","52",143,150,8,8,13,11,14,7,9,12,5,12,14,13,12,16,15,13,11,15,13,14,16,10,18,13,13,15,13,16,13,13,12,9,18,12,17,10,12,12,16,18,13,20,4,15,8,4,13,13,14,3,2,2,1,1,3,1,3,3,2,1
"6552",13136629,"Taiwo Awoniyi","8/12/1997 (25 years old)","ST (C)","Nottm Forest","English Premier Division","NGA","No","7/1/2022","6/30/2027","$30M - $36M","Right","Reasonable","Very Strong","6'0""","163 lbs","183","55",136,145,7,9,15,16,14,8,14,11,5,4,11,12,4,14,14,13,13,9,11,10,13,13,5,15,5,11,11,13,16,15,16,11,13,15,13,16,5,12,10,11,10,9,5,13,5,10,11,14,12,2,3,3,3,1,3,2,1,3,1,2
"6553",28111079,"Calvin Bassey","12/31/1999 (23 years old)","D (LC)","Ajax","Eredivisie","NGA","Yes","7/20/2022","6/30/2027","$17M - $22M","Left Only","Very Strong","Weak","6'1""","171 lbs","61","1",134,144,9,12,12,7,9,7,15,7,14,14,10,9,13,11,13,12,15,12,11,12,10,11,10,11,13,12,7,15,13,10,13,15,16,15,19,18,13,17,18,15,9,14,5,9,11,7,10,16,10,3,3,3,3,3,4,3,2,3,1,1
"6554",2000155408,"Emmanuel Ayaosi","10/28/2005 (17 years old)","AM (RC)","Karviná","Czech First Division","NGA","No","3/25/2023","6/30/2025","$160K - $1.6M","Right","Reasonable","Very Strong","5'11""","147 lbs","36","8",87,144,8,11,13,11,13,6,6,8,2,5,13,2,7,13,7,4,3,5,7,13,4,13,9,12,6,3,10,8,13,13,8,5,11,13,10,5,11,20,8,12,12,11,8,14,10,1,7,13,20,2,2,3,2,3,1,2,1,2,1,1
"6555",43207763,"Michael Folorunsho","2/7/1998 (25 years old)","DM, M/AM (C)","Parthenope","Italian Serie A","NGA","Yes","7/13/2019","6/30/2024","$170K - $1.7M","Right Only","Weak","Very Strong","6'1""","169 lbs","162","26",130,143,5,12,13,12,13,11,10,14,8,11,14,9,14,13,16,12,14,13,12,13,15,13,11,14,12,14,13,16,12,12,14,14,15,13,15,15,10,12,13,13,11,11,3,12,14,10,13,14,12,3,3,1,2,3,2,2,3,3,3,2
"6556",27129125,"Frank Onyeka","1/1/1998 (25 years old)","DM, M (C)","Brentford","English Premier Division","NGA","No","7/20/2021","6/30/2026","$7.8M - $9.4M","Right","Reasonable","Very Strong","6'0""","174 lbs","136","14",128,142,6,9,12,11,12,7,11,11,8,10,12,8,13,12,14,13,12,12,13,12,17,11,7,14,13,15,13,17,14,13,12,11,14,14,15,13,16,8,13,12,12,13,5,12,8,7,11,12,13,1,1,4,1,3,3,1,2,2,1,3
"6557",93127168,"Alhassan Yusuf","7/18/2000 (22 years old)","DM, M (C)","Antwerp","Jupiler Pro League","NGA","No","7/16/2021","6/30/2025","$9.6M - $14.5M","Right Only","Weak","Very Strong","5'9""","145 lbs","128","5",128,142,7,9,13,8,14,8,8,7,3,10,14,9,15,14,14,16,14,14,12,13,12,9,8,12,14,15,13,16,14,13,12,8,12,13,15,12,13,11,11,12,12,11,7,10,7,6,12,14,13,1,2,3,2,1,3,2,3,3,3,3
"6558",2000257691,"Emmanuel Michael","6/16/2006 (16 years old)","D (L)","Simoiben FC","Nigerian Lower Division","NGA","No","6/12/2023","6/30/2026","$14K - $140K","Left","Very Strong","Fairly Strong","5'7""","127 lbs","-","-",97,142,7,14,8,9,11,3,10,6,9,9,10,5,12,10,8,8,11,9,8,15,6,12,2,8,8,10,10,10,14,13,10,5,12,11,12,3,10,11,11,13,9,11,5,13,7,6,12,9,7,2,1,3,1,3,3,3,3,1,3,2
"6559",27162493,"Raphael Onyedika","4/19/2001 (22 years old)","DM, M (C)","Club Brugge","Jupiler Pro League","NGA","No","8/28/2022","6/30/2027","$13.5M - $16M","Right","Reasonable","Very Strong","6'0""","182 lbs","96","5",118,141,6,7,11,8,11,7,13,9,10,12,13,7,13,12,15,12,13,11,11,13,11,6,7,14,12,13,13,15,12,13,11,12,14,13,14,14,11,13,7,9,12,9,5,12,9,8,12,9,13,2,2,2,1,3,1,3,3,3,2,2
"6560",2000155999,"Olamilekan Adams","10/11/2004 (18 years old)","AM (RLC)","Remo Stars","Nigerian Premier League","NGA","No","8/25/2022","9/1/2024","$40K - $400K","Right","Strong","Very Strong","6'2""","167 lbs","33","4",88,140,8,13,14,12,10,7,8,9,3,5,14,5,3,14,11,10,8,8,8,12,5,13,10,9,7,8,9,9,10,9,8,12,14,12,13,5,15,13,10,12,8,12,5,13,7,8,8,11,19,3,3,2,1,1,3,3,1,2,2,3
"6561",57070194,"Tony Nwakaeme","3/21/1989 (34 years old)","AM (L), ST (C)","Al-Fayha","Saudi Professional League","NGA","No","5/31/2022","6/30/2024","$650K - $6.4M","Right","Reasonable","Very Strong","6'1""","176 lbs","352","113",130,140,8,13,15,14,15,8,11,14,9,5,14,12,5,16,13,15,13,15,12,14,12,18,10,14,6,15,16,12,11,11,16,11,17,11,11,15,8,9,10,12,12,9,7,15,4,6,15,10,13,3,2,2,1,3,3,1,1,3,3,2
"6562",29125343,"Scott McTominay","12/8/1996 (26 years old)","DM, M/AM (C)","Man UFC","English Premier Division","SCO","No","6/23/2020","6/30/2025","$34M","Right","Fairly Strong","Very Strong","6'4""","194 lbs","144","12",139,148,5,12,12,14,13,5,14,12,10,11,13,7,15,12,17,11,16,11,14,11,18,6,14,14,11,18,9,15,13,14,15,17,17,14,19,15,15,16,14,18,15,16,4,14,17,2,13,15,15,2,3,3,3,2,2,2,3,1,3,4
"6563",13106718,"Ahmed Musa","10/14/1992 (30 years old)","AM (RL), ST (C)","Sivasspor","Turkish Super League","NGA","No","9/2/2022","6/30/2024","$240K - $2.4M","Right","Reasonable","Very Strong","5'6""","152 lbs","344","91",105,140,7,7,12,10,11,5,6,8,4,6,11,8,7,10,8,9,11,11,11,8,9,11,7,12,7,10,11,11,16,13,11,6,12,15,12,6,12,14,16,17,11,15,9,10,3,7,9,14,7,1,2,3,2,3,2,3,2,1,2,2
"6564",67214340,"Uche Agbo","12/4/1995 (27 years old)","DM, M (C)","Slovan Bratislava","Slovak First Division","NGA","No","9/1/2021","6/30/2024","$0 - $80K","Right","Reasonable","Very Strong","6'1""","165 lbs","206","6",100,140,3,9,12,6,12,4,14,9,7,12,13,7,12,10,13,13,15,11,10,8,12,10,11,12,12,14,8,12,10,12,10,14,14,11,15,13,13,10,16,14,15,11,16,12,11,9,11,16,11,4,3,3,2,2,3,1,2,3,2,1
"6565",95078952,"Samson Tijani","5/17/2002 (21 years old)","D (C), DM","FC RB Salzburg","Austrian Premier Division","NGA","No","7/1/2020","5/31/2025","$180K - $1.8M","Right","Fairly Strong","Very Strong","5'9""","154 lbs","33","-",108,140,6,7,11,6,11,8,10,9,6,12,11,11,11,12,12,11,12,9,11,9,13,8,8,9,13,13,12,12,12,12,13,9,12,12,13,12,7,11,7,13,11,10,6,8,7,2,10,15,13,3,3,1,1,1,2,2,3,1,3,3
"6566",28106417,"Josh Maja","12/27/1998 (24 years old)","ST (C)","Bordeaux","Ligue 2 BKT","NGA","No","6/15/2020","6/30/2025","$4M - $7.8M","Right","Reasonable","Very Strong","5'11""","163 lbs","156","45",126,139,7,9,11,14,13,7,13,12,4,9,12,14,7,14,12,13,15,13,6,13,14,11,10,14,10,15,14,14,11,14,12,14,12,12,13,14,10,14,13,12,12,13,6,12,6,7,13,15,6,3,4,2,1,2,2,1,2,2,1,1
"6567",2000147542,"Moses Usor","2/5/2002 (21 years old)","AM (RL)","LASK","Austrian Premier Division","NGA","No","6/21/2022","6/30/2025","$550K - $5.2M","Left","Very Strong","Reasonable","5'11""","141 lbs","40","11",116,139,11,10,16,13,16,13,10,15,11,11,16,9,10,14,11,7,15,12,7,10,17,11,13,12,11,9,9,14,13,12,9,6,11,13,11,9,14,14,11,14,11,8,8,15,5,8,10,10,19,2,3,3,3,2,1,1,1,1,1,3
"6568",13195100,"Stephen Odey","1/15/1998 (25 years old)","ST (C)","Randers FC","3F Superliga","NGA","No","6/30/2022","6/30/2024","$200K - $2M","Right","Fairly Strong","Very Strong","6'0""","158 lbs","181","53",117,139,7,11,13,13,11,7,12,9,5,5,11,10,6,13,11,12,12,10,9,10,10,14,6,12,6,10,10,12,15,14,11,11,14,15,12,12,13,11,9,13,8,10,9,10,8,8,8,13,12,2,2,1,3,1,2,2,1,3,2,2
"6569",2000143929,"Kayode Bankole","10/16/2002 (20 years old)","GK","Remo Stars","Nigerian Premier League","NGA","No","10/31/2021","12/12/2024","$650K - $1.4M","Right","Fairly Strong","Very Strong","6'1""","165 lbs","52","-",109,139,2,1,2,1,5,6,1,2,3,2,12,3,3,6,8,10,15,9,10,13,11,3,10,3,12,6,8,8,12,13,9,10,15,13,4,7,12,13,11,11,10,10,13,8,10,5,10,10,9,9,9,14,5,14,11,14,5,7,11,14
"6570",28090452,"Ola Aina","10/8/1996 (26 years old)","D/WB/M (RL)","Torino","Italian Serie A","NGA","No","6/15/2020","6/30/2026","$5.2M - $8M","Right","Strong","Very Strong","6'0""","180 lbs","180","4",131,138,5,12,12,7,11,4,11,6,12,9,11,5,12,12,11,9,9,11,9,9,12,14,7,11,9,10,10,12,17,13,12,11,16,17,13,10,16,15,14,15,11,10,7,12,11,7,11,14,12,4,2,1,4,1,2,2,2,1,1,1
"6571",89046527,"Joe Aribo","7/21/1996 (26 years old)","M (C), AM (RLC)","Southampton","Sky Bet Championship","NGA","No","7/9/2022","6/30/2026","$7.4M","Left Only","Very Strong","Weak","6'2""","163 lbs","217","34",127,138,10,10,16,14,18,8,8,12,6,6,12,9,10,15,7,16,8,15,10,12,11,15,5,14,9,11,14,13,11,14,15,13,14,11,14,15,12,11,10,13,8,8,4,10,4,3,7,11,14,3,1,2,1,2,1,2,3,4,1,2
"6572",13139098,"Moses Simon","7/12/1995 (27 years old)","M (L), AM (RL)","FC Nantes","Ligue 1 Uber Eats","NGA","No","6/1/2020","6/30/2024","$6.2M - $9.6M","Right","Reasonable","Very Strong","5'6""","145 lbs","283","57",130,138,11,13,14,12,14,10,6,11,4,5,13,11,6,15,8,11,13,11,11,11,12,15,9,13,10,11,12,11,16,15,11,5,12,15,12,10,10,16,13,13,12,12,11,9,8,9,11,14,12,1,1,2,4,1,1,1,1,3,2,1
"6573",61064267,"Scott McKenna","11/12/1996 (26 years old)","D (C)","Nottm Forest","English Premier Division","SCO","No","9/23/2020","6/30/2024","$7.8M","Left","Very Strong","Reasonable","6'2""","160 lbs","207","8",127,148,4,5,7,6,10,7,15,10,10,14,11,10,14,10,15,13,14,12,12,12,15,7,16,7,13,13,8,13,12,11,11,15,12,14,13,15,11,13,10,14,12,12,8,14,13,7,14,15,12,3,2,3,2,1,3,3,1,1,1,3
"6574",12036026,"Kenneth Omeruo","10/17/1993 (29 years old)","D (RC)","Leganés","Spanish Second Division","NGA","No","8/14/2019","6/30/2025","$210K - $2.1M","Right","Weak","Very Strong","6'1""","176 lbs","262","9",115,138,7,8,10,6,12,3,12,5,15,13,11,4,15,12,12,14,16,11,12,10,14,12,7,11,10,11,11,13,13,12,16,12,17,14,13,14,13,16,13,13,12,12,7,10,12,5,9,12,15,2,3,3,1,2,4,1,3,2,2,3
"6575",95078945,"Hamzat Ojediran","11/14/2003 (19 years old)","DM, M (C)","Debrecen","Hungarian Division I","NGA","No","8/1/2022","6/30/2024","$110K - $325K","Right Only","Weak","Very Strong","5'10""","165 lbs","20","-",95,138,7,7,9,7,6,7,8,8,1,13,13,3,12,9,14,10,16,12,13,12,6,7,8,10,10,13,9,14,13,14,10,9,14,12,10,11,14,17,13,11,11,13,4,17,9,5,11,11,7,4,1,1,1,2,3,1,4,2,4,4
"6576",2000251031,"Chinecherem Ugwueze","7/9/2002 (20 years old)","DM","Enugu Rangers IFC","Nigerian Premier League","NGA","No","7/1/2022","6/30/2024","$26K - $250K","Right","Fairly Strong","Very Strong","6'1""","169 lbs","3","-",80,137,6,4,7,7,10,6,6,7,1,7,10,2,13,7,11,13,8,7,4,13,4,5,13,6,12,7,10,11,13,10,7,11,14,11,6,6,12,13,10,9,11,10,9,10,8,7,9,11,7,2,1,2,4,2,3,1,1,1,3,1
"6577",47102376,"Toluwalase Arokodare","11/23/2000 (22 years old)","ST (C)","KRC Genk","Jupiler Pro League","NGA","No","1/31/2023","6/30/2027","$21M - $32M","Right","Reasonable","Very Strong","6'6""","213 lbs","108","38",121,137,5,7,11,12,12,9,15,12,7,8,11,10,8,11,13,11,12,13,13,12,15,7,8,12,13,14,11,13,11,8,15,18,12,11,12,18,10,12,12,7,11,8,9,9,8,13,9,12,10,2,3,3,3,3,1,1,2,4,1,3
"6578",8158621,"Peter Utaka","2/12/1984 (39 years old)","ST (C)","Kofu","J2 League","NGA","Yes","1/2/2023","1/31/2024","$30K - $95K","Right","Fairly Strong","Very Strong","5'10""","174 lbs","622","265",118,137,9,8,13,14,13,7,9,10,12,3,8,11,4,13,10,14,12,13,7,11,6,13,6,14,8,6,8,7,14,12,12,8,16,13,12,14,8,7,13,7,14,11,7,15,12,8,10,8,15,1,1,3,2,4,3,2,2,2,1,1
"6579",2000011530,"Somiari Alalibo","11/30/2001 (21 years old)","D (C)","Enyimba Aba","Nigerian Premier League","NGA","No","7/1/2020","9/1/2023","$90K - $900K","Right","Fairly Strong","Very Strong","5'11""","154 lbs","29","-",101,137,6,5,3,4,14,3,12,8,3,12,11,5,16,14,7,12,11,9,12,12,10,5,11,10,16,10,10,11,12,12,11,8,14,11,12,7,15,13,10,12,12,11,10,16,14,4,11,7,8,2,1,3,1,3,1,3,3,1,2,3
"6580",13224511,"Olakunle Olusegun","4/23/2002 (21 years old)","AM (RL), ST (C)","Krasnodar","Russian Premier League","NGA","No","6/14/2022","6/10/2026","$850K - $5.6M","Right Only","Weak","Very Strong","5'6""","147 lbs","86","18",124,137,9,8,12,10,12,6,6,10,3,3,11,5,8,12,12,8,5,10,9,8,15,12,15,11,6,8,8,12,17,15,11,4,10,20,12,7,10,14,12,11,12,8,6,13,11,6,10,11,12,2,3,1,1,1,2,3,2,2,1,4
"6581",2000155273,"Mustapha Lawal","8/11/2001 (21 years old)","GK","Sunshine Stars","Nigerian Premier League","NGA","No","9/1/2021","9/1/2023","$325K - $1M","Right","Fairly Strong","Very Strong","6'0""","167 lbs","42","-",101,137,4,3,1,2,5,8,1,3,2,2,11,3,3,4,11,8,15,10,9,15,5,1,1,2,14,10,9,9,12,9,10,9,7,11,5,8,10,11,11,10,14,11,6,16,6,7,18,11,19,10,14,15,9,9,11,9,5,10,10,12
"6582",2000011516,"Vincent Edafe","11/23/2001 (21 years old)","GK","Remo Stars","Nigerian Premier League","NGA","No","8/18/2022","6/30/2024","$150K - $1.5M","Left Only","Very Strong","Weak","6'2""","171 lbs","43","-",101,137,4,3,1,2,1,8,1,3,3,2,11,3,1,8,5,6,13,8,9,13,4,2,1,3,9,8,7,6,14,15,8,9,12,13,1,7,10,12,12,9,8,11,12,3,7,3,11,9,10,9,5,12,12,10,10,13,8,9,11,10
"6583",83169004,"Zaidu Sanusi","6/13/1997 (25 years old)","D/WB/M (L)","FC Porto","Portuguese Premier League","NGA","No","10/7/2022","6/30/2027","$475K - $4.7M","Left","Very Strong","Weak","6'0""","156 lbs","162","8",132,136,12,11,11,11,9,9,14,8,12,12,11,8,9,10,14,13,14,11,13,9,14,10,9,13,12,12,7,14,17,13,13,14,14,17,15,12,14,13,15,14,13,9,5,16,11,5,13,14,10,1,3,3,1,2,3,1,2,3,2,3
"6584",61089387,"Aaron Hickey","6/10/2002 (21 years old)","D/WB (RL)","Brentford","English Premier Division","SCO","No","7/9/2022","6/30/2026","$72M - $91M","Left","Very Strong","Strong","5'9""","158 lbs","97","6",139,165,9,13,14,9,12,7,9,13,11,11,12,8,12,13,12,13,15,12,12,12,15,13,8,12,13,15,13,14,14,14,11,11,13,14,13,11,14,11,14,14,13,12,8,12,14,3,13,13,15,3,1,3,3,3,3,3,4,2,2,2
"6585",61042729,"Ryan Gauld","12/16/1995 (27 years old)","M (C), AM (LC)","Vancouver","Major League Soccer","SCO","No","8/1/2021","12/31/2024","$7M - $8.4M","Left Only","Very Strong","Weak","5'7""","134 lbs","277","51",136,146,15,16,15,13,16,13,7,11,5,6,15,12,10,16,6,14,11,13,14,14,14,10,12,15,11,14,16,15,14,14,15,5,12,13,11,8,14,12,13,16,11,14,8,13,4,6,12,10,13,3,3,2,2,1,2,3,3,3,1,3
"6586",12036029,"Larry Kayode","5/8/1993 (30 years old)","AM (R), ST (C)","Shakhtar","Ukrainian Premier League","NGA","No","6/14/2021","6/30/2024","$0","Right","Reasonable","Very Strong","5'9""","147 lbs","267","85",115,136,5,8,13,10,12,7,11,8,6,5,10,12,10,12,14,12,8,9,7,10,12,9,8,13,3,9,9,10,16,16,6,9,12,16,15,11,11,6,8,7,6,10,8,11,15,13,9,12,15,4,2,3,3,3,3,3,3,3,3,3
"6587",16010162,"David Alaba","6/24/1992 (30 years old)","D (LC), WB (L), M (C)","R. Madrid","Spanish First Division","AUT","Yes","7/1/2021","6/30/2026","$77M - $116M","Left","Very Strong","Reasonable","5'11""","171 lbs","389","28",164,174,12,12,12,10,15,15,13,14,13,14,16,14,13,15,13,15,12,15,15,15,16,12,15,14,15,15,13,14,15,13,14,12,18,15,15,13,19,10,12,15,15,14,7,15,8,10,14,17,12,1,3,2,1,1,1,3,1,1,3,1
"6588",16191724,"Nicolas Seiwald","5/4/2001 (22 years old)","DM, M (C)","FC RB Salzburg","Austrian Premier Division","AUT","Yes","6/15/2020","6/30/2027","$15M - $23M","Right","Reasonable","Very Strong","5'10""","174 lbs","114","8",136,159,14,11,12,8,13,13,8,12,6,12,13,8,15,13,15,14,16,13,15,12,16,12,14,12,13,16,12,16,13,12,13,9,18,14,16,12,13,14,14,18,15,17,3,14,12,6,16,16,8,1,1,3,3,1,3,3,4,2,3,2
"6589",16045721,"Marcel Sabitzer","3/17/1994 (29 years old)","DM, M/AM (C)","Man UFC","English Premier Division","AUT","Yes","8/30/2021","6/30/2026","$16.5M - $20M","Right","Fairly Strong","Very Strong","5'10""","167 lbs","393","96",148,156,11,12,12,12,13,15,10,16,7,12,14,16,13,13,16,14,15,13,12,13,17,13,13,16,13,16,14,17,12,12,12,10,16,14,16,12,18,10,8,15,15,7,10,14,12,13,15,15,12,1,3,1,2,2,3,3,1,4,1,2
"6590",16337125,"Leopold Querfeld","12/20/2003 (19 years old)","D (C), DM","SK Rapid","Austrian Premier Division","AUT","Yes","2/21/2023","6/30/2025","$17.5M - $21M","Right","Reasonable","Very Strong","6'3""","182 lbs","70","2",118,156,5,5,8,6,11,10,10,11,10,10,10,10,11,12,9,12,13,11,12,11,16,5,6,8,15,13,11,14,13,10,15,16,14,13,14,13,14,13,12,15,9,9,11,6,15,3,11,17,12,2,2,2,1,2,1,3,2,1,1,4
"6591",16191675,"Niklas Hedl","3/17/2001 (22 years old)","GK","SK Rapid","Austrian Premier Division","AUT","Yes","4/26/2023","6/30/2027","$9.4M - $12M","Right","Reasonable","Very Strong","6'2""","178 lbs","96","-",124,156,1,1,2,1,11,1,5,5,11,2,11,4,2,4,4,8,11,8,11,9,17,7,8,1,14,13,8,14,11,12,12,15,14,10,12,12,1,14,15,15,13,16,4,11,5,4,14,17,16,15,12,16,9,12,15,14,7,13,14,13
"6592",37003555,"Marko Arnautović","4/19/1989 (34 years old)","ST (C)","Bologna","Italian Serie A","AUT","Yes","8/1/2021","6/30/2024","$95K - $950K","Right","Strong","Very Strong","6'4""","182 lbs","409","118",141,155,4,11,14,15,17,12,14,14,4,4,15,16,7,16,16,9,14,12,9,11,15,17,11,14,6,13,15,13,12,11,16,13,10,13,12,17,11,8,10,18,12,11,10,13,14,14,15,18,14,1,3,1,2,3,3,2,2,2,1,3
"6593",16337140,"Nikolas Sattlberger","1/18/2004 (19 years old)","DM, M (C)","SK Rapid","Austrian Premier Division","AUT","Yes","6/30/2022","6/30/2025","$11M - $17M","Right","Fairly Strong","Very Strong","6'2""","160 lbs","34","1",117,155,12,12,9,7,10,12,12,14,10,11,9,6,10,11,10,10,12,10,11,12,14,5,6,9,14,13,10,14,14,12,13,17,13,14,13,14,16,10,11,10,8,11,9,6,7,8,11,14,8,2,2,2,1,1,1,1,2,2,3,2
"6594",2000174791,"Oliver Lukic","9/22/2006 (16 years old)","M (C)","FC RB Salzburg","Austrian Premier Division","AUT","Yes","7/1/2022","6/30/2026","$1.1M - $6.2M","Right","Reasonable","Very Strong","6'1""","156 lbs","3","-",94,155,6,6,6,10,15,9,9,13,6,10,15,3,12,12,6,10,4,6,8,15,15,10,9,10,8,10,8,13,15,10,10,14,13,12,8,7,11,11,11,12,10,11,6,4,15,7,11,13,8,2,1,2,3,3,4,3,2,2,1,3
"6595",16147659,"Konrad Laimer","5/27/1997 (26 years old)","D/WB (R), DM, M (C)","RB Leipzig","Bundesliga","AUT","Yes","6/14/2021","6/30/2026","$36M - $45M","Right","Reasonable","Very Strong","5'11""","158 lbs","206","14",149,154,6,11,13,10,12,7,8,12,8,13,13,8,17,13,17,14,18,12,14,13,18,11,13,13,13,19,12,20,14,14,12,9,13,15,17,12,17,12,12,16,15,12,10,16,10,8,15,16,12,2,3,1,3,2,2,4,2,3,1,2
"6596",61042900,"Ryan Christie","2/22/1995 (28 years old)","M/AM (RLC)","Bournemouth","English Premier Division","SCO","No","8/31/2021","6/30/2024","$17.5M","Left","Very Strong","Reasonable","5'10""","163 lbs","274","51",132,145,11,12,14,11,14,12,5,13,1,5,13,11,7,14,10,15,7,12,11,12,12,15,8,15,9,12,15,16,13,14,12,9,15,14,14,11,10,13,14,14,10,14,6,14,6,8,15,14,10,2,2,1,2,2,2,1,3,2,1,2
"6597",16253898,"Patrick Wimmer","5/30/2001 (22 years old)","M (R), AM (RL)","VfL Wolfsburg","Bundesliga","AUT","Yes","7/1/2022","6/30/2027","$52M - $79M","Right","Fairly Strong","Very Strong","6'0""","169 lbs","162","23",136,153,13,11,15,10,12,13,8,10,6,9,12,7,11,14,16,12,16,11,12,12,16,15,6,12,9,16,12,16,15,14,11,11,13,15,13,11,18,9,11,14,12,8,8,12,9,6,13,16,12,1,3,1,4,1,2,2,4,3,2,3
"6598",16147660,"Xaver Schlager","9/28/1997 (25 years old)","DM, M (C)","RB Leipzig","Bundesliga","AUT","Yes","7/1/2022","6/30/2026","$26M - $39M","Left","Very Strong","Fairly Strong","5'9""","167 lbs","204","18",147,152,4,8,12,8,14,12,8,12,4,13,15,8,16,14,16,15,16,15,16,13,17,11,15,12,14,16,14,17,12,12,14,9,16,14,16,12,14,12,12,15,14,12,10,12,12,12,15,17,13,2,3,1,1,2,3,2,2,1,3,1
"6599",16202375,"David Affengruber","3/19/2001 (22 years old)","D (C)","SK Sturm Graz","Austrian Premier Division","AUT","Yes","7/1/2021","6/30/2024","$9.4M - $12M","Right","Fairly Strong","Very Strong","6'1""","180 lbs","112","10",127,152,4,6,8,5,12,8,14,8,7,13,10,7,13,13,11,13,14,13,12,10,15,4,7,6,16,13,12,14,12,10,15,12,13,14,13,13,8,16,13,9,10,13,5,6,6,3,12,14,19,2,3,1,1,3,1,2,1,2,3,1
"6600",16337074,"Dijon Kameri","4/20/2004 (19 years old)","M/AM (C)","FC RB Salzburg","Austrian Premier Division","AUT","Yes","6/7/2022","6/30/2026","$11.5M - $17.5M","Right","Reasonable","Very Strong","5'11""","167 lbs","42","4",121,151,7,12,14,9,13,9,9,12,8,8,12,9,6,14,9,12,13,10,11,10,17,9,8,14,8,13,13,12,14,13,12,10,13,15,13,11,6,14,12,14,12,13,9,9,7,9,11,17,14,3,1,1,3,2,3,4,3,2,1,1
"6601",16254007,"Matthias Braunöder","3/27/2002 (21 years old)","DM, M (C)","FK Austria Vienna","Austrian Premier Division","AUT","Yes","7/29/2022","6/30/2025","$7.4M - $9.2M","Right","Fairly Strong","Very Strong","5'9""","147 lbs","102","5",114,150,7,8,12,7,11,9,10,9,7,12,12,7,13,12,9,11,13,11,13,10,16,8,9,12,15,13,9,15,13,12,12,8,13,12,13,10,8,14,9,10,14,16,5,10,6,4,12,16,8,1,1,2,2,3,1,3,1,3,3,1
"6602",2000199064,"Phillip Verhounig","1/5/2006 (17 years old)","ST (C)","FC Liefering","Austrian First Division","AUT","Yes","6/13/2022","6/30/2025","$150K - $6.8M","Right","Reasonable","Very Strong","5'9""","145 lbs","2","-",95,150,6,7,13,13,13,7,13,8,1,4,8,10,1,13,14,8,9,13,7,13,7,13,10,13,4,3,8,8,13,13,8,7,12,13,8,7,12,14,12,12,12,14,13,14,10,4,10,11,10,3,1,3,4,2,1,1,4,2,1,2
"6603",16184707,"Christoph Baumgartner","8/1/1999 (23 years old)","M/AM (C), ST (C)","TSG Hoffenheim","Bundesliga","AUT","Yes","6/15/2020","6/30/2027","$21M - $26M","Right","Reasonable","Very Strong","5'11""","160 lbs","135","32",138,150,12,9,14,12,14,12,14,12,6,9,13,12,11,15,16,15,16,14,12,12,17,14,12,16,10,15,13,17,13,13,13,11,15,14,14,10,16,10,12,15,15,15,6,14,13,7,14,16,13,2,3,3,1,1,4,2,2,2,2,2
"6604",16191306,"Emanuel Aiwu","12/25/2000 (22 years old)","D (RC)","Cremonese","Italian Serie B","AUT","Yes","8/5/2022","6/30/2026","$230K - $7.6M","Right","Reasonable","Very Strong","6'1""","180 lbs","149","7",122,149,5,8,8,6,11,7,14,8,10,13,9,8,14,10,14,13,12,10,9,10,16,8,8,9,13,14,10,14,14,13,13,14,15,15,14,15,14,12,14,13,12,8,5,10,9,13,9,14,17,2,1,2,2,3,2,2,4,3,2,1
"6605",91172522,"Flavius Daniliuc","4/27/2001 (22 years old)","D (RC)","Salernitana","Italian Serie A","AUT","Yes","8/29/2022","6/30/2026","$4.3M - $6.6M","Right","Reasonable","Very Strong","6'2""","174 lbs","80","1",126,149,6,8,12,6,12,5,14,7,11,13,13,7,15,13,16,13,15,10,10,12,15,8,7,8,13,16,11,15,13,11,14,13,16,13,15,15,16,13,13,15,12,13,6,13,11,5,13,13,11,1,3,4,1,2,2,2,2,2,1,3
"6606",16191722,"Alexander Prass","5/26/2001 (22 years old)","D (L), M (LC)","SK Sturm Graz","Austrian Premier Division","AUT","Yes","7/18/2022","6/30/2025","$6.8M - $10M","Left","Very Strong","Fairly Strong","5'11""","158 lbs","118","14",126,149,9,8,13,7,12,7,9,13,7,10,13,8,11,14,7,11,12,11,11,12,16,7,8,14,9,13,10,13,14,12,8,10,12,15,17,9,9,18,12,11,12,10,11,8,6,3,13,17,12,3,3,1,3,2,3,2,2,3,1,2
"6607",2000170028,"Lennon Miller","8/25/2006 (16 years old)","DM, M/AM (C)","Motherwell","cinch Premiership","SCO","No","6/13/2022","5/31/2025","$5.8M - $8.6M","Right","Fairly Strong","Very Strong","6'0""","158 lbs","4","-",107,145,10,11,12,8,11,9,11,10,3,7,12,7,9,11,14,16,14,11,12,11,6,13,12,12,8,14,12,16,9,8,10,12,12,9,14,13,10,16,12,11,11,11,6,10,13,6,8,11,12,2,1,3,1,3,3,1,2,3,3,3
"6608",16254134,"Moritz Oswald","1/5/2002 (21 years old)","DM, M (C)","SK Rapid","Austrian Premier Division","AUT","Yes","2/8/2022","6/30/2025","$7.2M - $11M","Right","Reasonable","Very Strong","5'7""","145 lbs","44","1",116,148,6,8,10,7,11,10,8,12,7,10,11,7,12,12,8,11,12,10,11,12,15,5,7,12,14,14,12,14,14,14,10,8,13,14,13,10,11,14,14,11,13,9,11,8,5,2,11,16,13,1,1,2,2,3,1,2,1,1,1,1
"6609",16130398,"Philipp Lienhart","7/11/1996 (26 years old)","D (C)","SC Freiburg","Bundesliga","AUT","Yes","6/1/2023","6/30/2027","$19M - $29M","Right","Reasonable","Very Strong","6'2""","182 lbs","223","12",142,147,4,7,11,6,12,4,16,6,16,14,13,7,13,12,12,15,13,15,15,14,13,8,12,9,14,16,11,12,12,11,15,16,16,14,13,14,7,18,15,16,14,16,7,14,9,4,15,12,8,1,4,3,1,1,3,1,3,3,3,2
"6610",16010163,"Aleksandar Dragović","3/6/1991 (32 years old)","D (C)","Crvena zvezda","Serbian SuperLeague","AUT","Yes","5/26/2021","6/30/2024","$120K - $1.2M","Right","Strong","Very Strong","6'1""","187 lbs","364","14",131,146,5,7,8,7,10,5,12,7,8,14,12,10,15,11,11,15,15,15,12,13,15,7,12,8,14,14,12,11,12,11,13,13,15,13,12,13,12,10,12,12,15,11,4,15,7,11,11,14,15,1,2,2,3,3,3,2,1,1,3,2
"6611",5608859,"Zlatko Junuzovic","9/26/1987 (35 years old)","M/AM (C)","FC RB Salzburg","Austrian Premier Division","AUT","Yes","6/14/2021","6/30/2024","$0","Right","Fairly Strong","Very Strong","5'8""","158 lbs","479","63",115,145,16,13,10,10,12,15,5,11,7,9,14,11,9,12,18,9,14,12,14,13,16,9,16,11,9,15,11,15,10,13,13,6,10,10,10,9,17,12,14,18,12,15,16,15,8,3,16,11,11,1,1,3,3,2,4,2,1,2,2,1
"6612",16096614,"Florian Grillitsch","8/7/1995 (27 years old)","D (C), DM, M (C)","Ajax","Eredivisie","AUT","Yes","8/31/2022","6/30/2026","$13M - $19.5M","Right","Reasonable","Very Strong","6'2""","169 lbs","224","16",137,145,11,8,11,8,14,11,12,11,6,12,15,10,13,14,14,14,13,16,15,13,11,12,12,8,16,15,14,13,11,12,15,13,12,13,15,12,15,15,12,12,10,8,10,13,6,10,14,12,6,2,2,2,1,2,1,2,3,2,1,1
"6613",16147386,"Stefan Posch","5/14/1997 (26 years old)","D (RC)","TSG Hoffenheim","Bundesliga","AUT","Yes","6/15/2020","6/30/2025","$650K - $9.2M","Right","Reasonable","Very Strong","6'3""","180 lbs","205","15",138,145,4,12,12,9,11,5,14,9,12,13,12,9,14,11,14,14,14,16,13,13,12,5,10,12,12,16,11,11,13,12,17,15,14,15,16,15,12,18,15,12,16,9,7,16,12,9,15,15,12,2,2,3,3,3,3,2,1,3,3,3
"6614",91144914,"Kevin Danso","9/19/1998 (24 years old)","D (C)","RC Lens","Ligue 1 Uber Eats","AUT","Yes","8/6/2021","6/30/2028","$15.5M - $24M","Right","Reasonable","Very Strong","6'3""","187 lbs","154","8",140,145,5,7,8,10,12,5,15,7,14,14,13,10,13,10,13,14,15,11,12,11,15,7,10,13,15,12,8,15,14,12,14,17,16,16,13,15,16,10,14,14,13,11,4,13,12,6,16,17,15,3,2,1,1,1,1,2,3,3,2,3
"6615",16283560,"Onurhan Babuşcu","9/5/2003 (19 years old)","M (C), AM (LC)","Gaziantep FK","Turkish Super League","AUT","Yes","8/15/2022","6/30/2026","$850K - $9M","Right","Fairly Strong","Very Strong","5'9""","154 lbs","17","2",105,145,7,9,13,9,13,7,6,12,6,5,10,9,7,14,8,10,11,10,9,9,14,15,5,13,6,11,12,12,13,13,12,6,11,11,11,10,8,12,10,11,12,9,5,6,5,4,10,16,15,2,1,4,2,3,3,4,1,1,1,1
"6616",16202374,"Junior Adamu","6/6/2001 (22 years old)","ST (C)","FC RB Salzburg","Austrian Premier Division","AUT","Yes","6/13/2022","6/30/2026","$7M - $10.5M","Right","Fairly Strong","Very Strong","6'0""","174 lbs","108","42",125,144,8,8,12,13,11,9,12,10,6,6,10,13,7,12,11,12,13,11,11,11,16,12,5,15,6,11,10,12,16,14,11,12,11,15,12,12,7,8,10,11,11,15,12,10,7,12,11,16,14,2,2,1,1,2,3,1,1,3,2,2
"6617",16337073,"Samson Baidoo","3/31/2004 (19 years old)","D (C), DM","FC RB Salzburg","Austrian Premier Division","AUT","Yes","4/20/2022","6/30/2027","$9.2M - $11M","Right","Fairly Strong","Very Strong","6'2""","189 lbs","49","1",114,143,6,5,9,6,10,8,10,9,8,11,10,8,12,8,9,10,12,11,10,10,14,5,8,9,14,12,9,13,13,11,15,16,13,14,13,14,7,12,13,12,11,13,11,7,6,9,9,14,13,2,3,2,1,3,3,3,2,2,1,2
"6618",29040974,"James Forrest","7/7/1991 (31 years old)","M/AM (RL)","Celtic","cinch Premiership","SCO","No","5/12/2022","5/31/2025","Not for Sale","Right","Reasonable","Very Strong","5'7""","147 lbs","291","66",126,145,9,12,14,13,12,8,7,10,1,9,13,12,12,14,13,14,5,13,12,12,12,11,8,14,12,13,13,13,14,14,12,7,12,13,13,12,10,8,13,13,14,20,13,13,5,5,9,14,12,2,2,1,1,1,3,1,1,3,2,1
"6619",28109939,"Christoph Klarer","6/14/2000 (22 years old)","D (C)","Düsseldorf","Bundesliga 2","AUT","Yes","10/5/2020","6/30/2026","$190K - $1.9M","Right","Reasonable","Very Strong","6'3""","180 lbs","87","5",122,143,3,7,9,6,10,3,15,6,12,13,11,7,13,10,16,12,15,11,13,12,15,7,12,8,13,13,10,13,12,11,15,16,15,12,12,14,8,9,10,13,12,10,3,13,8,5,13,13,10,2,3,1,1,1,3,3,1,2,2,3
"6620",91194543,"Muhammed Cham","9/26/2000 (22 years old)","M/AM (RC)","Clermont","Ligue 1 Uber Eats","AUT","Yes","8/17/2022","6/30/2025","$5.2M - $6.4M","Left","Very Strong","Reasonable","5'11""","165 lbs","109","24",124,143,12,11,14,14,13,13,9,14,8,7,13,10,8,14,10,12,12,12,11,13,12,11,9,12,10,11,13,11,14,14,12,9,11,13,13,11,10,11,10,10,11,10,8,9,8,10,12,12,10,1,3,2,2,2,3,3,3,2,3,3
"6621",16283659,"Yusuf Demir","6/2/2003 (20 years old)","AM (RC)","Galatasaray","Turkish Super League","AUT","Yes","9/8/2022","6/30/2026","$190K - $1.9M","Left","Very Strong","Reasonable","5'8""","152 lbs","65","9",110,143,12,9,15,10,14,12,7,12,5,5,13,8,6,16,7,10,11,10,11,10,14,15,5,12,6,10,13,9,14,15,12,8,12,12,11,7,14,16,16,15,11,12,5,6,5,1,10,17,8,2,1,3,1,3,1,2,3,3,3,1
"6622",16254059,"Pascal Juan Estrada","3/12/2002 (21 years old)","D (C), DM","Olimpija","Slovenian First League","AUT","Yes","7/1/2022","6/30/2024","$130K - $1.3M","Right","Weak","Very Strong","6'2""","171 lbs","33","1",111,143,8,7,11,11,10,10,11,10,4,13,11,9,13,11,12,12,11,10,11,12,13,5,15,10,12,12,11,13,11,12,12,14,15,12,12,11,16,12,13,11,13,10,9,7,12,2,15,10,7,3,1,1,1,1,2,3,1,3,3,3
"6623",16023937,"Kevin Wimmer","11/15/1992 (30 years old)","D (C)","SK Rapid","Austrian Premier Division","AUT","Yes","7/1/2021","6/30/2025","$1.9M - $4M","Left","Very Strong","Reasonable","6'2""","187 lbs","225","7",116,142,5,8,7,6,9,6,13,8,12,13,9,9,14,9,13,13,16,15,11,12,13,7,14,5,13,15,10,10,8,7,15,15,13,12,14,17,8,13,17,16,12,10,5,15,10,6,11,15,12,3,1,2,3,3,2,3,1,2,1,1
"6624",16045723,"Michael Gregoritsch","4/18/1994 (29 years old)","AM (C), ST (C)","SC Freiburg","Bundesliga","AUT","Yes","7/1/2022","6/30/2025","$8M - $10M","Left","Very Strong","Reasonable","6'4""","200 lbs","379","86",134,142,7,8,11,14,14,14,15,11,8,7,12,14,8,14,14,14,16,13,12,13,13,12,10,14,8,14,12,13,12,11,16,17,12,12,13,15,15,11,10,14,11,8,12,12,6,13,12,15,12,2,3,2,2,2,1,1,2,4,3,2
"6625",16147700,"Maximilian Wöber","2/4/1998 (25 years old)","D (LC)","Leeds","Sky Bet Championship","AUT","Yes","1/3/2023","6/30/2027","$14M - $21M","Left","Very Strong","Reasonable","6'2""","187 lbs","179","10",135,141,6,11,10,6,12,13,14,9,12,13,13,12,14,12,15,14,16,14,12,12,16,8,16,11,14,16,12,15,12,11,15,14,12,13,14,14,13,18,15,15,15,10,12,11,8,3,14,15,12,2,2,3,1,1,2,1,2,3,1,3
"6626",35002612,"Martin Harnik","6/10/1987 (36 years old)","M/AM (R), ST (C)","Dassendorf","German Div. Hamburg","AUT","Yes","11/30/2021","6/30/2024","$45K - $450K","Right","Fairly Strong","Very Strong","6'1""","167 lbs","441","204",123,141,6,9,10,13,11,7,13,9,4,6,10,10,9,12,11,14,14,11,12,12,16,13,10,16,9,13,10,11,12,13,10,14,18,12,13,11,10,10,12,16,14,12,7,15,9,8,15,15,8,3,2,1,3,1,1,1,4,3,2,3
"6627",16283572,"Muharem Huskovic","3/5/2003 (20 years old)","AM (C), ST (C)","FK Austria Vienna","Austrian Premier Division","AUT","Yes","1/17/2022","6/30/2025","$5.6M - $8.6M","Right","Reasonable","Very Strong","5'11""","145 lbs","60","12",117,141,9,11,13,10,11,9,10,11,10,9,11,12,9,14,7,11,12,12,11,10,15,9,7,15,8,14,10,14,14,14,11,11,12,15,14,12,11,20,10,12,12,10,11,7,6,7,11,12,16,3,3,2,2,3,3,2,2,2,3,3
"6628",16254151,"Manuel Polster","12/23/2002 (20 years old)","M/AM (L), ST (C)","FK Austria Vienna","Austrian Premier Division","AUT","Yes","7/1/2022","6/30/2025","$5.4M - $6.8M","Left","Very Strong","Reasonable","6'0""","143 lbs","62","8",117,141,10,14,14,15,13,8,12,11,6,8,14,8,7,12,5,13,8,11,11,14,14,10,11,15,9,11,11,12,12,10,11,13,12,13,12,13,13,16,10,11,10,10,13,6,11,6,12,10,17,2,1,3,3,2,3,2,3,2,2,2
"6629",2000115073,"Murray Johnson","11/13/2004 (18 years old)","GK","Queen of the South","cinch League 1","SCO","No","2/25/2023","5/31/2027","$1.8M - $3.8M","Right","Reasonable","Very Strong","6'2""","176 lbs","6","-",85,144,4,2,2,2,5,8,1,3,1,2,13,2,1,6,6,9,14,7,8,13,18,1,9,2,10,7,6,6,11,10,5,10,5,11,6,6,10,17,15,11,10,11,5,10,7,8,10,11,12,11,9,13,10,8,13,13,8,8,9,13
"6630",2000097073,"Benjamin Göschl","11/16/2005 (17 years old)","GK","SK Rapid","Austrian Premier Division","AUT","Yes","4/26/2023","6/30/2025","$2.5M - $5.2M","Right Only","Weak","Very Strong","6'2""","160 lbs","7","-",94,141,5,1,3,1,1,6,5,1,3,1,10,3,3,5,14,10,15,6,9,13,19,3,7,1,8,8,7,6,10,15,8,12,7,13,1,11,9,18,9,12,14,13,9,11,6,5,10,11,19,6,15,13,7,10,9,13,5,7,8,10
"6631",2000186565,"Elias Lorenz","3/27/2006 (17 years old)","GK","SK Sturm Graz II","Austrian First Division","AUT","Yes","7/1/2022","6/30/2025","$2M - $4.2M","Right","Reasonable","Very Strong","6'3""","176 lbs","3","-",87,141,3,2,1,2,5,7,1,1,3,3,11,3,2,4,8,10,15,8,9,14,8,1,7,2,7,8,6,7,9,14,4,15,9,6,4,6,10,18,11,10,9,9,5,9,8,1,11,10,19,9,14,14,10,12,12,8,6,12,11,12
"6632",2000092905,"Maximilian Fillafer","12/26/2004 (18 years old)","M/AM (R)","SV Spittal/Drau","Austrian Carinthia League","AUT","Yes","7/1/2020","6/30/2026","$0","Right","Fairly Strong","Very Strong","6'2""","167 lbs","63","15",88,140,6,10,9,13,13,5,6,7,5,5,11,2,6,10,7,7,8,7,8,13,10,14,5,8,5,7,8,8,13,13,7,13,7,13,8,4,12,11,9,10,11,11,10,11,11,5,9,11,12,4,2,2,3,1,2,3,4,3,3,2
"6633",16020469,"Martin Hinteregger","9/7/1992 (30 years old)","ST (C)","SGA Sirnitz","Austrian Under League East (K)","AUT","Yes","6/12/2023","6/30/2024","$110K - $325K","Left","Very Strong","Reasonable","6'1""","180 lbs","346","27",90,140,3,6,7,1,6,8,13,10,7,14,11,9,13,4,9,12,14,11,10,11,10,10,15,2,11,11,9,8,10,6,11,11,11,13,10,13,12,8,12,9,13,15,11,15,12,17,12,12,8,2,3,2,1,2,3,3,4,2,1,4
"6634",16155354,"Dejan Ljubičić","10/8/1997 (25 years old)","DM, M/AM (RC)","1. FC Köln","Bundesliga","AUT","Yes","7/1/2021","6/30/2025","$9.8M - $15M","Right Only","Weak","Very Strong","6'2""","163 lbs","210","17",135,140,11,12,13,11,13,7,11,11,7,12,13,12,12,13,13,13,14,12,12,12,17,13,13,15,12,16,13,17,13,12,12,11,15,15,17,12,18,16,12,13,12,14,8,13,7,4,13,12,14,1,2,3,2,3,2,3,3,4,2,2
"6635",91143703,"Marco Friedl","3/16/1998 (25 years old)","D (LC), WB (L)","SV Werder","Bundesliga","AUT","Yes","7/1/2022","6/30/2026","$5.6M - $7M","Left","Very Strong","Reasonable","6'2""","180 lbs","148","6",131,140,11,12,11,7,12,13,12,7,15,13,13,10,15,13,17,13,14,12,12,12,16,10,13,9,13,14,12,13,12,12,14,12,12,14,15,13,16,8,8,12,10,12,10,15,12,9,12,14,12,2,2,1,3,1,2,2,2,2,2,2
"6636",16023929,"Gernot Trauner","3/25/1992 (31 years old)","D (RC)","Feyenoord","Eredivisie","AUT","Yes","3/21/2023","6/30/2026","Not for Sale","Right","Reasonable","Very Strong","6'0""","180 lbs","305","23",140,140,8,10,9,7,11,9,15,10,9,14,12,8,13,11,16,12,14,14,16,13,14,6,14,9,15,15,13,15,12,11,13,16,13,11,13,16,11,16,15,13,12,8,8,14,11,5,16,13,10,3,2,3,1,2,1,1,2,1,3,1
"6637",2000105004,"Leon Grgic","1/22/2006 (17 years old)","ST (C)","SK Sturm Graz","Austrian Premier Division","AUT","Yes","3/14/2023","6/30/2026","$35K - $350K","Right","Strong","Very Strong","6'2""","163 lbs","16","2",87,140,6,6,13,12,13,6,13,7,3,5,5,2,1,12,13,13,6,9,6,9,15,12,1,13,4,6,7,7,16,10,4,7,7,15,6,4,10,14,13,12,12,13,11,10,5,6,8,9,19,2,1,3,2,3,2,3,3,2,3,2
"6638",16202269,"David Nemeth","3/18/2001 (22 years old)","D (C)","St. Pauli","Bundesliga 2","AUT","Yes","7/1/2022","6/30/2026","$2.3M - $4.8M","Right","Fairly Strong","Very Strong","6'3""","196 lbs","86","3",112,139,3,6,10,6,12,3,13,6,6,13,12,6,13,12,10,12,13,12,12,11,14,10,6,7,13,12,11,12,11,10,12,15,11,12,11,14,8,17,15,12,10,8,10,10,3,6,12,13,13,3,2,1,3,2,2,3,1,4,1,2
"6639",16004033,"Guido Burgstaller","4/29/1989 (34 years old)","ST (C)","SK Rapid","Austrian Premier Division","AUT","Yes","7/1/2022","6/30/2024","$1M - $2.1M","Right","Fairly Strong","Very Strong","6'2""","176 lbs","448","147",128,139,8,12,11,13,10,8,12,11,8,6,10,13,7,11,17,14,14,14,12,12,16,15,16,14,6,12,9,13,12,9,16,13,17,13,15,14,15,11,8,12,15,8,5,14,10,10,16,14,12,1,1,2,3,1,2,2,3,1,3,2
"6640",61098180,"Calvin Ramsay","7/31/2003 (19 years old)","D/WB (R)","Liverpool","English Premier Division","SCO","No","6/19/2022","6/30/2027","$475K - $4.7M","Right","Fairly Strong","Very Strong","5'10""","149 lbs","28","1",113,144,13,14,14,8,13,14,8,8,7,10,14,7,10,15,11,12,9,11,11,9,16,14,8,12,8,13,14,13,14,13,12,10,8,14,10,9,12,14,10,15,12,12,14,12,7,3,14,18,10,1,3,1,2,3,3,1,2,3,2,3
"6641",16191211,"Leo Greiml","7/3/2001 (21 years old)","D (C)","Schalke 04","Bundesliga 2","AUT","Yes","7/1/2022","6/30/2025","$425K - $4.3M","Right","Reasonable","Very Strong","6'2""","176 lbs","83","-",117,139,2,7,10,6,10,3,14,6,7,13,12,7,14,10,16,13,16,12,12,12,16,8,11,8,13,12,11,14,12,11,13,14,8,12,11,13,7,10,12,15,9,10,13,11,11,7,12,12,6,2,1,3,1,1,1,1,3,3,2,2
"6642",92020288,"Heung-Min Son","7/8/1992 (30 years old)","M/AM (L), ST (C)","Tottenham","English Premier Division","KOR","No","7/23/2021","6/30/2025","$109M - $164M","Either","Very Strong","Very Strong","6'0""","169 lbs","409","145",169,173,14,14,15,16,13,13,8,16,6,5,13,9,6,17,8,15,6,14,11,13,14,13,13,17,7,14,12,17,16,14,12,10,16,16,16,10,14,15,11,18,14,7,5,14,5,8,14,17,14,1,1,2,2,1,1,3,2,2,3,2
"6643",89063073,"Kim Min-Jae","11/15/1996 (26 years old)","D (C)","Parthenope","Italian Serie A","KOR","No","7/27/2022","6/30/2028","$39M - $47M","Right","Fairly Strong","Very Strong","6'3""","189 lbs","180","6",162,165,2,7,11,7,12,3,16,6,7,16,14,6,16,12,17,15,17,15,14,14,18,8,13,8,16,14,12,17,14,12,16,16,16,15,15,17,8,10,12,17,18,10,7,15,8,8,17,18,17,3,2,2,1,1,1,2,3,3,2,2
"6644",2000160973,"Lee Seung-hwan","4/5/2003 (20 years old)","GK","Pohang","Hana 1Q K LEAGUE 1","KOR","No","12/30/2021","12/31/2024","$160K - $475K","Right","Reasonable","Very Strong","6'1""","171 lbs","3","-",53,157,2,1,2,1,1,4,1,2,1,1,10,3,2,4,8,6,12,6,8,13,8,2,7,2,10,6,5,5,9,6,6,8,12,11,3,6,13,15,9,11,14,9,10,5,5,3,12,9,7,3,13,13,12,6,10,11,9,8,9,9
"6645",67260506,"Kang-In Lee","2/19/2001 (22 years old)","M/AM (RLC)","Mallorca","Spanish First Division","KOR","No","8/30/2021","6/30/2027","$17.5M - $26M","Left","Very Strong","Fairly Strong","5'8""","149 lbs","136","13",141,155,12,12,16,13,14,12,8,14,7,6,15,13,6,15,13,14,11,12,13,12,16,17,10,13,8,9,15,11,14,15,13,8,12,12,12,10,14,10,10,15,15,15,8,13,8,5,11,14,13,1,2,2,3,2,3,1,2,3,2,1
"6646",66044734,"Oh Hyeon-Gyu","4/12/2001 (22 years old)","ST (C)","Celtic","cinch Premiership","KOR","No","1/25/2023","5/31/2028","$14M - $21M","Right","Fairly Strong","Very Strong","6'1""","176 lbs","103","26",124,149,7,9,12,12,11,6,13,9,5,4,8,11,7,12,16,12,14,10,12,13,19,10,13,13,9,11,11,11,12,16,13,13,12,12,14,17,11,8,16,17,14,16,5,10,6,13,11,12,16,2,1,2,2,4,2,3,1,1,2,2
"6647",2000160751,"Kim Yong-Hak","5/20/2003 (20 years old)","AM (RLC)","Pohang","Hana 1Q K LEAGUE 1","KOR","No","1/1/2020","12/31/2025","$0","Left","Very Strong","Reasonable","5'8""","141 lbs","-","-",101,149,7,10,13,7,9,10,4,11,4,6,15,7,5,15,6,8,7,12,9,12,6,14,5,11,8,10,15,10,13,12,10,6,11,13,13,7,13,16,13,13,9,11,5,10,4,3,10,11,16,1,1,1,3,3,3,1,3,1,3,1
"6648",2000161280,"Jeong Ho-Yeon","9/28/2000 (22 years old)","DM, M (C)","Gwangju","Hana 1Q K LEAGUE 1","KOR","No","1/4/2022","12/31/2025","$140K - $1.4M","Right","Fairly Strong","Very Strong","5'10""","149 lbs","38","1",104,148,10,12,11,7,12,11,10,12,10,10,13,8,9,12,14,10,12,11,10,11,9,13,11,11,12,12,13,14,10,11,9,10,11,11,10,9,9,20,13,12,9,13,5,13,13,5,15,10,10,1,1,4,3,2,2,3,4,2,2,1
"6649",66047103,"Goh Young-Joon","7/9/2001 (21 years old)","AM (C), ST (C)","Pohang","Hana 1Q K LEAGUE 1","KOR","No","6/13/2022","12/31/2024","$120K - $1.2M","Right","Strong","Very Strong","5'7""","149 lbs","78","13",115,148,12,10,14,10,13,9,11,10,5,6,13,11,9,13,9,12,13,11,12,11,12,14,10,12,14,13,11,10,14,12,10,7,9,10,10,10,10,12,10,15,12,15,9,13,5,7,13,10,12,2,2,3,1,1,2,1,3,3,3,3
"6650",2000083077,"Yang Hyunjun","5/25/2002 (21 years old)","AM (RL)","Gangwon","Hana 1Q K LEAGUE 1","KOR","No","1/1/2021","12/31/2025","$0","Right","Fairly Strong","Very Strong","5'10""","152 lbs","68","9",101,146,6,8,14,9,9,6,8,10,7,8,11,8,10,11,8,13,13,13,11,14,12,10,10,14,10,9,9,12,12,13,12,7,12,11,12,7,10,13,12,11,11,13,10,8,9,2,10,13,16,1,2,2,2,3,1,2,2,3,1,1
"6651",2000027244,"Kerr Smith","12/12/2004 (18 years old)","D (RC)","Aston Villa","English Premier Division","SCO","No","1/14/2022","6/30/2025","$8.2M - $12.5M","Right","Weak","Very Strong","6'3""","174 lbs","10","-",102,142,6,12,8,10,12,2,13,8,5,10,10,9,13,7,10,11,11,11,8,12,5,5,1,10,16,10,10,11,12,8,11,16,12,12,9,12,14,18,14,12,13,11,5,9,8,1,20,11,20,4,3,1,3,2,1,1,4,4,3,2
"6652",66006737,"Kim Shin-Wook","4/14/1988 (35 years old)","ST (C)","Kitchee","Hong Kong Premier League","KOR","No","2/2/2023","5/31/2026","Not for Sale","Right","Fairly Strong","Very Strong","6'6""","205 lbs","386","150",118,145,6,8,11,13,13,10,16,10,5,5,9,12,5,11,10,11,10,12,13,12,15,10,10,13,10,11,12,12,9,8,13,17,14,10,14,15,11,8,16,19,14,16,6,11,12,6,10,15,13,1,2,1,2,3,3,2,3,3,1,1
"6653",2000082779,"Lee Han-Beom","6/17/2002 (20 years old)","D (C)","Seoul","Hana 1Q K LEAGUE 1","KOR","No","12/31/2020","12/31/2025","$160K - $1.6M","Right","Reasonable","Very Strong","6'2""","158 lbs","53","1",111,145,3,10,12,8,11,8,11,8,3,13,14,12,12,12,10,11,12,13,11,12,11,13,10,11,12,11,13,14,13,10,11,13,11,12,11,13,10,1,11,13,10,10,4,12,2,1,16,13,11,3,2,1,1,2,2,1,1,1,3,1
"6654",45030305,"Kim Young-Gwon","2/27/1990 (33 years old)","D (C)","Ulsan","Hana 1Q K LEAGUE 1","KOR","No","12/19/2021","12/31/2025","$140K - $425K","Left","Very Strong","Weak","6'1""","163 lbs","281","5",112,143,5,10,12,7,11,6,12,6,5,13,8,7,14,11,12,13,9,13,13,10,15,7,12,11,14,12,12,13,12,13,12,13,12,12,13,11,8,11,11,10,11,8,6,7,6,6,12,8,9,1,1,1,1,2,1,1,2,2,3,2
"6655",66034886,"Hwang In-Beom","9/20/1996 (26 years old)","DM, M/AM (C)","Olympiacos","Greek Super League 1","KOR","No","7/29/2022","6/30/2025","$650K - $9.2M","Right","Fairly Strong","Very Strong","5'10""","154 lbs","222","27",140,140,13,11,14,10,14,12,8,12,5,12,14,11,9,16,13,14,11,14,14,16,15,12,11,14,12,18,14,16,13,14,12,8,12,11,14,8,10,12,17,16,13,13,9,16,6,3,15,13,14,3,1,3,3,2,1,4,1,1,2,2
"6656",66014588,"Hwang Hee-Chan","1/26/1996 (27 years old)","M/AM (RL), ST (C)","Wolves","English Premier Division","KOR","No","1/26/2022","6/30/2026","$28M - $43M","Right","Fairly Strong","Very Strong","5'10""","169 lbs","214","51",135,140,8,10,14,14,10,8,11,10,4,6,11,12,8,12,16,12,14,12,12,11,15,13,8,14,9,15,12,16,15,14,13,11,13,14,14,12,12,14,11,16,10,10,14,11,7,5,10,17,12,1,2,1,1,1,1,3,1,2,2,2
"6657",5704105,"Jung Sung Ryong","1/4/1985 (38 years old)","GK","Kawasaki-F","J1 League","KOR","No","1/1/2022","1/31/2024","$160K - $500K","Right","Fairly Strong","Very Strong","6'3""","200 lbs","532","-",127,140,3,1,1,1,11,1,10,2,1,1,11,3,3,3,12,15,11,12,13,14,13,2,5,1,12,11,2,2,10,12,13,16,15,8,7,11,1,14,13,17,6,13,3,8,7,3,15,7,13,13,7,11,11,12,17,13,2,14,14,13
"6658",66032157,"Lee Jae-Sung","8/10/1992 (30 years old)","M/AM (C)","Mainz 05","Bundesliga","KOR","No","7/1/2021","6/30/2025","$8.4M - $10M","Left","Very Strong","Fairly Strong","5'11""","154 lbs","291","56",133,140,11,11,13,12,14,11,15,8,6,10,13,8,12,14,15,13,14,13,12,13,15,13,10,14,11,16,13,15,13,14,11,12,16,12,15,8,17,16,15,17,11,14,7,13,7,5,12,13,14,2,1,1,2,2,2,1,2,2,3,3
"6659",5704958,"Yeom Ki-Hun","3/30/1983 (40 years old)","AM (LC)","Suwon","Hana 1Q K LEAGUE 1","KOR","No","12/31/2022","12/31/2023","$0 - $130K","Left","Very Strong","Reasonable","5'11""","158 lbs","442","77",109,139,12,15,12,12,11,16,9,13,4,7,11,9,9,12,12,16,16,13,16,16,14,10,18,13,10,12,16,15,7,10,12,10,16,7,8,10,11,14,17,16,12,13,11,15,9,4,16,11,13,3,3,1,1,1,2,4,1,2,2,1
"6660",2000205548,"Ahn Ji-Man","1/11/2003 (20 years old)","DM, M (C)","Gimhae","Korean K3 League","KOR","No","7/6/2022","12/31/2024","$28K - $275K","Left","Very Strong","Weak","5'10""","160 lbs","-","-",53,139,4,4,1,1,11,4,4,7,3,5,12,3,11,6,10,9,6,5,3,12,13,5,10,5,6,6,7,11,12,12,5,2,7,12,10,5,17,17,13,11,9,12,8,8,14,1,11,12,7,1,2,1,4,3,3,2,2,3,1,1
"6661",2000205621,"Lee Sang-Min","6/29/2004 (18 years old)","M (L), AM (R)","Suwon","Hana 1Q K LEAGUE 1","KOR","No","1/1/2023","12/31/2025","$500K - $1.5M","Left Only","Very Strong","Weak","5'9""","143 lbs","5","-",98,139,8,13,11,10,10,7,7,8,7,7,5,5,7,13,9,8,7,7,8,13,16,15,16,11,7,12,6,13,15,11,10,5,13,14,10,7,13,16,11,9,11,11,12,10,5,4,14,8,13,2,3,3,3,3,3,1,1,3,3,1
"6662",5207960,"Graham Dorrans","5/5/1987 (36 years old)","DM, M (C)","Johnstone Burgh","West of Scotland First Division","SCO","No","5/2/2023","5/31/2024","$0 - $12K","Right","Reasonable","Very Strong","5'10""","171 lbs","401","62",94,142,10,8,12,10,11,10,8,11,6,7,12,11,8,12,9,11,10,14,11,15,11,13,10,13,12,14,12,13,7,7,9,7,4,8,11,11,10,12,11,15,13,12,17,10,8,3,8,13,12,1,3,3,1,2,3,3,1,2,3,1
"6663",2000083166,"Lee Dong-Hee","2/7/2000 (23 years old)","D (C)","Bucheon 1995","Hana 1Q K LEAGUE 2","KOR","No","1/1/2022","12/31/2025","$140K - $1.4M","Right","Strong","Very Strong","6'1""","180 lbs","24","1",117,138,7,6,7,4,7,2,14,6,8,15,10,9,15,5,12,12,11,10,10,15,14,5,1,8,11,10,9,11,15,15,9,11,10,15,8,10,16,14,9,10,12,9,5,8,7,3,14,10,17,3,1,3,3,2,2,3,2,2,1,3
"6664",66044536,"Cho Gue-Sung","1/25/1998 (25 years old)","ST (C)","Jeonbuk","Hana 1Q K LEAGUE 1","KOR","No","1/29/2020","12/31/2024","$750K - $7.4M","Right","Fairly Strong","Very Strong","6'2""","154 lbs","123","46",127,138,6,9,12,14,13,6,15,12,4,10,11,12,5,12,13,13,13,13,13,13,11,10,10,12,7,12,12,13,11,11,13,14,13,13,13,14,14,6,14,15,14,16,8,14,7,13,13,12,15,2,1,1,3,2,2,2,2,3,4,3
"6665",2000083123,"Eom Ji-Sung","5/9/2002 (21 years old)","M (R), AM (RL)","Gwangju","Hana 1Q K LEAGUE 1","KOR","No","6/13/2022","12/31/2025","$75K - $750K","Right","Fairly Strong","Very Strong","5'9""","141 lbs","72","14",111,137,9,12,14,11,12,9,11,12,10,9,11,12,7,13,12,10,10,10,11,11,12,14,7,13,6,9,11,10,14,13,12,13,9,13,9,9,13,9,8,12,11,12,10,9,12,8,13,14,12,1,2,1,1,2,1,1,3,2,3,1
"6666",66028999,"Kwon Chang-Hoon","6/30/1994 (28 years old)","M (C), AM (RC)","Suwon","Hana 1Q K LEAGUE 1","KOR","No","7/1/2021","12/31/2023","$50K - $500K","Left","Very Strong","Fairly Strong","5'8""","158 lbs","244","36",119,136,11,13,14,12,12,11,6,12,2,5,15,6,8,14,15,11,10,12,11,13,11,14,12,14,13,14,14,15,11,13,11,7,15,11,11,11,14,8,16,17,10,12,9,12,4,10,13,14,10,2,3,3,2,2,1,1,2,3,2,3
"6667",66002201,"Kim Min-Woo","2/25/1990 (33 years old)","D/WB/M/AM (L)","CD Rongcheng","Chinese Super League","KOR","No","1/1/2022","1/31/2024","$550K - $1.6M","Left","Very Strong","Weak","5'8""","158 lbs","413","58",117,136,11,11,12,10,11,11,7,10,4,6,11,8,8,11,10,12,6,9,8,11,16,12,12,11,10,12,12,16,14,16,9,8,17,12,15,10,15,8,19,17,16,19,6,8,7,7,17,11,14,2,1,3,3,1,2,3,2,2,3,2
"6668",5708979,"Lee Chung-Yong","7/2/1988 (34 years old)","M (C), AM (RC)","Ulsan","Hana 1Q K LEAGUE 1","KOR","No","3/5/2020","12/31/2024","$2.5K - $26K","Right","Reasonable","Very Strong","5'11""","154 lbs","383","37",109,136,12,12,12,11,12,8,12,11,5,6,14,9,10,14,13,12,13,11,12,13,15,13,14,11,11,14,14,15,11,11,11,11,12,11,9,9,11,11,10,11,12,8,11,10,11,12,12,15,12,4,2,2,4,1,1,3,3,1,1,2
"6669",66040716,"Lee Dong-jun","2/1/1997 (26 years old)","AM (RL), ST (C)","Jeonbuk","Hana 1Q K LEAGUE 1","KOR","No","12/22/2022","12/31/2024","$210K - $2.1M","Right","Reasonable","Very Strong","5'8""","143 lbs","134","36",126,135,4,7,15,9,12,7,8,8,6,8,11,13,8,13,10,13,13,9,13,13,9,13,9,14,9,12,13,13,15,15,13,6,11,14,12,12,11,14,8,14,12,12,13,8,12,8,10,11,11,2,1,3,3,2,1,1,2,1,2,1
"6670",66014497,"Lee Myung-Joo","4/24/1990 (33 years old)","DM, M/AM (C)","Incheon","Hana 1Q K LEAGUE 1","KOR","No","1/30/2022","12/31/2024","Not for Sale","Right","Reasonable","Very Strong","5'9""","167 lbs","297","39",115,135,11,11,12,12,12,10,10,11,3,12,14,8,9,11,11,11,11,13,12,11,12,12,12,12,12,13,12,14,12,11,12,9,20,10,15,11,11,10,14,14,13,15,5,13,10,10,13,13,13,1,3,2,1,2,2,3,1,2,3,3
"6671",66045361,"Kwon Hyeok-Kyu","3/13/2001 (22 years old)","DM, M (C)","Busan","Hana 1Q K LEAGUE 2","KOR","No","1/1/2019","12/31/2024","$1.2M - $2.7M","Right","Fairly Strong","Very Strong","6'2""","178 lbs","78","3",97,135,7,10,11,7,13,6,11,5,5,9,13,12,8,13,8,14,12,14,11,13,11,6,6,12,10,13,12,13,9,10,12,7,14,9,9,12,9,18,12,10,11,9,3,10,8,4,9,11,18,2,1,3,3,3,3,1,2,2,1,1
"6672",66014583,"Jang Hyun-Soo","9/28/1991 (31 years old)","D (C)","Al-Hilal (KSA)","Saudi Professional League","KOR","No","6/28/2022","6/30/2023","$60K - $600K","Right","Reasonable","Very Strong","6'2""","174 lbs","242","15",130,135,12,10,9,8,11,12,13,5,10,14,12,11,15,12,9,14,12,15,12,13,12,10,12,8,14,14,10,12,11,11,13,14,13,11,12,15,6,13,14,17,13,9,7,13,4,2,13,12,17,2,2,1,2,4,3,1,4,1,1,3
"6673",2000283799,"Aidan Borland","4/25/2007 (16 years old)","M (C)","Aston Villa","English Premier Division","SCO","No","4/25/2023","6/30/2025","$450K - $4.5M","Right","Reasonable","Very Strong","5'9""","141 lbs","-","-",75,141,7,7,7,8,14,7,5,10,5,7,14,5,7,12,15,10,5,7,6,14,16,7,9,6,8,8,9,13,7,11,8,9,7,10,12,6,12,17,13,11,13,11,10,17,10,3,8,11,15,3,2,2,1,3,3,2,3,1,3,3
"6674",91187682,"Woo-Yeong Jeong","9/20/1999 (23 years old)","M (RC), AM (RLC)","SC Freiburg","Bundesliga","KOR","No","7/1/2019","6/30/2027","$550K - $5.4M","Right","Strong","Very Strong","5'10""","154 lbs","135","26",129,135,8,10,13,10,13,8,11,9,6,7,12,8,7,13,8,12,13,11,10,10,13,14,8,12,7,15,10,15,14,15,9,8,15,14,15,8,15,18,15,14,10,12,5,12,6,4,9,13,10,3,1,1,1,1,2,1,2,1,2,2
"6675",66029214,"Jo Hyeon-Woo","9/25/1991 (31 years old)","GK","Ulsan","Hana 1Q K LEAGUE 1","KOR","No","1/1/2020","12/31/2024","Not for Sale","Right","Weak","Very Strong","6'2""","165 lbs","300","-",118,135,5,5,4,4,5,5,11,4,13,5,4,7,5,3,8,11,14,11,13,13,11,11,14,14,14,13,13,14,11,12,14,13,13,11,12,13,3,11,15,9,10,10,3,8,5,6,11,19,16,7,12,12,13,13,9,13,9,12,12,15
"6676",66000930,"Kim Seung-Gyu","9/30/1990 (32 years old)","GK","Al-Shabab","Saudi Professional League","KOR","No","7/5/2022","6/30/2025","Not for Sale","Right","Weak","Very Strong","6'2""","167 lbs","343","-",130,135,3,3,1,2,11,4,10,3,2,1,12,2,1,12,8,11,12,12,11,11,17,6,11,6,12,13,11,8,12,14,13,12,10,11,11,12,10,15,15,18,16,6,9,8,7,3,8,19,12,9,11,14,12,15,12,15,11,15,15,14
"6677",66010001,"Kim Bo-Kyung","10/6/1989 (33 years old)","M/AM (RLC)","Suwon","Hana 1Q K LEAGUE 1","KOR","No","1/17/2023","12/31/2024","$60K - $180K","Left","Very Strong","Fairly Strong","5'9""","158 lbs","351","60",108,135,11,12,13,11,13,10,10,11,3,9,11,11,11,13,10,12,12,12,13,12,14,13,11,12,11,12,13,11,11,12,12,10,13,11,10,11,11,9,9,15,12,11,9,11,10,5,13,14,14,4,1,2,1,2,4,1,2,3,2,2
"6678",5704503,"Lee Yong-Rae","4/17/1986 (37 years old)","DM, M (C)","Daegu","Hana 1Q K LEAGUE 1","KOR","No","1/11/2021","12/31/2024","$1.5K - $18K","Left","Very Strong","Strong","5'9""","156 lbs","327","21",105,134,10,10,9,8,11,10,9,8,3,9,12,5,9,11,13,16,12,12,10,12,14,11,5,10,11,13,12,14,8,9,10,9,13,11,11,9,14,11,14,16,12,10,16,10,8,2,15,10,14,3,2,3,4,2,2,1,1,2,2,1
"6679",66010145,"Hong Jeong-Ho","8/12/1989 (33 years old)","D (C)","Jeonbuk","Hana 1Q K LEAGUE 1","KOR","No","1/1/2020","12/31/2024","Not for Sale","Right","Reasonable","Very Strong","6'1""","169 lbs","275","14",130,133,5,9,11,6,12,10,14,8,10,14,13,8,13,11,13,13,15,15,12,13,14,9,13,8,14,15,12,10,11,11,13,15,12,13,11,14,10,13,13,15,12,10,11,13,8,8,14,15,10,3,3,2,2,1,1,3,1,1,2,2
"6680",2000205553,"Kang Sang-Yoon","5/31/2004 (19 years old)","DM, M/AM (C)","Jeonbuk","Hana 1Q K LEAGUE 1","KOR","No","3/15/2022","12/31/2025","$0","Left","Very Strong","Fairly Strong","5'7""","141 lbs","17","-",97,133,6,10,12,8,11,7,8,7,5,9,9,8,6,11,13,12,12,13,12,11,12,13,7,10,9,12,11,11,12,13,10,9,13,12,11,8,15,18,11,12,10,9,10,14,8,4,13,12,17,2,2,2,3,1,3,1,3,2,2,2
"6681",66012020,"Lee Seung-Gi","6/2/1988 (35 years old)","M (C), AM (LC)","Busan","Hana 1Q K LEAGUE 2","KOR","No","3/15/2023","12/31/2023","$0 - $10K","Either","Very Strong","Very Strong","5'10""","147 lbs","304","51",99,132,12,11,11,10,12,12,5,12,2,8,13,11,3,12,11,9,9,12,11,11,11,14,11,11,10,11,12,9,9,9,10,5,12,10,8,6,8,12,13,13,12,10,14,13,3,7,15,12,14,2,3,1,2,1,1,2,3,2,3,4
"6682",2000161759,"Bae Jun-Ho","8/21/2003 (19 years old)","WB (RL), AM (C)","Daejeon","Hana 1Q K LEAGUE 1","KOR","No","1/11/2022","12/31/2025","$0","Right","Weak","Very Strong","5'11""","154 lbs","26","3",105,132,10,11,10,10,12,9,8,9,1,7,12,9,7,12,11,9,11,10,10,12,12,11,10,12,12,13,12,12,15,12,12,12,12,10,12,10,9,12,12,12,11,11,7,9,10,4,11,12,10,2,2,2,1,3,1,2,2,3,2,1
"6683",66029295,"Kwon Kyung Won","1/31/1992 (31 years old)","D (C), DM","G-Osaka","J1 League","KOR","No","1/2/2022","1/31/2024","$22K - $210K","Left","Very Strong","Fairly Strong","6'2""","182 lbs","221","11",106,132,2,8,7,8,9,6,12,15,9,13,7,7,12,6,13,12,14,13,10,10,14,10,10,7,12,10,12,15,9,9,11,10,16,10,13,13,14,10,12,11,13,9,6,9,9,6,12,12,7,1,3,3,1,1,1,3,1,1,1,3
"6684",2000126895,"Charlie McArthur","5/12/2005 (18 years old)","D (C)","Newcastle","English Premier Division","SCO","No","7/6/2022","6/30/2025","$375K - $3.8M","Left","Very Strong","Reasonable","6'2""","167 lbs","1","-",81,141,5,7,6,1,8,6,13,1,3,9,10,4,10,3,9,10,14,8,11,8,5,5,8,5,9,8,8,9,14,9,9,15,15,13,12,12,10,17,12,12,11,10,6,8,9,2,11,13,18,3,3,2,3,2,3,2,1,3,1,3
"6685",66042120,"Hong Hyun-Seok","6/16/1999 (23 years old)","DM, M (C)","AA Gent","Jupiler Pro League","KOR","No","8/8/2022","6/30/2025","$350K - $3.6M","Left","Very Strong","Reasonable","5'10""","158 lbs","110","5",124,132,6,9,12,11,13,6,9,9,7,13,13,7,11,14,8,12,12,12,12,12,15,8,8,13,13,13,12,13,15,13,12,9,13,15,13,12,6,14,11,12,10,11,6,11,6,8,13,12,14,2,1,3,2,3,1,3,3,2,2,4
"6686",66040272,"Na Sang-Ho","8/12/1996 (26 years old)","AM (RLC), ST (C)","Seoul","Hana 1Q K LEAGUE 1","KOR","No","1/9/2021","12/31/2024","$190K - $1.9M","Right Only","Weak","Very Strong","5'8""","154 lbs","164","46",117,132,8,11,13,14,13,9,8,13,7,11,11,12,8,12,12,12,11,12,13,11,12,11,9,13,13,13,10,13,14,13,12,9,14,13,12,11,10,8,12,11,10,12,2,13,4,7,15,13,12,4,2,3,3,4,1,3,2,4,4,1
"6687",2000082776,"Lee Tae-Suk","7/28/2002 (20 years old)","D/WB (L), M (C)","Seoul","Hana 1Q K LEAGUE 1","KOR","No","1/1/2021","12/31/2025","$160K - $1.6M","Left Only","Very Strong","Very Weak","5'9""","134 lbs","50","-",102,132,12,14,13,10,11,11,7,11,10,12,11,11,11,11,12,11,12,10,12,11,10,11,9,12,12,11,10,12,13,11,11,9,16,12,12,11,14,10,10,11,10,12,1,12,5,1,15,12,10,1,2,3,1,3,2,2,3,1,1,1
"6688",67191240,"Paik Seung-Ho","3/17/1997 (26 years old)","DM, M (C)","Jeonbuk","Hana 1Q K LEAGUE 1","KOR","No","3/30/2021","12/31/2024","$220K - $2.2M","Right","Fairly Strong","Very Strong","5'11""","171 lbs","160","10",125,131,12,12,12,9,14,14,8,14,7,11,14,11,10,14,10,13,12,12,12,13,12,12,13,11,12,13,14,13,11,11,13,9,13,11,13,11,12,18,17,15,14,10,7,12,11,3,14,20,15,2,1,3,2,3,1,3,1,2,2,2
"6689",66010141,"Park Jong-Woo","3/10/1989 (34 years old)","DM, M (C)","Busan","Hana 1Q K LEAGUE 2","KOR","No","12/31/2018","12/31/2023","$4.5K - $14K","Right","Reasonable","Very Strong","5'11""","163 lbs","286","13",90,131,9,11,9,8,10,12,8,11,3,8,13,10,12,12,9,8,11,12,13,13,11,8,15,12,11,11,10,10,7,7,12,7,10,8,9,13,10,16,13,14,13,14,13,14,17,13,16,14,15,2,2,1,1,3,1,1,2,1,1,1
"6690",2000276958,"Park Seung-Soo","3/17/2007 (16 years old)","ST (C)","Suwon","Hana 1Q K LEAGUE 1","KOR","No","6/12/2023","12/31/2025","$90K - $900K","Right","Reasonable","Very Strong","6'0""","143 lbs","-","-",80,131,5,3,14,14,10,7,11,8,2,6,6,7,1,12,6,9,2,11,5,5,13,11,1,8,7,7,8,8,14,11,8,7,12,15,13,9,9,14,12,13,12,9,7,2,7,4,17,10,19,4,1,3,1,3,2,2,2,3,3,3
"6691",66012019,"Kim Eun-Sun","3/30/1988 (35 years old)","DM, M (C)","Gimhae","Korean K3 League","KOR","No","7/1/2020","12/31/2024","Not for Sale","Right Only","Weak","Very Strong","6'0""","171 lbs","204","22",83,131,4,8,9,7,8,7,11,7,3,9,9,9,12,10,16,11,6,9,11,11,17,4,15,11,11,14,10,12,10,10,7,10,10,11,11,11,14,17,15,11,16,19,13,11,11,5,13,8,16,1,3,3,1,1,1,1,3,1,3,3
"6692",66014321,"Ju Se-Jong","10/30/1990 (32 years old)","DM, M (C)","Daejeon","Hana 1Q K LEAGUE 1","KOR","No","1/8/2023","12/31/2024","Not for Sale","Right","Reasonable","Very Strong","5'9""","158 lbs","238","13",105,130,11,8,12,10,11,12,9,12,9,11,11,8,11,11,11,12,13,11,12,12,11,8,13,11,12,13,12,12,11,10,12,9,11,10,13,12,8,12,13,13,12,9,8,12,5,7,11,12,12,1,2,1,1,2,2,1,2,1,3,2
"6693",66029640,"Hwang Ui-Jo","8/28/1992 (30 years old)","ST (C)","Seoul","Hana 1Q K LEAGUE 1","KOR","No","8/25/2022","6/30/2025","$22K - $5.6M","Right","Reasonable","Very Strong","6'1""","180 lbs","330","99",119,130,4,10,12,13,12,5,12,11,3,8,12,12,7,12,12,12,14,12,11,12,12,12,9,13,9,15,12,15,12,12,13,12,12,13,14,13,12,15,14,14,9,10,5,12,12,6,12,15,9,1,4,4,3,1,3,2,2,2,1,1
"6694",66044551,"Eom Won-Sang","1/6/1999 (24 years old)","M/AM (R)","Ulsan","Hana 1Q K LEAGUE 1","KOR","No","2/18/2022","12/31/2025","$90K - $900K","Right","Fairly Strong","Very Strong","5'7""","138 lbs","99","27",120,130,7,11,14,11,12,7,7,6,4,5,12,9,7,13,13,12,12,11,12,11,9,12,11,12,10,12,11,12,16,14,11,8,10,13,12,10,11,11,14,16,9,10,8,8,5,9,11,11,9,3,1,1,3,2,2,2,3,3,1,1
"6695",61043456,"Andrew Robertson","3/11/1994 (29 years old)","D/WB (L)","Liverpool","English Premier Division","SCO","No","8/24/2021","6/30/2026","$161M - $243M","Left Only","Very Strong","Very Weak","5'10""","141 lbs","364","15",157,165,14,16,12,5,15,9,10,5,13,14,14,7,15,14,17,14,15,15,14,15,16,11,15,14,13,16,12,17,16,14,13,9,17,16,18,12,6,13,9,15,15,16,6,15,13,9,14,15,17,1,4,3,3,2,3,3,1,3,1,2
"6696",61089481,"Stuart McKinstry","9/18/2002 (20 years old)","M/AM (RL)","Leeds","Sky Bet Championship","SCO","No","6/1/2019","6/30/2025","$250K - $750K","Right","Strong","Very Strong","5'10""","149 lbs","22","4",107,141,6,11,13,10,12,6,6,8,7,4,10,7,5,13,9,11,9,9,7,8,12,14,12,12,6,12,9,11,14,13,12,8,12,14,12,7,14,11,12,12,10,11,5,10,12,4,9,13,13,3,1,2,3,3,2,3,2,1,2,4
"6697",2000244697,"Kim Young-Jun","5/2/2000 (23 years old)","AM (R), ST (C)","Daegu","Hana 1Q K LEAGUE 1","KOR","No","1/3/2022","12/31/2026","$600K - $1.8M","Right","Strong","Very Strong","6'0""","174 lbs","6","2",115,130,8,9,13,13,12,5,9,11,6,11,14,12,9,11,8,13,12,13,13,16,13,10,12,13,12,12,11,10,12,12,13,9,11,12,13,11,13,19,9,13,12,12,14,16,5,4,16,12,13,1,3,2,2,1,3,3,1,1,3,1
"6698",2000120742,"Evan Ferguson","10/19/2004 (18 years old)","ST (C)","Brighton","English Premier Division","IRL","Yes","4/25/2023","6/30/2028","$92M - $139M","Right","Fairly Strong","Very Strong","6'2""","174 lbs","23","6",138,172,6,7,9,15,13,7,14,14,8,7,11,14,7,13,12,13,14,13,14,14,14,9,8,13,7,13,11,14,15,9,13,14,13,16,14,14,12,12,11,10,13,10,7,13,11,8,18,10,14,3,2,2,1,2,1,1,1,2,2,3
"6699",52094936,"Gavin Bazunu","2/20/2002 (21 years old)","GK","Southampton","Sky Bet Championship","IRL","Yes","6/17/2022","6/30/2027","$33M - $50M","Right","Weak","Very Strong","6'2""","174 lbs","109","-",127,156,2,3,3,1,11,4,8,1,3,1,13,3,3,11,8,11,11,11,8,11,15,8,7,12,11,12,12,11,12,13,13,13,13,11,13,10,7,15,12,15,14,12,4,8,5,3,12,15,12,12,11,16,9,14,14,16,4,13,14,14
"6700",28117372,"Nathan Collins","4/30/2001 (22 years old)","D (C)","Wolves","English Premier Division","IRL","Yes","7/12/2022","6/30/2027","$51M - $77M","Right","Weak","Very Strong","6'5""","196 lbs","84","4",135,155,4,6,11,5,11,6,15,5,7,14,12,5,15,12,13,14,17,15,14,13,14,5,14,5,14,15,11,15,13,11,12,15,15,14,14,14,16,7,14,16,11,10,4,14,9,4,13,16,16,3,3,3,2,1,1,3,1,3,3,2
"6701",28104130,"Caoimhin Kelleher","11/23/1998 (24 years old)","GK","Liverpool","English Premier Division","IRL","Yes","6/24/2020","6/30/2025","$26M - $39M","Right Only","Weak","Very Strong","6'2""","182 lbs","5","-",141,154,5,3,1,2,14,6,10,1,3,3,14,3,3,13,13,13,13,14,14,13,15,1,11,1,14,13,7,12,13,14,13,13,13,12,10,12,13,17,13,15,16,14,11,14,10,4,14,14,15,12,13,16,11,15,12,14,8,10,13,14
"6702",56001681,"Seamus Coleman","10/11/1988 (34 years old)","D/WB/M (R)","Everton","English Premier Division","IRL","Yes","6/14/2021","6/30/2024","$1.1M - $2.3M","Right","Reasonable","Very Strong","5'10""","147 lbs","390","23",128,153,5,11,11,12,12,8,14,13,12,12,12,7,14,12,15,13,15,13,13,14,18,11,17,13,14,15,9,15,12,11,14,10,9,13,13,12,10,14,15,15,14,18,14,12,12,7,13,13,10,2,3,1,1,1,1,2,1,3,1,2
"6703",52032335,"Matt Doherty","1/16/1992 (31 years old)","D/WB (R)","A. Madrid","Spanish First Division","IRL","Yes","1/31/2023","6/30/2025","$6.8M - $8.6M","Right","Reasonable","Very Strong","6'1""","196 lbs","336","26",138,152,7,12,15,12,13,10,13,10,13,13,13,8,13,13,11,13,13,13,14,14,14,12,12,16,13,14,13,13,13,11,13,13,15,13,15,14,13,10,11,13,13,15,10,12,11,9,15,12,12,3,2,2,2,3,1,2,1,3,2,1
"6704",29218111,"Andrew Omobamidele","6/23/2002 (20 years old)","D (C)","Norwich","Sky Bet Championship","IRL","Yes","6/6/2022","6/30/2026","$12.5M - $16M","Right","Weak","Very Strong","6'3""","187 lbs","48","2",126,150,2,4,8,4,10,4,14,4,3,14,12,4,14,12,11,14,14,16,12,11,15,3,13,6,14,13,11,12,15,13,13,14,10,15,13,12,4,14,11,14,13,12,4,12,7,6,13,15,12,3,1,3,3,3,1,1,3,2,2,2
"6705",29216094,"Festy Ebosele","8/2/2002 (20 years old)","D/WB/M (R)","Udinese","Italian Serie A","IRL","Yes","7/1/2022","6/30/2027","$8.6M - $13M","Right","Weak","Very Strong","5'11""","141 lbs","55","2",124,149,6,10,13,6,10,7,9,4,14,12,11,6,14,11,15,13,12,10,11,11,13,9,7,8,9,10,8,11,16,13,10,11,9,17,14,14,12,11,8,9,12,12,11,10,14,11,10,16,15,1,1,3,2,2,1,2,2,1,1,3
"6706",2000123791,"Kevin Zefi","2/11/2005 (18 years old)","AM (RL), ST (C)","Inter","Italian Serie A","IRL","Yes","8/31/2021","6/30/2024","$250K - $2.5M","Right Only","Weak","Very Strong","5'9""","158 lbs","-","-",87,149,5,8,15,12,12,8,7,7,4,4,12,10,6,14,9,10,7,7,7,9,12,15,7,11,5,9,10,8,13,13,10,7,12,12,9,7,13,18,12,13,12,12,4,11,8,8,19,8,15,2,3,2,2,2,2,2,3,2,1,3
"6707",151741,"Matt Ritchie","9/10/1989 (33 years old)","WB (L), M/AM (RL)","Newcastle","English Premier Division","SCO","No","6/14/2021","6/30/2024","$600K - $1.8M","Left","Very Strong","Weak","5'8""","167 lbs","473","90",124,141,12,14,11,13,12,13,8,12,5,10,13,15,12,12,15,11,15,12,12,12,14,10,15,11,12,15,12,18,11,11,13,6,16,11,13,11,15,10,11,12,10,13,7,14,11,5,14,13,13,3,2,1,2,1,2,2,1,2,1,1
"6708",29233147,"Ollie O'Neill","1/8/2003 (20 years old)","M (C), AM (RLC)","Fulham","English Premier Division","IRL","Yes","7/12/2022","6/30/2025","$9.2M - $11.5M","Right","Fairly Strong","Very Strong","6'0""","152 lbs","19","1",95,148,4,8,11,13,14,7,7,8,7,9,11,8,9,13,15,10,6,7,9,14,11,13,11,7,10,13,12,12,14,10,14,11,17,13,7,6,12,15,9,12,12,12,9,10,8,8,10,10,17,3,2,2,3,2,1,1,3,1,2,3
"6709",28126238,"Joe Hodge","9/14/2002 (20 years old)","DM, M (C)","Wolves","English Premier Division","IRL","Yes","1/21/2023","6/30/2027","$17.5M - $26M","Right","Reasonable","Very Strong","5'8""","143 lbs","6","-",110,148,10,8,11,7,12,10,8,12,8,8,13,11,12,13,13,12,15,12,11,13,15,4,13,10,12,12,12,13,12,12,10,8,13,13,14,8,8,9,10,14,9,12,12,13,11,8,12,16,16,3,3,2,1,2,2,2,2,3,2,2
"6710",61002273,"James McCarthy","11/12/1990 (32 years old)","DM, M (C)","Celtic","cinch Premiership","IRL","Yes","8/3/2021","5/31/2025","$900K - $2M","Right","Reasonable","Very Strong","5'11""","158 lbs","384","26",117,146,8,9,11,9,11,7,13,9,5,15,13,8,13,10,12,14,16,12,13,14,13,6,10,8,15,16,9,13,9,12,14,10,8,10,12,14,14,10,10,15,14,16,19,13,14,17,10,5,12,3,3,2,1,1,2,2,1,2,3,2
"6711",29190795,"Adam Idah","2/11/2001 (22 years old)","ST (C)","Norwich","Sky Bet Championship","IRL","Yes","2/2/2023","6/30/2028","$8.4M - $10.5M","Right Only","Weak","Very Strong","6'3""","191 lbs","71","6",117,146,5,8,12,13,9,6,13,11,4,5,11,18,4,11,11,9,11,13,9,9,14,7,5,13,4,14,11,14,16,13,14,15,10,15,13,15,6,12,10,14,12,14,10,11,3,8,9,16,14,1,3,2,2,2,1,3,2,1,3,1
"6712",52080573,"Mark Travers","5/18/1999 (24 years old)","GK","Bournemouth","English Premier Division","IRL","Yes","6/28/2022","6/30/2027","$5M - $9.6M","Right","Weak","Very Strong","6'3""","185 lbs","92","1",125,145,4,3,1,2,9,8,1,2,3,2,10,1,1,10,8,14,12,10,12,11,12,6,8,1,14,11,11,12,11,13,10,13,14,11,15,11,14,12,12,14,13,15,9,12,7,6,13,10,10,14,8,15,7,12,14,14,7,13,11,14
"6713",29191596,"Jason Knight","2/13/2001 (22 years old)","M/AM (C)","Derby","Sky Bet League One","IRL","Yes","6/15/2020","6/30/2027","$30K - $7.6M","Right","Fairly Strong","Very Strong","5'8""","138 lbs","150","12",124,145,8,9,13,10,12,8,9,11,4,9,13,9,13,13,16,13,13,9,10,11,14,11,12,10,9,17,11,17,14,14,12,7,16,12,16,12,9,16,12,14,10,16,10,11,8,4,12,14,14,3,3,1,2,1,1,3,1,1,4,2
"6714",28019284,"Robbie Brady","1/14/1992 (31 years old)","WB/M/AM (L)","Preston","Sky Bet Championship","IRL","Yes","6/5/2023","6/30/2025","Not for Sale","Left","Very Strong","Reasonable","5'9""","143 lbs","294","21",116,145,12,13,11,11,12,13,7,11,6,10,12,13,11,12,14,11,13,11,11,11,16,12,9,13,12,14,11,14,12,12,13,8,13,11,13,11,14,9,12,11,10,13,14,12,13,9,8,13,15,1,1,1,1,2,1,2,2,2,1,4
"6715",28116312,"Mark McGuinness","1/5/2001 (22 years old)","D (C)","Cardiff","Sky Bet Championship","IRL","Yes","6/21/2021","6/30/2024","$6.4M - $9.8M","Right Only","Weak","Very Strong","6'4""","198 lbs","94","5",117,142,5,9,7,9,10,6,15,7,10,14,11,6,13,11,12,13,14,12,12,12,14,9,13,7,13,14,9,12,11,9,12,15,13,11,13,14,10,12,13,14,13,12,13,11,11,6,11,14,10,2,1,1,1,3,1,1,1,1,3,2
"6716",2000191248,"Trent Kone-Doherty","6/30/2006 (16 years old)","AM (RL)","Liverpool","English Premier Division","IRL","Yes","7/1/2022","6/30/2025","$5.2M - $7.8M","Right","Reasonable","Very Strong","5'7""","116 lbs","-","-",71,141,6,6,12,8,13,6,6,5,6,2,6,3,4,9,7,3,8,6,7,8,12,13,1,5,6,7,8,11,14,13,12,6,12,13,7,2,10,17,8,9,14,12,7,6,8,3,4,11,19,2,3,1,3,3,2,3,2,2,1,1
"6717",52101552,"Jake O'Brien","5/15/2001 (22 years old)","D (C)","Crystal Palace","English Premier Division","IRL","Yes","8/16/2021","6/30/2024","$275K - $8.6M","Right","Weak","Very Strong","6'6""","176 lbs","58","3",116,141,4,5,6,6,10,6,15,4,7,13,11,4,13,9,14,11,12,10,12,11,14,3,14,11,14,12,7,14,12,7,14,17,10,12,14,15,4,13,14,15,13,11,6,12,7,3,14,15,12,3,4,1,2,2,4,2,4,3,2,4
"6718",28084714,"Angus Gunn","1/22/1996 (27 years old)","GK","Norwich","Sky Bet Championship","SCO","No","6/23/2021","6/30/2025","$1.1M - $11.5M","Right Only","Weak","Very Strong","6'5""","169 lbs","122","-",125,140,4,3,3,3,9,5,4,3,1,1,12,5,1,12,8,13,13,14,12,11,15,2,9,1,13,8,10,10,9,14,12,15,14,7,12,10,13,15,12,15,14,16,9,17,5,5,8,14,12,11,14,15,15,14,14,15,6,13,13,15
"6719",28109942,"Will Smallbone","2/21/2000 (23 years old)","DM, M (C)","Southampton","Sky Bet Championship","IRL","Yes","6/10/2020","6/30/2024","$4.3M - $6.4M","Right","Fairly Strong","Very Strong","5'8""","134 lbs","59","3",126,140,9,12,13,10,14,9,9,9,6,7,14,9,11,14,7,13,7,13,13,13,13,12,9,13,11,14,16,14,12,13,13,11,12,12,14,9,10,19,11,13,11,10,6,10,7,3,6,10,19,2,1,3,1,4,3,1,2,2,2,1
"6720",28062309,"Callum Robinson","2/2/1995 (28 years old)","AM (RLC), ST (C)","Cardiff","Sky Bet Championship","IRL","Yes","9/1/2022","6/30/2025","$4.1M - $8M","Right","Weak","Very Strong","5'11""","165 lbs","289","56",118,140,9,12,13,12,12,9,10,10,6,7,12,11,8,13,7,12,9,10,10,11,12,13,8,14,8,15,13,14,13,14,14,11,12,13,12,11,12,9,11,14,10,11,10,9,7,6,10,13,17,1,3,1,3,1,3,3,3,2,1,2
"6721",28087685,"Josh Cullen","4/7/1996 (27 years old)","DM, M (C)","Burnley","English Premier Division","IRL","Yes","7/12/2022","6/30/2026","$17M - $21M","Right","Reasonable","Very Strong","5'9""","154 lbs","243","5",131,140,10,11,12,6,13,11,8,7,6,14,15,7,14,12,8,14,15,14,13,13,14,9,13,13,14,16,13,17,12,13,13,9,15,11,17,10,10,12,13,15,8,12,6,5,7,6,14,12,7,1,3,3,3,2,1,3,1,1,1,2
"6722",2000142155,"Cian Coleman","9/23/2004 (18 years old)","M/AM (C)","Leeds","Sky Bet Championship","IRL","Yes","2/17/2023","6/30/2025","$70K - $700K","Right","Fairly Strong","Very Strong","5'10""","154 lbs","-","-",75,140,11,7,12,10,10,13,7,10,2,9,9,4,8,14,7,8,6,8,6,8,8,11,8,10,9,13,10,12,13,9,7,6,12,11,7,6,13,14,8,10,13,12,5,6,9,3,11,12,14,1,2,2,3,3,2,1,4,4,2,2
"6723",29130341,"Max O'Leary","10/10/1996 (26 years old)","GK","Bristol City","Sky Bet Championship","IRL","Yes","2/27/2023","6/30/2026","$900K - $1.9M","Right","Weak","Very Strong","6'1""","176 lbs","153","-",114,140,3,3,1,1,14,6,1,2,2,1,10,3,3,9,7,11,12,12,11,11,13,7,9,1,14,8,8,12,10,14,6,12,13,9,12,10,14,12,13,11,12,16,3,11,6,5,10,13,8,13,8,12,15,11,12,13,6,12,16,12
"6724",52096632,"Luke McNally","9/20/1999 (23 years old)","D (C)","Burnley","English Premier Division","IRL","Yes","6/28/2022","6/30/2026","$600K - $10M","Right","Weak","Very Strong","6'4""","191 lbs","101","14",120,140,3,6,14,8,11,4,14,8,8,12,9,4,12,12,12,11,13,14,10,12,14,11,12,10,13,12,9,12,14,13,16,15,14,15,12,13,12,13,15,15,12,13,5,10,8,4,12,13,12,2,2,3,1,1,1,1,4,2,1,1
"6725",28110180,"Conor Coventry","3/25/2000 (23 years old)","DM, M (C)","West Ham","English Premier Division","IRL","Yes","1/4/2020","6/30/2024","$5M - $7.6M","Right","Reasonable","Very Strong","5'10""","143 lbs","56","1",108,140,11,12,11,11,12,13,8,11,6,10,12,9,11,11,14,13,12,12,10,11,7,8,12,10,13,12,11,14,12,11,13,8,13,11,14,9,19,19,12,11,13,12,9,6,5,8,10,11,14,2,2,3,1,2,3,1,3,3,3,3
"6726",28122837,"Troy Parrott","2/4/2002 (21 years old)","AM (RL), ST (C)","Tottenham","English Premier Division","IRL","Yes","7/25/2022","6/30/2025","$4.7M - $9M","Right","Fairly Strong","Very Strong","6'1""","171 lbs","104","13",115,140,8,11,12,11,14,10,7,10,5,6,12,11,9,13,14,12,10,10,11,10,12,13,7,13,7,12,13,14,13,13,13,11,12,13,14,11,12,14,12,13,12,11,6,14,6,5,12,15,9,1,1,2,2,1,2,2,3,1,4,1
"6727",28106528,"Dara O'Shea","3/4/1999 (24 years old)","D (RC)","West Brom","Sky Bet Championship","IRL","Yes","6/15/2020","6/30/2026","$6.2M - $9.4M","Right","Weak","Very Strong","6'2""","163 lbs","155","11",121,140,6,6,7,9,12,8,14,6,10,13,13,7,14,13,15,12,16,11,12,11,14,2,14,10,13,13,7,14,13,11,13,14,12,12,13,13,12,11,12,15,12,9,7,12,11,6,12,10,19,2,2,3,2,1,2,1,1,1,1,3
"6728",28027621,"Shane Duffy","1/1/1992 (31 years old)","D (C)","Fulham","English Premier Division","IRL","Yes","1/31/2023","6/30/2025","$5.2M - $9.6M","Right","Weak","Very Strong","6'4""","169 lbs","287","19",124,140,3,4,5,7,8,5,16,6,7,13,9,6,16,8,15,14,18,8,13,14,17,4,15,6,14,14,7,15,8,8,8,18,14,9,16,16,7,13,11,13,15,9,2,14,7,13,15,15,13,1,1,3,1,1,1,3,3,3,1,1
"6729",61094101,"Alex Lowry","6/23/2003 (19 years old)","M/AM (C)","Rangers","-","SCO","No","5/7/2022","5/31/2025","$800K - $1.7M","Right","Weak","Very Strong","6'2""","160 lbs","32","15",111,140,11,13,13,13,14,15,5,13,9,5,13,14,6,15,4,13,5,16,7,7,10,15,3,14,6,7,15,8,12,15,13,11,9,13,15,5,7,14,8,10,15,11,12,12,5,5,9,12,13,2,2,3,2,3,2,2,1,1,1,1
"6730",29000229,"Harry Arter","12/28/1989 (33 years old)","DM, M (C)","Nottm Forest","English Premier Division","IRL","Yes","9/22/2020","6/30/2024","$40K","Left","Very Strong","Strong","5'10""","154 lbs","345","36",99,140,6,9,10,10,11,11,7,12,2,10,13,12,14,13,15,10,13,11,12,11,14,8,13,11,13,16,11,13,7,8,12,8,14,7,13,9,14,16,12,13,12,13,7,15,17,12,11,15,10,1,3,3,4,1,1,2,3,3,2,2
"6731",5130729,"Shane Long","1/22/1987 (36 years old)","ST (C)","Reading","Sky Bet League One","IRL","Yes","7/13/2022","6/30/2024","$30K - $95K","Right","Weak","Very Strong","5'11""","178 lbs","526","104",109,140,7,10,11,11,10,6,13,9,3,6,11,14,9,10,13,13,17,10,10,12,15,10,9,13,10,18,12,18,14,13,12,12,14,12,13,10,10,5,15,16,15,11,5,13,10,8,13,12,15,1,1,2,1,3,2,2,2,3,4,1
"6732",2000207761,"Stephan Negru","7/24/2002 (20 years old)","D (C)","Oxford United","Sky Bet League One","IRL","Yes","1/1/2023","6/30/2026","$1.2M - $2.5M","Right Only","Weak","Very Strong","6'1""","171 lbs","8","-",103,139,6,8,11,9,11,7,14,6,7,11,11,7,13,12,14,11,13,12,12,11,13,6,9,8,11,11,9,12,12,11,12,14,13,11,12,14,11,14,12,13,15,10,4,11,11,4,12,14,13,1,3,1,2,1,2,3,2,1,2,1
"6733",28109945,"Michael Obafemi","7/6/2000 (22 years old)","ST (C)","Swansea","Sky Bet Championship","IRL","Yes","8/31/2021","6/30/2026","$3.7M - $7.2M","Right","Reasonable","Very Strong","5'7""","171 lbs","95","21",119,138,7,7,12,13,11,7,8,10,7,5,9,11,7,12,12,13,11,12,11,12,12,12,8,14,6,11,10,15,17,15,14,6,14,16,14,11,9,8,8,7,10,7,14,11,5,16,8,12,8,1,1,2,2,3,1,1,2,3,2,3
"6734",28044428,"John Egan","10/20/1992 (30 years old)","D (C)","Sheff Utd","English Premier Division","IRL","Yes","8/21/2020","6/30/2024","$12.5M - $19M","Right","Reasonable","Very Strong","6'1""","158 lbs","369","24",130,138,7,8,8,8,10,5,14,10,6,12,12,8,14,11,14,14,17,11,14,13,16,7,14,9,14,14,12,15,12,10,13,15,13,12,14,14,7,14,12,16,12,14,11,13,9,5,13,12,14,3,1,1,3,2,2,2,3,1,2,3
"6735",28028494,"Jeff Hendrick","1/31/1992 (31 years old)","DM, M (RC)","Newcastle","English Premier Division","IRL","Yes","8/24/2020","6/30/2024","$20K - $200K","Right","Reasonable","Very Strong","6'1""","174 lbs","396","39",107,138,11,11,12,13,11,8,12,13,5,10,11,10,12,12,7,11,12,14,12,12,14,10,12,13,12,13,10,14,9,10,12,12,13,10,14,12,11,18,15,15,13,14,7,13,11,3,12,17,18,3,2,2,3,2,1,1,1,3,2,3
"6736",29217605,"Eiran Cashin","11/9/2001 (21 years old)","D (C)","Derby","Sky Bet League One","IRL","Yes","7/2/2022","6/30/2024","$4.1M - $8M","Left","Very Strong","Reasonable","6'0""","160 lbs","61","2",111,138,4,6,10,6,10,6,15,4,12,13,12,3,13,10,16,13,18,12,11,9,14,5,12,10,13,12,11,14,10,11,9,13,15,9,14,15,8,12,8,15,11,16,6,10,14,12,14,13,14,2,2,1,1,2,1,3,1,1,2,2
"6737",28123237,"Gavin Kilkenny","2/1/2000 (23 years old)","DM, M (C)","Bournemouth","English Premier Division","IRL","Yes","12/12/2019","6/30/2025","$4.1M - $8M","Right","Reasonable","Very Strong","5'7""","147 lbs","26","-",112,137,8,9,10,9,13,7,8,11,7,10,13,9,12,12,11,10,11,14,11,13,14,9,7,11,11,10,14,13,12,12,11,7,12,13,14,10,10,11,14,12,12,14,7,9,6,5,11,14,12,2,2,1,1,2,3,2,3,1,3,1
"6738",29156202,"Jayson Molumby","8/6/1999 (23 years old)","DM, M (C)","West Brom","Sky Bet Championship","IRL","Yes","4/30/2022","6/30/2025","$9.8M - $15M","Right","Fairly Strong","Very Strong","5'9""","141 lbs","126","6",128,137,8,9,12,8,13,8,12,11,5,10,14,12,15,14,14,11,15,12,12,12,15,10,12,13,14,16,11,16,12,14,11,10,16,13,14,11,16,14,14,14,10,10,11,10,14,5,15,15,12,3,2,3,1,2,2,2,3,3,3,3
"6739",52012309,"Enda Stevens","7/9/1990 (32 years old)","D/WB (L)","Sheff Utd","English Premier Division","IRL","Yes","6/14/2021","6/30/2025","$2.4M - $4.9M","Left Only","Very Strong","Weak","6'0""","163 lbs","416","11",122,137,9,11,11,9,12,8,11,11,11,12,12,6,13,13,13,13,12,12,13,12,11,12,10,13,14,13,13,15,13,13,12,11,14,13,16,13,13,9,9,11,10,12,6,12,10,6,12,13,12,3,1,1,2,1,2,2,2,1,2,3
"6740",90055302,"Che Adams","7/13/1996 (26 years old)","ST (C)","Southampton","Sky Bet Championship","SCO","No","6/15/2020","6/30/2024","$9M - $13.5M","Right","Reasonable","Very Strong","5'9""","154 lbs","363","84",134,140,6,10,14,12,14,6,11,13,4,7,15,11,8,14,11,13,13,11,10,12,14,11,7,15,9,16,15,16,14,14,13,11,16,15,14,16,12,12,15,15,13,14,5,7,5,12,13,11,10,2,1,3,3,3,1,3,1,3,2,3
"6741",5004726,"Darren Randolph","5/12/1987 (36 years old)","GK","Bournemouth","English Premier Division","IRL","Yes","1/26/2023","6/30/2024","$300K - $3.1M","Right","Reasonable","Very Strong","6'2""","216 lbs","403","-",127,137,2,1,3,3,11,5,6,3,10,2,11,2,5,11,10,10,12,13,9,10,15,5,14,11,14,10,9,9,9,14,15,15,12,9,13,15,1,11,11,15,8,15,5,11,1,12,12,10,15,11,11,16,10,14,13,14,11,13,14,14
"6742",2000142460,"Sam Curtis","12/1/2005 (17 years old)","D (RC), WB (R)","St. Pat's Athletic","Irish Premier Division","IRL","Yes","1/19/2022","11/30/2023","$65K - $650K","Right Only","Weak","Very Strong","5'10""","136 lbs","20","-",86,137,5,10,10,6,10,6,11,8,8,10,11,5,10,12,11,9,11,10,10,10,14,11,6,10,10,11,10,11,12,11,12,11,15,12,13,10,13,12,6,14,11,5,4,10,11,5,11,18,13,3,3,4,3,1,1,2,1,1,3,4
"6743",2000065864,"Anselmo García McNulty","2/19/2003 (20 years old)","D (LC)","VfL Wolfsburg","Bundesliga","IRL","Yes","7/1/2019","6/30/2025","$0","Left","Very Strong","Weak","6'2""","176 lbs","35","-",105,137,3,8,12,8,12,5,12,10,6,12,13,9,12,13,17,10,12,15,10,9,16,12,13,8,12,12,13,15,12,12,14,14,14,12,11,12,10,14,16,15,13,8,5,12,12,7,14,15,16,1,3,2,2,1,1,1,1,1,2,3
"6744",2000145982,"James Abankwah","1/16/2004 (19 years old)","D (RC)","Udinese","Italian Serie A","IRL","Yes","1/26/2022","6/30/2026","$18K - $190K","Right","Weak","Very Strong","6'0""","174 lbs","26","-",95,136,3,7,9,6,11,5,11,5,7,13,11,5,11,12,11,10,12,10,11,11,14,8,5,8,10,12,11,13,13,11,14,12,14,12,13,11,11,14,7,14,12,6,5,10,7,5,12,15,17,1,3,3,1,2,2,2,1,3,2,3
"6745",28000484,"Alan Judge","11/11/1988 (34 years old)","DM, M/AM (C)","Colchester","Sky Bet League Two","IRL","Yes","7/1/2021","6/30/2024","$0 - $5K","Right","Fairly Strong","Very Strong","5'7""","154 lbs","423","58",81,136,13,13,10,9,13,12,5,11,3,6,12,11,8,12,11,10,13,11,10,9,16,14,11,10,8,12,12,12,6,11,10,7,13,6,9,8,12,14,14,17,12,17,13,13,8,2,12,14,15,3,1,2,3,1,1,1,2,1,1,3
"6746",95037868,"Aaron Connolly","1/28/2000 (23 years old)","ST (C)","Brighton","English Premier Division","IRL","Yes","7/30/2020","6/30/2024","$140K - $1.4M","Right","Fairly Strong","Very Strong","5'9""","160 lbs","76","9",118,136,6,6,12,13,11,7,8,11,4,5,10,7,5,11,15,14,14,12,12,11,16,7,7,16,8,11,10,15,15,14,12,8,14,14,10,13,13,8,8,14,9,13,5,11,7,13,12,14,14,2,2,2,2,3,3,3,2,2,2,3
"6747",52014383,"James McClean","4/22/1989 (34 years old)","D/WB (L), M/AM (RL)","Wigan","Sky Bet League One","IRL","Yes","5/23/2023","6/30/2024","$6K - $60K","Left Only","Very Strong","Weak","5'9""","154 lbs","485","60",111,135,12,10,11,11,11,12,11,13,6,7,11,10,7,11,18,8,14,12,11,10,13,14,8,12,7,12,11,20,11,12,15,9,14,12,13,12,13,6,11,10,10,11,8,10,18,17,12,14,13,3,4,2,3,1,2,3,3,3,2,3
"6748",28070819,"Darragh Lenihan","3/16/1994 (29 years old)","D (C)","Middlesbrough","Sky Bet Championship","IRL","Yes","7/1/2022","6/30/2026","$8M - $10M","Right","Fairly Strong","Very Strong","6'2""","160 lbs","291","10",129,135,6,8,6,7,11,5,15,6,8,13,11,7,13,11,17,12,19,11,12,12,18,8,16,9,12,14,11,15,13,11,13,16,16,12,15,14,10,14,4,20,13,16,12,13,16,5,14,14,14,3,1,4,3,2,1,2,2,1,1,3
"6749",95031615,"Jack Taylor","6/23/1998 (24 years old)","DM, M/AM (C)","Peterborough","Sky Bet League One","IRL","Yes","1/7/2020","6/30/2026","$200K - $2M","Right","Fairly Strong","Very Strong","6'1""","154 lbs","236","30",115,135,11,12,11,13,11,9,10,13,3,11,12,10,12,13,12,11,13,13,12,11,10,10,9,12,10,14,12,16,12,9,10,12,14,11,15,12,9,12,10,12,12,11,13,11,8,5,13,9,10,2,3,3,2,2,1,3,2,2,2,2
"6750",28127120,"Tom Cannon","12/28/2002 (20 years old)","ST (C)","Everton","English Premier Division","IRL","Yes","8/21/2022","6/30/2025","$4.8M - $7.4M","Right","Weak","Very Strong","5'11""","167 lbs","22","8",120,135,11,10,12,15,11,11,13,11,9,9,9,12,8,12,9,13,12,14,11,11,9,9,7,11,8,12,10,11,14,12,11,13,12,13,12,13,11,18,13,10,11,15,10,15,8,6,9,10,20,1,1,3,2,3,3,1,2,4,1,3
"6751",28027432,"Grant Hanley","11/20/1991 (31 years old)","D (C)","Norwich","Sky Bet Championship","SCO","No","7/19/2021","6/30/2025","$375K - $3.8M","Right Only","Weak","Very Strong","6'3""","169 lbs","362","13",121,140,6,6,8,6,9,6,16,6,8,14,10,6,15,9,16,13,16,10,11,11,16,8,16,8,14,17,6,14,13,8,10,15,10,13,14,15,9,12,4,16,13,15,10,14,16,12,13,14,12,1,3,1,1,1,3,3,2,2,3,1
"6752",5113246,"David McGoldrick","11/29/1987 (35 years old)","AM (C), ST (C)","Derby","Sky Bet League One","IRL","Yes","7/6/2022","6/30/2024","$55K - $550K","Right","Fairly Strong","Very Strong","6'0""","163 lbs","503","134",116,135,8,10,13,12,14,9,11,13,6,9,12,13,8,14,6,12,11,13,13,13,14,13,13,13,11,13,13,15,9,13,14,12,14,10,9,13,10,17,13,14,11,11,13,10,5,6,12,13,10,2,1,2,2,3,3,1,3,1,2,3
"6753",20041862,"Alphonso Davies","11/2/2000 (22 years old)","D/WB/M/AM (L)","FC Bayern","Bundesliga","CAN","No","6/14/2021","6/30/2025","$93M - $141M","Left","Very Strong","Reasonable","6'1""","169 lbs","188","19",156,172,10,11,17,9,12,11,9,9,14,9,12,11,14,13,15,11,15,12,10,12,17,16,8,13,10,14,12,16,19,14,12,11,14,19,15,12,15,11,12,12,12,13,8,12,7,8,12,19,18,1,1,3,1,1,1,4,2,1,3,1
"6754",72056311,"Jahkeele Marshall-Rutty","6/16/2004 (18 years old)","D/WB/M/AM (RL)","Toronto FC","Major League Soccer","CAN","No","6/13/2022","12/31/2023","$6.2M - $7.8M","Right Only","Weak","Very Strong","5'9""","141 lbs","36","-",107,155,10,12,13,10,13,10,7,10,2,9,13,7,11,14,12,11,11,12,10,8,7,13,7,10,10,11,10,13,12,11,10,10,11,13,9,7,17,16,14,10,11,12,9,9,7,3,8,14,12,2,1,3,2,1,4,1,3,1,2,3
"6755",18108540,"Jonathan David","1/14/2000 (23 years old)","AM (RLC), ST (C)","LOSC","Ligue 1 Uber Eats","CAN","No","8/11/2020","6/30/2025","$44M - $68M","Right","Fairly Strong","Very Strong","5'10""","169 lbs","172","82",144,154,8,10,13,14,14,10,12,11,5,7,13,15,6,13,12,13,12,13,12,12,14,14,12,14,8,12,12,14,16,13,12,12,14,15,13,13,14,10,13,13,12,13,7,14,8,7,13,14,11,1,1,1,3,3,3,3,2,3,2,2
"6756",2000121309,"Ismaël Koné","6/16/2002 (20 years old)","DM, M/AM (C)","Watford","Sky Bet Championship","CAN","No","12/5/2022","6/30/2027","$12.5M - $15.5M","Right","Reasonable","Very Strong","6'2""","169 lbs","42","2",119,154,8,10,12,12,12,7,10,10,3,10,14,8,10,14,8,11,10,14,11,12,9,13,6,11,13,12,14,13,10,12,13,13,14,13,15,11,12,11,12,10,12,11,7,10,7,7,9,11,20,3,1,2,3,2,2,3,3,2,1,3
"6757",55079798,"Stephen Eustáquio","12/21/1996 (26 years old)","DM, M (C)","FC Porto","Portuguese Premier League","CAN","Yes","5/31/2022","6/30/2027","$17.5M - $27M","Right","Reasonable","Very Strong","5'10""","156 lbs","225","6",141,146,13,13,13,12,14,11,11,12,11,8,15,10,12,14,13,15,14,15,13,14,14,12,12,14,13,15,16,14,13,14,14,9,16,12,15,8,9,16,14,16,16,10,6,14,9,13,15,11,5,1,2,2,1,2,1,1,3,3,2,2
"6758",72056139,"Alistair Johnston","10/8/1998 (24 years old)","D/WB/M (R)","Celtic","cinch Premiership","CAN","No","1/1/2023","1/1/2028","$11M - $14M","Right","Reasonable","Very Strong","5'11""","171 lbs","91","6",132,145,8,13,11,8,11,8,11,10,9,13,13,9,14,11,12,13,18,11,11,12,16,9,11,11,14,15,12,16,14,13,13,10,14,13,14,15,11,10,10,13,11,12,7,14,11,6,16,12,12,3,1,2,4,3,3,3,1,3,2,1
"6759",78058339,"Lucas Cavallini","12/28/1992 (30 years old)","ST (C)","Tijuana","Mexican First Division","CAN","Yes","1/3/2023","12/31/2024","$220K - $2.2M","Left","Very Strong","Fairly Strong","6'0""","185 lbs","272","93",126,138,11,11,9,13,10,11,16,7,3,12,10,12,7,11,16,11,16,13,15,10,15,9,11,13,11,12,9,16,13,11,15,12,14,14,14,16,14,10,12,10,8,13,7,12,14,6,13,10,11,2,3,1,3,2,2,3,2,1,3,2
"6760",72044151,"Cyle Larin","4/17/1995 (28 years old)","AM (RL), ST (C)","Club Brugge","Jupiler Pro League","CAN","No","7/4/2022","6/30/2027","$160K - $1.6M","Right","Fairly Strong","Very Strong","6'2""","198 lbs","232","94",130,135,3,7,12,14,13,3,15,10,5,8,11,12,8,12,14,14,14,13,11,12,7,10,5,14,6,14,8,14,12,12,14,16,15,12,14,14,2,15,16,6,12,6,7,12,10,8,11,8,12,3,2,3,3,3,1,3,1,1,1,2
"6761",62206980,"Derek Cornelius","11/25/1997 (25 years old)","D (LC)","Malmö FF","Swedish Premier Division","CAN","No","1/1/2023","12/31/2026","$170K - $1.7M","Left Only","Very Strong","Weak","6'2""","189 lbs","118","5",122,133,8,11,9,8,11,12,15,10,12,13,12,9,14,10,12,13,14,14,12,11,13,11,12,11,11,13,11,12,11,11,10,15,14,13,12,15,14,11,9,14,13,13,8,13,9,10,14,11,16,1,3,3,2,1,2,2,3,3,2,1
"6762",2000102668,"Mitchell Robertson","2/18/2005 (18 years old)","D (LC)","Celtic","cinch Premiership","SCO","No","4/26/2023","5/31/2025","$110K - $1.1M","Left","Very Strong","Reasonable","5'10""","145 lbs","26","-",60,140,8,10,5,4,10,8,9,7,6,10,9,3,16,8,15,10,9,11,10,6,9,5,10,8,9,8,2,9,7,10,9,9,16,10,5,5,11,19,12,15,10,12,4,14,5,1,8,12,19,2,1,3,1,3,2,1,2,1,3,1
"6763",72052880,"Tajon Buchanan","2/8/1999 (24 years old)","M (R), AM (RL)","Club Brugge","Jupiler Pro League","CAN","No","8/24/2021","6/30/2025","$450K - $7.8M","Right","Reasonable","Very Strong","6'0""","152 lbs","106","15",127,133,10,13,14,12,12,10,11,11,10,9,12,11,11,12,12,11,14,12,11,11,11,14,6,13,11,11,11,13,15,12,11,10,13,15,12,9,15,19,10,11,11,13,13,13,12,3,10,15,10,3,1,3,3,2,3,1,1,1,3,3
"6764",57189533,"Theo Corbeanu","5/17/2002 (21 years old)","AM (RL), ST (C)","Arminia Bielefeld","3. Liga","CAN","Yes","7/28/2022","6/30/2026","$8.2M - $9.8M","Left","Very Strong","Strong","6'3""","149 lbs","60","6",118,132,11,10,15,11,12,11,8,9,6,6,11,11,6,13,10,10,8,11,8,9,13,15,3,12,6,9,10,11,14,13,10,13,13,14,12,9,8,10,7,11,8,6,6,8,11,5,13,14,13,3,2,3,1,1,3,4,4,3,2,1
"6765",20501493,"Mark-Anthony Kaye","12/2/1994 (28 years old)","D (L), DM, M (LC)","Toronto FC","Major League Soccer","CAN","No","7/8/2022","12/31/2024","$4.4M - $8.4M","Left","Very Strong","Reasonable","6'1""","160 lbs","221","23",123,131,11,12,13,9,12,7,10,9,9,10,14,8,12,12,7,11,13,12,11,11,11,8,11,9,12,12,13,14,14,13,9,13,14,14,12,13,14,11,11,13,10,11,10,11,7,4,14,13,15,2,2,3,1,3,8,2,1,2,3,1
"6766",28000482,"Junior Hoilett","6/5/1990 (33 years old)","WB/M/AM (RL)","Reading","Sky Bet League One","CAN","No","7/5/2022","6/30/2023","$0 - $12K","Right","Fairly Strong","Very Strong","5'8""","154 lbs","457","58",107,130,12,10,11,10,12,12,8,12,6,10,10,11,9,13,8,10,9,10,9,9,10,13,9,12,11,11,11,13,12,13,13,7,14,11,10,10,14,15,5,10,11,9,14,10,5,15,10,18,10,2,1,2,3,2,2,3,1,3,2,2
"6767",72052878,"Dayne St. Clair","5/9/1997 (26 years old)","GK","Minnesota","Major League Soccer","CAN","No","11/30/2021","12/31/2024","$700K - $7M","Left","Very Strong","Reasonable","6'4""","185 lbs","134","-",118,130,3,1,2,3,10,6,1,1,3,3,12,1,1,8,8,13,12,9,12,11,13,1,5,3,13,12,8,11,11,13,9,14,12,11,9,13,13,8,12,12,11,9,11,14,8,8,13,12,15,10,13,16,5,12,12,12,6,11,8,14
"6768",28103592,"Iké Ugbo","9/21/1998 (24 years old)","AM (RL), ST (C)","Troyes","Ligue 2 BKT","CAN","No","8/4/2022","6/30/2026","$600K - $10M","Right","Fairly Strong","Very Strong","6'1""","160 lbs","163","42",122,130,5,8,12,13,11,10,11,10,5,7,9,11,8,11,11,11,13,13,14,13,12,12,8,12,7,12,9,12,15,12,11,11,11,16,12,12,8,14,14,12,10,10,9,11,4,9,13,10,11,1,1,1,1,3,2,3,4,3,3,3
"6769",20046586,"Noble Okello","7/20/2000 (22 years old)","DM, M (C)","New England II","MLS Next Pro Eastern Conference","CAN","No","3/16/2023","12/31/2023","$250K - $2.6M","Right","Reasonable","Very Strong","6'5""","185 lbs","107","3",97,129,10,9,11,6,12,5,10,11,6,9,11,6,13,13,8,9,8,10,10,11,14,7,15,9,10,10,11,13,11,9,8,18,14,14,12,14,12,11,9,13,11,13,11,3,14,6,7,15,13,2,1,1,2,1,2,2,2,1,1,2
"6770",2000015847,"Keesean Ferdinand","8/17/2003 (19 years old)","D (RLC)","Portland","Major League Soccer","CAN","No","3/2/2023","12/31/2024","$240K - $2.4M","Either","Very Strong","Very Strong","6'0""","149 lbs","38","4",90,129,5,9,7,7,10,6,9,6,10,10,10,6,11,10,9,10,11,13,10,9,11,3,1,10,11,10,8,10,11,8,12,13,12,9,12,11,14,20,13,11,10,10,9,12,4,3,11,9,10,1,3,4,2,1,3,3,1,1,2,2
"6771",765016,"Olivier Occéan","10/23/1981 (41 years old)","ST (C)","Urædd","Norwegian Fourth Division Telemark","CAN","Yes","1/1/2020","12/31/2023","$0","Right","Reasonable","Very Strong","6'1""","189 lbs","433","174",80,128,6,8,7,11,12,6,14,7,8,5,11,14,6,11,12,13,10,12,12,13,13,11,7,9,7,13,10,11,6,11,13,14,16,6,9,14,5,13,8,9,14,10,11,13,15,9,12,14,15,3,2,4,1,1,1,2,3,2,2,2
"6772",2000225029,"Luc de Fougerolles","10/12/2005 (17 years old)","D (RLC)","Fulham","English Premier Division","CAN","No","4/6/2023","6/30/2026","$1.4M - $2.9M","Right","Strong","Very Strong","5'11""","156 lbs","-","-",82,128,7,7,11,4,9,6,7,5,9,10,10,6,10,11,8,10,10,12,7,8,13,8,6,6,7,13,10,9,14,13,12,9,11,12,10,9,14,11,11,10,11,10,8,4,7,3,13,10,7,3,2,3,2,4,1,3,3,3,1,2
"6773",61005139,"Ryan Jack","2/27/1992 (31 years old)","DM, M (C)","Rangers","cinch Premiership","SCO","No","5/19/2023","5/31/2024","$425K - $4.2M","Right","Reasonable","Very Strong","6'0""","158 lbs","319","26",124,140,11,5,11,10,12,3,6,11,6,13,13,10,13,13,16,10,15,15,12,10,17,6,14,12,12,15,13,16,11,10,13,10,5,11,16,12,13,9,8,17,14,15,18,12,12,5,18,14,11,1,1,3,2,1,2,3,3,1,2,2
"6774",2000056755,"Federico Rose","8/7/2004 (18 years old)","ST (C)","Vélez","Argentine Premier Division","CAN","No","6/13/2022","12/31/2025","$50K - $500K","Right","Weak","Very Strong","5'10""","149 lbs","1","-",84,128,6,7,14,14,7,3,9,6,1,4,8,7,1,8,15,9,4,14,8,8,8,7,1,13,6,7,3,12,14,14,14,7,8,14,14,4,12,20,11,11,10,12,10,13,9,8,18,9,12,1,1,3,2,3,3,2,2,1,2,2
"6775",28109697,"Liam Millar","9/27/1999 (23 years old)","WB/M/AM (L)","Basel","Swiss Super League","CAN","No","7/8/2021","6/30/2025","$1.5M - $3.2M","Right","Reasonable","Very Strong","5'11""","165 lbs","117","11",117,128,8,12,14,8,13,7,8,12,4,6,12,10,7,13,12,12,8,8,11,12,12,14,7,12,6,12,10,13,14,13,13,9,11,13,14,10,8,12,10,13,9,12,8,10,7,8,8,14,14,3,2,1,1,3,2,1,1,3,3,2
"6776",2000018421,"Nikola Bursać","9/11/2001 (21 years old)","GK","Spartak","Serbian SuperLeague","CAN","No","7/1/2018","6/30/2025","$0","Right Only","Weak","Very Strong","6'3""","167 lbs","18","-",93,128,3,1,1,3,7,4,3,1,2,1,10,2,3,9,5,11,13,9,10,10,11,2,10,3,11,10,10,10,8,10,11,17,13,9,12,14,12,19,11,10,12,10,6,6,9,8,11,12,10,10,11,11,11,11,11,12,9,11,12,13
"6777",20042816,"Ayo Akinola","1/20/2000 (23 years old)","AM (RL), ST (C)","Toronto FC","Major League Soccer","CAN","No","1/20/2022","12/31/2024","$700K - $6.8M","Right Only","Weak","Very Strong","5'10""","182 lbs","113","23",114,128,6,10,11,13,11,6,12,11,5,8,10,11,5,11,11,12,9,10,9,9,11,9,7,12,13,11,10,13,15,12,9,6,12,16,12,14,11,13,11,10,10,8,11,10,10,12,9,12,10,1,3,2,2,3,4,3,3,2,3,2
"6778",2000093121,"Kamron Habibullah","10/3/2003 (19 years old)","AM (LC)","Vancouver","Major League Soccer","CAN","No","4/23/2021","12/31/2023","$1.3M - $2.8M","Right","Fairly Strong","Very Strong","5'7""","152 lbs","17","-",94,127,10,7,12,8,10,9,10,11,8,9,9,7,6,11,9,11,6,11,9,12,6,12,6,10,9,10,11,10,12,14,13,4,12,11,8,5,13,14,13,12,10,13,13,3,7,1,12,11,14,3,2,2,2,3,2,1,2,1,4,3
"6779",2000022499,"Sean Young","4/20/2001 (22 years old)","DM, M (C)","Pacific FC","Canadian Premier League","CAN","No","11/26/2022","11/30/2023","$35K - $350K","Right Only","Weak","Very Strong","6'2""","169 lbs","64","3",88,127,7,8,10,8,10,9,11,6,11,12,12,6,11,11,10,10,10,12,10,12,13,8,9,10,12,11,11,12,10,11,10,9,12,10,12,11,8,12,15,14,15,16,6,1,7,3,11,8,7,1,1,1,1,1,1,1,1,1,1,1
"6780",20049594,"Jayden Nelson","9/26/2002 (20 years old)","M (C), AM (RLC), ST (C)","Rosenborg","Norwegian Premier Division","CAN","No","2/8/2023","12/31/2025","$425K - $4.2M","Right","Weak","Very Strong","5'8""","145 lbs","73","4",110,127,9,10,13,10,11,9,8,12,5,10,10,4,7,11,10,9,11,8,9,8,13,14,5,11,9,13,10,14,16,13,9,7,12,14,10,7,13,18,14,13,12,12,9,2,4,4,10,14,12,1,1,2,2,3,2,3,3,2,2,2
"6781",29174499,"Thomas McGill","3/25/2000 (23 years old)","GK","Brighton","English Premier Division","CAN","No","6/1/2023","6/30/2025","$2.5K - $22K","Right","Weak","Very Strong","6'1""","174 lbs","33","-",87,127,1,1,2,2,8,5,7,1,1,1,9,3,3,9,9,8,13,9,10,9,9,1,8,1,9,9,7,9,10,12,10,11,13,11,14,9,8,12,13,12,12,10,9,10,5,1,8,13,18,9,8,13,11,11,13,11,4,11,9,11
"6782",2000015123,"Mo Farsi","12/16/1999 (23 years old)","D/WB (R)","Columbus","Major League Soccer","CAN","No","7/22/2022","12/31/2023","$90K - $900K","Right","Reasonable","Very Strong","5'10""","152 lbs","100","3",103,127,9,13,13,9,11,8,8,9,9,13,11,8,10,11,8,10,8,11,10,10,16,9,9,13,11,10,9,11,13,13,11,8,10,12,12,9,12,16,10,12,10,10,5,14,7,4,12,11,12,3,1,2,1,3,3,1,3,3,2,3
"6783",2000274490,"Antoni Klukowski","4/2/2007 (16 years old)","ST (C)","Legia","PKO Bank Polski Ekstraklasa","CAN","Yes","7/1/2022","6/30/2026","$0","Left","Very Strong","Reasonable","6'1""","158 lbs","-","-",65,126,5,4,11,13,12,5,13,3,2,4,5,3,4,10,6,11,7,10,5,7,15,13,11,13,4,5,6,6,9,11,3,11,10,12,11,4,7,14,8,9,11,12,12,6,5,6,6,12,16,3,1,1,1,2,1,1,2,2,1,3
"6784",28122327,"Harrison Ashby","11/14/2001 (21 years old)","D/WB (R)","Newcastle","English Premier Division","SCO","No","1/31/2023","6/30/2028","$190K - $1.9M","Right","Reasonable","Very Strong","5'10""","158 lbs","1","-",106,140,12,11,10,10,10,12,9,10,8,11,11,11,12,12,14,10,12,10,11,10,13,8,14,12,11,10,11,13,13,12,10,10,14,14,12,12,11,8,8,12,8,12,12,13,10,1,13,12,18,2,2,1,3,3,2,1,4,3,3,1
"6785",72040331,"Jonathan Osorio","6/12/1992 (30 years old)","M (RLC), AM (LC)","Toronto FC","Major League Soccer","CAN","No","12/12/2022","12/31/2025","Not for Sale","Right","Reasonable","Very Strong","5'9""","160 lbs","292","56",126,126,11,11,14,12,13,10,8,12,7,12,13,9,11,13,11,12,12,11,11,12,15,12,12,13,10,14,12,15,12,14,14,7,12,13,14,10,15,15,13,15,11,13,7,13,5,4,14,16,12,2,1,2,1,1,3,3,2,1,3,1
"6786",78018507,"Milan Borjan","10/23/1987 (35 years old)","GK","Crvena zvezda","Serbian SuperLeague","CAN","No","7/27/2022","6/30/2026","Not for Sale","Right Only","Very Weak","Very Strong","6'5""","191 lbs","323","1",124,126,4,2,3,3,7,6,7,3,3,3,8,11,9,3,12,11,16,12,13,11,15,9,14,4,14,11,7,10,9,13,14,16,15,9,10,15,11,9,11,11,15,12,8,15,15,9,12,13,12,13,13,15,10,14,9,13,7,13,15,14
"6787",2000069112,"Sean Rea","5/15/2002 (21 years old)","AM (RLC)","CF Montréal","Major League Soccer","CAN","Yes","11/15/2022","12/31/2023","$300K - $3.1M","Right Only","Weak","Very Strong","5'5""","138 lbs","65","9",99,125,10,10,14,10,12,10,7,12,6,9,12,6,10,13,6,12,7,10,10,12,12,14,6,10,7,10,12,12,12,14,10,5,11,12,8,11,11,11,10,10,9,12,10,7,5,5,11,11,20,1,3,1,1,3,4,2,2,2,2,3
"6788",72045915,"Richie Laryea","1/7/1995 (28 years old)","D/WB (RL)","Nottm Forest","English Premier Division","CAN","No","1/8/2022","6/30/2025","$210K - $2.1M","Right","Weak","Very Strong","5'9""","152 lbs","171","19",122,125,9,13,12,10,12,8,8,10,3,11,13,9,11,11,14,11,12,10,10,10,11,10,8,12,11,11,12,12,15,13,13,9,12,14,14,12,16,7,10,14,11,11,10,11,11,10,12,13,7,4,1,1,1,4,2,2,1,2,3,2
"6789",2000239167,"Moïse Bombito","3/30/2000 (23 years old)","D (C)","Colorado","Major League Soccer","CAN","No","12/21/2022","12/31/2024","$120K - $1.2M","Right","Weak","Very Strong","6'3""","187 lbs","75","12",100,125,7,7,8,7,9,3,14,5,6,10,12,5,12,10,14,12,11,9,10,10,13,4,8,7,9,13,11,14,12,10,11,16,14,14,13,14,9,11,9,9,10,9,9,9,11,9,16,10,11,1,2,3,2,3,4,2,1,1,2,4
"6790",37059530,"Tristan Borges","8/26/1998 (24 years old)","AM (LC)","Forge FC","Canadian Premier League","CAN","Yes","7/1/2022","11/30/2023","$40K - $400K","Left","Very Strong","Reasonable","5'7""","145 lbs","88","23",96,125,11,12,13,12,12,10,6,8,5,8,12,13,8,14,14,12,8,9,10,11,11,13,7,11,7,10,13,11,12,13,12,5,11,10,11,9,13,12,14,9,10,8,8,10,11,7,11,12,15,3,3,4,2,2,3,2,3,1,1,2
"6791",2000125802,"Osaze De Rosario","7/19/2001 (21 years old)","ST (C)","York United FC","Canadian Premier League","CAN","No","11/16/2022","11/30/2024","$120K - $1.2M","Right","Weak","Very Strong","6'2""","174 lbs","30","12",95,125,5,6,11,13,12,6,10,14,5,4,10,11,5,12,10,10,9,12,12,11,13,10,6,10,6,9,11,10,10,12,12,13,14,10,14,14,7,19,11,13,11,13,6,8,4,5,11,12,7,2,3,1,2,1,1,2,1,2,1,1
"6792",20041365,"Ballou Tabla","3/31/1999 (24 years old)","AM (RL)","Manisa FK","Turkish 1. League","CAN","No","1/24/2023","6/30/2025","$600K - $1.8M","Right","Fairly Strong","Very Strong","5'9""","154 lbs","107","18",105,125,9,12,16,12,13,9,7,11,8,5,12,8,7,14,8,11,12,9,7,8,11,16,6,10,6,8,11,9,14,14,9,7,11,13,10,7,13,10,10,6,12,6,5,10,6,13,10,10,14,2,3,1,1,3,3,3,4,2,2,2
"6793",2000015846,"Jonathan Sirois","6/27/2001 (21 years old)","GK","CF Montréal","Major League Soccer","CAN","No","3/6/2020","12/31/2025","$12K - $6M","Right","Weak","Very Strong","6'0""","163 lbs","57","-",106,125,3,3,2,1,1,8,1,1,3,1,13,2,1,5,10,13,15,9,10,12,10,2,12,2,13,9,8,7,14,11,9,11,12,12,3,8,14,14,12,10,10,13,7,5,11,3,12,11,14,10,8,14,14,13,12,12,6,10,11,11
"6794",72040306,"Sam Adekugbe","1/16/1995 (28 years old)","D/WB (L)","Hatayspor","Turkish Super League","CAN","No","8/1/2021","6/30/2025","$210K - $2.1M","Left Only","Very Strong","Weak","5'9""","165 lbs","184","-",115,125,7,12,9,7,13,7,10,6,10,12,12,6,13,12,12,12,12,14,11,13,12,7,10,9,12,13,10,14,13,12,14,10,16,14,15,13,5,12,17,13,9,14,8,12,9,3,12,12,14,3,2,3,1,2,3,1,2,3,1,3
"6795",61058341,"John Souttar","9/25/1996 (26 years old)","D (C)","Rangers","cinch Premiership","SCO","No","6/1/2022","5/31/2026","$6.8M - $8M","Right","Fairly Strong","Very Strong","6'1""","169 lbs","205","7",124,140,5,9,10,8,13,6,13,9,9,13,13,8,13,13,11,12,13,13,11,12,16,11,13,10,13,13,14,11,12,11,12,14,13,13,13,14,12,18,14,15,15,10,18,14,8,3,13,14,19,1,2,3,1,3,3,3,3,3,2,1
"6796",55006634,"Steven Vitória","1/11/1987 (36 years old)","D (C)","Chaves","Portuguese Premier League","CAN","Yes","7/4/2022","6/30/2024","$20K - $200K","Right","Reasonable","Very Strong","6'5""","189 lbs","307","46",117,125,10,12,6,8,8,13,15,11,10,15,10,12,10,9,15,12,16,12,12,10,12,5,15,10,14,13,10,11,8,7,15,16,14,8,11,17,11,15,15,15,13,14,7,10,10,5,14,14,11,1,3,2,3,2,1,2,1,3,2,3
"6797",20503500,"Diyaeddine Abzi","11/23/1998 (24 years old)","D/WB (L)","Pau FC","Ligue 2 BKT","CAN","No","7/1/2022","6/30/2025","$30K - $300K","Left","Very Strong","Weak","6'0""","165 lbs","113","10",100,125,10,11,13,9,10,10,10,4,9,11,10,7,11,10,7,11,8,11,12,10,11,11,7,10,12,11,11,12,12,12,13,10,12,12,12,14,10,11,11,9,12,12,9,3,7,2,11,12,13,3,2,2,1,3,3,3,3,1,3,1
"6798",75036502,"Juan Córdova","6/25/1995 (27 years old)","D/WB (RL)","Ñublense","Chilean First Division","CAN","No","12/20/2022","12/31/2024","$120K - $1.2M","Left","Very Strong","Strong","5'5""","136 lbs","164","1",110,125,11,13,11,6,11,9,5,6,9,10,12,5,11,11,7,10,10,8,9,9,9,11,7,12,9,12,12,13,13,13,11,5,12,12,13,7,10,15,12,9,9,12,7,8,8,2,11,12,8,3,2,1,2,2,2,1,1,3,3,1
"6799",2000166621,"Matthew Catavolo","2/13/2003 (20 years old)","AM (C)","Toronto FC II","MLS Next Pro Eastern Conference","CAN","Yes","3/21/2023","12/31/2024","$1.5M - $3.1M","Left","Very Strong","Weak","5'4""","132 lbs","16","-",80,125,8,11,11,8,11,9,5,8,5,6,12,2,4,11,7,10,7,9,9,8,10,11,8,11,9,9,9,11,13,13,9,2,9,13,8,9,11,12,11,12,13,13,6,9,7,4,8,9,8,1,3,2,3,3,3,1,2,2,1,3
"6800",75037988,"Cristián Gutiérrez","2/18/1997 (26 years old)","D/WB (L)","Toronto FC","Major League Soccer","CAN","No","3/14/2023","12/31/2023","$70K - $700K","Left Only","Very Strong","Weak","5'11""","152 lbs","113","1",103,124,9,13,12,8,10,8,8,11,13,11,11,9,11,11,13,11,12,10,9,11,12,7,8,8,11,12,9,12,13,13,10,10,15,12,14,11,7,9,12,13,13,13,4,9,7,13,13,15,12,2,1,1,1,3,1,1,3,4,2,1
"6801",85100464,"Samuel Piette","11/12/1994 (28 years old)","DM, M (C)","CF Montréal","Major League Soccer","CAN","Yes","11/14/2022","12/31/2025","$110K - $6.6M","Right","Weak","Very Strong","5'7""","176 lbs","274","5",116,124,8,7,9,7,11,7,9,11,6,13,13,8,14,11,14,13,14,13,14,13,17,10,16,10,13,14,10,15,11,10,13,7,15,11,17,13,10,8,12,12,11,10,5,11,11,11,16,14,10,1,1,1,1,1,10,1,1,1,1,1
"6802",72022967,"Maxime Crépeau","5/11/1994 (29 years old)","GK","LAFC","Major League Soccer","CAN","No","11/14/2022","12/31/2023","$100K - $1M","Right","Fairly Strong","Very Strong","6'0""","194 lbs","158","-",120,124,3,1,3,1,7,6,1,1,1,3,11,2,3,8,15,11,14,10,12,11,12,9,15,2,12,10,10,12,10,14,10,11,10,10,13,14,13,14,15,14,10,10,5,5,9,8,12,11,8,10,12,14,14,13,13,12,5,12,10,11
"6803",2000095843,"Kobe Franklin","5/10/2003 (20 years old)","D (R)","Toronto FC","Major League Soccer","CAN","No","2/24/2023","12/31/2024","$250K - $2.6M","Right Only","Weak","Very Strong","5'8""","156 lbs","47","5",95,123,11,13,11,8,11,8,10,8,6,11,11,3,9,12,11,11,9,8,12,8,17,11,13,10,12,10,13,12,14,12,11,6,13,13,13,8,12,16,11,9,10,13,10,8,9,3,11,16,8,1,3,3,1,2,1,1,1,3,3,2
"6804",20503373,"Victor Loturi","5/21/2001 (22 years old)","DM, M (C)","Ross County","cinch Premiership","CAN","No","6/21/2022","5/31/2025","$550K - $1.6M","Right","Reasonable","Very Strong","5'8""","134 lbs","66","2",100,123,10,10,12,7,12,10,7,7,7,11,12,7,12,7,10,13,12,11,11,8,6,8,12,6,11,15,8,16,13,12,12,7,14,13,14,10,13,18,10,11,10,9,7,9,7,7,15,12,10,2,1,3,2,2,1,2,3,2,4,1
"6805",20501686,"Adonijah Reid","8/13/1999 (23 years old)","AM (RLC), ST (C)","Pacific FC","Canadian Premier League","CAN","No","1/31/2023","11/30/2023","$50K - $475K","Right","Reasonable","Very Strong","5'6""","152 lbs","126","34",90,123,9,8,11,11,10,7,8,9,10,5,9,10,6,10,10,8,6,10,9,7,10,12,6,10,7,8,8,12,14,14,12,6,11,13,8,8,7,19,11,11,8,8,7,11,9,7,10,12,20,3,2,1,2,3,2,2,2,3,3,1
"6806",61070563,"Kieran Tierney","6/5/1997 (26 years old)","D (LC), WB (L)","Arsenal","English Premier Division","SCO","No","6/25/2021","6/30/2026","$47M - $59M","Left","Very Strong","Reasonable","5'10""","167 lbs","193","8",152,164,10,15,14,11,14,10,12,11,15,13,12,8,15,13,15,13,16,13,13,13,18,12,14,13,13,19,12,18,15,15,15,12,13,14,15,11,12,13,13,17,15,18,13,14,11,7,15,15,12,1,2,3,3,1,4,2,1,2,2,3
"6807",61003328,"John Fleck","8/24/1991 (31 years old)","DM, M (C)","Sheff Utd","English Premier Division","SCO","No","6/14/2021","6/30/2026","$5M - $7.6M","Left Only","Very Strong","Weak","5'7""","160 lbs","460","25",125,138,12,12,12,10,13,11,8,11,7,12,14,10,13,13,14,14,13,13,12,13,13,12,11,13,13,14,14,13,12,14,15,7,14,13,14,11,9,12,12,12,9,13,11,12,12,10,11,14,10,2,1,1,3,2,1,2,2,2,2,4
"6808",20020017,"Jordan Hamilton","3/17/1996 (27 years old)","ST (C)","Forge FC","Canadian Premier League","CAN","No","8/5/2022","11/30/2023","$45K - $140K","Left Only","Very Strong","Weak","6'0""","185 lbs","153","36",90,123,5,7,11,12,10,4,13,11,5,7,9,12,6,11,9,10,12,11,10,10,9,11,9,11,11,10,10,8,12,12,10,13,13,12,9,13,6,12,11,8,10,9,7,10,7,8,9,14,11,2,3,2,3,3,1,3,4,3,2,2
"6809",2000166563,"Carlos Baleba","1/3/2004 (19 years old)","DM, M/AM (C)","LOSC","Ligue 1 Uber Eats","CMR","No","1/14/2022","6/30/2026","$23M - $29M","Left","Very Strong","Reasonable","6'0""","169 lbs","19","-",130,171,6,12,13,8,14,8,9,12,5,11,14,7,15,13,12,11,13,13,13,12,17,11,7,13,12,14,13,14,13,14,11,12,14,14,14,14,13,19,12,12,10,10,6,9,7,8,11,11,7,3,1,3,2,2,2,1,3,2,3,2
"6810",48030711,"André-Franck Zambo Anguissa","11/16/1995 (27 years old)","DM, M (C)","Parthenope","Italian Serie A","CMR","No","11/11/2022","6/30/2025","$81M - $102M","Right","Reasonable","Very Strong","6'0""","171 lbs","235","5",156,162,4,10,16,11,16,5,12,11,4,12,16,9,16,16,14,16,14,15,14,14,17,16,14,16,14,15,13,15,14,14,18,12,15,14,15,16,10,14,13,16,17,13,6,16,8,6,15,16,16,3,3,1,1,3,1,1,3,1,1,1
"6811",29219115,"Flavien-Enzo Boyomo","10/7/2001 (21 years old)","D (RC)","Albacete","Spanish Second Division","CMR","Yes","6/30/2019","6/30/2026","$240K - $2.4M","Right","Fairly Strong","Very Strong","5'11""","167 lbs","93","2",129,161,5,11,11,5,13,5,13,9,6,13,13,8,14,13,10,14,11,12,13,13,14,5,7,8,12,12,13,14,14,13,12,13,13,12,13,14,9,15,14,10,12,12,4,14,5,4,14,12,13,2,2,2,3,3,3,1,3,1,1,1
"6812",67201634,"André Onana","4/2/1996 (27 years old)","GK","Inter","Italian Serie A","CMR","No","7/1/2022","6/30/2027","$41M - $62M","Right","Reasonable","Very Strong","6'3""","205 lbs","211","-",153,160,2,1,3,1,13,4,5,3,3,3,14,2,3,12,9,13,13,16,12,12,17,14,14,2,14,14,10,14,12,15,15,16,16,11,13,13,13,10,14,11,16,11,7,15,8,5,15,17,15,15,15,17,9,13,15,15,19,14,14,15
"6813",91018389,"Joël Matip","8/8/1991 (31 years old)","D (C)","Liverpool","English Premier Division","CMR","Yes","6/14/2021","6/30/2024","$31M - $37M","Right","Weak","Very Strong","6'5""","198 lbs","338","27",152,158,4,7,15,5,15,5,16,3,8,15,14,5,15,14,13,15,14,15,15,15,14,11,8,10,16,15,11,14,13,14,12,16,13,14,14,14,5,15,10,15,14,17,11,14,8,5,13,13,16,2,3,3,2,3,2,4,3,1,1,3
"6814",48042658,"Bryan Mbeumo","8/7/1999 (23 years old)","M (L), AM (RL), ST (C)","Brentford","English Premier Division","CMR","Yes","1/26/2022","6/30/2026","$69M - $105M","Left","Very Strong","Reasonable","5'7""","154 lbs","200","47",144,156,13,13,14,12,12,9,11,13,6,6,13,13,6,13,12,13,14,13,13,13,15,14,7,14,8,14,13,16,15,13,12,8,16,15,15,13,13,13,12,14,13,14,4,12,8,8,13,14,13,3,2,3,4,3,3,2,3,2,3,2
"6815",85085653,"Karl Toko Ekambi","9/14/1992 (30 years old)","AM (RL), ST (C)","Rennes","Ligue 1 Uber Eats","CMR","Yes","6/2/2020","6/30/2024","$2.1M - $4.4M","Right","Weak","Very Strong","6'1""","163 lbs","368","121",130,151,9,11,12,14,12,10,14,11,6,5,11,12,7,12,8,12,11,11,12,10,12,13,8,13,8,11,11,12,16,12,13,12,13,16,14,13,8,14,13,12,10,13,7,15,7,7,10,13,19,3,2,3,2,1,1,3,1,1,2,3
"6816",917333,"Carlos Kameni","2/18/1984 (39 years old)","GK","U.E. Santa Coloma","Andorran First Division","CMR","Yes","8/31/2022","6/30/2024","$0","Right","Weak","Very Strong","6'1""","189 lbs","356","-",100,150,2,2,1,3,8,4,9,1,2,3,10,3,1,8,7,13,15,12,8,12,16,10,10,1,14,8,9,10,9,9,8,13,13,8,8,14,11,12,15,12,14,13,6,14,5,12,12,18,16,12,13,10,16,14,12,13,16,12,12,9
"6817",12028932,"Vincent Aboubakar","1/22/1992 (31 years old)","ST (C)","Beşiktaş","Turkish Super League","CMR","No","1/21/2023","6/30/2025","Not for Sale","Right","Fairly Strong","Very Strong","6'0""","182 lbs","311","122",135,150,2,5,16,17,16,5,12,14,1,2,14,16,2,16,10,14,10,15,12,14,15,18,7,15,2,12,14,10,13,13,16,10,16,11,10,15,10,15,16,15,15,10,7,14,10,14,15,15,14,1,1,2,2,2,2,1,3,3,1,1
"6818",29226253,"Tommy Conway","8/6/2002 (20 years old)","AM (RL), ST (C)","Bristol City","Sky Bet Championship","SCO","No","7/21/2022","6/30/2025","$7.8M - $9.4M","Right Only","Weak","Very Strong","6'0""","165 lbs","66","16",117,138,5,7,12,15,13,4,14,7,1,6,10,12,7,12,9,11,9,14,9,12,15,6,13,13,10,12,11,14,14,14,12,13,10,12,14,11,7,10,7,13,11,6,4,10,7,3,10,11,5,2,2,1,2,2,3,3,3,1,3,1
"6819",12007662,"Nicolas Nkoulou","3/27/1990 (33 years old)","D (C)","Aris","Greek Super League 1","CMR","Yes","8/23/2022","6/30/2024","$150K - $1.5M","Right","Weak","Very Strong","6'0""","169 lbs","395","12",120,150,5,6,9,8,12,5,14,7,6,13,13,7,14,12,12,13,16,13,12,12,15,6,13,7,14,15,11,14,11,11,15,12,10,12,11,14,6,15,10,12,12,9,12,14,12,7,11,13,12,2,1,1,3,2,4,2,3,2,3,3
"6820",8428095,"Alex Song","9/9/1987 (35 years old)","DM, M (C)","AS Arta","Djiboutian Premier Division","CMR","Yes","3/20/2020","-","$0","Right","Reasonable","Very Strong","6'1""","167 lbs","309","8",97,150,9,8,10,9,11,9,7,7,9,13,11,9,10,12,14,15,17,11,9,14,13,10,15,11,13,12,10,15,9,10,9,10,11,10,10,10,11,14,13,7,16,15,2,13,17,8,8,14,14,2,2,3,1,2,3,3,1,1,3,2
"6821",85122274,"Olivier Ntcham","2/9/1996 (27 years old)","M/AM (C)","Swansea","Sky Bet Championship","CMR","Yes","9/1/2021","6/30/2025","$0","Right","Fairly Strong","Very Strong","5'11""","160 lbs","205","28",119,148,10,11,14,12,13,10,7,14,5,7,13,13,9,14,7,13,8,14,9,12,10,16,7,12,9,12,14,10,12,13,15,10,9,12,10,13,10,14,12,10,12,10,5,9,5,6,10,15,14,3,2,3,3,2,3,1,3,2,2,2
"6822",35015916,"Eric Maxim Choupo-Moting","3/23/1989 (34 years old)","AM (RLC), ST (C)","FC Bayern","Bundesliga","CMR","Yes","3/2/2023","6/30/2024","$230K - $2.3M","Right","Fairly Strong","Very Strong","6'3""","200 lbs","359","74",140,145,4,8,12,15,14,6,14,11,6,6,13,13,7,15,12,14,12,15,12,13,12,15,13,13,7,12,13,11,12,11,16,15,12,13,11,15,14,18,11,12,15,5,13,15,6,14,13,12,19,1,1,1,1,1,3,3,2,1,1,2
"6823",83313842,"Junior Onana","1/8/2000 (23 years old)","DM, M (C)","RC Lens","Ligue 1 Uber Eats","CMR","No","8/31/2022","6/30/2027","$250K - $7M","Right Only","Weak","Very Strong","6'2""","189 lbs","77","5",119,144,8,6,12,9,12,9,14,9,9,12,12,10,14,11,17,13,13,11,14,13,15,9,9,11,13,14,12,15,13,11,12,14,13,12,15,14,10,13,10,10,11,11,8,13,14,2,12,12,8,2,1,3,2,2,3,3,2,2,1,1
"6824",49048590,"Christopher Wooh","9/18/2001 (21 years old)","D (C)","Rennes","French National 3 - Group E","CMR","Yes","9/1/2022","6/30/2026","$5M - $7.6M","Right","Weak","Very Strong","6'3""","198 lbs","41","2",114,143,8,5,11,7,10,7,13,8,9,12,11,8,13,11,13,12,12,12,12,11,12,8,8,10,12,13,11,13,12,13,12,15,13,13,12,13,11,13,12,13,10,12,8,11,11,1,12,14,8,1,2,1,1,2,3,3,1,2,1,2
"6825",85084594,"Jean-Pierre Nsame","5/1/1993 (30 years old)","ST (C)","Young Boys","Swiss Super League","CMR","Yes","1/31/2022","6/30/2024","$450K - $4.5M","Right","Fairly Strong","Very Strong","6'2""","196 lbs","278","131",125,141,4,9,11,15,11,6,15,11,4,6,12,15,6,12,11,13,12,13,12,13,15,12,9,15,5,10,8,12,11,10,13,15,13,13,13,15,7,8,8,16,8,13,10,15,11,14,14,11,15,2,2,1,3,3,4,1,1,1,2,3
"6826",34009070,"Allan Nyom","5/10/1988 (35 years old)","D/WB/M (R)","Leganés","Spanish Second Division","CMR","Yes","3/9/2023","6/30/2024","$80K - $800K","Right Only","Weak","Very Strong","6'2""","176 lbs","481","7",130,140,5,11,11,6,11,5,12,6,12,13,11,7,15,12,15,14,16,13,13,12,16,10,9,14,13,16,10,15,13,11,10,14,15,13,15,16,15,13,12,16,14,15,5,15,13,12,13,14,14,2,1,1,3,1,2,3,3,3,3,3
"6827",20040254,"Christian Bassogog","10/18/1995 (27 years old)","AM (RL), ST (C)","SH Shenhua","Chinese Super League","CMR","No","1/1/2021","12/31/2023","$30K - $7.4M","Right","Fairly Strong","Very Strong","5'9""","165 lbs","176","39",123,140,10,11,16,10,13,8,6,7,6,5,10,10,5,14,10,10,10,9,8,11,11,17,7,11,6,9,8,10,16,15,12,8,13,15,9,12,11,15,14,11,12,10,5,13,8,5,8,10,12,2,1,2,3,3,1,1,1,2,1,3
"6828",53135726,"Thomas Amang","2/9/1998 (25 years old)","AM (RL), ST (C)","Orange County","USSL Championship Western Conference","CMR","No","3/3/2023","11/30/2024","$240K - $2.4M","Right Only","Very Weak","Very Strong","5'9""","185 lbs","125","30",110,140,8,8,11,9,10,9,8,8,5,6,8,7,7,8,14,7,14,8,7,6,15,17,2,12,5,14,8,17,16,13,15,16,19,18,15,15,13,10,12,14,12,7,9,15,17,5,16,15,15,3,3,2,1,1,3,3,2,1,3,2
"6829",2000300161,"Lewis Pirie","1/28/2007 (16 years old)","ST (C)","Aberdeen","cinch Premiership","SCO","No","7/1/2022","5/31/2026","$550K - $1.6M","Left","Very Strong","Reasonable","5'11""","141 lbs","-","-",80,138,7,3,10,14,11,3,9,8,3,2,10,7,4,11,12,11,8,9,3,6,13,10,3,14,8,7,3,12,14,13,10,9,15,14,9,4,10,20,9,12,12,11,14,9,5,1,13,11,17,4,3,1,2,1,3,2,2,2,2,3
"6830",2000182073,"Freddy Bomo","10/2/2005 (17 years old)","M (RLC)","Young Boys","Swiss Promotion League","CMR","No","6/13/2022","6/30/2025","$300K - $900K","Right Only","Very Weak","Very Strong","5'9""","152 lbs","-","-",75,139,6,8,11,7,10,6,6,8,4,6,9,9,6,11,10,9,12,10,8,9,9,12,6,10,7,12,11,13,12,12,12,12,14,12,12,11,11,18,12,12,11,11,8,14,12,6,9,10,17,3,2,3,2,1,1,3,2,1,1,3
"6831",48036715,"Didier Lamkel Zé","9/17/1996 (26 years old)","AM (RL), ST (C)","KV Kortrijk","Jupiler Pro League","CMR","No","8/23/2022","6/30/2025","$0","Right","Reasonable","Very Strong","6'4""","174 lbs","157","36",127,138,9,10,14,13,12,10,13,14,6,7,12,10,5,14,19,12,12,11,12,10,10,14,6,12,9,14,8,10,13,12,16,14,12,13,11,17,9,5,5,2,6,12,12,15,18,20,7,14,10,2,3,2,2,1,2,1,2,2,1,3
"6832",85054562,"Stéphane Bahoken","5/28/1992 (31 years old)","ST (C)","Kasımpaşa","Turkish Super League","CMR","Yes","7/14/2022","6/30/2024","$0","Right","Weak","Very Strong","6'1""","171 lbs","270","54",110,138,4,8,12,12,13,7,14,8,5,6,10,13,7,14,9,13,12,13,11,13,13,11,9,12,10,11,10,12,11,12,14,11,12,9,12,16,5,14,14,13,12,15,11,13,8,10,12,13,10,3,1,3,1,1,4,1,3,1,3,2
"6833",2000256306,"Yvan Noh Nafeng","5/28/2005 (18 years old)","M/AM (C)","APEJES","Cameroonian MTN Elite One Group B","CMR","No","7/1/2021","6/30/2025","$0 - $70K","Right","Reasonable","Very Strong","5'7""","132 lbs","-","-",76,138,6,5,7,13,13,6,2,13,1,5,13,4,7,13,15,7,7,5,8,13,5,13,5,7,7,7,11,11,13,13,7,2,9,13,6,1,12,19,11,10,11,11,14,6,10,1,12,10,12,4,1,1,3,3,3,2,2,3,1,1
"6834",2000127351,"Patient Wassou","4/22/2004 (19 years old)","AM (L), ST (C)","Cotonsport","Cameroonian MTN Elite One Group B","CMR","No","7/1/2020","6/30/2024","$5K - $50K","Left","Very Strong","Reasonable","6'1""","167 lbs","-","-",92,137,7,10,13,8,13,7,9,9,7,6,12,5,8,11,10,9,9,6,6,9,10,11,12,13,6,7,8,12,13,12,13,11,11,13,7,5,12,15,10,9,11,11,8,8,5,2,16,11,13,1,1,2,2,1,3,2,1,2,1,1
"6835",48036572,"Enzo Ebosse","3/11/1999 (24 years old)","D (LC), WB (L)","Udinese","Italian Serie A","CMR","Yes","7/29/2022","6/30/2027","$200K - $2.1M","Left","Very Strong","Reasonable","6'1""","169 lbs","70","-",123,137,5,11,10,5,12,4,13,6,11,13,12,6,14,12,10,12,13,11,11,11,11,10,7,12,14,13,11,13,13,13,11,13,14,13,14,15,12,11,10,11,8,11,8,10,8,4,12,11,19,1,4,3,2,1,3,3,2,1,1,2
"6836",20046847,"Faris","7/1/2000 (22 years old)","AM (L), ST (C)","Bodø/Glimt","Norwegian Premier Division","CMR","No","1/12/2023","6/30/2026","$230K - $2.3M","Left","Very Strong","Fairly Strong","6'0""","176 lbs","88","24",128,136,6,9,12,14,12,7,12,9,5,8,7,12,6,12,14,11,12,13,10,9,15,16,7,13,8,12,10,13,14,14,15,15,13,14,14,17,10,8,14,12,8,6,5,12,12,5,13,15,10,1,2,2,3,3,2,3,3,4,3,1
"6837",2000097739,"Abdouraman Daman","8/11/2002 (20 years old)","M (R), AM (RL)","Cotonsport","Cameroonian MTN Elite One Group B","CMR","No","7/1/2019","6/30/2024","$5K - $50K","Right","Reasonable","Very Strong","6'1""","165 lbs","-","-",95,136,8,13,13,12,13,8,7,10,7,7,14,3,4,14,9,10,8,5,8,14,9,13,11,11,8,9,10,10,14,14,9,8,12,14,7,6,16,11,10,12,10,11,11,8,9,1,15,11,10,3,2,3,1,2,2,3,3,4,2,1
"6838",13137529,"Léandre Tawamba","12/20/1989 (33 years old)","ST (C)","Al-Taawoun","Saudi Professional League","CMR","No","6/2/2021","6/30/2024","$0","Right","Reasonable","Very Strong","6'2""","187 lbs","268","109",130,135,8,8,13,14,14,9,14,11,5,5,13,12,5,14,11,14,13,14,13,12,13,13,12,14,7,13,12,13,12,12,15,14,14,12,13,16,12,9,10,12,12,12,8,12,9,9,15,13,13,3,3,2,3,3,3,1,1,3,2,1
"6839",85133797,"Harold Moukoudi","11/27/1997 (25 years old)","D (C)","AEK","Greek Super League 1","CMR","Yes","8/18/2022","6/30/2026","$5.4M - $10M","Right Only","Weak","Very Strong","6'3""","185 lbs","152","11",125,135,3,7,9,6,12,6,15,7,7,14,11,9,15,11,15,12,16,13,12,12,15,9,10,8,13,13,9,15,12,10,16,15,16,12,14,16,10,11,11,13,13,12,10,14,12,11,13,15,12,3,2,3,2,1,1,3,2,1,2,2
"6840",61074080,"Allan Campbell","7/4/1998 (24 years old)","DM, M/AM (C)","Luton","English Premier Division","SCO","No","6/15/2021","6/30/2024","$4.1M - $6.2M","Right","Fairly Strong","Very Strong","5'9""","160 lbs","210","21",120,138,4,9,11,10,12,5,10,10,4,13,12,6,14,12,16,12,19,13,13,10,18,4,12,12,15,14,11,16,10,13,12,10,18,10,16,14,11,15,15,18,12,17,4,13,5,4,17,13,11,3,2,2,1,1,3,3,1,3,3,1
"6841",67185039,"Wilfrid Kaptoum","7/7/1996 (26 years old)","M/AM (C)","Las Palmas","Spanish First Division","CMR","No","1/13/2023","6/30/2025","$65K - $650K","Right","Reasonable","Very Strong","5'9""","158 lbs","130","8",119,135,10,10,14,8,15,10,12,9,7,8,13,12,9,15,8,11,13,13,9,12,10,12,6,12,14,12,14,11,13,15,14,7,15,12,12,11,9,14,11,8,9,11,7,13,10,7,8,15,9,3,4,3,3,3,2,2,4,3,4,1
"6842",49058321,"Darlin Yongwa","9/21/2000 (22 years old)","D/WB/M (L)","FC Lorient","Ligue 1 Uber Eats","CMR","No","7/1/2022","6/30/2026","$2.9M - $6M","Left","Very Strong","Reasonable","5'11""","149 lbs","80","1",116,134,7,12,12,8,12,9,8,5,10,9,12,8,12,13,12,10,13,11,10,10,7,8,6,13,11,12,11,14,15,13,12,9,10,14,13,12,13,17,11,11,11,13,10,8,6,5,11,13,17,4,2,3,3,1,2,2,2,1,1,3
"6843",13171659,"Nicolas Moumi Ngamaleu","7/9/1994 (28 years old)","M/AM (RL)","Dinamo Moscow","Russian Premier League","CMR","No","9/8/2022","6/30/2024","$425K - $4.3M","Right","Reasonable","Very Strong","5'11""","165 lbs","210","40",124,134,12,13,12,13,14,9,9,12,7,6,10,10,8,14,8,11,11,11,11,9,11,15,8,12,9,10,13,10,14,15,11,10,14,14,14,10,14,13,9,14,12,13,6,9,7,6,10,13,11,2,3,2,1,1,1,2,2,1,1,3
"6844",13208559,"Steve Mvoué","2/2/2002 (21 years old)","DM, M/AM (C)","Seraing FC","Belgian Challenger Pro League","CMR","No","9/6/2022","6/30/2024","$150K - $1.5M","Right Only","Weak","Very Strong","6'1""","160 lbs","26","2",102,134,7,9,11,13,12,9,9,11,4,11,13,6,11,14,11,12,9,11,11,12,13,15,8,11,14,10,12,12,13,12,11,12,8,15,12,11,10,18,14,12,12,10,10,2,10,8,11,10,13,4,2,3,3,2,1,2,1,1,3,3
"6845",13193979,"Wilitty Younoussa","9/9/2001 (21 years old)","DM, M (C)","Rodez AF","Ligue 2 BKT","CMR","No","8/23/2022","6/30/2024","$110K - $1.1M","Right Only","Weak","Very Strong","5'9""","145 lbs","50","1",101,133,6,12,11,6,13,6,6,11,5,12,11,7,13,13,11,12,14,12,12,11,12,13,5,14,13,13,12,14,11,14,12,7,12,13,12,7,8,8,8,15,11,10,6,11,10,3,10,13,16,1,2,3,2,1,3,1,1,2,3,3
"6846",13157239,"Martin Hongla","3/16/1998 (25 years old)","DM, M (C)","Valladolid","Spanish Second Division","CMR","No","7/1/2022","6/30/2026","$325K - $3.2M","Right","Reasonable","Very Strong","5'11""","174 lbs","140","6",127,132,5,8,11,8,13,9,12,12,9,11,13,12,13,13,14,12,12,12,12,12,12,8,10,12,12,15,12,15,13,13,14,12,15,12,16,14,13,10,12,14,12,11,6,11,14,8,11,12,11,1,4,3,1,4,3,1,2,1,2,2
"6847",49061892,"Malcom Bokélé","2/12/2000 (23 years old)","D (RC)","Bordeaux","Ligue 2 BKT","CMR","Yes","2/24/2023","6/30/2027","$325K - $3.1M","Right","Weak","Very Strong","6'4""","171 lbs","43","2",115,132,5,7,10,6,12,7,14,7,6,12,12,7,13,8,13,12,13,10,11,12,14,8,8,8,12,12,12,13,13,11,11,16,15,13,11,14,11,15,13,11,12,8,7,11,12,14,12,16,12,2,1,3,1,2,3,3,2,3,1,1
"6848",85128158,"James Léa Siliki","6/12/1996 (26 years old)","M (LC)","Estoril Praia","Portuguese Premier League","CMR","Yes","7/22/2022","6/30/2025","$210K - $2.1M","Left","Very Strong","Weak","6'0""","160 lbs","117","6",118,132,11,12,12,9,12,8,9,11,6,10,14,8,12,14,11,12,8,11,13,12,11,12,10,11,12,10,14,12,14,14,12,12,13,12,14,11,14,13,9,11,9,11,12,12,8,8,12,12,17,3,1,3,2,3,1,3,2,2,3,3
"6849",48037720,"Jeando Fuchs","10/11/1997 (25 years old)","DM, M (C)","Peterborough","Sky Bet League One","CMR","Yes","1/28/2022","6/30/2024","$40K - $400K","Right","Weak","Very Strong","5'9""","154 lbs","188","5",108,131,4,5,9,6,10,4,8,6,4,11,12,10,15,12,13,13,14,10,12,11,16,6,8,14,14,13,10,16,11,12,16,9,14,11,14,13,12,12,13,16,12,13,9,13,10,6,12,14,14,3,2,1,1,2,2,3,2,1,1,2
"6850",85138188,"Oumar Gonzalez","2/25/1998 (25 years old)","D (C)","AC Ajaccio","Ligue 2 BKT","CMR","Yes","1/28/2022","6/30/2024","$130K - $1.3M","Right","Reasonable","Very Strong","6'1""","191 lbs","170","9",120,130,6,8,7,7,10,8,13,7,6,13,11,5,13,8,14,12,14,13,13,12,10,9,10,9,13,13,12,12,12,10,15,13,14,12,14,16,10,15,12,14,11,10,11,12,13,1,12,13,16,4,4,3,1,3,3,3,2,3,3,2
"6851",5200647,"Craig Gordon","12/31/1982 (40 years old)","GK","Hearts","cinch Premiership","SCO","No","12/31/2021","5/31/2024","$18K - $180K","Left Only","Very Strong","Weak","6'4""","182 lbs","463","-",120,138,6,3,1,1,6,7,5,1,2,3,8,3,3,6,11,15,11,11,18,13,15,2,17,8,16,15,8,14,5,10,10,15,15,5,10,10,14,18,14,19,19,17,12,15,3,7,18,15,12,12,12,14,8,15,8,13,5,14,13,17
"6852",85117457,"Olivier Kemen","7/20/1996 (26 years old)","DM, M/AM (C)","Kayserispor","Turkish Super League","CMR","Yes","8/6/2021","6/30/2024","$2.3M - $4.6M","Right","Fairly Strong","Very Strong","5'10""","167 lbs","157","17",120,130,5,8,10,8,12,7,11,13,5,10,12,9,12,12,13,12,14,13,13,12,14,10,13,13,12,14,10,15,12,12,13,10,14,12,15,14,12,12,12,16,10,14,6,13,10,5,12,12,12,2,2,2,3,3,4,1,1,2,2,3
"6853",2000090938,"Yvan Dibango","3/10/2002 (21 years old)","D/WB (L)","FCI Levadia","Estonian Premier League","CMR","No","8/16/2022","7/30/2025","$120K - $1.2M","Left","Very Strong","Fairly Strong","6'0""","176 lbs","65","4",110,130,12,11,11,6,10,5,10,12,10,11,8,6,13,12,8,9,16,9,9,11,13,6,11,9,11,14,8,15,13,12,15,10,13,14,14,12,8,13,15,15,9,10,8,8,14,8,12,16,10,3,1,3,2,3,2,1,3,1,3,3
"6854",27139567,"Victor Mpindi","2/27/1997 (26 years old)","DM, M (C)","Vendsyssel FF","NordicBet Liga","CMR","No","8/26/2022","6/30/2025","$22K - $220K","Right","Reasonable","Very Strong","6'3""","174 lbs","115","3",97,130,6,6,7,7,9,4,12,6,13,13,12,6,12,8,14,12,15,12,11,11,12,6,5,8,12,12,12,13,9,8,14,16,15,12,12,17,9,10,10,12,12,10,10,14,11,5,9,11,12,2,4,3,2,1,3,3,2,1,3,3
"6855",85134218,"Yvan Neyou","1/3/1997 (26 years old)","M/AM (RC)","ASSE","Ligue 2 BKT","CMR","Yes","11/18/2020","6/30/2025","$0","Right","Weak","Very Strong","5'11""","138 lbs","131","4",124,130,11,13,13,7,12,11,8,8,6,6,11,10,10,12,12,14,10,13,13,12,10,11,8,14,8,14,12,13,14,15,12,11,12,15,14,12,13,14,11,12,12,10,8,15,9,2,10,14,13,2,2,2,1,1,3,2,1,2,1,3
"6856",49045927,"Ignatius Ganago","2/16/1999 (24 years old)","ST (C)","FC Nantes","Ligue 1 Uber Eats","CMR","No","9/1/2022","6/30/2026","$1.1M - $6.2M","Right","Weak","Very Strong","5'10""","180 lbs","136","23",125,130,7,9,13,14,14,10,12,11,8,8,11,12,8,12,8,11,13,12,11,11,12,12,8,14,6,11,10,13,15,13,14,11,14,16,12,14,6,10,12,12,11,10,11,10,6,4,12,14,13,3,3,2,3,2,1,2,1,2,1,3
"6857",85068487,"Jean-Charles Castelletto","1/26/1995 (28 years old)","D (RC)","FC Nantes","Ligue 1 Uber Eats","CMR","Yes","3/10/2022","6/30/2026","$950K - $5.8M","Right","Weak","Very Strong","6'1""","167 lbs","262","10",127,130,4,10,10,5,11,5,15,7,7,14,11,6,14,12,13,13,15,13,12,12,12,6,13,10,13,13,10,13,12,12,14,15,13,12,15,14,13,12,10,12,10,10,8,13,12,2,12,13,9,3,1,1,1,3,3,1,1,1,1,1
"6858",2000097351,"Brice Ambina","11/17/2001 (21 years old)","DM, M (C)","Cape Town City","South African Premier Soccer League","CMR","No","7/1/2021","6/30/2026","$22K - $220K","Right","Fairly Strong","Very Strong","5'11""","147 lbs","35","-",106,130,9,6,6,9,15,7,9,10,2,11,15,4,15,15,11,11,10,9,10,15,11,5,1,10,15,10,11,13,8,10,10,9,13,12,10,7,15,18,13,11,10,11,13,14,12,6,18,12,16,3,3,1,3,1,2,2,2,2,2,3
"6859",34013939,"Dany Nounkeu","4/11/1986 (37 years old)","D (C)","AS Arta","Djiboutian Premier Division","CMR","No","12/11/2020","-","$0","Right","Fairly Strong","Very Strong","6'0""","187 lbs","227","5",92,130,2,6,8,3,10,3,9,3,7,13,10,5,13,10,10,12,13,11,8,11,8,12,7,8,12,8,10,13,12,11,12,12,15,12,11,13,10,10,12,13,15,12,6,14,7,4,10,12,12,3,1,2,2,3,3,2,3,2,1,2
"6860",91123789,"Michael Ngadeu-Ngadjui","11/23/1990 (32 years old)","D (C), DM","Beijing","Chinese Super League","CMR","Yes","3/30/2023","12/31/2025","Not for Sale","Right","Weak","Very Strong","6'3""","191 lbs","287","29",125,129,3,6,6,10,9,8,16,10,5,15,9,13,15,6,12,10,15,14,8,10,14,5,10,8,14,13,6,14,10,11,16,18,14,11,14,18,12,13,14,13,12,10,5,13,10,5,14,12,14,3,2,2,1,3,2,4,3,2,2,3
"6861",13177250,"Mohamed Djetei","8/18/1994 (28 years old)","D (C)","Albacete","Spanish Second Division","CMR","No","3/28/2023","6/30/2026","$275K - $2.8M","Right Only","Weak","Very Strong","6'1""","154 lbs","137","6",123,128,5,13,9,6,12,7,14,5,7,12,13,6,13,12,12,13,14,13,15,12,14,8,14,8,13,12,12,13,13,13,12,14,15,13,13,14,3,15,8,11,10,9,7,13,12,6,14,12,11,2,2,3,1,2,3,1,1,1,1,3
"6862",8454808,"Jordan Rhodes","2/5/1990 (33 years old)","ST (C)","Huddersfield","Sky Bet Championship","SCO","No","7/1/2021","6/30/2024","$80K - $800K","Right","Fairly Strong","Very Strong","6'1""","156 lbs","532","202",113,138,6,9,10,15,12,8,12,11,6,5,11,15,7,11,8,14,11,14,11,12,10,11,11,13,7,9,10,11,12,12,10,13,18,10,10,11,8,18,10,16,12,16,6,16,5,4,9,16,11,2,3,2,2,2,3,2,2,2,2,2
"6863",23246379,"John Mary","3/9/1993 (30 years old)","ST (C)","Rizespor","Turkish Super League","CMR","No","2/16/2023","6/30/2024","$110K - $1.1M","Right","Reasonable","Very Strong","6'1""","180 lbs","264","138",115,128,4,7,12,12,11,6,12,7,7,4,9,12,6,9,12,11,13,12,11,12,13,13,6,11,9,9,9,13,15,12,14,13,13,14,14,15,12,12,12,12,10,13,5,5,8,2,9,12,10,3,2,3,1,1,1,3,3,2,2,2
"6864",43295814,"Dejan Kulusevski","4/25/2000 (23 years old)","M (R), AM (RC)","Juventus","Italian Serie A","SWE","Yes","6/14/2021","6/30/2028","$25M - $38M","Left","Very Strong","Fairly Strong","6'1""","174 lbs","142","22",156,171,11,15,16,11,15,9,7,11,4,4,17,11,7,16,7,15,8,13,12,15,15,15,6,15,6,15,16,15,13,14,17,12,14,14,16,16,15,10,13,14,15,12,6,14,11,8,12,14,16,2,2,2,1,3,3,1,2,2,2,1
"6865",93070286,"Alexander Isak","9/21/1999 (23 years old)","ST (C)","Newcastle","English Premier Division","SWE","Yes","8/26/2022","6/30/2028","$185M - $221M","Right","Reasonable","Very Strong","6'3""","163 lbs","184","71",158,166,7,9,17,15,15,8,12,10,6,5,13,16,6,17,11,15,13,15,12,14,14,17,7,16,6,14,15,14,17,15,15,16,14,16,14,12,8,14,14,12,13,10,5,15,7,5,12,15,13,2,2,2,2,4,3,1,1,2,3,1
"6866",2000008568,"Williot Swedberg","2/1/2004 (19 years old)","M (C), AM (RLC), ST (C)","Vigo","Spanish First Division","SWE","Yes","7/1/2022","6/30/2027","$22M - $33M","Right","Fairly Strong","Very Strong","6'1""","147 lbs","60","8",123,162,8,12,12,11,13,9,14,9,6,9,12,11,8,13,8,14,12,15,13,11,14,12,8,15,12,10,12,10,12,12,10,12,12,12,11,8,14,18,16,15,15,18,5,16,9,1,13,13,14,2,1,2,1,2,1,3,2,3,3,3
"6867",93070271,"Viktor Gyökeres","6/4/1998 (25 years old)","ST (C)","Coventry","Sky Bet Championship","SWE","Yes","7/9/2021","6/30/2027","$22M - $27M","Right","Reasonable","Very Strong","6'2""","189 lbs","202","68",148,162,6,10,15,16,14,7,12,12,6,6,11,16,8,13,17,14,14,13,13,13,18,13,7,12,9,15,13,19,15,12,14,13,16,15,18,16,11,8,9,12,14,10,6,11,14,4,10,12,20,1,1,2,4,2,2,1,2,3,3,3
"6868",2000088490,"Roony Bardghji","11/15/2005 (17 years old)","M/AM (R)","FC København","3F Superliga","SWE","Yes","1/7/2023","12/31/2025","$7.8M - $11.5M","Left","Very Strong","Fairly Strong","5'7""","130 lbs","32","5",124,161,13,11,15,13,14,11,5,14,5,3,14,9,3,15,10,13,13,13,10,12,16,15,7,13,6,13,12,13,13,15,14,5,15,13,12,8,10,13,16,16,15,13,5,13,5,5,12,18,15,3,2,3,3,3,2,4,2,3,2,3
"6869",2000169739,"Lucas Bergvall","2/2/2006 (17 years old)","DM, M/AM (C)","Djurgårdens IF","Swedish Premier Division","SWE","Yes","12/9/2022","12/31/2025","$40K - $375K","Right Only","Weak","Very Strong","6'1""","163 lbs","12","1",99,157,10,8,12,8,13,10,5,9,3,5,13,8,7,14,12,11,9,11,11,12,18,12,10,9,7,12,12,11,16,13,7,11,12,12,9,7,14,18,16,16,15,17,5,15,12,2,11,16,11,1,2,2,1,2,3,3,2,2,2,1
"6870",93065015,"Tim Rönning","2/15/1999 (24 years old)","GK","IF Elfsborg","Swedish Premier Division","SWE","Yes","3/12/2022","12/31/2026","$40K - $400K","Right Only","Weak","Very Strong","6'7""","200 lbs","91","-",108,155,3,4,4,3,6,5,4,2,2,3,7,3,2,6,5,12,13,9,12,12,13,3,7,3,12,9,7,10,8,11,14,18,8,8,9,14,13,15,15,15,14,18,3,12,3,2,12,13,12,13,13,13,8,13,7,13,6,12,14,17
"6871",93070929,"Jesper Karlsson","7/25/1998 (24 years old)","AM (RL), ST (C)","AZ","Eredivisie","SWE","Yes","12/13/2021","6/30/2026","$12M - $14M","Right","Reasonable","Very Strong","5'10""","160 lbs","220","71",143,152,13,15,15,13,16,14,6,16,5,4,13,14,4,16,8,13,13,13,13,12,13,18,6,13,4,10,14,10,15,17,11,7,12,14,13,6,9,11,12,13,13,11,8,10,4,5,10,13,11,1,1,3,2,3,3,2,1,3,2,2
"6872",2000019708,"Hugo Larsson","6/27/2004 (18 years old)","DM, M (C)","Malmö FF","Swedish Premier Division","SWE","Yes","6/13/2022","11/30/2025","$9M - $13.5M","Right","Reasonable","Very Strong","6'2""","174 lbs","47","3",123,150,11,10,12,8,13,11,8,11,7,10,13,10,11,13,12,13,12,12,13,11,15,13,11,13,11,14,13,15,13,13,12,12,16,14,16,11,12,14,14,16,14,15,6,5,8,2,13,15,12,3,2,2,3,2,2,1,3,1,4,3
"6873",61094102,"Jay Hogarth","7/18/2003 (19 years old)","GK","Rangers","-","SCO","No","7/8/2022","5/31/2025","$150K - $1.5M","Left","Very Strong","Weak","6'1""","180 lbs","54","-",74,137,1,1,1,1,5,4,1,1,3,3,9,2,1,1,6,10,9,6,14,9,14,1,9,1,6,8,7,7,9,8,8,13,15,7,2,5,8,11,12,11,14,12,5,8,7,2,11,13,15,9,9,14,10,12,9,10,5,8,9,10
"6874",68007650,"John Guidetti","4/15/1992 (31 years old)","ST (C)","AIK","Swedish Premier Division","SWE","Yes","7/17/2022","12/31/2025","$30K - $300K","Right","Reasonable","Very Strong","6'1""","174 lbs","229","57",101,150,7,10,12,13,12,12,13,14,9,7,12,16,9,13,16,13,15,12,12,13,11,10,13,10,11,12,11,12,9,6,14,14,12,10,8,14,8,8,8,10,16,10,18,14,13,14,13,8,18,1,4,1,3,3,2,2,3,2,3,3
"6875",93069729,"Jens Cajuste","8/10/1999 (23 years old)","DM, M (C)","Reims","Ligue 1 Uber Eats","SWE","Yes","1/10/2022","6/30/2027","$13M - $15.5M","Right","Fairly Strong","Very Strong","6'2""","169 lbs","111","7",134,150,10,7,12,8,12,11,12,11,8,13,13,8,13,13,16,13,12,14,13,13,14,13,10,13,12,15,12,17,13,12,15,13,12,13,14,15,11,16,14,14,9,13,13,14,5,6,12,14,15,1,1,1,2,1,2,2,1,3,1,3
"6876",93023425,"Victor Lindelöf","7/17/1994 (28 years old)","D (C)","Man UFC","English Premier Division","SWE","Yes","6/14/2021","6/30/2024","$36M - $43M","Right","Fairly Strong","Very Strong","6'2""","176 lbs","353","9",143,150,3,10,12,7,14,6,13,4,10,15,13,12,15,14,8,14,9,13,14,14,12,7,10,8,15,14,12,13,13,13,13,14,16,13,16,13,14,16,15,17,13,18,5,15,8,6,13,16,14,4,3,3,2,2,1,1,1,3,2,1
"6877",93011051,"Emil Forsberg","10/23/1991 (31 years old)","M (L), AM (RLC)","RB Leipzig","Bundesliga","SWE","Yes","5/12/2021","6/30/2025","$7.8M - $9.8M","Right","Fairly Strong","Very Strong","5'10""","167 lbs","385","91",142,150,16,13,13,12,15,14,8,15,7,8,15,17,8,15,11,13,12,15,13,13,13,14,12,15,9,15,15,12,13,13,15,7,14,13,13,10,12,12,7,15,13,15,10,13,6,12,12,17,14,2,3,1,3,2,1,1,4,2,3,2
"6878",93085044,"Emil Holm","5/13/2000 (23 years old)","D/WB/M (R)","Spezia","Italian Serie B","SWE","Yes","8/26/2021","6/30/2026","$375K - $7.8M","Right Only","Weak","Very Strong","6'3""","182 lbs","96","9",134,149,7,12,13,7,12,9,13,9,8,11,13,5,12,12,11,12,14,11,13,12,14,8,7,14,12,14,10,14,14,13,12,15,10,16,15,14,11,8,12,14,11,13,8,11,6,6,12,14,11,1,2,3,1,4,2,1,3,2,1,3
"6879",93087462,"Pontus Almqvist","7/10/1999 (23 years old)","AM (RL), ST (C)","Rostov","Russian Premier League","SWE","Yes","10/15/2020","5/31/2025","$4.4M - $6.6M","Left","Very Strong","Strong","6'2""","147 lbs","127","18",130,148,10,9,13,11,13,11,9,10,7,7,12,8,9,13,13,10,13,11,11,11,14,16,5,12,8,12,11,12,14,14,9,12,12,16,13,8,8,6,6,10,12,9,11,11,9,9,12,13,14,1,2,2,4,3,3,2,1,2,2,1
"6880",2000251820,"Jonah Kusi-Asare","7/4/2007 (15 years old)","ST (C)","AIK","Swedish Premier Division","SWE","Yes","1/1/2023","12/31/2025","$275K - $2.7M","Right","Strong","Very Strong","6'5""","176 lbs","5","1",95,147,4,6,8,11,11,7,12,8,4,3,6,10,7,10,10,10,13,9,9,9,14,9,2,12,6,9,7,9,11,8,13,17,13,13,12,13,7,12,12,12,12,9,5,9,10,5,10,14,12,3,3,3,2,3,3,3,2,2,3,2
"6881",93142470,"Yasin Ayari","10/6/2003 (19 years old)","M/AM (RLC)","Brighton","English Premier Division","SWE","Yes","1/30/2023","6/30/2027","$10.5M - $16M","Right","Reasonable","Very Strong","5'8""","154 lbs","40","4",125,147,8,12,13,9,14,9,8,13,7,9,13,8,14,14,12,13,13,14,13,12,14,12,7,13,11,14,12,14,13,13,11,7,11,12,13,10,13,12,12,12,12,14,5,14,7,7,13,13,14,3,3,1,3,3,1,3,2,2,2,3
"6882",93083839,"Isak Hien","1/13/1999 (24 years old)","D (C)","Hellas Verona","Italian Serie A","SWE","Yes","8/26/2022","6/30/2026","$5.4M - $6.8M","Right Only","Weak","Very Strong","6'3""","194 lbs","149","6",131,147,6,8,10,5,10,5,14,7,9,14,12,5,15,11,16,12,15,10,14,11,15,8,7,8,12,12,10,13,13,13,13,17,12,15,14,17,14,15,14,14,15,11,6,12,14,8,14,13,14,2,1,1,1,3,3,2,2,3,1,2
"6883",93065023,"Mattias Svanberg","1/5/1999 (24 years old)","DM, M/AM (C)","VfL Wolfsburg","Bundesliga","SWE","Yes","7/16/2022","6/30/2027","$10M - $12.5M","Right","Reasonable","Very Strong","6'1""","169 lbs","186","18",136,146,14,11,12,11,14,14,11,14,4,11,13,11,12,14,14,12,13,13,12,13,14,14,7,14,12,12,14,14,13,12,14,11,15,15,15,12,14,12,12,14,12,12,6,12,11,6,12,14,11,2,1,1,2,3,3,1,3,1,2,3
"6884",28107128,"George Johnston","9/1/1998 (24 years old)","D (C)","Bolton","Sky Bet League One","SCO","No","7/1/2021","6/30/2024","$55K - $550K","Left","Very Strong","Reasonable","6'1""","180 lbs","105","4",109,137,4,7,8,6,12,4,12,4,6,12,11,4,13,12,11,13,12,13,12,12,14,6,14,12,13,12,10,11,12,10,11,12,12,12,13,12,11,14,12,14,14,14,7,12,10,6,12,14,12,1,3,1,1,3,1,1,1,2,2,3
"6885",28121568,"Anthony Elanga","4/27/2002 (21 years old)","M/AM (RL), ST (C)","Man UFC","English Premier Division","SWE","Yes","6/13/2022","6/30/2027","$9.8M - $14.5M","Right","Reasonable","Very Strong","5'11""","156 lbs","39","3",130,145,5,8,14,13,12,4,7,11,2,1,10,10,6,13,12,9,8,10,9,8,13,16,3,12,8,13,6,14,18,14,11,10,15,18,14,13,14,14,15,15,12,15,6,14,4,2,12,12,15,3,3,1,2,2,2,2,2,3,1,1
"6886",37060310,"Hampus Finndell","6/6/2000 (23 years old)","DM, M/AM (C)","Djurgårdens IF","Swedish Premier Division","SWE","Yes","3/18/2021","12/31/2024","$275K - $2.7M","Right","Reasonable","Very Strong","5'10""","163 lbs","85","8",119,145,12,11,11,8,14,11,9,9,6,9,14,10,12,14,11,13,13,13,13,13,15,13,11,14,11,13,14,13,11,13,12,8,14,12,12,12,10,10,13,14,15,12,11,12,9,5,14,13,12,2,1,3,3,3,2,3,1,3,3,3
"6887",93070264,"Hjalmar Ekdal","10/21/1998 (24 years old)","D (C)","Burnley","English Premier Division","SWE","Yes","1/21/2023","6/30/2027","$5.2M - $7.8M","Right","Reasonable","Very Strong","6'2""","176 lbs","131","11",124,145,6,11,11,6,13,7,12,7,8,12,13,7,14,13,8,14,14,14,14,12,15,10,13,9,13,13,11,13,12,11,12,14,14,13,13,12,8,17,17,16,14,15,8,12,7,2,15,12,12,3,2,3,1,1,3,1,1,3,1,1
"6888",93068324,"Pontus Dahlberg","1/21/1999 (24 years old)","GK","IFK Göteborg","Swedish Premier Division","SWE","Yes","8/11/2022","12/31/2026","$130K - $1.3M","Right Only","Weak","Very Strong","6'4""","185 lbs","92","-",115,145,3,4,4,3,6,5,3,2,3,1,6,3,2,6,13,12,15,9,12,12,14,2,10,3,12,7,6,7,11,13,12,13,13,10,11,13,11,11,13,15,13,11,7,11,9,5,12,12,12,12,13,13,12,13,11,13,10,13,12,15
"6889",93122428,"Oliver Dovin","7/11/2002 (20 years old)","GK","Hammarby IF","Swedish Premier Division","SWE","Yes","2/1/2021","12/31/2024","$350K - $3.5M","Right Only","Weak","Very Strong","6'2""","189 lbs","58","-",114,145,4,5,5,3,8,5,1,2,2,2,10,2,3,7,9,12,14,12,11,12,14,3,6,1,11,12,10,11,12,14,12,11,12,11,10,12,13,14,14,14,14,14,8,14,6,6,13,13,19,11,11,14,5,13,12,12,7,11,11,12
"6890",93121623,"Sebastian Nanasi","5/16/2002 (21 years old)","WB (L), M (LC), AM (RLC)","Malmö FF","Swedish Premier Division","SWE","Yes","12/23/2021","12/31/2025","$170K - $1.7M","Right","Weak","Very Strong","5'10""","156 lbs","64","16",121,144,13,13,14,11,14,11,7,10,6,7,12,12,7,14,8,11,11,13,12,12,13,14,8,14,9,14,13,10,13,14,11,8,12,12,11,8,15,13,14,13,13,14,5,11,5,7,12,13,13,1,3,2,3,3,2,2,1,2,2,1
"6891",93122984,"Noah Eile","7/19/2002 (20 years old)","D (C)","Mjällby AIF","Swedish Premier Division","SWE","Yes","12/28/2021","12/31/2025","$300K - $2.9M","Right","Reasonable","Very Strong","6'5""","182 lbs","36","-",109,143,6,9,7,6,11,6,11,6,8,12,11,8,12,10,10,12,13,12,11,11,13,7,8,9,12,12,11,11,11,9,12,16,12,14,12,12,8,14,14,14,14,12,9,10,8,5,12,12,15,1,3,3,1,2,2,1,3,3,1,3
"6892",2000169758,"Liam Mahachai Källman","2/23/2006 (17 years old)","D/WB (RL)","Hammarby TFF","Swedish First Division North","SWE","Yes","6/13/2022","11/30/2025","$220K - $2.2M","Right","Weak","Very Strong","5'9""","149 lbs","11","1",84,143,6,8,10,5,11,7,4,6,3,7,10,7,7,11,8,9,11,8,9,9,14,12,6,11,9,10,9,11,14,12,8,8,12,13,13,7,7,12,12,14,14,15,5,13,6,5,12,14,11,1,2,1,1,3,1,2,2,3,1,1
"6893",8120012,"Albin Ekdal","7/28/1989 (33 years old)","DM, M (C)","Spezia","Italian Serie B","SWE","Yes","7/14/2022","6/30/2024","$60K - $600K","Right","Reasonable","Very Strong","6'1""","180 lbs","389","14",117,142,6,10,10,9,13,9,11,10,4,12,14,10,12,14,12,14,15,16,16,13,15,10,13,12,14,15,13,15,8,9,14,11,15,11,12,12,12,16,13,16,13,12,9,15,10,4,14,15,15,1,3,2,1,3,2,2,1,2,2,2
"6894",93120995,"Patrik Wålemark","10/14/2001 (21 years old)","M (R), AM (RLC)","Feyenoord","Eredivisie","SWE","Yes","1/17/2022","6/30/2026","$650K - $5.2M","Left","Very Strong","Reasonable","6'0""","165 lbs","124","35",124,142,12,12,14,14,13,13,7,14,7,8,13,10,7,13,11,13,10,13,12,13,14,13,7,12,11,11,13,10,14,14,10,12,12,14,12,7,12,15,13,14,13,13,5,13,7,2,12,13,17,2,1,2,2,2,1,2,3,3,1,2
"6895",61078171,"Andy Irving","5/13/2000 (23 years old)","M (C)","SK Austria Klagenfurt","Austrian Premier Division","SCO","No","7/1/2022","6/30/2025","$180K - $1.8M","Left","Very Strong","Weak","6'1""","174 lbs","137","10",123,137,15,13,11,10,13,13,14,14,6,10,14,9,9,14,8,11,12,14,10,13,12,12,5,11,9,12,14,13,10,12,12,13,11,12,13,13,6,13,13,11,7,10,11,14,9,6,12,11,20,1,3,4,1,1,2,1,3,2,3,3
"6896",93099931,"Rami Al Hajj","9/17/2001 (21 years old)","M/AM (C)","sc Heerenveen","Eredivisie","SWE","Yes","9/1/2018","6/30/2026","$110K - $1.1M","Right","Weak","Very Strong","5'11""","165 lbs","64","1",108,141,10,12,12,12,11,10,11,13,3,5,13,9,5,15,12,9,8,10,11,11,12,14,10,12,7,9,10,11,13,14,12,12,13,13,13,12,14,13,12,12,12,11,5,9,7,3,10,10,13,3,1,2,4,2,1,2,2,1,4,3
"6897",93024775,"Ludwig Augustinsson","4/21/1994 (29 years old)","D/WB (L)","Mallorca","Spanish First Division","SWE","Yes","8/15/2021","6/30/2025","$475K - $4.6M","Left","Very Strong","Reasonable","5'11""","163 lbs","261","8",128,141,13,15,10,9,12,12,10,12,10,11,13,10,13,13,10,14,10,15,13,13,15,8,8,12,13,15,12,14,12,13,12,10,15,13,14,12,6,16,14,18,13,13,11,13,6,3,12,16,12,2,2,3,2,2,1,2,2,2,1,2
"6898",2000020257,"Jusef Erabi","6/8/2003 (20 years old)","ST (C)","Hammarby IF","Swedish Premier Division","SWE","Yes","8/10/2022","12/31/2024","$1.6M - $3.3M","Right","Weak","Very Strong","6'0""","185 lbs","71","18",114,141,5,6,9,12,13,6,13,8,5,6,7,10,12,11,15,10,16,12,12,12,14,12,5,12,8,14,7,14,14,9,17,13,14,13,15,19,3,7,9,12,13,13,7,13,13,8,13,13,12,3,1,3,2,1,3,1,3,2,2,3
"6899",68007215,"Robin Olsen","1/8/1990 (33 years old)","GK","Aston Villa","English Premier Division","SWE","Yes","7/1/2022","6/30/2025","$6.2M - $7.8M","Right","Weak","Very Strong","6'6""","196 lbs","247","-",128,141,1,2,1,3,11,1,3,2,3,1,10,4,1,10,13,12,14,12,14,12,10,2,10,1,13,12,8,10,11,12,13,17,13,10,10,13,10,16,16,16,13,8,4,13,8,4,11,11,13,13,11,15,9,13,10,13,6,12,12,17
"6900",93141679,"Oscar Vilhelmsson","10/2/2003 (19 years old)","ST (C)","Darmstadt 98","Bundesliga","SWE","Yes","7/12/2022","6/30/2026","$400K - $4M","Left","Very Strong","Reasonable","6'2""","169 lbs","42","6",108,141,4,7,11,13,12,4,12,8,6,5,11,10,6,12,11,12,12,12,11,10,13,12,6,13,6,12,11,11,13,12,12,12,12,15,12,12,6,14,14,16,12,12,10,13,5,2,12,12,11,3,1,1,1,1,1,1,2,1,2,3
"6901",93122306,"Dennis Collander","5/9/2002 (21 years old)","D (R), M/AM (RC)","Hammarby IF","Swedish Premier Division","SWE","Yes","1/12/2022","6/30/2026","$250K - $2.5M","Right","Reasonable","Very Strong","5'10""","163 lbs","55","3",100,140,7,11,9,8,11,8,9,9,8,9,11,6,10,11,13,12,10,12,12,12,15,11,10,10,10,14,11,12,11,10,10,13,16,11,12,11,16,14,14,18,15,14,17,10,10,2,14,14,11,1,2,3,2,2,3,2,3,2,2,3
"6902",93083203,"Peter Gwargis","9/4/2000 (22 years old)","M (RL), AM (RLC)","Degerfors IF","Swedish Premier Division","SWE","Yes","7/1/2021","12/31/2024","$95K - $950K","Left Only","Very Strong","Weak","5'11""","152 lbs","54","6",98,140,12,11,13,10,13,10,8,13,7,6,12,10,7,13,10,9,9,11,10,9,12,13,6,10,8,8,11,8,13,13,10,8,12,12,12,10,11,9,9,10,10,10,11,10,10,6,10,12,10,1,2,2,3,4,2,1,3,1,1,3
"6903",93123174,"Jacob Ondrejka","9/2/2002 (20 years old)","M/AM (RL)","IF Elfsborg","Swedish Premier Division","SWE","Yes","1/3/2020","11/30/2025","$375K - $3.7M","Right","Reasonable","Very Strong","5'9""","154 lbs","125","15",117,140,12,11,14,11,13,13,7,11,7,7,11,9,6,14,11,11,12,12,12,12,14,14,6,11,8,11,11,11,14,13,8,7,12,14,12,8,10,14,14,13,13,14,5,12,5,2,13,13,20,1,3,2,4,2,1,2,1,4,3,3
"6904",93087487,"Leopold Wahlstedt","7/4/1999 (23 years old)","GK","Odd","Norwegian Premier Division","SWE","Yes","1/15/2021","12/31/2023","$110K - $1.1M","Right","Weak","Very Strong","6'3""","176 lbs","103","-",121,140,1,1,2,3,11,9,9,1,11,3,11,5,1,11,12,13,11,12,8,12,15,14,7,12,14,12,10,12,12,15,13,16,11,10,11,11,1,12,14,15,14,10,2,10,13,7,15,15,15,11,16,15,12,15,13,11,15,11,13,13
"6905",93135498,"Edvin Kurtuluş","3/5/2000 (23 years old)","D (RC)","Hammarby IF","Swedish Premier Division","SWE","Yes","2/17/2023","12/31/2025","$325K - $3.1M","Right","Reasonable","Very Strong","6'1""","174 lbs","88","3",122,140,6,11,8,8,12,7,13,8,8,14,12,7,14,11,15,13,15,12,13,13,15,7,10,11,13,12,11,12,12,10,13,11,12,13,13,14,11,7,7,14,14,8,5,14,15,5,13,14,14,2,3,3,1,2,3,1,1,2,1,1
"6906",29199549,"Jensen Weir","1/31/2002 (21 years old)","DM, M/AM (C)","Brighton","English Premier Division","SCO","No","7/1/2022","6/30/2024","$500K - $1.5M","Right","Weak","Very Strong","6'0""","163 lbs","59","11",105,137,9,7,11,12,12,12,7,12,6,9,12,10,12,12,6,13,11,13,11,9,13,8,8,13,12,14,11,13,12,9,13,12,12,12,13,10,8,8,10,14,11,12,11,9,7,5,10,13,12,4,2,3,3,3,4,1,2,2,1,1
"6907",2000106513,"Jonathan Macaulay","3/17/2005 (18 years old)","GK","Watford","Sky Bet Championship","SWE","Yes","2/1/2021","6/30/2025","$500K - $1.5M","Right","Reasonable","Very Strong","6'4""","176 lbs","1","-",70,140,2,3,1,2,4,4,1,3,1,2,7,3,1,1,5,5,12,6,7,13,11,1,8,2,8,7,6,6,11,9,7,15,13,12,4,6,10,16,12,10,11,8,12,3,7,7,12,13,20,8,5,9,5,7,6,13,5,10,6,13
"6908",8111329,"Marcus Berg","8/17/1986 (36 years old)","ST (C)","IFK Göteborg","Swedish Premier Division","SWE","Yes","7/15/2021","12/31/2023","$30K - $95K","Right","Reasonable","Very Strong","6'0""","167 lbs","436","214",109,140,7,9,10,14,13,10,14,11,7,7,12,15,7,13,11,14,12,14,13,14,11,8,13,11,12,12,12,12,10,8,12,13,12,11,10,13,4,10,12,16,14,13,10,16,14,8,13,9,14,3,3,3,2,1,4,3,4,4,1,4
"6909",93081501,"Samuel Brolin","9/29/2000 (22 years old)","GK","AC Horsens","NordicBet Liga","SWE","Yes","1/10/2019","12/31/2023","$1M - $2.2M","Right Only","Weak","Very Strong","6'8""","209 lbs","90","-",108,140,2,3,4,3,6,1,4,3,1,1,7,1,3,5,6,11,12,11,11,12,14,4,5,3,12,6,6,5,6,11,13,19,12,8,9,14,1,16,16,15,15,13,5,1,5,2,13,13,15,11,10,13,7,13,12,13,7,12,15,17
"6910",93014195,"Viktor Claesson","1/2/1992 (31 years old)","M/AM (LC)","FC København","3F Superliga","SWE","Yes","6/16/2022","6/30/2026","Not for Sale","Right","Reasonable","Very Strong","6'0""","176 lbs","359","107",130,140,10,12,12,14,13,9,15,10,5,8,13,10,10,13,16,15,14,15,15,15,15,13,14,15,11,16,15,16,10,11,12,11,16,12,15,10,15,18,15,16,14,14,7,15,10,1,13,13,15,1,4,3,3,3,2,2,3,2,2,3
"6911",2000015710,"Jacob Widell Zetterström","7/11/1998 (24 years old)","GK","Djurgårdens IF","Swedish Premier Division","SWE","Yes","12/30/2021","12/31/2025","$140K - $1.4M","Right","Weak","Very Strong","6'6""","187 lbs","88","-",113,140,3,4,4,3,8,7,6,3,1,2,8,2,2,7,7,12,12,11,10,10,16,5,11,1,11,7,9,12,10,12,8,18,15,12,9,15,12,15,16,17,12,15,8,11,5,2,12,12,8,15,13,15,14,13,12,11,7,13,11,16
"6912",2000088488,"Emmanuel Tannor","1/12/2005 (18 years old)","ST (C)","Parma","Italian Serie B","SWE","Yes","2/21/2021","6/30/2024","$100K - $1M","Left Only","Very Strong","Weak","6'0""","165 lbs","-","-",66,140,5,7,10,11,10,6,10,7,7,4,8,7,6,9,10,7,11,8,7,9,11,8,7,11,8,9,7,12,12,10,13,9,13,12,10,9,12,18,13,12,9,9,7,10,6,4,11,13,16,2,3,3,2,2,1,2,3,2,1,3
"6913",68015337,"Robin Quaison","10/9/1993 (29 years old)","M/AM (LC), ST (C)","Al-Ettifaq","Saudi Professional League","SWE","Yes","7/8/2021","6/30/2024","$22M - $26M","Right","Weak","Very Strong","6'0""","169 lbs","304","66",130,140,11,12,12,11,12,11,9,13,6,8,13,10,10,12,16,12,15,10,10,10,16,14,9,14,8,12,13,16,14,12,15,11,15,15,14,14,17,10,12,14,13,10,6,13,6,5,11,15,13,2,2,2,1,1,1,1,2,4,1,2
"6914",93123163,"Daniel Svensson","2/12/2002 (21 years old)","D/WB (L)","FC Nordsjælland","3F Superliga","SWE","Yes","7/1/2020","6/30/2025","$250K - $2.5M","Left Only","Very Strong","Weak","6'1""","165 lbs","78","3",115,139,11,12,13,8,13,10,8,9,12,13,13,8,13,13,9,14,11,14,13,11,12,7,8,13,14,13,12,13,13,13,9,11,14,13,13,9,6,12,14,14,9,10,6,9,7,3,12,12,10,3,2,2,2,1,3,2,1,3,2,3
"6915",2000169771,"Jimi Dos Reis Nikko","8/17/2006 (16 years old)","D (LC), WB (L)","Salento","Italian Serie A","SWE","Yes","1/21/2023","6/30/2026","$45K - $450K","Left Only","Very Strong","Weak","5'10""","147 lbs","-","-",66,139,10,9,8,3,9,9,10,8,5,8,9,10,10,8,8,9,10,7,8,8,14,5,11,9,9,9,7,10,12,10,8,10,10,13,9,8,13,10,10,10,10,10,14,18,6,5,10,12,17,4,2,1,1,2,2,1,2,2,1,2
"6916",93121745,"Oskar Fallenius","11/1/2001 (21 years old)","AM (RLC)","Djurgårdens IF","Swedish Premier Division","SWE","Yes","2/27/2023","12/31/2026","$1.3M - $2.7M","Right","Weak","Very Strong","5'11""","158 lbs","69","22",109,139,7,8,14,10,13,7,5,9,5,5,12,7,5,13,6,11,11,12,12,13,13,14,6,13,8,13,11,14,14,13,12,8,10,13,12,10,10,12,13,13,12,12,11,13,6,3,12,12,11,2,1,1,1,3,4,3,2,3,3,1
"6917",28127254,"Elliot Anderson","11/6/2002 (20 years old)","M (C), AM (RLC)","Newcastle","English Premier Division","SCO","No","9/21/2022","6/30/2027","$51M - $76M","Right","Strong","Very Strong","5'10""","167 lbs","44","7",127,164,10,11,13,12,13,12,9,12,3,8,13,11,10,13,14,12,14,13,12,12,11,13,8,12,12,14,12,15,12,12,13,8,11,13,13,12,11,15,12,7,12,12,10,10,11,2,11,10,20,3,3,2,2,2,3,1,3,3,3,2
"6918",2000026132,"Ben Summers","6/16/2004 (18 years old)","M/AM (C)","Celtic","Scottish Lowland League","SCO","No","6/13/2022","5/31/2025","$0 - $55K","Right","Fairly Strong","Very Strong","5'7""","125 lbs","43","12",70,137,5,2,8,10,12,6,1,10,1,4,7,6,5,7,12,7,8,10,6,11,7,8,7,8,7,6,13,10,13,13,7,5,12,13,6,5,10,19,11,15,11,11,4,5,13,2,8,10,7,2,1,1,1,4,3,1,2,1,2,2
"6919",93084711,"Gustaf Lagerbielke","4/10/2000 (23 years old)","D (C)","IF Elfsborg","Swedish Premier Division","SWE","Yes","8/10/2021","12/31/2025","$350K - $3.6M","Right","Reasonable","Very Strong","6'3""","176 lbs","106","11",121,139,6,9,8,8,11,7,14,8,7,13,12,12,14,11,13,13,15,13,13,13,14,7,12,8,13,12,12,11,11,10,11,15,12,12,13,13,8,14,14,14,14,12,4,9,9,5,14,14,12,2,1,3,3,3,3,2,2,2,3,3
"6920",950975,"Radamel Falcao","2/10/1986 (37 years old)","ST (C)","Vallecano","Spanish First Division","COL","No","6/6/2023","6/30/2024","$45K - $450K","Right","Fairly Strong","Very Strong","5'10""","158 lbs","442","225",131,176,10,10,12,17,14,14,17,12,3,4,13,18,6,15,12,15,16,18,16,15,16,16,17,15,7,13,15,9,9,10,10,13,14,9,9,10,6,17,16,17,19,15,15,17,8,8,14,16,14,2,2,2,2,3,2,2,2,3,1,1
"6921",76049803,"Luis Díaz","1/13/1997 (26 years old)","AM (RL)","Liverpool","English Premier Division","COL","No","1/30/2022","6/30/2027","$240M - $264M","Right","Fairly Strong","Very Strong","5'11""","154 lbs","208","52",164,172,10,12,17,15,18,10,13,13,4,8,14,6,7,18,13,13,13,14,13,13,15,19,4,15,9,13,14,14,17,17,14,10,15,16,13,10,10,13,10,12,16,13,7,17,11,8,15,15,15,2,1,1,1,2,4,1,3,2,3,3
"6922",2000053239,"Yaser Asprilla","11/19/2003 (19 years old)","AM (RLC), ST (C)","Watford","Sky Bet Championship","COL","No","1/1/2022","6/30/2025","$10M - $12.5M","Left","Very Strong","Strong","6'1""","165 lbs","77","7",125,169,11,12,14,11,12,11,8,11,4,5,14,6,6,13,13,11,12,12,11,12,10,13,6,13,5,11,12,13,13,12,10,12,13,13,13,10,11,19,14,12,13,13,12,19,6,6,11,10,14,1,1,3,3,2,1,2,1,3,1,2
"6923",2000069652,"Óscar Cortés","12/3/2003 (19 years old)","AM (RLC)","Millonarios F.C.","Colombian First Division","COL","No","7/1/2019","12/31/2024","$550K - $9.6M","Right","Reasonable","Very Strong","5'9""","163 lbs","35","5",108,166,9,11,12,9,11,9,8,11,9,8,12,13,9,12,11,10,12,9,10,10,9,13,12,12,10,10,11,12,12,12,9,9,12,12,12,9,11,12,12,13,12,12,7,19,13,6,11,12,16,2,1,1,3,3,3,1,1,1,1,1
"6924",76010707,"Juan Cuadrado","5/26/1988 (35 years old)","D/WB/M/AM (R)","Juventus","Italian Serie A","COL","Yes","6/14/2021","6/30/2024","$170K - $1.7M","Right","Reasonable","Very Strong","5'10""","158 lbs","396","44",142,163,13,15,15,10,15,10,6,12,12,12,15,8,14,16,16,12,13,12,13,11,19,16,12,15,13,14,14,15,14,14,12,7,15,14,12,8,15,14,8,19,16,13,10,12,15,6,15,14,15,1,2,3,3,3,1,1,1,3,2,4
"6925",76003938,"Carlos Bacca","9/8/1986 (36 years old)","ST (C)","Junior","Colombian First Division","COL","No","7/13/2022","6/30/2024","$40K - $400K","Right","Fairly Strong","Very Strong","5'11""","169 lbs","521","224",124,160,6,12,13,13,14,6,13,12,8,5,16,15,6,14,9,14,12,15,14,14,15,15,16,15,9,15,14,10,10,12,12,9,12,11,10,12,7,11,15,14,13,15,10,14,9,11,12,14,14,3,2,3,2,2,1,1,3,3,1,1
"6926",76015142,"Luis Muriel","4/16/1991 (32 years old)","ST (C)","Atalanta","Italian Serie A","COL","No","7/25/2022","6/30/2024","$300K - $7.2M","Right","Fairly Strong","Very Strong","5'10""","174 lbs","363","118",138,155,6,11,17,15,18,15,9,16,4,4,13,17,4,17,11,15,10,13,10,12,15,18,7,14,2,10,14,10,14,13,14,10,12,15,10,14,12,12,13,16,12,12,10,11,9,5,12,16,12,1,2,3,1,4,2,1,2,1,3,1
"6927",76046285,"Luis Suárez","12/2/1997 (25 years old)","ST (C)","Almería","Spanish First Division","COL","Yes","7/19/2022","6/30/2026","$8.6M - $10.5M","Right","Fairly Strong","Very Strong","6'1""","163 lbs","243","62",134,155,7,10,13,13,12,8,13,10,5,4,11,14,6,13,14,13,16,10,11,11,16,15,12,16,6,10,11,18,15,13,12,12,16,16,13,13,9,10,11,13,13,9,5,16,11,8,13,14,15,2,3,1,1,3,1,3,3,1,3,3
"6928",8835677,"David Ospina","8/31/1988 (34 years old)","GK","Al-Nassr (KSA)","Saudi Professional League","COL","Yes","7/11/2022","6/30/2024","$2.1M","Right Only","Weak","Very Strong","6'0""","174 lbs","411","-",135,155,6,3,2,1,10,7,8,2,1,3,11,1,1,10,10,14,14,13,12,14,16,5,15,1,13,10,8,10,10,15,13,12,17,8,10,12,1,15,15,15,15,12,8,15,8,6,16,16,14,13,11,16,11,14,14,14,11,13,14,11
"6929",61083649,"Nathan Patterson","10/16/2001 (21 years old)","D/WB (R)","Everton","English Premier Division","SCO","No","1/4/2022","6/30/2027","$102M - $122M","Right","Reasonable","Very Strong","6'0""","163 lbs","32","-",134,162,12,14,12,11,12,6,8,11,10,10,12,5,13,11,12,11,12,13,14,7,15,7,4,13,12,13,14,15,15,13,12,11,14,15,17,12,11,16,16,15,14,17,6,14,13,6,11,12,12,3,1,2,2,2,1,1,1,1,3,2
"6930",76014012,"Duván Zapata","4/1/1991 (32 years old)","ST (C)","Atalanta","Italian Serie A","COL","No","6/14/2021","6/30/2024","$650K - $6.6M","Right","Reasonable","Very Strong","6'2""","194 lbs","374","134",141,155,5,9,12,15,13,4,16,11,4,4,13,14,7,13,13,16,14,15,12,14,15,12,7,14,5,17,12,12,12,10,16,15,12,15,13,19,5,13,18,19,12,13,12,14,11,5,13,15,14,2,1,2,3,3,1,1,1,3,1,3
"6931",8825553,"Cristián Zapata","9/30/1986 (36 years old)","D (C)","Atlético Nacional","Colombian First Division","COL","No","1/2/2023","12/31/2023","$45K - $140K","Right","Reasonable","Very Strong","6'2""","185 lbs","432","11",126,154,4,9,10,7,11,3,15,3,7,14,12,8,14,12,14,14,13,14,9,14,15,4,15,8,14,14,9,13,9,11,15,15,13,11,13,15,8,15,16,18,11,13,13,14,13,4,13,14,18,2,3,4,3,2,3,3,1,2,3,3
"6932",76037151,"Yerry Mina","9/23/1994 (28 years old)","D (C)","Everton","English Premier Division","COL","No","6/14/2021","6/30/2026","$27M - $34M","Right","Reasonable","Very Strong","6'4""","174 lbs","200","21",138,154,5,5,12,7,12,6,16,8,9,14,12,9,15,11,13,13,13,14,13,14,15,9,17,10,14,13,9,14,10,12,8,17,11,12,12,16,5,11,12,13,14,12,15,12,13,9,12,14,15,3,1,2,2,3,3,1,1,2,2,2
"6933",76047347,"Luis Sinisterra","6/17/1999 (23 years old)","M/AM (RL)","Leeds","Sky Bet Championship","COL","No","7/7/2022","6/30/2027","$27M - $34M","Right","Reasonable","Very Strong","5'8""","145 lbs","138","30",141,152,11,13,16,13,14,13,11,13,2,5,11,6,4,14,10,13,11,12,10,12,14,17,5,13,5,12,10,13,16,16,14,10,17,16,12,9,13,10,10,8,12,14,7,12,5,13,13,14,16,3,1,1,1,1,2,2,2,3,2,3
"6934",76023027,"Davinson Sánchez","6/12/1996 (26 years old)","D (C)","Tottenham","English Premier Division","COL","No","6/15/2020","6/30/2024","$9.6M - $12M","Right","Reasonable","Very Strong","6'2""","182 lbs","201","9",136,150,7,7,11,10,13,10,13,9,8,13,13,7,15,14,15,12,15,10,11,11,14,10,9,10,13,14,10,14,15,14,13,14,15,15,15,16,10,12,12,14,10,8,8,13,11,12,13,16,16,1,1,2,1,3,1,2,3,3,1,3
"6935",76065313,"Alexis Castillo","1/30/2003 (20 years old)","AM (RLC)","Cortuluá","Colombian Second Division","COL","No","6/13/2022","12/31/2023","$1.1M - $2.4M","Right","Reasonable","Very Strong","5'6""","149 lbs","83","9",105,149,12,12,12,11,12,10,8,11,10,4,12,6,6,12,8,11,10,10,11,11,12,12,8,12,6,11,11,11,13,12,11,6,12,13,12,12,12,17,10,11,12,9,8,11,8,6,13,11,7,2,1,1,1,3,1,1,2,1,3,3
"6936",2000136010,"Juan José Pérez","7/25/2004 (18 years old)","AM (RLC)","Emelec","Ecuadorian Serie A","COL","No","7/22/2021","12/31/2024","$130K - $1.3M","Left","Very Strong","Reasonable","5'7""","138 lbs","31","2",103,148,10,11,14,6,11,11,6,9,4,3,10,9,4,12,7,10,9,9,8,12,15,16,6,12,7,8,10,9,13,15,5,4,14,13,15,4,14,20,12,13,13,11,13,6,7,4,14,12,12,2,1,3,3,1,4,2,2,1,3,1
"6937",76038475,"Jefferson Lerma","10/25/1994 (28 years old)","DM, M (C)","Bournemouth","English Premier Division","COL","No","6/14/2021","6/30/2027","$28M - $35M","Right","Weak","Very Strong","5'10""","154 lbs","349","21",137,148,9,10,11,8,12,9,13,13,8,13,13,9,16,12,15,15,16,12,14,13,15,9,9,12,13,13,11,16,13,14,15,14,17,12,15,14,14,7,7,15,12,13,6,14,13,10,11,14,14,1,1,2,3,1,1,3,2,3,1,3
"6938",76043783,"Cucho Hernández","4/20/1999 (24 years old)","AM (RLC), ST (C)","Columbus","Major League Soccer","COL","No","6/21/2022","12/31/2025","$8.8M - $11M","Right","Fairly Strong","Very Strong","5'9""","163 lbs","250","76",135,148,7,10,11,15,13,10,13,13,6,4,12,15,5,13,9,13,13,12,14,11,15,14,9,12,5,14,12,15,14,14,15,11,14,14,15,14,10,11,12,12,12,11,6,11,8,6,12,11,14,3,1,2,2,1,3,3,3,2,1,2
"6939",76058683,"Juan David Mosquera","9/5/2002 (20 years old)","D/WB (R)","Portland","Major League Soccer","COL","No","7/27/2022","12/31/2026","$5.2M - $6.6M","Right","Reasonable","Very Strong","5'11""","158 lbs","63","3",120,148,9,12,11,7,11,5,7,9,13,11,12,5,13,12,10,11,11,12,10,10,11,12,14,10,12,12,13,13,14,13,12,12,13,15,13,12,13,14,11,10,12,11,11,8,7,5,12,12,12,1,2,3,3,3,2,3,2,3,2,2
"6940",61078265,"Billy Gilmour","6/11/2001 (22 years old)","DM, M (C)","Brighton","English Premier Division","SCO","No","9/1/2022","6/30/2026","$100M - $120M","Right","Fairly Strong","Very Strong","5'7""","143 lbs","49","-",138,161,13,9,12,9,15,13,6,10,7,6,16,15,11,16,11,15,12,16,14,13,15,8,12,13,14,14,16,13,14,13,13,6,9,13,14,7,4,15,10,16,12,10,12,16,3,2,11,15,16,3,2,3,1,3,1,2,2,1,2,4
"6941",76003032,"Dorlan Pabón","1/24/1988 (35 years old)","AM (RLC), ST (C)","Atlético Nacional","Colombian First Division","COL","No","7/5/2021","6/30/2024","$50K - $475K","Right","Fairly Strong","Very Strong","5'7""","152 lbs","548","165",125,147,13,13,13,13,13,14,10,14,7,6,13,14,6,13,7,13,12,12,13,13,14,13,14,12,9,12,12,11,13,13,12,7,13,12,12,8,12,12,13,10,13,6,5,14,6,10,12,15,13,1,1,1,1,2,2,2,1,3,2,2
"6942",76015366,"Juan Fernando Quintero","1/18/1993 (30 years old)","M/AM (RC)","Junior","Colombian First Division","COL","No","1/13/2023","7/7/2023","$28K - $275K","Left","Very Strong","Reasonable","5'7""","149 lbs","250","44",129,147,15,16,14,12,16,18,6,15,6,5,16,15,5,17,8,13,8,13,12,13,15,18,9,14,7,14,18,7,13,14,12,5,8,9,10,9,8,11,12,8,14,12,14,14,10,10,11,15,11,2,1,3,2,2,2,2,1,3,3,1
"6943",2000151103,"Carlos Garcés","10/11/2001 (21 years old)","D (C)","PTM","Portuguese Premier League","COL","No","7/10/2022","6/30/2025","$110K - $1.1M","Right","Weak","Very Strong","6'1""","165 lbs","28","1",113,147,4,5,7,6,11,5,13,6,4,12,11,10,13,11,11,12,13,12,12,12,13,5,8,6,13,12,7,12,13,12,13,13,13,14,13,14,16,17,10,12,13,11,11,11,9,3,13,11,15,3,2,1,3,2,2,4,3,4,1,1
"6944",2000241275,"Kevin Álvarez","1/7/2005 (18 years old)","AM (C)","Cúcuta Deportivo","Colombian Second Division","COL","No","1/8/2023","12/31/2023","$45K - $475K","Left","Very Strong","Weak","5'7""","141 lbs","18","1",88,147,7,7,13,14,13,14,5,9,3,7,14,4,6,13,11,4,6,9,8,14,16,10,10,6,9,8,12,9,14,12,8,3,12,12,7,5,11,10,12,13,13,11,9,11,12,5,18,10,14,2,1,2,3,3,1,1,1,1,3,2
"6945",2000231497,"Jhoan Hernández","2/20/2006 (17 years old)","D/WB (L)","Millonarios F.C.","Colombian First Division","COL","No","3/22/2022","12/31/2024","$800K - $1.7M","Left","Very Strong","Weak","6'2""","174 lbs","7","1",88,146,5,12,7,4,11,3,7,7,2,7,9,1,12,7,10,9,8,5,7,11,16,5,1,6,7,8,7,8,15,13,12,16,13,15,13,13,14,12,12,12,10,10,12,14,7,6,17,10,11,3,3,2,1,3,2,3,2,1,3,2
"6946",2000069654,"Beckham Castro","9/12/2003 (19 years old)","AM (RL)","Millonarios F.C.","Colombian First Division","COL","No","7/1/2022","6/30/2024","$240K - $2.4M","Left","Very Strong","Reasonable","5'9""","158 lbs","19","1",103,146,10,12,12,11,12,10,8,12,10,6,11,7,5,12,10,11,10,10,10,11,11,11,9,11,7,11,11,10,12,12,12,8,12,12,12,11,16,16,12,9,8,10,9,12,8,2,10,10,19,2,2,2,1,2,4,3,3,1,1,2
"6947",2000171507,"Andrés Tovar","3/25/2006 (17 years old)","GK","Envigado F.C.","Colombian First Division","COL","No","6/13/2022","12/31/2024","$85K - $850K","Left","Very Strong","Weak","6'0""","165 lbs","4","-",90,146,5,3,3,1,7,7,1,2,3,3,9,3,3,6,5,11,15,6,7,14,6,3,5,1,7,9,8,8,12,9,9,11,6,9,6,7,9,18,12,10,10,13,9,14,7,1,12,13,16,7,7,14,12,8,9,14,14,11,10,11
"6948",2000148761,"Carlos Gómez","9/12/2002 (20 years old)","AM (RL)","Real Salt Lake","Major League Soccer","COL","No","1/10/2023","12/31/2027","$6.2M - $11M","Right","Reasonable","Very Strong","5'9""","163 lbs","51","10",117,146,10,11,14,12,12,11,8,12,11,4,12,8,6,13,8,12,9,10,13,11,10,13,11,12,7,11,11,13,13,13,12,8,13,15,12,10,10,13,13,13,13,12,7,10,8,7,14,12,10,3,1,2,3,1,2,1,3,3,3,2
"6949",76033272,"Wílmar Barrios","10/16/1993 (29 years old)","DM, M (C)","Zenit","Russian Premier League","COL","No","10/19/2021","6/30/2026","$9M - $13.5M","Right","Reasonable","Very Strong","5'10""","163 lbs","267","7",144,146,10,10,11,6,12,6,9,11,6,18,13,6,15,11,15,17,18,15,18,13,14,9,11,8,16,18,8,18,14,14,14,9,16,13,17,10,12,10,12,11,14,12,8,10,13,14,19,12,10,2,3,3,1,1,2,1,2,2,2,2
"6950",8829000,"Adrián Ramos","1/22/1986 (37 years old)","AM (L), ST (C)","América de Cali","Colombian First Division","COL","No","12/30/2022","12/31/2023","$16K - $150K","Right","Strong","Very Strong","6'1""","165 lbs","555","177",125,146,6,12,12,13,14,7,13,11,7,5,14,14,7,14,8,13,11,13,11,13,16,13,17,14,8,14,13,13,10,11,13,13,12,11,11,13,10,18,16,20,17,16,13,15,6,7,13,17,18,1,3,2,3,1,2,3,4,4,3,1
"6951",2000106725,"Rory Wilson","1/5/2006 (17 years old)","ST (C)","Aston Villa","English Premier Division","SCO","No","7/1/2022","6/30/2026","$22M - $26M","Right Only","Weak","Very Strong","6'2""","171 lbs","1","-",89,157,9,10,7,15,14,9,9,10,5,8,7,7,7,9,7,12,1,13,8,8,7,8,10,9,8,9,8,12,13,12,10,14,5,13,10,9,11,17,10,11,9,11,5,6,8,6,8,12,16,4,2,3,3,4,2,1,2,2,2,2
"6952",76037139,"Harold Preciado","6/1/1994 (29 years old)","AM (RL), ST (C)","Santos Laguna","Mexican First Division","COL","No","2/5/2022","12/31/2024","$250K - $2.6M","Right","Fairly Strong","Very Strong","6'0""","154 lbs","291","150",129,146,5,11,12,15,12,6,13,11,7,6,12,13,6,15,14,13,12,13,14,13,14,12,9,12,13,12,13,12,12,12,11,13,16,12,14,13,5,11,12,12,12,15,3,11,9,11,13,12,19,1,3,1,3,2,2,2,1,2,3,3
"6953",76043626,"Duván Vergara","9/9/1996 (26 years old)","AM (RL)","Santos Laguna","Mexican First Division","COL","No","6/25/2021","6/30/2024","$160K - $7.2M","Right","Reasonable","Very Strong","5'8""","160 lbs","195","33",130,145,8,13,15,13,14,10,8,13,9,7,13,10,10,14,8,12,11,11,12,13,13,15,11,13,11,13,13,13,13,14,13,6,12,14,12,11,12,11,8,14,15,12,13,15,8,8,14,12,10,3,3,3,1,3,2,3,1,1,3,2
"6954",51056626,"Julián Quiñones","3/24/1997 (26 years old)","AM (R), ST (C)","Atlas","Mexican First Division","COL","No","7/1/2022","6/30/2027","$0","Right","Fairly Strong","Very Strong","5'9""","163 lbs","179","60",135,145,12,11,11,16,11,11,15,13,11,6,10,12,7,12,13,13,12,13,11,13,11,9,8,13,12,13,13,13,14,15,13,10,13,15,14,14,10,8,8,7,10,8,13,12,12,10,13,13,13,1,2,1,3,2,1,2,3,2,2,3
"6955",76036999,"Víctor Cantillo","10/15/1993 (29 years old)","DM, M (C)","COR","Brazilian National First Division","COL","No","7/1/2021","12/31/2023","$140K - $1.4M","Right","Weak","Very Strong","5'11""","154 lbs","292","7",125,145,11,10,12,10,14,11,11,13,6,11,16,7,12,14,8,12,12,12,10,15,14,11,13,11,13,15,16,12,11,9,11,10,11,12,13,9,12,11,10,13,11,12,9,13,9,6,11,13,11,2,3,4,1,1,2,2,3,1,3,2
"6956",76023875,"Juan David Pérez","3/23/1991 (32 years old)","AM (RL), ST (C)","Sport Huancayo","Peruvian First Division","COL","No","1/7/2023","1/31/2024","$14K - $130K","Right","Fairly Strong","Very Strong","5'7""","158 lbs","329","74",121,145,12,12,13,13,13,11,12,12,4,5,12,13,4,13,6,12,12,12,13,12,12,12,15,13,8,13,12,12,13,13,12,7,13,12,12,12,11,10,11,12,11,13,12,14,12,11,11,10,12,3,4,3,1,3,1,2,2,1,3,1
"6957",76062664,"Kener Valencia","10/4/2001 (21 years old)","AM (RL), ST (C)","Deportivo Pereira","Colombian First Division","COL","No","1/2/2023","12/31/2024","$160K - $1.6M","Right","Reasonable","Very Strong","6'0""","171 lbs","96","16",115,145,10,12,13,11,12,11,8,10,4,4,12,10,6,13,7,12,12,11,12,12,12,12,3,13,8,12,12,11,13,12,12,11,12,13,12,10,10,12,8,12,12,9,6,6,7,4,11,10,12,2,1,2,4,2,2,1,1,2,1,1
"6958",76016518,"Jeison Murillo","5/27/1992 (31 years old)","D (C)","Sampdoria","Italian Serie B","COL","Yes","6/14/2021","6/30/2025","$250K - $2.5M","Right","Reasonable","Very Strong","6'0""","171 lbs","309","14",121,145,4,4,6,4,10,4,12,4,4,12,12,5,15,10,13,12,15,12,10,12,16,6,13,9,15,12,12,13,12,13,13,13,13,12,14,15,9,15,16,13,11,11,13,10,12,3,10,13,14,2,4,1,2,2,1,2,3,1,3,2
"6959",76001455,"Ayron del Valle","1/27/1989 (34 years old)","AM (L), ST (C)","Selangor","Malaysian Super League","COL","No","1/28/2023","12/31/2023","$2.5K - $22K","Right","Fairly Strong","Very Strong","5'9""","165 lbs","498","147",126,145,8,11,13,15,12,9,13,9,11,3,12,14,3,12,5,12,12,12,13,13,14,15,13,13,13,12,12,12,12,12,13,10,12,12,13,13,13,11,11,12,11,12,8,14,10,10,15,11,11,3,3,3,1,1,1,2,3,3,1,1
"6960",76044979,"Nicolás Benedetti","4/24/1997 (26 years old)","AM (C)","Mazatlán","Mexican First Division","COL","No","12/23/2022","12/31/2025","$150K - $1.5M","Right","Reasonable","Very Strong","5'10""","154 lbs","205","26",125,145,12,12,13,12,13,10,8,11,11,7,13,11,8,15,9,12,9,13,13,13,12,15,11,12,10,11,15,12,14,15,13,9,8,12,10,10,12,10,11,8,12,13,15,10,6,8,11,12,18,1,3,3,2,2,2,3,4,1,1,1
"6961",76037891,"Eddie Segura","2/2/1997 (26 years old)","D (C)","LAFC","Major League Soccer","COL","No","7/29/2019","12/31/2024","$275K - $2.8M","Right","Reasonable","Very Strong","5'9""","156 lbs","217","6",119,145,5,6,7,7,11,6,13,8,8,13,12,7,13,10,4,12,14,13,14,12,13,6,13,8,13,12,8,12,12,12,12,13,10,13,14,10,11,12,11,13,12,11,15,10,7,8,12,11,17,2,2,1,3,3,1,2,2,3,1,2
"6962",2000026129,"MacKenzie Carse","2/29/2004 (19 years old)","DM, M (C)","Celtic","Scottish Lowland League","SCO","No","3/28/2023","5/31/2025","$9.2M - $11M","Right","Reasonable","Very Strong","5'9""","147 lbs","61","5",94,156,8,8,4,7,9,8,8,12,6,12,10,7,14,14,7,8,9,10,8,11,6,5,4,8,13,9,13,13,14,10,9,8,17,13,10,6,12,19,11,10,11,10,4,17,8,6,7,12,13,1,3,2,2,3,3,2,3,1,1,4
"6963",2000147877,"Edier Ocampo","10/3/2003 (19 years old)","D/WB (R)","Atlético Nacional","Colombian First Division","COL","No","8/1/2021","12/31/2024","$1.1M - $2.4M","Right","Weak","Very Strong","5'7""","143 lbs","39","-",105,145,8,11,11,10,11,6,10,10,14,10,11,7,10,11,12,11,12,10,10,11,11,8,6,8,10,11,10,13,12,12,13,8,13,13,13,12,13,10,11,12,12,13,5,16,10,7,11,12,12,1,4,1,2,3,2,3,1,2,1,2
"6964",76068782,"Sebastián Girado","8/11/2004 (18 years old)","AM (RL)","Real Cartagena","Colombian Second Division","COL","No","6/13/2022","6/30/2024","$35K - $325K","Right","Reasonable","Very Strong","5'5""","143 lbs","79","12",98,145,12,10,12,10,10,11,6,11,10,3,9,12,3,12,6,14,6,12,9,9,10,13,7,11,9,11,10,12,14,11,9,5,12,13,11,9,10,10,10,9,10,11,15,5,13,1,11,10,10,1,1,1,4,3,3,3,2,1,1,3
"6965",2000018045,"Miguel Monsalve","2/27/2004 (19 years old)","AM (LC)","Independiente Medellín","Colombian First Division","COL","No","12/22/2022","12/31/2026","$1.1M - $2.3M","Right","Fairly Strong","Very Strong","5'10""","160 lbs","22","1",110,144,11,12,12,12,13,12,7,11,6,5,13,11,4,12,9,12,8,12,11,12,12,13,8,12,8,12,13,9,12,13,12,8,11,12,9,11,12,16,12,11,11,12,8,12,7,1,13,11,17,2,1,3,3,2,4,3,2,4,4,2
"6966",76015950,"Santiago Arias","1/13/1992 (31 years old)","D/WB (R)","Cincinnati","Major League Soccer","COL","No","2/9/2023","12/31/2023","$500K - $5.2M","Right","Reasonable","Very Strong","5'10""","158 lbs","273","13",136,144,9,13,11,6,12,11,9,11,13,12,14,8,13,12,15,13,13,13,12,12,17,13,10,13,14,15,13,15,14,14,13,9,16,15,15,12,13,12,15,15,14,14,6,13,14,6,11,14,14,2,2,2,1,3,1,2,2,3,3,3
"6967",2000252192,"Santiago Paniagua","3/21/2005 (18 years old)","M (C)","Atlético Nacional","Colombian First Division","COL","No","3/29/2022","12/31/2023","$180K - $1.8M","Right","Reasonable","Very Strong","5'11""","154 lbs","6","1",78,144,6,6,5,7,13,6,6,5,4,8,13,4,12,10,7,6,8,8,7,12,6,9,11,12,7,7,10,12,12,7,2,9,9,9,13,4,12,14,10,9,10,9,11,9,5,3,9,11,20,2,4,3,2,2,3,3,2,3,3,1
"6968",8835347,"Darwin Quintero","9/19/1987 (35 years old)","AM (RLC), ST (C)","América de Cali","Colombian First Division","COL","No","1/2/2023","12/31/2024","$7K - $70K","Right","Fairly Strong","Very Strong","5'5""","134 lbs","588","174",115,143,11,12,14,13,11,10,9,12,6,5,13,14,5,13,13,12,11,12,11,13,14,13,8,13,7,12,13,11,12,14,10,5,12,12,10,7,11,13,12,15,13,12,6,11,8,10,12,13,11,2,3,2,2,2,1,1,1,2,1,1
"6969",78011012,"Carlos Sánchez","2/6/1986 (37 years old)","D (C), DM, M (C)","San Lorenzo","Argentine Premier Division","COL","Yes","11/30/2022","12/31/2023","$35K - $350K","Left","Very Strong","Weak","6'0""","180 lbs","469","17",121,143,7,9,8,8,13,9,13,9,8,14,12,10,14,11,15,14,13,14,10,13,12,8,14,9,14,13,9,14,10,12,15,10,13,8,13,15,11,12,14,14,13,10,12,13,12,10,12,14,12,1,2,1,3,1,1,2,4,1,2,2
"6970",76014908,"Yimmi Chará","4/2/1991 (32 years old)","AM (RL), ST (C)","Portland","Major League Soccer","COL","No","1/2/2020","12/31/2023","$300K - $3.1M","Right","Fairly Strong","Very Strong","5'5""","149 lbs","393","74",130,142,6,11,15,12,11,5,8,13,8,7,12,11,8,14,8,12,12,11,11,9,12,15,10,13,8,12,15,12,14,15,13,9,12,14,11,12,15,18,13,12,12,13,7,11,7,11,10,12,12,2,2,2,2,1,1,1,2,4,2,4
"6971",76016507,"Stefan Medina","6/14/1992 (30 years old)","D (RC), DM","Monterrey","Mexican First Division","COL","No","7/20/2021","12/31/2025","$425K - $4.3M","Right","Reasonable","Very Strong","5'10""","156 lbs","384","15",137,142,6,10,7,9,13,8,14,9,10,15,13,10,15,13,9,14,13,16,15,14,13,8,12,12,14,13,13,14,13,12,14,11,14,13,13,9,15,12,11,12,11,13,10,13,8,7,14,14,12,4,3,1,3,1,4,3,2,4,4,1
"6972",76040711,"Kevin Balanta","4/28/1997 (26 years old)","DM, M (C)","Tijuana","Mexican First Division","COL","No","7/1/2022","6/30/2025","$2.5K - $24K","Right","Reasonable","Very Strong","5'10""","160 lbs","173","4",116,142,13,10,11,10,8,8,10,10,10,13,11,8,14,10,12,13,13,12,13,12,11,11,12,11,13,11,10,12,14,12,12,11,10,13,13,14,12,10,11,9,10,13,6,16,9,8,13,9,10,3,1,1,2,1,1,2,3,2,1,2
"6973",43017197,"Pierre-Emerick Aubameyang","6/18/1989 (33 years old)","AM (RL), ST (C)","Chelsea","English Premier Division","GAB","Yes","9/1/2022","6/30/2025","$0","Right","Reasonable","Very Strong","6'1""","176 lbs","459","227",138,170,5,10,14,15,14,11,12,14,2,5,12,15,6,14,10,15,12,14,12,11,10,17,13,17,8,12,13,8,14,14,15,14,13,14,12,10,14,16,14,9,9,11,8,13,8,14,10,14,15,1,3,3,4,2,3,3,2,1,2,1
"6974",67138360,"Lévy Madinda","6/11/1992 (31 years old)","M/AM (C)","N. Sembilan","Malaysian Super League","GAB","Yes","7/7/2022","5/31/2024","$14K - $150K","Right","Weak","Very Strong","6'0""","169 lbs","199","13",95,130,12,10,12,9,12,12,10,10,5,7,13,12,8,12,14,12,10,12,12,10,12,12,7,10,11,12,12,10,11,12,12,11,14,11,11,11,8,13,12,10,10,9,7,8,9,12,13,11,12,3,2,3,2,3,2,1,1,2,3,2
"6975",43090349,"Krisztián Tamás","4/18/1995 (28 years old)","D/WB (L)","Honvéd","Hungarian Division II","HUN","Yes","1/1/2021","6/30/2024","$350K - $1M","Left Only","Very Strong","Weak","6'0""","163 lbs","152","7",107,125,7,13,12,5,11,5,8,13,8,12,13,6,11,11,13,12,12,8,9,10,16,6,3,15,9,11,8,10,15,14,8,10,14,15,13,10,8,10,14,15,13,10,10,5,8,5,13,16,16,3,2,3,1,2,1,3,2,1,3,2
"6976",71101331,"Mykhaylo Mudryk","1/5/2001 (22 years old)","M (L), AM (RLC)","Chelsea","English Premier Division","UKR","No","1/15/2023","6/30/2030","$117M - $147M","Right","Reasonable","Very Strong","5'9""","134 lbs","64","9",143,170,11,13,15,12,12,11,5,10,5,7,13,13,5,13,6,9,12,11,11,11,16,16,8,11,11,11,13,14,17,16,12,6,10,18,12,15,10,5,12,19,9,20,10,14,5,12,12,13,11,3,2,2,3,1,2,2,2,3,2,1
"6977",71101334,"Anatolii Trubin","8/1/2001 (21 years old)","GK","Shakhtar","Ukrainian Premier League","UKR","No","6/13/2022","6/30/2026","$15.5M - $24M","Right","Reasonable","Very Strong","6'6""","189 lbs","67","-",145,167,3,1,2,2,13,4,8,3,3,2,14,11,2,12,7,14,14,13,14,11,12,5,7,3,15,12,13,14,11,15,12,18,14,12,13,14,11,5,15,15,14,20,5,18,2,3,14,13,8,10,13,15,6,11,13,16,3,12,13,17
"6978",71081391,"Oleksandr Zinchenko","12/15/1996 (26 years old)","D/WB (L), DM, M (C)","Arsenal","English Premier Division","UKR","No","7/22/2022","6/30/2026","$239M - $262M","Left","Very Strong","Fairly Strong","5'9""","134 lbs","153","3",161,165,12,13,14,10,15,13,12,13,9,11,15,9,13,16,13,16,15,16,14,15,18,13,14,16,11,16,16,16,14,14,14,10,13,13,15,10,18,15,14,15,13,13,12,13,12,6,15,15,18,2,1,4,1,2,4,3,2,1,2,3
"6979",71113679,"Illia Zabarnyi","9/1/2002 (20 years old)","D (C)","Bournemouth","English Premier Division","UKR","No","1/31/2023","6/30/2028","$76M - $95M","Right","Weak","Very Strong","6'1""","178 lbs","55","1",132,165,3,3,9,5,11,4,13,5,5,13,11,6,15,11,10,14,13,15,15,14,14,6,9,8,14,16,10,13,13,12,15,15,15,14,15,14,15,16,14,14,16,15,3,18,2,3,14,15,15,3,1,1,1,4,3,2,1,1,2,3
"6980",71003202,"Andriy Yarmolenko","10/23/1989 (33 years old)","M/AM (R)","Al-Ain","UAE Professional League","UKR","No","7/13/2022","6/30/2025","$550K - $5.2M","Left Only","Very Strong","Weak","6'3""","182 lbs","380","134",128,160,13,14,15,14,15,12,12,13,8,6,12,15,7,16,11,14,15,13,12,13,14,16,13,15,8,12,14,11,12,12,15,14,14,13,12,14,13,11,8,16,14,16,14,10,8,12,12,10,8,2,2,1,1,2,3,2,1,2,1,3
"6981",71108249,"Heorhii Sudakov","9/1/2002 (20 years old)","M (C), AM (LC)","Shakhtar","Ukrainian Premier League","UKR","No","2/13/2022","12/31/2026","$29M - $35M","Right","Fairly Strong","Very Strong","5'10""","149 lbs","49","10",130,159,9,9,12,11,12,12,7,13,5,7,15,11,10,13,8,14,9,13,13,13,13,9,7,12,10,15,15,13,13,13,13,11,11,14,14,12,17,8,14,15,8,20,7,10,6,3,15,12,10,3,2,2,3,1,2,1,3,2,2,3
"6982",2000293459,"Andrii Stefanyshyn","1/24/2007 (16 years old)","D (C)","Dnipro-1","Ukrainian Premier League","UKR","No","5/30/2023","6/30/2026","$55K - $550K","Right","Reasonable","Very Strong","6'2""","163 lbs","-","-",55,158,1,1,1,4,5,1,5,2,1,12,5,1,12,4,13,12,7,1,9,12,14,5,3,2,12,4,3,5,12,11,5,9,12,11,7,8,13,20,14,9,10,13,13,8,11,8,9,13,15,1,3,2,1,2,1,3,3,1,3,2
"6983",71099053,"Andriy Lunin","2/11/1999 (24 years old)","GK","R. Madrid","Spanish First Division","UKR","No","6/15/2020","6/30/2024","$4.3M - $8.4M","Right","Reasonable","Very Strong","6'3""","176 lbs","84","-",138,156,3,3,1,1,12,4,9,1,1,3,11,4,1,10,5,12,11,13,12,13,15,1,8,1,13,13,11,14,12,15,12,15,14,11,14,12,11,12,14,17,12,14,3,10,5,5,13,10,14,11,11,16,14,15,12,13,12,14,14,15
"6984",71048716,"Ruslan Malinovskyi","5/4/1993 (30 years old)","M/AM (C)","OM","Ligue 1 Uber Eats","UKR","No","6/14/2021","6/30/2026","$9.6M - $14.5M","Left","Very Strong","Fairly Strong","5'11""","174 lbs","342","66",139,155,16,14,15,12,16,16,4,18,4,6,14,14,11,17,15,12,12,13,12,13,14,16,8,13,6,11,14,15,13,12,16,9,16,12,11,15,12,11,14,16,13,14,6,13,12,6,13,14,15,3,1,1,1,3,2,3,1,2,3,3
"6985",85051090,"Merlin Tandjigora","4/6/1990 (33 years old)","DM, M (C)","US Vimy","French National 3 - Group G","GAB","No","7/1/2022","6/30/2023","$0 - $4K","Right Only","Weak","Very Strong","5'8""","165 lbs","175","5",88,126,6,8,10,6,11,13,9,10,7,11,11,6,13,11,14,10,13,10,12,12,15,9,9,8,12,14,8,14,9,10,12,7,4,10,9,10,10,11,11,13,12,13,16,14,11,7,15,14,12,2,1,3,2,3,3,1,1,3,3,2
"6986",5314413,"Dmytro Chygrynskyi","11/7/1986 (36 years old)","D (C)","Ionikos","Greek Super League 2 South","UKR","No","9/10/2021","6/30/2024","$75K - $230K","Right","Reasonable","Very Strong","6'3""","178 lbs","348","24",115,155,3,7,8,7,12,8,14,7,5,13,13,8,12,11,11,16,12,16,12,13,12,6,14,7,15,15,13,12,8,8,13,14,9,9,9,13,7,19,18,19,14,18,15,15,8,1,14,10,15,3,1,1,3,1,2,2,2,1,4,3
"6987",71104595,"Vitaliy Mykolenko","5/29/1999 (24 years old)","D/WB (L)","Everton","English Premier Division","UKR","No","1/1/2022","6/30/2026","$28M - $35M","Left","Very Strong","Reasonable","5'11""","156 lbs","135","6",133,150,8,13,10,7,12,5,13,9,10,13,13,4,14,12,12,12,15,12,12,13,16,7,8,13,13,13,11,16,15,13,11,13,14,15,15,12,6,12,11,14,16,13,3,15,12,5,12,15,20,1,4,2,2,2,1,1,3,3,4,1
"6988",71003050,"Taras Stepanenko","8/8/1989 (33 years old)","DM, M (C)","Shakhtar","Ukrainian Premier League","UKR","No","10/28/2021","6/30/2024","$375K - $3.8M","Left","Very Strong","Fairly Strong","5'11""","167 lbs","340","22",125,147,3,11,8,11,12,7,13,11,5,15,11,13,14,10,14,13,18,14,15,12,17,9,15,11,13,17,11,19,10,11,12,13,15,11,11,13,13,11,17,20,15,20,2,15,14,4,17,15,15,1,1,1,1,1,1,1,1,1,1,1
"6989",71012671,"Serhiy Sydorchuk","5/2/1991 (32 years old)","DM, M (C)","Dynamo Kyiv","Ukrainian Premier League","UKR","No","7/17/2022","6/30/2025","Not for Sale","Right","Fairly Strong","Very Strong","6'2""","176 lbs","286","19",123,145,8,9,11,8,10,6,12,13,4,13,14,11,14,11,15,12,15,12,9,13,16,12,16,12,12,15,14,16,10,11,13,13,15,11,14,14,6,9,14,15,14,16,8,14,12,7,13,14,14,2,4,2,3,1,1,1,4,1,3,2
"6990",71080414,"Viktor Tsygankov","11/15/1997 (25 years old)","M/AM (RL)","Girona","Spanish First Division","UKR","No","1/17/2023","6/30/2027","$12.5M - $18.5M","Left","Very Strong","Reasonable","5'10""","158 lbs","175","80",139,145,14,13,15,12,15,14,7,13,9,6,14,15,8,16,10,12,9,12,11,12,15,14,13,14,8,11,14,11,15,14,12,9,10,14,13,12,10,8,16,14,5,17,13,7,7,5,10,15,13,3,2,3,3,2,1,4,3,2,3,1
"6991",71108778,"Volodymyr Brazhko","1/23/2002 (21 years old)","DM, M (C)","Dynamo Kyiv","Ukrainian Premier League","UKR","No","6/13/2022","6/30/2025","$650K - $11M","Right","Reasonable","Very Strong","6'0""","169 lbs","29","7",115,145,5,5,7,8,12,11,11,14,6,11,12,12,13,12,13,14,12,12,12,11,13,9,10,12,12,14,13,15,12,11,15,12,13,12,13,12,10,10,12,12,11,11,13,13,9,12,11,13,11,3,3,3,2,3,3,2,2,3,3,2
"6992",71016685,"Roman Bezus","9/26/1990 (32 years old)","M/AM (C)","Omonoia","Cypriot First Division","UKR","No","8/6/2022","5/31/2024","$400K - $1.2M","Right","Weak","Very Strong","6'1""","171 lbs","401","68",120,145,12,14,12,12,14,11,12,12,8,10,15,18,9,13,9,14,14,11,14,12,10,15,13,14,13,12,14,14,12,11,13,13,11,11,12,11,12,8,17,14,8,14,12,9,9,7,10,10,4,3,1,4,3,2,2,2,3,1,3,2
"6993",71088179,"Mykola Shaparenko","10/4/1998 (24 years old)","DM, M/AM (C)","Dynamo Kyiv","Ukrainian Premier League","UKR","No","10/1/2020","6/30/2025","$7.4M - $9.2M","Right","Fairly Strong","Very Strong","5'10""","152 lbs","95","14",133,144,14,11,13,11,13,15,9,12,6,8,15,13,11,14,10,12,10,12,8,12,15,15,10,13,10,14,15,13,13,14,12,10,10,13,13,9,4,10,10,14,10,16,14,15,11,8,10,14,17,1,2,2,2,1,4,3,2,1,2,2
"6994",71111030,"Oleh Ocheretko","5/25/2003 (20 years old)","AM (RLC)","Shakhtar","Ukrainian Premier League","UKR","No","6/13/2022","6/30/2025","$45K - $450K","Left","Very Strong","Reasonable","5'11""","165 lbs","40","2",105,144,9,12,13,12,10,11,7,14,5,6,12,10,7,13,8,10,9,9,11,8,13,12,6,11,10,7,11,13,13,13,11,9,12,14,13,8,9,6,12,11,9,15,9,9,6,8,10,12,13,3,3,3,4,3,1,3,1,2,2,1
"6995",71042280,"Ihor Perduta","11/15/1990 (32 years old)","D (RL)","Vorskla","Ukrainian Premier League","UKR","No","6/14/2021","6/30/2024","$22K - $220K","Right","Fairly Strong","Very Strong","5'9""","158 lbs","262","3",109,143,11,11,10,7,11,10,9,9,12,13,11,7,13,10,8,11,12,11,12,10,13,11,14,8,13,15,11,14,11,10,12,10,13,12,14,12,12,10,12,13,14,20,3,11,11,5,11,10,17,1,1,2,3,1,3,2,2,2,4,1
"6996",85083535,"Lloyd Palun","11/28/1988 (34 years old)","D/WB (R)","SC Bastia","Ligue 2 BKT","GAB","Yes","7/1/2021","6/30/2024","$2K - $20K","Right Only","Weak","Very Strong","5'10""","169 lbs","281","10",102,126,6,10,9,8,10,7,14,10,6,11,11,8,12,10,14,13,15,10,12,12,15,8,12,10,12,12,11,12,11,11,14,12,14,11,12,13,14,11,11,14,11,13,7,13,10,7,11,13,14,4,3,3,4,1,3,1,3,2,1,2
"6997",71110357,"Yehor Yarmoliuk","3/1/2004 (19 years old)","M/AM (C)","Brentford","English Premier Division","UKR","No","7/14/2022","6/30/2027","$14.5M - $17M","Right","Fairly Strong","Very Strong","5'11""","158 lbs","18","-",115,142,10,11,12,11,11,9,8,11,7,11,13,9,12,12,10,11,9,11,11,12,15,12,6,11,8,13,13,18,13,12,11,9,15,13,13,8,10,11,12,15,12,9,5,12,4,3,13,15,14,2,3,1,3,2,1,1,1,2,2,2
"6998",19033594,"Junior Moraes","4/4/1987 (36 years old)","ST (C)","COR","Brazilian National First Division","UKR","No","3/14/2022","12/31/2024","$0 - $28K","Right","Fairly Strong","Very Strong","5'9""","158 lbs","293","141",108,141,6,11,12,13,13,11,13,13,3,3,13,14,5,12,13,12,12,13,12,13,14,13,14,16,11,15,14,15,10,10,11,8,8,10,8,12,9,12,9,19,14,15,6,14,14,5,12,14,17,2,2,2,3,2,1,1,3,3,1,1
"6999",2000012061,"Nazar Voloshyn","6/17/2003 (19 years old)","M (R), AM (RL)","Dynamo Kyiv","Ukrainian Premier League","UKR","No","7/1/2019","6/30/2026","$4.6M - $8.8M","Right","Weak","Very Strong","5'9""","147 lbs","26","7",108,141,12,11,14,10,13,10,5,10,8,5,11,7,5,14,11,12,6,9,6,9,13,15,3,13,7,7,12,12,15,15,10,8,13,14,10,8,6,16,9,8,12,11,6,17,11,15,11,15,7,3,2,3,2,2,2,3,3,3,1,1
"7000",71068312,"Vyacheslav Tankovskyi","8/16/1995 (27 years old)","DM, M (C)","Dnipro-1","Ukrainian Premier League","UKR","No","8/19/2021","6/30/2024","$50K - $500K","Right","Reasonable","Very Strong","5'6""","141 lbs","98","2",110,140,11,9,10,5,13,11,11,13,7,13,13,1,15,12,13,13,11,9,10,13,17,5,10,13,9,14,13,12,11,14,7,7,13,13,13,7,15,18,10,12,9,12,5,6,10,7,12,13,12,1,3,3,2,2,3,1,1,1,1,1
"7001",71023439,"Oleksandr Karavaiev","6/2/1992 (31 years old)","D/WB/M/AM (R)","Dynamo Kyiv","Ukrainian Premier League","UKR","No","6/27/2019","6/30/2025","Not for Sale","Right","Reasonable","Very Strong","5'9""","160 lbs","297","44",123,140,13,13,12,10,9,10,10,10,11,9,12,11,11,12,9,11,12,10,10,9,14,10,12,13,10,15,12,15,13,13,13,8,13,13,13,11,18,11,16,14,12,7,7,12,5,5,15,14,7,3,1,1,2,2,2,2,2,1,3,3
"7002",71101325,"Artem Bondarenko","8/21/2000 (22 years old)","M/AM (C)","Shakhtar","Ukrainian Premier League","UKR","No","6/15/2020","6/30/2025","$5M - $9.6M","Left","Very Strong","Reasonable","6'0""","160 lbs","60","18",123,140,10,10,15,11,12,8,8,11,6,9,15,11,7,13,9,14,13,13,10,13,11,11,7,15,10,13,13,14,14,13,11,11,12,12,14,11,11,9,14,14,8,20,9,11,8,7,13,6,7,3,2,3,2,3,3,2,3,2,2,1
"7003",71113671,"Vladyslav Vanat","1/4/2002 (21 years old)","AM (L), ST (C)","Dynamo Kyiv","Ukrainian Premier League","UKR","No","7/26/2021","12/31/2025","$750K - $5.4M","Left","Very Strong","Fairly Strong","6'0""","152 lbs","43","15",120,140,7,9,13,16,12,6,10,7,6,4,11,11,5,12,15,13,14,13,8,12,17,13,7,13,6,12,10,13,13,13,12,11,12,15,11,12,8,11,7,12,12,15,8,11,13,13,11,10,5,4,2,3,1,3,4,1,2,2,2,3
"7004",71006775,"Serhiy Rybalka","4/1/1990 (33 years old)","DM, M/AM (C)","Oleksandriia","Ukrainian Premier League","UKR","No","7/23/2021","6/30/2024","$18K - $180K","Right","Reasonable","Very Strong","5'10""","158 lbs","312","49",110,140,14,12,11,10,13,13,7,12,6,11,14,11,11,13,12,13,10,14,11,13,12,12,13,11,11,14,14,12,10,9,11,10,8,10,10,10,14,9,14,14,8,15,16,13,8,6,13,12,12,1,1,2,3,3,2,4,2,2,2,3
"7005",71113690,"Ruslan Neshcheret","1/22/2002 (21 years old)","GK","Dynamo Kyiv","Ukrainian Premier League","UKR","No","1/27/2023","12/31/2027","$55K - $7M","Right Only","Weak","Very Strong","6'3""","178 lbs","23","-",110,140,5,3,3,3,8,7,9,7,2,2,10,2,1,7,12,11,14,14,12,15,15,1,9,1,12,13,10,9,8,13,10,12,8,8,4,10,13,17,12,11,11,13,14,7,5,5,10,14,12,10,15,14,15,11,10,12,15,14,11,13
"7006",71100666,"Dmytro Riznyk","1/30/1999 (24 years old)","GK","Shakhtar","Ukrainian Premier League","UKR","No","2/9/2023","12/31/2027","$550K - $9M","Right Only","Weak","Very Strong","6'3""","187 lbs","89","-",125,140,5,1,3,3,9,8,2,2,3,1,10,4,1,10,10,11,11,15,15,13,10,2,11,1,16,12,11,10,14,14,9,13,14,14,5,12,13,10,11,11,13,9,5,13,8,5,16,8,16,7,8,15,9,11,9,12,10,11,13,12
"7007",13134264,"Aaron Appindangoyé","2/20/1992 (31 years old)","D (C)","Sivasspor","Turkish Super League","GAB","No","7/10/2019","6/30/2025","Not for Sale","Right","Reasonable","Very Strong","6'0""","187 lbs","182","1",115,125,5,7,8,5,12,4,14,5,5,13,12,6,13,11,16,10,16,11,10,12,12,9,11,7,12,13,11,14,11,11,14,13,12,11,14,15,2,14,14,13,12,12,8,14,8,7,14,12,12,3,2,2,2,2,1,2,1,1,2,1
"7008",71109701,"Tymur Puzankov","3/4/2003 (20 years old)","GK","Shakhtar","Ukrainian Premier League","UKR","No","6/13/2022","6/30/2025","$3M - $6M","Left Only","Very Strong","Weak","6'4""","182 lbs","-","-",105,140,2,3,2,1,10,4,11,5,4,4,12,9,5,11,6,9,10,8,10,12,11,3,6,11,9,12,11,13,9,11,10,18,9,12,11,10,1,5,14,15,9,20,7,9,4,5,8,8,5,11,8,15,10,13,10,12,3,10,11,18
"7009",71113673,"Kostiantyn Vivcharenko","6/10/2002 (21 years old)","D/WB (L)","Dynamo Kyiv","Ukrainian Premier League","UKR","No","6/13/2022","12/31/2028","$3.8M - $7.6M","Left","Very Strong","Reasonable","5'10""","167 lbs","22","2",114,140,8,11,11,6,11,9,12,7,8,12,11,5,13,11,12,12,14,10,10,11,14,9,12,10,12,12,10,15,13,13,13,11,14,13,14,13,15,16,9,12,11,10,8,5,8,7,9,11,16,1,3,2,1,2,2,2,2,1,3,2
"7010",2000029018,"Eduard Kozik","4/19/2003 (20 years old)","D (C)","Shakhtar","Ukrainian Premier League","UKR","No","6/13/2022","6/30/2025","$50K - $8M","Right","Reasonable","Very Strong","6'0""","174 lbs","3","-",110,139,3,6,8,5,10,7,12,5,12,13,9,6,13,8,14,10,14,13,9,11,12,5,8,10,13,11,10,13,12,11,13,13,14,13,15,14,9,20,12,13,11,15,9,10,11,2,10,7,10,1,2,2,4,1,2,1,2,2,1,3
"7011",71110353,"Arsenii Batahov","3/5/2002 (21 years old)","D (C), DM, M (C)","Zoria","Ukrainian Premier League","UKR","No","7/1/2022","6/30/2026","$5M - $9.6M","Left","Very Strong","Reasonable","6'1""","165 lbs","74","1",115,139,7,6,9,5,12,6,13,9,9,14,13,7,14,11,13,13,12,12,11,11,12,8,11,7,12,14,11,14,12,9,12,14,12,12,13,12,11,15,11,11,5,15,10,7,9,2,12,11,15,3,2,4,2,1,1,3,2,3,3,1
"7012",71008509,"Oleksandr Skliar","2/26/1991 (32 years old)","DM, M (C)","Vorskla","Ukrainian Premier League","UKR","No","6/14/2021","6/30/2024","$110K - $325K","Right","Fairly Strong","Very Strong","5'9""","160 lbs","272","12",109,138,11,11,9,7,11,11,11,13,8,12,12,10,13,11,13,11,13,12,12,10,12,12,13,10,13,14,12,13,10,10,11,9,12,11,13,12,13,15,11,12,10,14,5,9,11,4,12,12,12,2,2,1,2,1,3,3,3,2,2,2
"7013",71085896,"Vasyl Kravets","8/20/1997 (25 years old)","D/WB (L)","Vorskla","Ukrainian Premier League","UKR","No","9/9/2022","6/30/2025","$210K - $2.1M","Left","Very Strong","Weak","6'0""","176 lbs","177","4",119,137,11,11,8,7,10,10,12,9,10,12,11,7,13,11,15,11,15,11,9,11,14,8,9,10,11,15,10,16,13,12,12,13,12,13,16,15,8,14,13,15,12,13,7,10,9,11,11,9,12,2,2,3,1,1,2,4,3,3,1,2
"7014",71099085,"Yukhym Konoplia","8/26/1999 (23 years old)","D (RL), WB (R)","Shakhtar","Ukrainian Premier League","UKR","No","6/15/2020","6/30/2026","$3.1M - $6.2M","Right","Reasonable","Very Strong","5'11""","163 lbs","71","4",125,137,11,13,11,7,14,13,10,6,14,13,15,8,11,11,9,12,10,11,12,12,11,9,7,13,9,13,9,15,16,13,11,6,14,15,14,12,12,16,7,12,11,20,6,12,7,12,10,6,6,3,3,4,3,2,1,3,3,3,3,1
"7015",71006535,"Serhiy Kryvtsov","3/15/1991 (32 years old)","D (C)","Inter Miami","Major League Soccer","UKR","No","1/31/2023","12/31/2024","Not for Sale","Right","Weak","Very Strong","6'1""","182 lbs","221","14",120,137,4,6,9,8,13,3,15,11,9,15,12,10,14,9,15,12,17,12,12,12,17,5,13,10,12,14,12,15,10,10,14,14,16,11,12,13,15,14,15,18,15,20,1,12,9,6,13,6,5,1,1,1,1,1,7,1,1,1,1,1
"7016",71042260,"Oleh Barannik","3/20/1992 (31 years old)","ST (C)","Standart Novi Sanzhary","Ukrainian Reg Div - Poltava region - D1","UKR","No","6/14/2021","6/30/2024","$0 - $10K","Right","Reasonable","Very Strong","5'10""","149 lbs","99","11",80,137,6,11,11,11,13,5,9,11,6,6,11,8,9,11,11,8,5,13,7,12,16,10,10,10,9,15,11,9,10,10,13,11,14,13,13,5,10,20,12,7,11,11,7,9,7,7,12,10,17,3,1,4,2,3,1,3,2,2,2,1
"7017",5314917,"Yuriy Pankiv","11/3/1984 (38 years old)","GK","Rukh","Ukrainian Premier League","UKR","No","6/15/2021","6/30/2024","$1.5K - $4.5K","Right","Weak","Very Strong","6'1""","176 lbs","491","-",99,137,3,3,2,2,6,7,9,2,3,2,10,3,3,6,9,13,12,13,12,12,19,1,14,9,15,10,12,10,5,7,8,13,14,6,6,10,13,19,13,10,11,11,8,8,2,1,14,11,17,11,7,12,8,11,14,13,7,14,14,12
"7018",93019866,"Serge-Junior Martinsson Ngouali","1/23/1992 (31 years old)","DM, M (C)","Sarpsborg","Norwegian Premier Division","GAB","Yes","1/31/2022","7/31/2024","Not for Sale","Right","Reasonable","Very Strong","5'8""","165 lbs","297","15",107,125,9,12,11,6,12,9,5,6,5,12,12,9,12,12,11,13,11,12,12,12,11,12,9,11,13,13,12,13,10,14,12,7,14,11,13,12,7,12,14,14,13,12,13,11,5,5,12,11,15,2,1,3,4,3,3,1,3,2,1,2
"7019",71093182,"Valeriy Bondar","2/27/1999 (24 years old)","D (C)","Shakhtar","Ukrainian Premier League","UKR","No","6/15/2020","10/31/2024","$240K - $2.4M","Right","Reasonable","Very Strong","6'0""","160 lbs","47","1",120,136,5,7,9,5,12,4,12,5,7,11,11,6,13,12,14,12,16,10,11,12,14,7,15,11,16,14,12,10,12,13,13,13,14,13,13,12,5,10,14,17,12,20,11,13,12,4,11,7,5,2,3,4,1,4,3,1,1,1,2,3
"7020",71075952,"Mykola Matviienko","5/2/1996 (27 years old)","D (LC)","Shakhtar","Ukrainian Premier League","UKR","No","3/20/2023","12/31/2027","$21M - $32M","Left","Very Strong","Reasonable","6'0""","163 lbs","144","8",135,136,13,11,11,6,12,12,14,7,13,14,15,7,13,12,12,12,17,12,13,13,15,8,9,14,12,15,14,14,13,13,13,12,15,14,14,13,15,13,14,19,13,20,8,15,7,5,14,15,10,3,2,1,1,3,3,1,2,1,2,1
"7021",71042301,"Vitaliy Buialskyi","1/6/1993 (30 years old)","M/AM (C)","Dynamo Kyiv","Ukrainian Premier League","UKR","No","6/14/2021","6/30/2025","$4.2M - $8.2M","Right","Fairly Strong","Very Strong","5'9""","149 lbs","208","50",129,135,11,11,12,11,12,10,10,11,7,9,13,14,12,12,9,12,15,13,9,12,15,13,13,17,10,15,13,16,13,13,14,9,13,13,14,9,9,12,15,16,11,16,11,13,10,6,11,8,13,1,3,3,3,3,1,2,1,3,3,1
"7022",71099098,"Dmytro Kryskiv","10/6/2000 (22 years old)","M (LC), AM (L)","Shakhtar","Ukrainian Premier League","UKR","No","6/15/2020","6/30/2025","$400K - $10M","Right","Reasonable","Very Strong","5'11""","147 lbs","59","9",124,135,8,13,13,13,13,7,10,12,5,9,14,9,8,13,5,13,13,12,12,13,12,12,7,11,11,14,15,14,13,13,13,7,11,12,14,11,11,5,12,12,11,18,8,11,6,4,15,11,6,3,2,3,2,3,2,1,2,4,3,3
"7023",71049105,"Heorhiy Bushchan","5/31/1994 (29 years old)","GK","Dynamo Kyiv","Ukrainian Premier League","UKR","No","6/15/2020","6/30/2026","$4.8M - $9M","Right","Fairly Strong","Very Strong","6'5""","205 lbs","98","-",130,135,6,1,3,3,8,7,10,3,1,3,11,5,2,8,10,11,12,13,14,12,13,1,10,3,12,12,12,14,9,13,15,16,16,8,11,12,14,15,11,11,14,15,11,13,6,5,13,6,12,14,11,15,15,12,15,12,5,13,14,15
"7024",71023108,"Yevhen Makarenko","5/21/1991 (32 years old)","DM, M (C)","Fehérvár","Hungarian Division I","UKR","No","8/12/2021","6/30/2024","$230K - $2.3M","Left","Very Strong","Reasonable","6'1""","182 lbs","249","11",115,135,12,11,14,10,15,10,13,11,12,11,15,11,13,14,12,13,13,14,13,13,16,13,9,11,12,15,14,11,8,9,12,8,13,8,12,11,11,8,16,14,13,15,7,11,9,7,9,11,13,4,4,3,1,2,1,1,1,2,2,3
"7025",71099061,"Vladyslav Supriaha","2/15/2000 (23 years old)","ST (C)","Dynamo Kyiv","Ukrainian Premier League","UKR","No","6/15/2020","12/31/2025","$1.3M - $2.7M","Right","Reasonable","Very Strong","6'0""","167 lbs","74","24",103,135,6,8,12,10,12,7,10,8,6,5,12,11,3,13,7,10,8,8,8,9,9,8,8,12,9,11,9,9,14,13,14,14,6,15,13,12,5,3,15,4,3,10,16,5,5,5,8,12,4,2,3,4,1,3,1,1,2,2,1,3
"7026",2000290284,"Oleksandr Petrenko","3/26/2007 (16 years old)","GK","Bayer 04","Bundesliga","UKR","No","9/5/2022","6/30/2025","$425K - $4.3M","Right","Reasonable","Very Strong","5'11""","145 lbs","-","-",85,135,2,3,3,3,2,4,1,1,2,3,8,4,3,4,12,7,10,8,10,14,12,2,10,2,14,8,7,7,11,7,3,8,15,10,4,6,10,11,9,10,11,11,9,12,12,8,10,12,10,8,10,14,5,11,8,14,5,5,7,8
"7027",71049854,"Serhiy Bolbat","6/13/1993 (29 years old)","D/WB/M (R), AM (RL)","Kolos","Ukrainian Premier League","UKR","No","8/18/2022","6/30/2025","$230K - $2.3M","Right","Reasonable","Very Strong","5'9""","154 lbs","262","38",117,135,12,13,13,9,10,10,7,10,8,8,12,13,10,13,10,13,13,9,9,8,14,10,6,13,9,11,11,13,13,12,13,8,11,13,13,11,16,8,15,10,10,10,5,10,12,10,13,14,5,3,3,2,2,2,1,3,4,1,4,1
"7028",71106198,"Danylo Sikan","4/16/2001 (22 years old)","AM (R), ST (C)","Shakhtar","Ukrainian Premier League","UKR","No","6/15/2020","6/30/2024","$65K - $8.2M","Right","Fairly Strong","Very Strong","6'1""","165 lbs","66","16",125,135,7,7,11,13,13,7,11,11,8,6,11,13,6,11,11,13,13,13,10,10,15,13,5,13,11,10,11,14,15,14,13,14,11,14,13,12,9,19,13,14,10,7,9,11,8,6,10,8,10,1,1,2,3,3,3,3,2,3,1,3
"7029",50039251,"Jim Allevinah","2/27/1995 (28 years old)","WB/M (R), AM (RL)","Clermont","Ligue 1 Uber Eats","GAB","Yes","8/11/2021","6/30/2024","$150K - $1.5M","Right","Weak","Very Strong","5'8""","134 lbs","218","37",119,124,8,12,14,9,13,8,9,11,5,8,12,10,5,14,10,11,13,11,11,12,14,10,10,12,5,11,11,12,15,12,10,10,12,14,13,13,11,12,12,11,11,10,9,11,9,11,12,13,12,4,1,3,4,2,3,1,1,1,2,3
"7030",71068783,"Igor Kharatin","2/2/1995 (28 years old)","D (C), DM, M (C)","Legia","PKO Bank Polski Ekstraklasa","UKR","Yes","9/1/2021","6/30/2024","$16K - $160K","Right Only","Weak","Very Strong","6'2""","176 lbs","158","16",105,135,10,10,10,11,12,10,13,11,10,12,13,14,12,11,10,12,12,14,14,13,10,11,13,11,12,15,10,15,10,9,10,13,14,9,11,12,6,9,11,12,9,10,5,10,10,5,11,10,8,3,4,1,1,2,4,2,2,1,1,3
"7031",8438112,"Miralem Pjanić","4/2/1990 (33 years old)","DM, M (C)","Sharjah","UAE Professional League","BIH","Yes","9/7/2022","5/31/2024","$550K - $5.4M","Right","Fairly Strong","Very Strong","5'8""","154 lbs","460","60",145,170,15,16,13,8,16,18,8,15,4,9,18,14,10,17,8,17,12,17,12,15,13,11,7,10,15,16,16,10,10,13,12,7,12,11,12,10,10,15,14,17,12,11,15,10,13,6,11,14,16,3,2,2,3,1,2,3,2,2,4,3
"7032",8502440,"Edin Džeko","3/17/1986 (37 years old)","ST (C)","Inter","Italian Serie A","BIH","Yes","8/14/2021","6/30/2024","$450K - $4.4M","Either","Very Strong","Very Strong","6'4""","207 lbs","605","248",146,168,4,10,11,16,16,8,17,11,4,5,14,13,7,15,8,16,14,13,14,15,19,12,14,12,6,16,14,13,10,9,17,16,19,10,12,17,5,10,14,20,15,13,4,14,10,8,14,18,10,3,1,3,4,2,3,1,1,2,2,1
"7033",93064994,"Anel Ahmedhodžić","3/26/1999 (24 years old)","D (C)","Sheff Utd","English Premier Division","BIH","Yes","7/5/2022","6/30/2026","$17M - $25M","Right","Reasonable","Very Strong","6'3""","185 lbs","124","10",128,165,5,12,10,5,12,7,14,7,7,13,14,8,14,12,14,14,14,13,13,14,15,10,12,9,13,11,13,11,13,9,12,15,12,14,13,13,10,8,9,14,15,10,6,14,7,8,15,15,15,3,2,1,1,2,3,2,1,3,1,3
"7034",93145052,"Benjamin Tahirović","3/3/2003 (20 years old)","DM, M/AM (C)","AS Roma","Italian Serie A","BIH","Yes","2/1/2021","6/30/2027","$6.6M - $10M","Right","Strong","Very Strong","6'4""","160 lbs","37","-",118,159,7,10,12,9,14,8,9,12,4,7,15,9,9,15,8,12,10,14,10,12,10,12,6,9,10,12,14,9,10,10,13,13,12,13,12,11,10,13,11,12,11,12,5,9,7,7,11,11,14,3,2,1,2,1,1,2,1,3,1,2
"7035",16283629,"Amar Dedić","8/18/2002 (20 years old)","D (RL)","FC RB Salzburg","Austrian Premier Division","BIH","Yes","1/11/2023","6/30/2027","$21M - $25M","Right","Fairly Strong","Very Strong","5'11""","163 lbs","108","5",130,155,6,12,12,8,13,7,10,9,9,13,12,8,13,12,10,13,12,13,12,12,17,7,14,13,13,13,12,14,14,13,12,10,14,16,13,13,9,14,14,13,13,12,6,9,6,7,13,15,15,2,2,1,2,1,3,3,2,4,2,1
"7036",16282801,"Adis Jašić","2/12/2003 (20 years old)","D/WB (R), M (RC)","Wolfsberger AC","Austrian Premier Division","BIH","Yes","12/30/2021","6/30/2025","$7.8M - $9.4M","Left","Very Strong","Fairly Strong","5'10""","165 lbs","65","7",110,150,6,8,10,6,12,7,9,8,4,8,9,9,10,12,6,11,13,10,11,9,14,4,8,9,12,13,11,13,13,12,13,13,12,15,13,12,5,14,12,11,12,10,9,8,5,7,11,9,7,1,3,2,2,3,1,2,3,2,3,1
"7037",5123112,"Asmir Begović","6/20/1987 (35 years old)","GK","Everton","English Premier Division","BIH","Yes","7/20/2021","6/30/2024","$375K - $3.8M","Right Only","Weak","Very Strong","6'6""","222 lbs","347","1",122,150,2,1,5,1,8,6,6,2,8,3,9,7,6,8,11,14,13,11,13,12,17,7,11,2,15,12,5,11,6,14,10,15,16,8,12,14,1,8,12,16,14,11,4,13,8,10,14,13,16,11,15,13,8,13,11,14,12,15,15,15
"7038",2000270322,"Milijan Kovačević","10/17/2005 (17 years old)","D (L)","Borac (BL)","Bosnian Premier League","BIH","Yes","7/1/2022","6/30/2025","$110K - $1.1M","Left","Very Strong","Reasonable","5'11""","156 lbs","1","-",70,148,7,10,4,7,6,4,8,5,7,10,5,3,14,8,12,7,9,6,9,14,6,5,1,6,12,8,8,8,11,13,8,8,9,12,9,6,14,16,6,10,12,11,11,5,7,8,8,9,19,1,1,2,1,3,1,1,3,2,2,3
"7039",62025884,"Rade Krunić","10/7/1993 (29 years old)","DM, M/AM (C)","AC Milan","Italian Serie A","BIH","Yes","9/8/2022","6/30/2025","$8.4M - $12.5M","Right","Fairly Strong","Very Strong","6'0""","163 lbs","287","24",142,145,10,11,13,8,13,13,12,12,5,13,13,11,14,13,11,13,11,12,14,12,14,12,11,13,14,17,12,15,13,14,14,12,14,14,14,13,18,12,14,14,12,13,8,11,11,5,14,13,15,3,2,3,2,4,2,3,1,1,1,3
"7040",48048302,"Sidney Obissa","5/4/2000 (23 years old)","D (C)","AC Ajaccio","Ligue 2 BKT","GAB","Yes","7/1/2019","6/30/2025","$24K - $250K","Left","Very Strong","Weak","6'4""","189 lbs","32","1",91,124,2,6,1,2,7,1,11,5,3,12,9,5,13,3,7,9,12,8,9,13,13,5,10,7,11,7,6,8,13,10,11,14,7,12,11,13,7,16,11,13,10,11,7,7,13,6,12,10,17,3,3,1,2,3,3,1,2,2,3,3
"7041",92029805,"Sead Kolašinac","6/20/1993 (29 years old)","D (LC), WB (L)","OM","Ligue 1 Uber Eats","BIH","Yes","1/18/2022","6/30/2026","$15M - $18M","Left","Very Strong","Weak","6'0""","180 lbs","245","13",137,144,4,10,11,7,12,6,14,8,8,14,11,8,15,11,17,13,18,10,11,12,17,9,9,12,12,15,9,17,14,13,15,12,18,16,14,17,14,10,10,12,15,10,7,14,14,13,13,16,12,3,3,3,2,3,1,4,2,1,2,2
"7042",43458779,"Petar Zovko","3/25/2002 (21 years old)","GK","Spezia","Italian Serie B","BIH","Yes","7/1/2021","6/30/2024","$120K - $1.2M","Left Only","Very Strong","Weak","6'4""","187 lbs","2","-",98,142,3,1,3,3,1,4,1,3,2,1,14,3,1,6,12,10,11,11,12,10,12,2,10,3,12,11,10,10,11,10,12,11,11,12,13,14,12,11,9,11,12,11,10,9,12,8,14,12,15,11,12,9,10,12,10,11,12,12,12,11
"7043",91158071,"Ermedin Demirović","3/25/1998 (25 years old)","M (L), AM (LC), ST (C)","Augsburg","Bundesliga","BIH","Yes","7/1/2022","6/30/2026","$9.6M - $12M","Right","Fairly Strong","Very Strong","6'1""","185 lbs","164","41",135,140,6,10,12,13,13,7,12,11,6,8,12,13,9,14,16,14,16,13,12,13,16,12,13,15,8,15,12,15,14,13,13,12,16,14,13,12,13,8,8,13,12,10,3,14,14,13,13,14,15,1,3,1,3,1,2,2,3,3,2,3
"7044",21026981,"Amir Hadžiahmetović","3/8/1997 (26 years old)","DM, M (C)","Beşiktaş","Turkish Super League","BIH","Yes","2/2/2023","6/30/2027","$11M - $13M","Right","Reasonable","Very Strong","5'10""","156 lbs","216","16",130,140,16,14,14,7,14,14,8,8,1,8,17,13,10,14,10,14,12,15,15,14,15,13,7,10,16,16,16,14,12,12,12,8,14,10,14,10,10,15,15,15,12,12,6,12,12,2,16,15,16,2,1,1,1,1,3,4,4,1,3,1
"7045",16191707,"Jusuf Gazibegović","3/11/2000 (23 years old)","D/WB/M (R)","SK Sturm Graz","Austrian Premier Division","BIH","Yes","12/8/2022","6/30/2026","$8.6M - $11M","Right","Strong","Very Strong","5'9""","147 lbs","119","2",127,140,5,12,9,5,11,4,8,7,9,11,10,8,12,13,11,11,13,11,11,11,16,6,7,12,14,13,11,12,13,13,12,8,13,16,14,12,9,9,7,12,12,9,14,7,9,2,14,15,16,3,2,3,1,1,1,2,2,1,1,2
"7046",62027632,"Edin Višća","2/17/1990 (33 years old)","M/AM (RL)","Trabzonspor","Turkish Super League","BIH","Yes","1/12/2022","6/30/2025","Not for Sale","Right","Strong","Very Strong","5'8""","138 lbs","413","113",125,140,12,14,13,14,13,11,5,14,7,7,12,12,7,13,11,12,7,13,13,12,14,16,12,16,7,12,13,14,13,14,11,7,14,11,12,7,15,18,14,15,12,16,11,14,10,2,11,14,14,1,3,3,1,3,3,1,1,1,3,2
"7047",2000225313,"Amar Zahirović","6/7/2005 (18 years old)","M (L), AM (RL)","Osijek","Croatian First League","BIH","Yes","7/1/2022","6/30/2025","$95K - $275K","Left","Very Strong","Fairly Strong","5'10""","158 lbs","-","-",70,139,8,11,12,8,10,6,6,7,6,5,9,5,7,13,9,9,8,5,2,8,8,14,8,13,5,7,10,12,10,12,7,5,9,11,7,6,13,11,9,10,12,12,8,8,5,3,13,12,19,3,4,2,1,1,2,1,1,3,3,2
"7048",85057002,"Sanjin Prcić","11/20/1993 (29 years old)","DM, M (C)","Strasbourg","Ligue 1 Uber Eats","BIH","Yes","5/24/2022","6/30/2025","$7M - $10.5M","Right","Reasonable","Very Strong","5'11""","160 lbs","206","10",125,138,12,11,12,7,13,12,9,13,6,9,15,10,10,13,12,12,14,13,15,13,12,11,10,12,12,15,15,16,11,12,13,9,15,11,13,12,8,14,13,14,12,16,9,14,11,5,12,14,13,3,1,2,2,2,1,3,1,2,3,1
"7049",2000270327,"Stefan Marčetić","12/2/2006 (16 years old)","ST (C)","Borac (BL)","Bosnian Premier League","BIH","Yes","7/1/2022","6/30/2026","$40K - $400K","Right","Reasonable","Very Strong","5'11""","147 lbs","2","-",70,137,2,6,11,13,10,5,13,7,1,6,7,3,1,13,11,9,2,8,7,6,3,13,11,11,5,6,7,7,13,12,2,10,12,13,11,7,9,18,10,11,11,11,6,9,11,2,8,13,10,3,3,3,2,4,2,1,1,1,2,1
"7050",2000056910,"Anes Krdžalić","8/28/2004 (18 years old)","DM, M (C)","Kustošija","Croatian Third League","BIH","Yes","1/20/2023","6/30/2026","$0","Right","Fairly Strong","Very Strong","5'11""","152 lbs","15","3",99,136,10,9,12,11,14,11,6,12,4,8,12,7,8,14,10,8,10,12,8,11,14,13,7,9,9,12,12,11,12,13,12,9,12,11,11,8,14,9,9,12,13,11,10,8,6,6,20,13,14,1,1,3,2,1,4,1,3,3,1,4
"7051",12002366,"Roguy Méyé","10/7/1986 (36 years old)","ST (C)","Racing HW 96","French Regional Divisions","GAB","No","7/1/2019","-","$0","Right Only","Weak","Very Strong","5'10""","165 lbs","99","25",70,120,3,6,9,8,8,4,10,5,2,3,6,8,3,9,12,6,13,6,10,5,14,10,6,10,3,7,5,12,14,12,12,8,10,13,12,12,7,13,13,9,8,9,6,13,12,7,10,13,12,1,2,2,3,3,3,4,3,2,2,3
"7052",35007493,"Mario Vrančić","5/23/1989 (34 years old)","DM, M/AM (C)","Stoke","Sky Bet Championship","BIH","Yes","7/5/2021","6/30/2024","$26K - $80K","Left","Very Strong","Reasonable","6'2""","176 lbs","418","61",116,136,13,13,13,11,14,16,7,14,7,8,15,13,10,15,10,13,7,15,11,12,11,15,9,13,11,13,14,10,8,10,12,11,14,9,12,10,10,13,10,13,13,11,11,12,8,11,12,15,12,4,1,1,1,2,1,2,1,2,2,2
"7053",862068,"Haris Medunjanin","3/8/1985 (38 years old)","DM, M (C)","PEC Zwolle","Eredivisie","BIH","Yes","8/9/2022","6/30/2024","$30K - $325K","Left Only","Very Strong","Weak","6'3""","187 lbs","457","52",108,136,16,14,13,14,17,15,11,14,7,5,17,17,8,18,6,14,6,7,10,13,7,16,13,15,8,14,15,11,7,9,12,11,16,8,7,12,10,13,15,13,7,9,8,14,6,12,12,9,12,3,2,1,1,2,3,1,4,2,2,1
"7054",2000045050,"Hamza Gasal","12/16/2002 (20 years old)","M (R), AM (RL)","Željezničar","Bosnian Premier League","BIH","Yes","7/1/2018","6/30/2024","$180K - $1.8M","Right","Fairly Strong","Very Strong","5'10""","154 lbs","38","4",84,136,6,12,13,11,13,4,5,7,6,6,8,6,5,13,12,6,8,6,7,10,10,13,12,9,6,7,10,6,13,13,7,5,9,13,9,4,17,10,12,9,14,9,10,12,5,8,20,9,10,1,2,2,1,2,4,1,2,1,3,2
"7055",21030043,"Vladan Danilović","7/27/1999 (23 years old)","DM, M (C)","Nacional da Madeira","Portuguese Second League","BIH","Yes","10/2/2020","6/30/2024","$90K - $900K","Right","Weak","Very Strong","6'0""","171 lbs","164","13",117,136,4,8,9,11,12,9,12,10,4,14,12,8,14,11,12,13,13,13,14,12,13,12,9,13,12,13,12,13,12,11,13,13,12,12,14,14,9,10,12,14,12,10,8,11,10,8,13,10,13,1,3,3,2,2,4,2,3,1,1,2
"7056",67047289,"Kenan Kodro","8/19/1993 (29 years old)","AM (LC), ST (C)","Fehérvár","Hungarian Division I","BIH","Yes","8/24/2021","6/30/2024","$1.1M - $2.4M","Right","Reasonable","Very Strong","6'2""","171 lbs","296","69",118,136,6,9,11,15,13,10,13,10,6,5,13,12,7,12,10,12,11,11,11,12,12,12,9,14,5,13,13,12,11,13,10,15,12,12,12,11,7,15,11,16,12,12,5,11,5,8,8,13,13,3,2,2,1,3,3,1,2,2,1,2
"7057",62011842,"Miroslav Stevanović","7/29/1990 (32 years old)","M/AM (R)","Servette","Swiss Super League","BIH","Yes","8/2/2021","6/30/2025","Not for Sale","Right","Strong","Very Strong","5'11""","158 lbs","382","70",136,136,13,16,14,10,15,12,11,11,6,7,15,11,8,14,12,15,11,12,12,13,12,12,4,13,9,19,14,15,12,13,14,9,14,12,13,8,10,20,13,18,7,17,8,13,8,1,16,9,11,3,1,4,1,3,3,3,3,2,2,3
"7058",2000270321,"Savo Sušić","1/27/2005 (18 years old)","D (C)","Borac (BL)","Bosnian Premier League","BIH","Yes","7/1/2022","6/30/2025","$425K - $1.3M","Right","Reasonable","Very Strong","6'3""","174 lbs","3","-",75,136,3,1,1,1,6,3,12,1,3,12,6,1,7,5,12,12,9,4,7,12,15,5,10,4,11,5,1,6,12,10,6,14,13,10,4,6,13,10,7,8,11,11,5,15,8,7,9,9,8,2,4,3,2,1,2,1,1,2,2,1
"7059",5797979,"Ervin Zukanovic","2/11/1987 (36 years old)","D (C)","Asteras Tripolis","Greek Super League 1","BIH","Yes","8/17/2022","6/30/2024","$5K - $50K","Left Only","Very Strong","Weak","6'2""","187 lbs","370","24",105,135,8,8,9,8,9,10,13,12,13,13,13,9,12,9,10,13,13,16,10,14,13,9,13,9,14,15,13,14,7,7,14,13,14,8,8,14,5,14,12,14,13,12,10,10,8,4,11,13,14,1,2,2,2,1,1,3,2,3,1,1
"7060",62004109,"Ibrahim Sehic","9/2/1988 (34 years old)","GK","Konyaspor","Turkish Super League","BIH","Yes","6/1/2023","6/30/2025","Not for Sale","Left Only","Very Strong","Weak","6'3""","176 lbs","425","-",125,135,4,2,3,2,8,7,3,2,3,3,11,3,3,8,15,12,14,12,13,11,11,6,16,3,11,14,7,11,11,13,10,14,16,10,11,12,14,11,13,12,9,12,8,11,9,5,13,15,12,11,15,15,13,13,13,14,5,14,14,14
"7061",2000270326,"Danilo Maconja","1/5/2005 (18 years old)","DM","Borac (BL)","Bosnian Premier League","BIH","Yes","7/1/2022","6/30/2025","$60K - $600K","Right","Reasonable","Very Strong","5'11""","156 lbs","1","-",68,135,6,6,3,7,10,6,6,7,5,5,9,4,11,14,8,10,7,5,8,14,4,5,1,6,9,7,12,10,14,13,7,6,12,14,5,7,15,15,11,9,10,12,5,12,9,2,11,10,13,3,1,2,4,1,1,4,1,2,3,1
"7062",2000162331,"Jacques Ekomié","8/19/2003 (19 years old)","D/WB (L)","Bordeaux","French National 3 - Group B","GAB","Yes","8/3/2022","6/30/2025","$30K - $325K","Left Only","Very Strong","Weak","5'10""","160 lbs","7","-",97,116,4,11,12,5,13,5,7,7,9,10,11,6,10,13,13,13,16,13,12,12,16,9,5,9,12,11,12,10,12,12,14,11,16,12,11,9,11,7,13,13,16,13,9,15,7,8,12,16,13,1,2,1,2,2,2,3,4,1,1,2
"7063",28085802,"Armin Hodžić","11/17/1994 (28 years old)","AM (C), ST (C)","Željezničar","Bosnian Premier League","BIH","Yes","7/1/2022","6/30/2025","$65K - $650K","Right","Fairly Strong","Very Strong","5'11""","176 lbs","224","76",95,135,8,9,12,11,12,10,13,13,4,2,9,11,4,14,16,14,12,13,5,9,4,13,1,10,9,7,11,14,9,10,10,9,6,11,13,10,9,12,7,4,11,10,4,11,11,10,7,4,12,3,1,3,2,2,3,4,1,2,2,3
"7064",24046771,"Rifet Kapić","7/3/1995 (27 years old)","M/AM (C)","Kryvbas","Ukrainian Premier League","BIH","Yes","10/7/2022","6/30/2025","$0","Left","Very Strong","Reasonable","6'0""","167 lbs","182","30",114,135,13,13,13,11,11,12,9,13,8,8,15,11,10,13,12,12,10,11,9,14,11,14,10,10,9,13,14,13,12,12,11,10,13,12,11,11,17,12,12,12,11,12,5,14,5,2,12,11,12,2,3,4,2,3,2,4,3,1,4,2
"7065",25048609,"Eldar Ćivić","5/28/1996 (27 years old)","D/WB/M (L)","Ferencváros","Hungarian Division I","BIH","Yes","3/18/2022","6/30/2024","$1.6M - $3.4M","Left","Very Strong","Weak","6'0""","167 lbs","153","4",123,135,10,12,12,12,12,13,11,10,11,13,12,13,12,12,11,11,12,13,12,11,12,13,9,10,9,11,11,13,14,14,14,10,13,14,13,13,12,8,12,12,12,12,10,10,11,10,13,13,12,1,1,4,2,1,2,3,3,3,2,1
"7066",62023252,"Ognjen Vranješ","10/24/1989 (33 years old)","D (C)","Hatayspor","Turkish Super League","BIH","Yes","7/28/2022","6/30/2025","Not for Sale","Right Only","Weak","Very Strong","6'0""","165 lbs","281","15",110,135,5,7,10,8,10,6,12,7,10,14,9,10,12,10,19,13,17,12,9,12,15,5,8,10,13,12,8,12,10,12,14,14,15,10,12,14,6,6,5,7,13,9,7,13,16,19,9,12,13,2,3,3,3,2,3,2,2,2,2,1
"7067",93060314,"Dennis Hadžikadunić","7/9/1998 (24 years old)","D (C)","Mallorca","Spanish First Division","BIH","Yes","6/30/2021","5/31/2026","$300K - $9M","Right","Weak","Very Strong","6'3""","178 lbs","108","3",123,135,3,7,8,6,12,3,14,6,12,13,14,6,14,11,13,13,13,14,13,13,13,5,8,8,13,12,13,13,12,11,13,15,12,13,12,14,10,11,11,14,12,10,8,13,13,5,13,13,17,2,1,2,2,3,2,4,3,3,1,1
"7068",92026066,"Muhamed Bešić","9/10/1992 (30 years old)","DM, M (C)","Ferencváros","Hungarian Division I","BIH","Yes","6/30/2021","6/30/2025","$70K - $700K","Right","Weak","Very Strong","5'10""","176 lbs","222","5",109,135,6,6,10,5,12,8,11,9,7,15,13,11,12,14,16,13,14,11,11,11,18,12,13,10,11,12,11,13,11,13,13,8,13,13,14,12,12,10,11,14,12,11,15,11,16,8,12,15,13,1,1,2,2,2,2,2,4,3,3,1
"7069",21027284,"Stjepan Lončar","11/10/1996 (26 years old)","DM, M (C), AM (L)","KV Kortrijk","Jupiler Pro League","BIH","Yes","7/16/2021","6/30/2024","$80K - $800K","Left","Very Strong","Reasonable","6'2""","178 lbs","178","13",119,134,8,10,12,10,13,10,10,13,2,6,12,7,12,11,13,11,12,10,10,11,12,12,9,12,10,13,14,17,12,11,12,12,14,13,15,13,10,8,15,14,11,11,8,1,5,4,11,12,11,3,1,4,2,1,1,4,2,2,3,2
"7070",37084725,"Saïd Hamulić","11/12/2000 (22 years old)","AM (LC), ST (C)","Toulouse FC","Ligue 1 Uber Eats","BIH","Yes","1/24/2023","6/30/2027","$4.1M - $8M","Right","Reasonable","Very Strong","6'2""","167 lbs","73","31",118,133,6,7,13,12,12,7,14,11,6,6,11,8,6,13,7,12,10,12,10,12,13,13,9,12,7,12,11,12,13,12,11,12,10,13,13,13,8,11,10,11,11,10,7,10,6,3,13,9,8,1,2,2,1,2,2,1,1,1,2,3
"7071",35013742,"Ermin Bičakčić","1/24/1990 (33 years old)","D (C)","TSG Hoffenheim","Bundesliga","BIH","Yes","6/14/2021","6/30/2024","$110K - $1.1M","Right","Reasonable","Very Strong","6'1""","187 lbs","235","11",120,132,3,6,7,6,9,3,14,5,12,15,11,5,14,9,12,13,17,11,13,12,18,6,13,8,13,15,10,16,10,9,14,13,10,12,9,16,10,14,12,17,16,17,15,13,13,7,15,15,8,2,2,2,1,2,3,3,3,2,3,2
"7072",62071162,"Hrvoje Miličević","4/30/1993 (30 years old)","D (C), DM","AEK Larnakas","Cypriot First Division","BIH","Yes","12/24/2022","5/31/2025","$120K - $1.2M","Right","Weak","Very Strong","6'4""","182 lbs","228","11",115,132,3,8,8,7,12,7,12,10,12,13,10,8,14,10,16,13,15,11,10,9,14,7,11,10,13,12,10,14,12,11,13,15,13,13,13,15,13,10,10,12,10,12,5,9,13,3,15,11,10,1,3,1,2,2,3,3,3,1,3,1
"7073",13225585,"Shavy Babicka","6/1/2000 (23 years old)","M (R), AM (RL)","Aris Limassol","Cypriot First Division","GAB","No","8/6/2021","5/31/2024","$200K - $600K","Right Only","Weak","Very Strong","5'11""","158 lbs","63","11",100,116,8,12,12,9,14,8,7,7,8,7,14,5,9,14,5,10,6,10,10,10,5,13,5,10,8,9,8,13,14,14,9,6,11,14,10,5,14,13,12,12,13,9,14,1,12,1,20,12,8,1,2,3,1,2,1,2,3,4,3,2
"7074",21029564,"Jovo Lukić","11/28/1998 (24 years old)","ST (C)","Borac (BL)","Bosnian Premier League","BIH","Yes","7/27/2020","6/30/2025","$30K - $300K","Left","Very Strong","Reasonable","6'4""","194 lbs","199","75",89,132,6,2,12,11,12,6,11,6,1,5,2,5,3,7,10,13,6,9,7,13,3,7,9,7,5,6,7,7,13,9,7,13,12,12,12,13,9,10,4,14,13,13,12,16,6,4,20,9,20,2,2,2,1,1,2,2,1,4,3,3
"7075",21034343,"Petar Bojo","1/8/1998 (25 years old)","DM, M (C)","Zrinjski","Bosnian Premier League","BIH","Yes","1/2/2022","6/30/2025","$0","Right","Reasonable","Very Strong","5'9""","149 lbs","141","19",101,132,8,8,7,9,13,4,8,12,4,9,14,6,14,12,12,13,9,10,8,9,12,5,13,8,14,9,14,12,14,14,9,8,10,14,8,6,11,18,7,11,10,13,5,14,10,6,15,10,14,3,2,2,2,2,3,3,2,2,1,1
"7076",24064014,"Adrian Leon Barišić","7/19/2001 (21 years old)","D (C)","Osijek","Croatian First League","BIH","Yes","2/14/2023","6/30/2025","$700K - $7M","Right","Reasonable","Very Strong","6'1""","180 lbs","97","2",112,131,8,9,9,6,11,5,12,10,9,13,11,5,14,12,12,13,12,12,13,12,13,10,9,8,12,12,11,11,11,11,14,13,13,11,11,13,11,9,8,15,13,13,6,8,12,2,13,10,19,2,3,1,1,1,2,2,2,1,1,2
"7077",43141700,"Dario Šarić","5/30/1997 (26 years old)","DM, M/AM (C)","Palermo","Italian Serie B","BIH","Yes","8/30/2022","6/30/2026","$350K - $3.5M","Right","Fairly Strong","Very Strong","5'11""","163 lbs","174","9",119,130,10,12,12,12,11,10,8,13,4,11,11,7,11,13,13,13,14,12,12,12,14,12,12,12,10,11,11,11,13,12,12,10,11,13,13,14,12,10,12,11,10,12,8,10,8,8,10,10,12,3,1,3,2,3,2,1,2,2,2,2
"7078",21020532,"Haris Hajradinović","2/18/1994 (29 years old)","M/AM (C)","Kasımpaşa","Turkish Super League","BIH","Yes","6/20/2022","6/30/2026","$500K - $5M","Left","Very Strong","Weak","5'10""","154 lbs","298","49",120,130,12,13,14,10,14,13,6,13,6,5,16,16,8,15,12,13,9,14,10,12,12,14,13,10,9,14,15,13,13,13,12,5,13,12,13,9,14,7,8,13,10,12,7,13,11,10,14,12,10,3,3,3,4,2,3,1,3,1,1,1
"7079",21028821,"Hamza Čataković","1/15/1997 (26 years old)","AM (C), ST (C)","Sarajevo","Bosnian Premier League","BIH","Yes","1/30/2022","6/30/2024","$425K - $1.2M","Left","Very Strong","Fairly Strong","6'1""","178 lbs","154","49",105,130,6,7,12,14,14,11,12,10,8,6,10,7,7,10,12,10,11,8,9,10,10,13,9,12,9,10,12,10,12,11,9,13,10,11,9,13,15,14,12,14,9,12,11,9,9,6,7,9,18,1,3,2,2,3,3,4,2,3,2,1
"7080",62036693,"Gojko Cimirot","12/19/1992 (30 years old)","DM, M (C)","Standard","Jupiler Pro League","BIH","Yes","6/14/2021","6/30/2025","$5.6M - $10.5M","Right","Weak","Very Strong","5'10""","163 lbs","330","9",125,130,11,11,12,8,13,12,8,12,6,11,14,9,9,14,12,14,13,13,12,14,13,8,12,13,13,15,14,13,12,13,13,10,14,13,14,11,13,10,13,13,12,14,6,13,9,4,14,14,10,2,1,1,3,2,2,1,2,2,1,3
"7081",21024350,"Riad Bajić","5/6/1994 (29 years old)","ST (C)","Giresunspor","Turkish 1. League","BIH","Yes","7/29/2022","6/30/2025","$230K - $8M","Left","Very Strong","Fairly Strong","6'2""","176 lbs","270","82",125,130,7,9,12,14,13,7,14,13,5,5,13,14,6,12,6,13,10,12,13,12,9,7,9,13,10,13,12,14,12,11,13,13,13,13,12,13,7,15,13,13,10,14,10,12,5,4,10,10,16,1,2,2,2,3,1,2,3,2,1,1
"7082",24014860,"Elvis Šarić","7/21/1990 (32 years old)","DM, M (C)","QD Hainiu","Chinese Super League","BIH","Yes","2/22/2023","12/31/2023","$80K - $800K","Left","Very Strong","Strong","5'11""","165 lbs","326","49",115,130,14,12,15,11,14,13,7,13,4,9,14,14,9,15,12,10,9,13,8,13,12,15,7,12,10,9,12,12,11,13,11,10,12,11,11,9,7,13,13,12,11,14,13,13,11,6,10,10,14,3,1,1,4,1,3,2,1,1,2,4
"7083",43009443,"Milan Đurić","5/22/1990 (33 years old)","ST (C)","Hellas Verona","Italian Serie A","BIH","Yes","7/1/2022","6/30/2025","Not for Sale","Right","Weak","Very Strong","6'6""","207 lbs","433","76",126,130,3,3,5,11,12,6,19,10,3,5,12,14,6,13,14,15,16,13,13,14,17,7,11,15,9,18,11,17,11,9,16,18,16,11,13,19,5,13,14,18,12,14,5,12,14,8,11,15,18,3,2,2,2,3,2,3,4,3,1,2
"7084",85104273,"Mario Lemina","9/1/1993 (29 years old)","DM, M (C)","Wolves","English Premier Division","GAB","Yes","1/13/2023","6/30/2025","$19M - $23M","Right","Reasonable","Very Strong","6'0""","187 lbs","239","10",130,147,9,9,13,11,12,8,12,12,10,12,14,9,14,12,14,13,15,12,11,10,15,14,12,12,11,13,13,15,13,13,15,13,14,13,15,16,13,9,12,14,13,10,13,14,12,8,14,15,14,2,1,3,3,4,3,2,2,2,1,1
"7085",2000023599,"Alan Do Marcolino","3/19/2002 (21 years old)","ST (C)","Rennes","French National 3 - Group E","GAB","Yes","6/13/2022","6/30/2027","$12K - $130K","Right","Weak","Very Strong","6'4""","185 lbs","3","-",90,115,6,5,13,13,13,7,13,8,4,7,5,7,1,11,10,13,9,11,8,8,8,11,2,11,8,7,5,8,12,11,8,16,15,10,6,6,13,14,11,11,12,11,5,15,8,4,16,13,13,3,2,3,2,1,1,2,1,1,1,1
"7086",8403420,"Admir Ljevakovic","8/7/1984 (38 years old)","DM, M (C)","Teplice","Czech First Division","BIH","Yes","6/14/2021","6/30/2024","$0 - $10K","Right","Reasonable","Very Strong","6'0""","154 lbs","398","22",85,130,11,9,12,12,12,14,11,12,10,13,13,13,13,12,12,13,13,15,14,13,7,13,13,11,13,12,12,10,5,4,11,9,11,5,4,10,12,5,7,10,9,14,7,15,12,2,15,7,13,3,2,3,2,1,4,4,1,3,3,2
"7087",27010680,"Christian Eriksen","2/14/1992 (31 years old)","DM, M/AM (C)","Man UFC","English Premier Division","DEN","Yes","7/15/2022","6/30/2025","Not for Sale","Right","Strong","Very Strong","5'10""","167 lbs","421","82",150,170,16,16,12,14,18,15,3,14,3,4,17,16,6,17,7,15,6,15,14,16,16,14,8,14,8,17,17,12,11,12,12,8,17,11,12,7,12,19,18,18,15,15,4,13,3,2,13,16,8,1,4,1,2,3,2,1,3,1,3,1
"7088",27160181,"Rasmus Højlund","2/4/2003 (20 years old)","ST (C)","Atalanta","Italian Serie A","DEN","Yes","8/27/2022","6/30/2028","$79M - $95M","Left","Very Strong","Fairly Strong","6'3""","174 lbs","69","18",142,165,6,11,13,14,14,7,13,10,5,4,13,9,7,14,14,14,15,12,10,11,16,13,8,14,5,14,11,17,14,12,16,15,13,17,14,16,9,10,14,16,15,15,7,13,10,5,12,15,17,1,2,1,3,1,1,2,2,3,3,2
"7089",27066387,"Andreas Christensen","4/10/1996 (27 years old)","D (C)","Barcelona","Spanish First Division","DEN","Yes","6/30/2022","6/30/2026","$47M","Right","Reasonable","Very Strong","6'2""","171 lbs","178","6",157,165,5,9,11,9,14,5,15,8,12,15,14,9,14,14,11,17,12,16,16,17,11,7,9,9,16,15,10,13,12,14,12,14,14,15,13,12,15,18,16,13,14,10,5,15,6,5,15,15,16,2,1,1,3,3,3,2,3,3,4,2
"7090",27156352,"Maurits Kjærgaard","6/26/2003 (19 years old)","M/AM (C), ST (C)","FC RB Salzburg","Austrian Premier Division","DEN","Yes","8/3/2022","6/30/2026","$17M - $26M","Left","Very Strong","Fairly Strong","6'4""","169 lbs","90","11",128,165,5,8,12,9,11,13,13,12,6,8,11,6,11,13,13,12,14,11,10,10,15,8,10,14,9,13,12,13,14,12,15,16,14,14,13,16,9,13,12,14,13,13,5,10,5,9,11,16,16,3,1,3,3,3,3,2,2,2,2,3
"7091",27148020,"Mohamed Daramy","1/7/2002 (21 years old)","AM (RL)","Ajax","Eredivisie","DEN","Yes","8/28/2021","6/30/2027","$12M - $18M","Right","Reasonable","Very Strong","5'11""","165 lbs","123","22",137,160,6,11,16,11,13,7,9,9,3,4,12,5,3,15,10,13,10,12,10,14,14,15,5,14,5,12,13,10,16,15,15,11,13,16,14,13,12,13,16,14,13,15,6,14,6,3,13,15,17,2,2,1,3,3,1,1,1,3,2,3
"7092",67283140,"Filip Jörgensen","4/16/2002 (21 years old)","GK","Villarreal","Spanish First Division","DEN","Yes","10/15/2020","6/30/2025","$56M - $86M","Right","Weak","Very Strong","6'2""","169 lbs","43","-",139,160,5,2,3,1,14,8,8,2,2,3,13,2,1,12,5,11,13,9,9,10,12,1,8,2,15,14,8,12,12,16,10,15,15,12,15,16,14,14,12,10,11,11,10,6,11,2,10,9,10,14,14,16,13,15,13,15,6,10,15,16
"7093",27128917,"Mikkel Damsgaard","7/3/2000 (22 years old)","M (RL), AM (RLC)","Brentford","English Premier Division","DEN","Yes","8/10/2022","6/30/2027","$74M - $89M","Right","Strong","Very Strong","5'11""","156 lbs","156","15",136,158,13,13,15,12,12,11,6,12,6,5,14,12,6,16,10,12,10,11,12,11,14,16,6,14,7,12,16,12,14,14,12,6,10,14,12,8,16,14,13,13,10,12,12,12,4,4,11,13,12,1,3,2,1,1,1,1,2,2,1,2
"7094",27132198,"Morten Frendrup","4/7/2001 (22 years old)","DM, M (C)","Genoa","Italian Serie A","DEN","Yes","1/30/2022","6/30/2026","$8.4M - $12.5M","Right","Fairly Strong","Very Strong","5'10""","156 lbs","125","4",133,156,8,10,9,10,13,8,13,10,6,15,13,7,15,13,15,12,13,12,13,13,12,7,12,13,13,14,13,17,13,13,11,9,13,14,15,11,15,14,14,15,12,15,5,12,9,3,13,15,14,2,2,1,2,1,3,3,3,3,3,1
"7095",27024000,"Jores Okore","8/11/1992 (30 years old)","D (C)","Changchun","Chinese Super League","DEN","Yes","2/25/2021","12/31/2023","$130K - $1.3M","Right","Fairly Strong","Very Strong","6'0""","194 lbs","274","11",117,155,4,6,10,6,12,6,12,4,9,15,10,5,15,9,16,13,16,12,11,10,12,8,11,6,13,13,7,13,9,9,13,13,11,14,13,16,8,7,13,7,15,8,12,12,8,15,11,15,14,1,1,4,1,3,1,2,2,3,4,3
"7096",13112864,"Malick Evouna","11/28/1992 (30 years old)","ST (C)","Aswan","Egyptian Second Division - Group 1","GAB","No","7/4/2022","7/31/2024","$35K - $325K","Right","Reasonable","Very Strong","5'11""","176 lbs","119","51",99,115,2,8,13,12,8,7,10,10,2,2,8,9,4,11,13,8,8,10,9,8,9,12,5,11,6,8,11,9,14,11,13,11,11,13,12,13,8,7,13,10,8,12,13,10,3,9,10,14,11,3,3,2,3,3,1,3,1,3,3,3
"7097",27000592,"Mathias Jørgensen","4/23/1990 (33 years old)","D (C)","Brentford","English Premier Division","DEN","Yes","5/15/2023","6/30/2025","$200K - $2M","Right","Fairly Strong","Very Strong","6'3""","174 lbs","357","20",126,155,5,5,11,7,13,8,13,6,11,13,14,7,13,13,12,13,13,15,11,11,13,9,14,7,14,13,12,12,12,11,15,15,13,12,13,14,7,8,8,12,16,10,9,17,16,16,12,14,16,1,2,2,2,1,1,2,2,1,3,2
"7098",947424,"Simon Kjær","3/26/1989 (34 years old)","D (C)","AC Milan","Italian Serie A","DEN","Yes","10/27/2021","6/30/2024","$450K - $4.4M","Right","Reasonable","Very Strong","6'3""","189 lbs","402","14",142,155,4,6,5,4,10,11,15,4,7,16,14,12,15,11,15,15,17,17,16,14,20,4,18,5,17,18,12,14,9,9,15,15,14,10,11,15,6,14,20,20,14,13,11,15,11,9,16,18,15,2,1,1,2,1,1,3,2,3,3,2
"7099",27058550,"Pione Sisto","2/4/1995 (28 years old)","M/AM (RL)","FC Midtjylland","3F Superliga","DEN","Yes","9/5/2020","6/30/2024","$170K - $1.7M","Right","Fairly Strong","Very Strong","5'7""","141 lbs","266","44",124,155,13,14,15,11,15,13,7,14,3,5,13,11,7,16,11,13,6,10,7,9,6,14,3,14,5,8,11,7,15,14,14,7,12,14,11,9,14,15,14,5,7,9,4,11,3,18,7,8,4,1,2,3,1,1,2,2,3,2,2,3
"7100",27161400,"Victor Kristiansen","12/16/2002 (20 years old)","D/WB (L)","Leicester","Sky Bet Championship","DEN","Yes","1/20/2023","6/30/2028","$12M - $18M","Left","Very Strong","Reasonable","6'0""","160 lbs","63","1",133,152,12,13,12,8,13,10,11,9,7,12,12,5,13,13,16,12,15,13,12,13,16,11,12,13,12,14,12,14,13,12,12,12,15,15,16,12,12,11,13,15,15,17,6,14,5,5,13,15,15,2,3,3,2,1,1,2,2,3,2,1
"7101",27143432,"Jesper Lindstrøm","2/29/2000 (23 years old)","AM (RLC)","Eintracht Frankfurt","Bundesliga","DEN","Yes","7/11/2021","6/30/2026","$28M - $42M","Right","Reasonable","Very Strong","6'0""","145 lbs","113","25",138,152,13,11,14,12,12,13,7,11,6,8,13,12,10,14,11,13,12,12,11,13,13,15,6,15,9,12,13,15,16,16,10,9,14,15,13,8,12,12,12,14,12,14,8,12,7,5,12,15,12,3,1,3,2,3,1,4,2,2,1,3
"7102",27058392,"Pierre-Emile Højbjerg","8/5/1995 (27 years old)","DM, M (C)","Tottenham","English Premier Division","DEN","Yes","8/11/2020","6/30/2025","$46M - $69M","Right","Reasonable","Very Strong","6'1""","185 lbs","318","26",144,151,12,12,11,11,14,13,8,9,10,10,14,13,15,14,17,13,15,13,14,13,18,11,13,13,12,15,14,17,11,11,14,12,20,14,20,15,17,10,7,15,15,9,6,14,13,14,13,18,14,1,3,2,2,3,1,2,2,3,2,1
"7103",27069975,"Joachim Andersen","5/31/1996 (27 years old)","D (C)","Crystal Palace","English Premier Division","DEN","Yes","7/28/2021","6/30/2026","$31M - $39M","Right","Fairly Strong","Very Strong","6'4""","187 lbs","244","7",146,151,8,9,10,6,13,11,14,8,5,15,16,9,14,14,14,15,13,15,14,13,15,11,13,11,14,14,14,12,13,11,13,17,14,12,13,14,8,14,13,16,14,12,7,12,13,3,14,15,11,3,3,1,1,1,1,1,2,3,1,4
"7104",5114022,"Kasper Schmeichel","11/5/1986 (36 years old)","GK","OGC Nice","Ligue 1 Uber Eats","DEN","Yes","8/3/2022","6/30/2025","Not for Sale","Right","Fairly Strong","Very Strong","6'2""","185 lbs","607","-",143,150,4,3,2,3,8,9,13,2,1,3,8,5,1,10,17,14,15,12,14,13,15,2,16,1,12,14,13,14,11,13,8,11,12,10,12,10,11,6,13,12,15,14,4,12,9,15,12,17,11,16,12,15,16,16,16,15,14,13,14,11
"7105",27129146,"Gustav Isaksen","4/19/2001 (22 years old)","M (R), AM (RL)","FC Midtjylland","3F Superliga","DEN","Yes","6/15/2020","12/31/2024","$13M - $20M","Right","Strong","Very Strong","5'11""","149 lbs","97","24",134,150,12,13,15,12,14,12,9,12,4,7,13,7,5,15,14,14,10,13,12,12,15,14,7,15,5,14,13,13,15,15,12,10,13,14,10,8,15,9,12,14,11,13,8,10,12,8,13,14,12,2,2,3,2,3,2,3,2,1,1,1
"7106",2000013326,"William Clem","6/20/2004 (18 years old)","DM, M (C)","FC København","3F Superliga","DEN","Yes","1/19/2023","6/30/2027","$650K - $9.2M","Right","Weak","Very Strong","6'1""","154 lbs","17","-",116,150,5,11,10,12,13,6,12,13,5,12,13,5,11,13,13,12,15,12,12,13,14,12,11,11,12,15,13,14,12,12,13,14,13,12,15,8,10,13,16,15,13,16,6,12,7,4,12,14,16,1,1,3,3,2,3,3,1,2,3,3
"7107",85028010,"Johann Obiang","7/5/1993 (29 years old)","D/WB/M (L)","SM Caen","Ligue 2 BKT","GAB","Yes","7/1/2022","6/30/2025","$0","Left Only","Very Strong","Weak","5'7""","141 lbs","226","5",108,115,7,12,11,7,11,7,7,9,11,10,12,7,12,10,10,12,11,12,11,11,13,11,8,12,11,12,10,13,14,14,12,5,12,13,13,9,12,12,15,13,11,14,10,10,8,6,12,12,10,1,2,2,2,1,3,1,1,2,3,3
"7108",936891,"Daniel Wass","5/31/1989 (34 years old)","D/WB (R), DM, M (RC)","Brøndby IF","3F Superliga","DEN","Yes","8/12/2022","6/30/2025","Not for Sale","Right","Weak","Very Strong","5'10""","154 lbs","502","55",135,150,13,14,13,11,14,15,10,14,14,11,13,9,12,13,13,13,12,12,12,13,13,11,8,13,13,14,13,14,12,12,12,9,13,12,12,12,19,11,11,15,17,13,4,14,12,7,11,16,17,2,3,1,1,1,3,3,1,2,3,2
"7109",27024589,"Andreas Cornelius","3/16/1993 (30 years old)","ST (C)","FC København","3F Superliga","DEN","Yes","8/31/2022","6/30/2027","$3.6M - $7M","Left","Very Strong","Reasonable","6'4""","200 lbs","283","81",129,150,6,7,12,14,12,7,15,12,5,5,12,10,7,12,14,14,14,13,12,12,14,8,10,12,6,15,12,16,10,10,13,17,16,14,13,18,6,11,13,13,15,14,19,14,15,6,12,13,14,3,2,3,3,4,1,2,2,1,3,1
"7110",27102367,"Daniel Iversen","7/19/1997 (25 years old)","GK","Leicester","Sky Bet Championship","DEN","Yes","2/28/2020","6/30/2025","$5.4M - $6.8M","Right","Weak","Very Strong","6'4""","176 lbs","162","-",126,150,5,2,3,1,10,7,2,2,1,1,7,3,2,6,8,12,13,12,12,12,14,3,11,2,13,12,10,11,9,14,10,15,12,9,12,14,14,15,14,20,6,12,3,10,5,2,14,14,15,13,9,15,14,15,9,13,4,13,14,14
"7111",27132703,"Morten Hjulmand","6/25/1999 (23 years old)","DM, M (C)","Salento","Italian Serie A","DEN","Yes","1/16/2021","6/30/2028","$15.5M - $19.5M","Right","Reasonable","Very Strong","6'1""","169 lbs","159","1",142,150,8,10,13,9,14,7,9,14,9,13,14,7,15,14,16,14,15,13,14,13,17,9,12,13,14,16,14,14,13,13,13,9,16,13,14,14,10,13,13,14,14,11,7,12,12,5,15,14,11,1,2,1,2,3,2,3,1,3,3,2
"7112",27013431,"Jannik Vestergaard","8/3/1992 (30 years old)","D (C)","Leicester","Sky Bet Championship","DEN","Yes","8/13/2021","6/30/2024","$4.4M","Right","Fairly Strong","Very Strong","6'6""","211 lbs","289","22",129,150,5,6,12,7,9,12,16,11,14,15,14,7,15,13,10,12,15,14,14,13,14,6,12,5,12,16,13,14,7,7,13,18,12,7,12,17,6,11,15,16,14,11,7,13,6,11,12,15,13,3,1,1,2,3,3,2,2,1,3,1
"7113",27161401,"Elias Jelert","6/12/2003 (20 years old)","D/WB (RL)","FC København","3F Superliga","DEN","Yes","6/13/2022","12/31/2024","$7.4M - $9M","Right","Reasonable","Very Strong","5'7""","123 lbs","37","1",123,150,11,11,13,9,13,2,8,9,4,10,14,6,12,13,15,12,15,12,11,12,15,13,4,14,10,14,13,15,15,14,13,5,15,15,14,6,15,12,14,15,15,15,3,13,8,8,12,15,15,1,1,1,2,3,1,2,1,2,1,2
"7114",27129532,"Alexander Bah","12/9/1997 (25 years old)","D/WB/M/AM (R)","Benfica","Portuguese Premier League","DEN","Yes","6/7/2022","6/30/2027","$13M - $20M","Right","Reasonable","Very Strong","6'0""","174 lbs","207","20",140,150,12,14,13,10,13,7,11,12,12,10,13,7,13,14,13,14,13,10,9,10,14,13,6,13,8,13,13,14,16,14,11,11,13,15,14,11,15,14,13,14,10,11,8,9,8,8,12,12,15,4,2,3,3,1,2,3,3,2,1,3
"7115",27139716,"Mads Bidstrup","2/25/2001 (22 years old)","DM, M (C)","Brentford","English Premier Division","DEN","Yes","7/16/2020","6/30/2026","$12.5M - $19M","Right","Reasonable","Very Strong","5'10""","152 lbs","51","-",130,148,10,12,13,9,13,9,10,11,6,13,13,6,13,13,13,13,14,14,13,13,16,9,12,12,14,15,13,16,12,13,12,9,15,12,17,11,13,12,13,14,12,9,6,16,10,4,12,15,15,3,3,3,2,1,1,2,2,2,1,2
"7116",27139574,"Albert Grønbæk","5/23/2001 (22 years old)","M (C), AM (RLC)","Bodø/Glimt","Norwegian Premier Division","DEN","Yes","5/10/2023","12/31/2027","$300K - $9M","Right","Fairly Strong","Very Strong","6'1""","160 lbs","95","12",126,147,12,12,14,11,15,12,10,13,8,8,12,10,6,14,13,12,13,12,11,12,10,15,7,12,8,13,12,14,14,15,13,12,14,13,14,8,12,10,9,11,12,10,5,13,10,7,13,10,10,2,2,4,2,1,3,1,3,1,2,3
"7117",27039017,"Christian Nørgaard","3/10/1994 (29 years old)","DM, M (C)","Brentford","English Premier Division","DEN","Yes","1/1/2022","6/30/2025","$49M - $59M","Right","Fairly Strong","Very Strong","6'2""","167 lbs","261","15",144,146,9,10,12,9,14,9,14,9,9,14,14,8,14,14,14,14,14,14,15,14,15,12,15,12,15,15,16,16,12,11,13,14,15,12,16,12,16,14,16,14,14,14,10,15,3,4,15,14,14,4,2,3,2,1,3,2,3,1,2,3
"7118",2000026694,"Orphé Mbina","11/2/2000 (22 years old)","ST (C)","FC Chamalières","French National 2 - A","GAB","No","7/1/2022","6/30/2024","$50K - $500K","Right","Weak","Very Strong","6'0""","182 lbs","50","18",97,114,9,12,10,13,10,6,12,9,2,8,10,13,8,12,6,11,9,12,9,9,12,9,9,10,12,8,9,13,12,12,8,13,12,11,12,13,8,13,11,9,10,11,5,12,10,10,12,12,9,2,3,2,2,1,2,1,1,3,2,3
"7119",27002693,"Thomas Delaney","9/3/1991 (31 years old)","DM, M (C)","TSG Hoffenheim","Bundesliga","DEN","Yes","7/1/2021","6/30/2025","$5M - $9.6M","Left","Very Strong","Reasonable","6'0""","174 lbs","320","32",132,146,4,8,10,7,12,13,16,12,12,13,12,10,15,12,15,13,17,13,14,13,18,8,16,11,13,16,12,17,11,11,14,13,14,12,16,13,15,12,15,18,13,14,12,15,14,4,13,13,17,1,2,1,3,3,3,1,1,1,1,1
"7120",2000005988,"Thomas Kristensen","1/17/2002 (21 years old)","D (C)","AGF","3F Superliga","DEN","Yes","12/1/2021","6/30/2026","$5.6M - $8.6M","Right","Reasonable","Very Strong","6'6""","187 lbs","33","1",119,145,5,7,10,8,11,7,12,7,7,13,12,6,13,12,13,12,12,12,10,11,12,7,9,9,13,14,11,14,11,10,12,18,12,13,12,14,9,10,13,13,10,12,7,7,8,5,12,15,12,3,3,2,3,2,3,2,1,1,1,1
"7121",27122565,"Jonas Wind","2/7/1999 (24 years old)","AM (C), ST (C)","VfL Wolfsburg","Bundesliga","DEN","Yes","1/31/2022","6/30/2026","$15M - $18.5M","Right","Fairly Strong","Very Strong","6'3""","180 lbs","126","47",138,145,2,7,11,15,15,12,15,11,6,7,14,17,7,16,11,14,13,15,12,13,15,14,8,13,7,12,14,12,11,12,16,16,13,11,13,16,11,15,14,15,14,18,12,15,7,8,14,15,15,3,1,3,2,3,3,2,2,2,1,2
"7122",27100968,"Rasmus Kristensen","7/11/1997 (25 years old)","D/WB/M (R)","Leeds","Sky Bet Championship","DEN","Yes","6/8/2022","6/30/2027","$10.5M - $16M","Right","Reasonable","Very Strong","6'2""","154 lbs","182","19",134,145,9,15,11,10,12,8,13,9,13,12,11,9,13,11,18,12,15,11,11,12,15,11,13,12,11,14,11,15,13,13,14,14,14,14,15,14,15,11,12,14,13,14,5,12,11,6,15,17,9,1,3,2,3,3,2,2,3,3,3,2
"7123",27088231,"Mathias Jensen","1/1/1996 (27 years old)","M (C)","Brentford","English Premier Division","DEN","Yes","1/18/2023","6/30/2026","$37M - $46M","Right","Strong","Very Strong","5'11""","156 lbs","221","23",142,145,13,13,13,10,14,12,9,11,17,9,14,11,13,14,9,14,13,14,13,14,14,14,13,13,12,14,16,15,12,12,12,10,13,12,13,12,13,14,13,13,13,14,11,13,8,4,14,15,15,2,3,1,4,3,4,1,2,3,2,2
"7124",27051813,"Yussuf Poulsen","6/15/1994 (28 years old)","AM (R), ST (C)","RB Leipzig","Bundesliga","DEN","Yes","10/3/2020","6/30/2024","$6.4M - $7.8M","Right","Fairly Strong","Very Strong","6'4""","185 lbs","315","81",135,145,2,8,12,12,12,5,14,8,7,8,11,12,10,12,17,12,17,12,15,12,17,13,13,15,8,18,11,18,13,11,14,17,15,15,14,16,8,9,15,13,12,18,12,15,8,9,13,13,15,3,1,3,3,3,1,4,3,3,1,3
"7125",29186052,"Matt O'Riley","11/21/2000 (22 years old)","DM, M/AM (C)","Celtic","cinch Premiership","DEN","Yes","1/20/2022","5/31/2026","$12.5M - $19M","Left","Very Strong","Fairly Strong","6'2""","169 lbs","104","17",126,145,13,12,13,12,16,8,11,10,5,8,14,8,10,15,12,13,8,14,12,14,14,13,9,13,11,13,13,12,12,11,14,14,14,12,13,12,10,16,10,13,12,10,4,14,7,7,16,17,12,2,1,1,1,1,3,4,2,3,1,1
"7126",27039538,"Lucas Andersen","9/13/1994 (28 years old)","M/AM (LC)","AaB","NordicBet Liga","DEN","Yes","6/15/2020","6/30/2024","$210K - $2.1M","Right","Fairly Strong","Very Strong","5'11""","158 lbs","305","50",109,145,11,11,13,10,15,14,7,11,15,4,13,13,7,15,10,12,7,11,10,10,8,16,13,13,6,12,13,11,10,13,10,9,10,10,11,7,15,13,13,13,8,17,16,11,8,5,8,12,10,3,2,4,3,1,2,4,1,2,3,1
"7127",27013502,"Nicolai Boilesen","2/16/1992 (31 years old)","D (LC), WB (L)","FC København","3F Superliga","DEN","Yes","7/22/2022","6/30/2025","Not for Sale","Left","Very Strong","Weak","6'1""","165 lbs","184","4",128,145,11,13,13,5,14,10,10,8,6,13,14,8,12,15,13,14,14,15,14,13,15,12,15,14,14,14,14,12,12,12,13,14,14,12,13,11,13,14,16,16,15,15,20,15,5,6,13,18,18,2,2,2,1,1,2,1,1,2,3,4
"7128",27137333,"Jacob Christensen","6/25/2001 (21 years old)","DM, M (C)","FC Nordsjælland","3F Superliga","DEN","Yes","6/13/2022","12/31/2024","$1.8M - $3.7M","Right","Weak","Very Strong","5'11""","152 lbs","141","1",122,145,11,9,12,6,13,11,8,9,8,13,13,12,13,14,16,14,16,14,14,12,14,9,11,12,13,14,13,14,12,12,13,10,14,12,14,12,10,11,14,14,13,12,4,11,14,5,13,12,7,1,2,3,4,1,3,3,3,1,1,2
"7129",34004939,"Gilles M'Bang Ondo","10/10/1985 (37 years old)","ST (C)","Porrentruy","Swiss Lower Division","GAB","Yes","2/9/2022","-","$0","Right Only","Weak","Very Strong","6'2""","194 lbs","226","95",58,114,4,5,11,11,10,7,12,7,2,3,9,12,2,11,12,8,11,10,8,8,12,10,6,10,9,8,8,9,8,7,8,10,7,10,8,12,10,13,9,15,13,13,10,11,7,7,12,8,15,3,3,4,3,3,4,1,3,2,3,1
"7130",27100970,"Mikkel Duelund","6/29/1997 (25 years old)","M (LC), AM (RLC)","AGF","3F Superliga","DEN","Yes","6/15/2020","6/30/2024","$275K - $8.4M","Right","Strong","Very Strong","5'11""","154 lbs","164","27",126,145,13,12,14,10,13,13,10,12,7,7,14,13,7,15,7,13,10,11,10,9,13,14,8,13,8,8,14,8,15,13,12,10,13,12,12,9,12,9,8,8,11,9,14,12,13,13,8,17,9,1,4,3,1,1,3,1,3,1,1,2
"7131",27010681,"Rasmus Falk","1/15/1992 (31 years old)","DM, M/AM (C)","FC København","3F Superliga","DEN","Yes","12/12/2020","6/30/2025","Not for Sale","Right","Reasonable","Very Strong","5'10""","143 lbs","340","42",131,145,5,10,15,6,16,5,5,6,3,6,15,8,8,16,15,15,13,15,13,14,14,15,12,14,10,15,14,15,14,15,16,6,16,11,14,9,13,14,18,15,14,18,16,15,3,6,14,13,14,3,2,1,1,2,3,2,3,1,3,3
"7132",27013113,"Martin Braithwaite","6/5/1991 (32 years old)","AM (RL), ST (C)","Espanyol","Spanish Second Division","DEN","Yes","7/1/2022","6/30/2024","$4.8M - $9.2M","Right","Fairly Strong","Very Strong","5'10""","169 lbs","393","89",140,145,8,11,12,12,12,9,11,10,4,3,11,10,5,12,12,13,13,13,15,13,15,14,13,15,5,16,12,15,14,14,12,12,14,15,14,13,13,16,15,16,12,14,11,14,7,6,12,15,14,3,3,2,3,2,4,2,4,2,4,2
"7133",27088214,"Emiliano Marcondes","3/9/1995 (28 years old)","AM (LC), ST (C)","FC Nordsjælland","3F Superliga","DEN","Yes","7/3/2021","6/30/2024","$230K - $8.6M","Right","Reasonable","Very Strong","6'0""","167 lbs","231","47",120,145,12,12,14,14,14,12,6,13,6,4,13,12,4,15,13,14,10,13,10,11,12,16,6,13,5,8,13,12,13,14,12,11,11,13,12,8,13,12,10,13,9,13,12,14,12,10,10,16,13,1,2,1,1,2,1,1,2,2,3,3
"7134",27000547,"Erik Sviatchenko","10/4/1991 (31 years old)","D (C)","Houston","Major League Soccer","DEN","Yes","3/24/2023","12/31/2024","Not for Sale","Right","Reasonable","Very Strong","6'1""","180 lbs","313","27",129,145,6,7,8,7,12,6,16,7,9,14,12,7,14,9,16,14,15,13,13,13,14,8,16,8,14,13,9,12,11,8,13,16,14,11,12,14,11,13,13,14,13,17,11,14,11,6,11,17,14,3,2,3,3,4,1,3,3,4,3,1
"7135",27097823,"Markus Bay","2/17/1997 (26 years old)","M/AM (C)","Fremad Amager","2. Division","DEN","Yes","4/16/2021","6/30/2024","$0","Right","Reasonable","Very Strong","6'0""","178 lbs","173","18",87,145,7,10,13,10,13,9,10,9,5,4,12,9,5,13,10,9,8,11,7,9,15,11,6,14,5,7,12,14,13,10,9,6,13,13,12,8,7,14,14,10,6,12,10,11,4,4,11,16,8,2,2,1,3,3,3,3,2,1,2,3
"7136",27043902,"Lasse Vigen","8/15/1994 (28 years old)","M (C)","Silkeborg IF","3F Superliga","DEN","Yes","1/5/2023","6/30/2024","$190K - $1.9M","Right","Reasonable","Very Strong","5'10""","158 lbs","228","18",119,144,10,11,10,10,13,10,7,11,5,10,14,11,12,12,13,13,12,14,12,13,15,12,14,10,12,14,12,15,11,12,13,9,11,12,12,12,14,12,14,13,12,12,13,11,4,4,10,12,5,3,2,4,3,2,1,2,4,1,1,3
"7137",27122563,"Mads Roerslev","6/24/1999 (23 years old)","D/WB (R)","Brentford","English Premier Division","DEN","Yes","2/15/2023","6/30/2026","$31M - $39M","Right","Reasonable","Very Strong","6'0""","147 lbs","79","1",136,144,12,13,13,9,13,7,12,9,12,13,14,7,13,14,13,13,14,13,14,14,14,14,9,11,14,14,13,14,14,13,12,12,14,14,14,12,13,12,14,13,11,13,6,13,7,5,13,13,12,4,1,3,1,3,1,1,2,2,2,2
"7138",27097478,"Joakim Mæhle","5/20/1997 (26 years old)","D/WB (RL)","Atalanta","Italian Serie A","DEN","Yes","1/4/2021","6/30/2027","$700K - $11M","Right","Reasonable","Very Strong","6'1""","174 lbs","209","9",138,144,6,12,13,9,13,6,8,11,13,10,12,8,11,13,15,12,11,12,10,11,15,14,10,14,10,15,12,16,14,13,12,11,16,15,17,12,17,13,14,12,11,14,7,14,8,5,12,15,17,3,1,1,1,3,3,3,3,2,1,1
"7139",27014805,"Kasper Kusk","11/10/1991 (31 years old)","M (R), AM (RL), ST (C)","Silkeborg IF","3F Superliga","DEN","Yes","8/31/2022","6/30/2024","$650K - $1.5M","Left","Very Strong","Reasonable","5'11""","147 lbs","341","61",117,144,14,14,13,11,14,12,6,11,8,5,14,11,6,15,7,13,7,12,11,10,7,14,8,13,6,10,15,8,13,14,11,9,10,13,9,6,12,16,12,12,7,18,5,12,5,5,11,12,6,1,3,2,3,1,3,2,1,2,1,1
"7140",49038999,"Ulrick Enémé Ella","5/22/2001 (22 years old)","AM (C), ST (C)","Angers SCO","Ligue 2 BKT","GAB","Yes","7/1/2022","6/30/2025","$40K - $400K","Right","Reasonable","Very Strong","6'0""","202 lbs","18","3",96,112,5,7,10,11,10,5,13,11,5,10,9,10,10,10,8,10,10,10,9,8,13,8,12,11,11,11,10,13,12,11,14,12,14,12,11,13,11,16,8,13,11,10,12,17,9,7,15,12,7,3,2,2,2,3,1,2,3,2,3,3
"7141",2000090977,"Mads Beyer","8/25/2005 (17 years old)","M/AM (C)","Brøndby IF","3F Superliga","DEN","Yes","3/19/2022","12/31/2024","$750K - $1.6M","Right Only","Weak","Very Strong","6'2""","158 lbs","-","-",68,144,5,3,7,8,12,5,5,5,1,5,13,1,5,13,8,11,7,8,5,12,11,13,8,6,4,10,11,10,11,10,5,13,8,10,13,5,9,12,12,13,9,12,9,12,5,8,8,12,17,3,1,3,2,1,1,4,2,1,2,3
"7142",62127037,"Sergej Milinković-Savić","2/27/1995 (28 years old)","M/AM (C)","Lazio","Italian Serie A","SRB","Yes","6/14/2021","6/30/2027","$43M - $52M","Right","Strong","Very Strong","6'3""","180 lbs","304","64",160,170,8,9,14,15,15,14,17,15,6,8,16,13,12,15,14,15,17,13,11,14,16,16,14,17,11,15,15,15,11,11,17,16,20,13,17,18,12,12,12,16,14,16,5,16,14,4,15,15,13,3,2,3,1,2,3,2,3,3,2,1
"7143",62220026,"Strahinja Pavlović","5/24/2001 (22 years old)","D (C)","FC RB Salzburg","Austrian Premier Division","SRB","No","7/1/2022","6/30/2027","$18.5M - $28M","Left","Very Strong","Reasonable","6'4""","185 lbs","90","3",133,167,5,5,8,6,11,6,14,9,8,14,10,8,14,11,14,13,15,14,12,11,14,10,12,9,15,15,10,14,11,11,14,16,14,13,14,16,7,12,12,12,12,13,11,12,13,9,15,13,11,3,3,3,3,3,2,3,3,3,4,2
"7144",62182055,"Dušan Vlahović","1/28/2000 (23 years old)","ST (C)","Juventus","Italian Serie A","SRB","No","1/28/2022","6/30/2026","$64M - $80M","Left","Very Strong","Reasonable","6'3""","178 lbs","161","62",156,165,7,8,13,17,12,16,15,14,7,5,12,18,7,13,14,18,16,15,15,14,15,14,11,14,7,14,12,15,12,13,15,15,13,15,16,18,8,13,9,15,12,10,10,12,11,10,13,17,12,2,1,2,2,2,2,2,3,2,1,3
"7145",62000307,"Nemanja Matić","8/1/1988 (34 years old)","DM, M (C)","AS Roma","Italian Serie A","SRB","Yes","3/20/2023","6/30/2024","$210K - $2.1M","Left","Very Strong","Reasonable","6'4""","187 lbs","453","20",146,165,10,11,12,8,15,10,16,14,5,13,15,12,16,15,10,15,14,16,13,14,13,4,14,10,16,16,13,13,10,10,19,16,10,10,12,17,10,11,11,18,16,16,7,13,11,5,14,13,13,1,2,1,1,2,2,1,1,3,2,1
"7146",91182849,"Lazar Samardžić","2/24/2002 (21 years old)","M/AM (C)","Udinese","Italian Serie A","SRB","Yes","8/5/2021","6/30/2026","$53M - $64M","Left","Very Strong","Fairly Strong","6'0""","174 lbs","74","8",146,165,15,15,16,13,16,16,6,16,5,6,15,13,6,16,13,13,11,14,12,13,13,16,8,14,8,13,16,11,14,15,15,12,11,13,13,12,13,14,9,13,14,7,12,11,12,13,13,15,13,1,3,2,3,2,2,1,3,2,3,3
"7147",5788648,"Dušan Tadić","11/20/1988 (34 years old)","AM (RLC), ST (C)","Ajax","Eredivisie","SRB","No","6/14/2021","6/30/2024","$500K - $9M","Left","Very Strong","Reasonable","5'11""","167 lbs","535","168",150,160,15,15,13,12,16,16,8,12,9,6,18,17,4,16,18,17,17,12,15,16,18,15,19,14,6,15,15,17,12,11,14,9,20,12,13,13,13,9,9,19,16,9,1,17,13,5,14,8,14,2,3,1,1,2,1,1,1,2,2,3
"7148",62000815,"Ljubomir Fejsa","8/14/1988 (34 years old)","DM, M (C)","Partizan","Serbian SuperLeague","SRB","No","1/26/2022","6/30/2024","$5K - $50K","Right","Reasonable","Very Strong","6'0""","182 lbs","301","6",110,156,7,7,9,7,12,7,12,8,6,13,12,9,14,11,14,13,14,12,13,13,13,8,13,8,13,14,12,14,8,11,13,12,12,9,12,14,8,12,14,14,13,14,12,14,15,4,14,14,14,2,2,2,3,1,1,1,3,1,2,3
"7149",2000155569,"Jovan Mijatović","7/11/2005 (17 years old)","AM (RL), ST (C)","Crvena zvezda","Serbian SuperLeague","SRB","No","6/13/2022","6/30/2026","$4.5M - $8.8M","Left","Very Strong","Reasonable","5'11""","154 lbs","20","6",103,156,11,9,12,12,10,9,10,12,10,5,10,10,8,13,11,10,9,12,10,11,11,12,7,9,12,7,11,10,11,12,12,12,12,12,12,12,8,12,8,11,11,9,9,12,8,4,10,12,10,3,1,1,2,3,3,3,3,3,2,3
"7150",62201068,"Ivan Ilić","3/17/2001 (22 years old)","DM, M/AM (C)","Torino","Italian Serie A","SRB","No","8/12/2021","6/30/2028","$13M - $19.5M","Left","Very Strong","Reasonable","6'0""","165 lbs","124","11",138,155,13,14,14,10,14,12,9,13,9,9,14,10,13,15,10,14,12,14,12,13,15,13,9,12,12,16,14,13,13,13,13,12,15,14,14,12,11,12,11,17,12,12,6,12,9,6,13,15,16,1,4,3,2,2,3,3,2,2,2,1
"7151",2000167208,"Eric Bocoum","3/10/1996 (27 years old)","ST (C)","Gol Gohar","Persian Gulf Premier League","GAB","No","11/9/2021","6/30/2024","$110K - $1.1M","Right","Reasonable","Very Strong","6'5""","178 lbs","24","2",105,112,8,4,13,13,13,8,14,7,7,8,9,9,3,14,14,14,8,10,9,10,4,13,3,13,7,7,5,9,14,13,8,13,13,14,12,6,13,14,10,11,13,10,7,10,13,5,14,12,11,3,2,1,1,2,2,3,2,3,3,4
"7152",62096282,"Aleksandar Mitrović","9/16/1994 (28 years old)","ST (C)","Fulham","English Premier Division","SRB","No","8/27/2021","6/30/2026","$34M - $51M","Right","Reasonable","Very Strong","6'2""","180 lbs","374","178",150,155,3,10,13,16,14,6,17,7,5,9,13,14,9,14,16,14,17,13,13,14,14,12,15,17,6,15,12,15,12,11,16,17,13,12,15,19,8,8,7,14,13,12,6,14,15,14,14,14,13,3,3,2,1,2,2,3,3,1,1,2
"7153",62070416,"Filip Kostić","11/1/1992 (30 years old)","WB/M/AM (L)","Juventus","Italian Serie A","SRB","No","8/12/2022","6/30/2026","$35M - $53M","Left Only","Very Strong","Weak","6'0""","185 lbs","382","52",148,155,15,18,12,9,13,10,6,13,10,8,15,12,9,13,13,11,14,12,12,11,15,12,7,13,9,13,13,14,15,14,16,10,16,16,16,13,16,11,11,13,14,10,5,13,9,12,15,17,14,2,2,2,3,3,2,1,4,1,1,4
"7154",2000151705,"Mihajlo Ilić","6/4/2003 (20 years old)","D (C)","Partizan","Serbian SuperLeague","SRB","No","7/20/2022","6/30/2027","$2.9M - $5.8M","Right","Reasonable","Very Strong","6'4""","182 lbs","9","-",115,155,5,6,8,7,11,5,13,9,6,13,12,7,14,11,12,12,13,10,11,11,12,8,10,6,13,12,11,12,12,12,12,15,13,13,12,13,10,13,12,12,13,14,6,11,10,8,12,13,11,3,3,1,1,1,2,1,1,2,1,1
"7155",62216198,"Đorđe Petrović","10/8/1999 (23 years old)","GK","New England II","MLS Next Pro Eastern Conference","SRB","No","4/6/2022","12/31/2024","$15.5M - $23M","Right Only","Weak","Very Strong","6'4""","196 lbs","126","-",138,155,7,3,1,2,11,8,3,2,2,3,11,2,1,8,14,14,12,14,13,13,15,1,5,2,15,11,10,12,11,13,7,16,7,14,13,14,13,13,12,14,13,11,7,14,8,5,12,11,14,11,10,17,13,12,13,13,9,12,12,13
"7156",62012544,"Adem Ljajić","9/29/1991 (31 years old)","AM (LC)","Fatih Karagümrük","Turkish Super League","SRB","No","6/30/2022","6/30/2025","Not for Sale","Right","Fairly Strong","Very Strong","6'0""","165 lbs","367","78",110,154,15,15,14,10,15,16,5,12,5,5,15,15,6,15,8,14,7,14,10,15,8,15,9,12,4,10,15,9,10,12,9,9,8,9,9,7,12,7,8,8,11,11,13,12,7,16,5,14,12,4,3,1,3,2,2,1,1,1,1,1
"7157",62191195,"Nikola Milenković","10/12/1997 (25 years old)","D (C)","Fiorentina","Italian Serie A","SRB","No","8/11/2022","6/30/2027","$16.5M - $21M","Right","Weak","Very Strong","6'5""","202 lbs","230","17",145,153,4,8,8,10,11,4,16,5,9,15,13,6,15,12,17,14,15,13,14,13,15,7,11,8,15,15,11,15,13,12,14,17,16,14,13,16,11,11,14,15,13,13,8,12,14,12,12,14,14,2,3,3,2,2,2,1,1,3,1,2
"7158",2000098836,"Petar Ratkov","8/18/2003 (19 years old)","AM (L), ST (C)","TSC","Serbian SuperLeague","SRB","Yes","7/1/2020","6/30/2026","$550K - $10.5M","Left","Very Strong","Reasonable","6'4""","176 lbs","76","16",120,150,10,11,10,11,12,8,12,10,7,6,13,9,7,12,11,11,13,12,12,12,15,9,10,13,7,11,13,12,13,10,14,16,14,14,12,14,9,11,12,11,11,10,8,9,8,8,12,14,12,2,2,2,3,3,2,1,3,3,3,3
"7159",62097340,"Nemanja Maksimović","1/26/1995 (28 years old)","DM, M (RC)","Getafe","Spanish First Division","SRB","No","6/14/2021","6/30/2024","$6.2M - $9.4M","Right","Fairly Strong","Very Strong","6'0""","165 lbs","266","17",139,150,12,12,12,11,13,9,12,11,10,11,14,9,11,12,11,12,12,13,12,13,15,12,13,14,13,15,14,15,13,12,11,13,14,14,15,15,11,13,14,13,14,13,6,15,10,11,10,15,14,2,2,2,2,1,3,1,3,1,2,3
"7160",62192744,"Aleksa Terzić","8/17/1999 (23 years old)","D/WB/M (L)","Fiorentina","Italian Serie A","SRB","No","6/15/2020","6/30/2028","$4.6M - $7M","Left","Very Strong","Reasonable","6'0""","156 lbs","61","1",132,150,13,10,11,9,12,12,11,11,11,11,13,10,10,13,10,11,13,12,13,11,12,7,7,12,11,13,13,13,17,11,12,13,14,16,13,12,11,11,12,13,12,11,7,11,10,9,12,12,11,2,2,2,2,1,3,3,2,2,2,3
"7161",62124117,"Saša Lukić","8/13/1996 (26 years old)","DM, M/AM (C)","Fulham","English Premier Division","SRB","No","1/31/2023","6/30/2027","$46M - $55M","Right","Fairly Strong","Very Strong","6'0""","169 lbs","229","18",137,150,12,11,13,11,14,7,11,13,4,10,15,14,14,14,15,13,12,14,13,12,14,14,10,13,13,13,12,13,13,13,14,11,14,13,14,13,11,13,13,15,12,12,9,13,14,9,13,13,12,2,3,2,1,3,3,2,1,2,3,3
"7162",85125851,"David Sambissa","1/11/1996 (27 years old)","D/WB/M (L)","SC Cambuur","Keuken Kampioen Divisie","GAB","Yes","6/15/2020","6/30/2025","$85K - $850K","Left Only","Very Strong","Weak","5'10""","147 lbs","169","7",109,111,6,12,11,7,12,8,12,8,12,11,9,7,11,13,7,11,13,12,11,10,13,11,9,12,12,15,10,15,12,12,12,10,14,14,13,12,10,16,12,8,12,12,6,12,7,7,13,11,13,2,3,2,3,3,1,1,1,3,1,1
"7163",43425978,"Filip Stanković","2/25/2002 (21 years old)","GK","Inter","Italian Serie A","SRB","Yes","6/13/2022","6/30/2026","$300K - $3M","Right","Reasonable","Very Strong","6'2""","158 lbs","60","-",116,149,6,3,2,3,6,7,4,3,2,1,10,2,1,11,6,11,10,12,13,12,16,11,9,1,13,12,10,12,12,13,10,12,5,11,12,8,12,19,12,13,13,12,15,14,15,3,12,13,11,11,12,15,11,16,9,13,6,10,10,15
"7164",2000288469,"Veljko Milosavljević","6/28/2007 (15 years old)","D (C)","Crvena zvezda","Serbian SuperLeague","SRB","No","6/13/2022","6/30/2027","$3.5M - $7M","Right","Reasonable","Very Strong","6'3""","169 lbs","-","-",88,149,5,6,7,7,10,8,12,10,4,12,10,10,12,9,11,10,11,10,11,10,12,7,12,8,11,12,9,13,10,9,12,12,12,10,12,12,5,15,13,14,10,12,6,11,8,1,11,10,11,3,2,1,3,2,2,3,1,1,3,3
"7165",62219051,"Strahinja Eraković","1/22/2001 (22 years old)","D (RC)","Crvena zvezda","Serbian SuperLeague","SRB","No","6/15/2020","6/30/2026","$7M - $8.6M","Right","Reasonable","Very Strong","6'0""","165 lbs","100","2",124,148,7,8,7,7,13,6,13,9,8,14,11,9,15,11,14,13,14,12,12,13,14,8,11,10,13,12,10,14,12,13,10,13,12,12,14,12,12,12,11,12,12,13,11,12,7,7,14,12,12,3,1,2,3,3,2,1,2,4,4,1
"7166",2000178782,"Jovan Milošević","7/31/2005 (17 years old)","ST (C)","Vojvodina","Serbian SuperLeague","SRB","No","6/13/2022","6/30/2024","$230K - $2.3M","Right","Weak","Very Strong","6'4""","174 lbs","18","3",104,148,7,8,11,12,10,9,13,10,7,7,12,12,5,10,10,12,10,13,10,11,18,13,10,12,9,10,11,11,10,11,11,16,14,10,10,12,5,11,12,11,12,10,9,11,9,1,12,12,11,3,1,3,1,3,2,2,2,2,1,1
"7167",62260395,"Dragan Stoisavljević","11/25/2003 (19 years old)","AM (L), ST (C)","Voždovac","Serbian SuperLeague","SRB","No","6/13/2022","6/30/2025","$90K - $900K","Right","Weak","Very Strong","6'2""","185 lbs","84","8",100,147,10,13,10,11,11,10,12,10,8,10,15,8,9,11,8,10,8,10,10,10,15,11,13,11,9,11,8,12,11,12,14,14,15,11,12,14,11,12,11,12,11,11,15,11,5,6,10,10,18,3,2,2,3,2,3,4,2,3,3,1
"7168",2000178780,"Jovan Šljivić","10/14/2005 (17 years old)","M/AM (C)","Crvena zvezda","Serbian SuperLeague","SRB","No","6/13/2022","6/30/2026","$425K - $4.2M","Right","Weak","Very Strong","5'9""","158 lbs","12","4",102,147,10,11,12,11,12,12,7,11,5,10,13,11,9,12,9,10,12,10,10,12,13,12,8,9,11,10,13,12,10,12,11,8,8,11,12,12,8,11,12,11,10,11,6,12,5,1,12,13,8,1,3,3,1,3,2,3,3,2,1,3
"7169",62076152,"Predrag Rajković","10/31/1995 (27 years old)","GK","Mallorca","Spanish First Division","SRB","No","7/22/2022","6/30/2026","$8.4M - $12.5M","Right","Fairly Strong","Very Strong","6'3""","194 lbs","306","-",138,147,1,3,8,10,10,1,2,6,6,5,9,10,4,7,11,13,16,10,13,11,11,5,14,5,15,14,10,12,10,12,14,14,13,10,13,14,8,6,8,12,10,11,7,12,9,12,15,15,9,13,14,15,14,14,12,14,14,14,16,14
"7170",2000288835,"Mihajlo Cvetković","1/10/2007 (16 years old)","AM (RL), ST (C)","Čukarički","Serbian SuperLeague","SRB","No","7/1/2021","6/30/2026","$180K - $1.8M","Right","Fairly Strong","Very Strong","5'9""","145 lbs","-","-",89,147,8,8,10,12,9,11,9,11,9,8,9,11,8,9,12,11,12,11,11,10,8,11,10,11,10,10,9,11,11,12,10,10,10,11,11,10,13,13,9,10,10,11,8,11,10,2,11,12,18,1,4,3,3,1,1,1,2,2,3,3
"7171",2000180152,"Andrej Petrović","4/24/2006 (17 years old)","DM, M (C)","Crvena zvezda","Serbian SuperLeague","SRB","No","7/1/2021","6/30/2026","$14K - $130K","Right","Reasonable","Very Strong","5'9""","145 lbs","-","-",87,147,10,10,9,10,11,11,6,13,5,12,13,10,12,11,11,10,12,9,9,12,13,9,8,10,9,11,12,13,11,11,10,7,8,11,10,10,6,12,11,12,12,10,5,8,6,5,11,11,8,3,1,1,2,4,1,3,1,3,3,1
"7172",2000076067,"Marko Milovanović","8/4/2003 (19 years old)","ST (C)","Almería","Spanish First Division","SRB","No","7/10/2022","6/30/2028","$7.4M - $9.4M","Right","Fairly Strong","Very Strong","6'5""","187 lbs","33","3",115,147,5,7,9,12,11,9,14,9,5,8,9,9,9,11,10,12,10,12,13,11,13,14,10,11,13,10,11,10,12,10,10,15,11,12,12,13,10,12,11,12,13,12,10,13,9,9,13,12,11,3,3,1,3,2,3,3,2,3,2,2
"7173",12093412,"Yannick Bikaye","11/15/2003 (19 years old)","M/AM (C)","Bouénguidi","Gabonese Premier Division","GAB","No","1/1/2020","6/30/2025","$0","Right","Fairly Strong","Very Strong","5'7""","143 lbs","-","-",62,111,5,4,7,10,13,5,5,8,2,6,13,1,9,11,7,6,5,6,7,11,16,12,2,7,7,7,7,11,9,11,5,6,10,12,6,4,9,14,12,12,11,13,5,7,6,2,9,13,8,3,2,3,1,3,2,1,4,1,3,3
"7174",62113639,"Luka Jović","12/23/1997 (25 years old)","ST (C)","Fiorentina","Italian Serie A","SRB","No","7/8/2022","6/30/2024","$0","Right","Strong","Very Strong","5'11""","187 lbs","201","54",135,147,7,11,13,14,14,8,15,11,4,5,13,12,5,15,7,15,13,12,9,10,13,13,7,14,7,10,12,7,13,13,16,11,11,14,11,14,7,15,10,10,8,7,9,16,6,12,10,13,9,3,2,4,4,3,2,1,1,2,2,1
"7175",21028824,"Vladan Kovačević","4/11/1998 (25 years old)","GK","Raków","PKO Bank Polski Ekstraklasa","SRB","Yes","7/7/2022","6/30/2026","$200K - $2M","Right Only","Weak","Very Strong","6'4""","178 lbs","143","-",123,146,4,2,1,1,6,7,6,3,1,2,9,3,1,6,16,14,15,14,13,11,17,2,13,2,11,14,7,12,12,14,11,16,14,10,8,9,12,14,14,14,17,13,8,19,8,5,16,14,15,9,12,16,12,14,12,13,5,10,12,15
"7176",62055271,"Matija Nastasić","3/28/1993 (30 years old)","D (C)","Mallorca","Spanish First Division","SRB","No","9/1/2022","6/30/2025","$230K - $2.3M","Left","Very Strong","Weak","6'2""","182 lbs","222","4",124,146,5,7,7,5,11,5,13,6,6,14,12,6,15,11,6,15,15,13,11,13,12,8,10,4,14,16,8,9,11,11,13,15,12,12,12,15,7,17,12,14,13,10,14,15,10,8,11,11,15,3,1,3,1,2,2,1,3,2,3,3
"7177",62028856,"Luka Milivojević","4/7/1991 (32 years old)","DM, M (C)","Crystal Palace","English Premier Division","SRB","No","6/14/2021","6/30/2024","$700K - $6.8M","Right","Reasonable","Very Strong","6'1""","176 lbs","355","50",125,146,12,11,8,11,12,13,14,13,7,14,10,16,14,13,16,13,15,14,13,12,16,9,15,10,14,16,14,13,10,11,13,13,13,10,13,14,10,8,8,15,14,16,7,14,16,8,12,15,13,1,1,2,3,2,2,2,2,1,2,2
"7178",62038612,"Marko Dmitrović","1/24/1992 (31 years old)","GK","Sevilla","Spanish First Division","SRB","No","6/30/2021","6/30/2025","Not for Sale","Left","Very Strong","Reasonable","6'3""","178 lbs","247","1",138,145,3,10,8,5,8,7,9,10,10,8,3,10,8,7,9,13,14,13,15,14,12,6,10,9,14,11,8,12,10,13,12,14,11,11,12,11,9,11,14,12,11,13,7,10,10,8,13,12,11,15,9,15,10,13,16,14,8,14,14,15
"7179",62082823,"Andrija Živković","7/11/1996 (26 years old)","M (RL), AM (RLC)","PAOK","Greek Super League 1","SRB","No","9/9/2020","6/30/2024","$8.4M - $10.5M","Left","Very Strong","Fairly Strong","5'7""","136 lbs","184","33",135,145,15,15,15,13,15,13,6,12,10,6,15,11,7,16,13,10,9,15,10,14,12,16,12,13,8,13,16,12,12,14,13,6,11,12,12,8,10,7,10,10,12,10,10,15,9,13,10,12,13,2,1,1,3,2,2,1,2,2,1,3
"7180",2000180531,"Miloš Luković","11/18/2005 (17 years old)","AM (RL), ST (C)","IMT","Serbian SuperLeague","SRB","No","6/13/2022","6/30/2025","$35K - $325K","Left","Very Strong","Weak","6'0""","167 lbs","46","18",106,145,11,11,10,12,13,9,12,10,10,7,16,12,10,12,5,11,10,12,8,9,12,13,6,11,9,12,12,12,12,10,11,12,15,12,16,8,11,12,11,12,12,10,11,8,7,1,12,12,20,2,1,3,2,2,2,2,3,2,1,4
"7181",62056935,"Nemanja Radoja","2/6/1993 (30 years old)","DM, M (C)","Sporting KC","Major League Soccer","SRB","No","1/1/2023","12/31/2025","$250K - $2.5M","Right","Reasonable","Very Strong","6'1""","171 lbs","274","3",125,145,8,9,10,9,14,9,12,12,8,13,14,9,12,13,13,15,15,12,15,13,13,10,15,9,16,15,12,14,11,11,11,12,12,11,13,14,14,13,13,13,14,12,11,14,8,9,14,13,12,1,3,1,3,2,2,2,3,2,2,3
"7182",62055906,"Lazar Marković","3/2/1994 (29 years old)","AM (RL), ST (C)","Gaziantep FK","Turkish Super League","SRB","No","7/21/2022","6/30/2024","$600K - $6M","Right","Reasonable","Very Strong","5'9""","145 lbs","217","45",120,145,11,12,14,10,14,9,9,11,5,7,11,12,8,15,9,12,11,12,11,11,10,14,15,14,8,12,12,10,15,13,15,8,9,12,8,9,12,12,13,13,10,12,16,10,7,6,11,11,8,3,3,4,2,1,1,2,4,2,2,1
"7183",62142830,"Vanja Milinković-Savić","2/20/1997 (26 years old)","GK","Torino","Italian Serie A","SRB","No","4/7/2023","6/30/2026","$6.2M - $9.2M","Right","Reasonable","Very Strong","6'8""","202 lbs","127","-",136,145,13,3,1,2,10,16,9,14,3,1,9,3,1,8,11,11,14,10,12,13,16,8,14,7,11,11,9,11,12,13,11,17,11,10,13,12,12,13,13,13,12,11,10,12,8,11,12,13,10,12,12,15,11,13,16,15,14,14,14,15
"7184",2000224445,"Urie-Michel Mboula","4/30/2003 (20 years old)","D (LC), WB (L)","Dinamo-Auto Tiraspol","Moldovan Divizia A Group A","GAB","No","7/1/2022","6/30/2023","$5K - $16K","Left Only","Very Strong","Weak","6'0""","169 lbs","22","4",85,110,4,9,8,6,10,5,12,6,8,12,9,6,12,9,13,9,11,11,8,7,12,6,11,6,10,12,8,12,14,13,11,13,13,13,11,10,12,20,12,10,13,9,10,4,8,3,14,12,16,3,2,4,3,2,1,1,2,1,2,1
"7185",62127145,"Nikola Maraš","12/19/1995 (27 years old)","D (C)","Almería","Spanish First Division","SRB","No","8/22/2020","6/30/2025","$1.6M - $3.4M","Right","Weak","Very Strong","6'2""","178 lbs","263","15",126,145,7,7,8,8,11,8,13,7,7,13,12,10,14,11,12,12,14,11,14,13,13,10,16,8,14,13,11,14,11,12,12,14,14,11,13,15,9,12,13,15,14,13,7,9,11,6,12,13,16,1,3,1,1,2,2,3,2,1,1,3
"7186",62124125,"Nemanja Radonjić","2/15/1996 (27 years old)","AM (RLC)","OM","Ligue 1 Uber Eats","SRB","No","6/15/2020","6/30/2026","$1.8M - $3.8M","Right","Reasonable","Very Strong","6'1""","169 lbs","152","19",140,145,10,13,16,13,15,9,7,13,4,4,12,11,7,15,15,13,10,12,9,12,11,16,8,13,6,9,13,12,16,16,14,11,10,15,12,11,9,8,10,9,11,9,8,11,12,14,12,13,8,3,2,3,2,2,1,3,3,3,1,1
"7187",62260391,"Stefan Mitrović","8/15/2002 (20 years old)","M/AM (L)","Crvena zvezda","Serbian SuperLeague","SRB","No","7/18/2022","6/30/2026","$650K - $5.2M","Right","Weak","Very Strong","6'0""","147 lbs","89","18",122,145,10,12,13,12,12,11,11,12,8,8,12,10,9,14,9,12,11,12,12,12,12,11,10,12,8,11,12,13,14,15,11,8,10,15,11,9,13,11,12,13,10,11,8,9,6,5,14,11,10,2,1,1,1,3,1,3,1,1,3,1
"7188",5781409,"Zoran Tošić","4/28/1987 (36 years old)","AM (RL)","Lamia","Greek Super League 1","SRB","No","1/26/2023","6/30/2024","$170K - $500K","Left","Very Strong","Weak","5'7""","149 lbs","377","89",110,145,13,13,13,12,15,16,7,13,5,6,14,10,9,14,10,13,10,13,13,14,12,15,15,13,7,13,13,10,11,12,10,6,10,12,9,8,13,15,15,10,11,15,13,16,8,7,11,10,16,2,3,2,3,3,3,3,3,2,2,3
"7189",2000288465,"Andrija Maksimović","6/5/2007 (16 years old)","M/AM (C)","Crvena zvezda","Serbian SuperLeague","SRB","No","6/13/2022","6/30/2026","$130K - $400K","Left","Very Strong","Strong","5'10""","132 lbs","-","-",90,145,10,9,11,11,11,10,7,10,5,8,12,12,8,12,9,10,9,10,12,11,8,12,9,10,10,9,12,12,11,12,9,9,10,11,9,7,10,16,8,12,10,11,11,11,11,7,12,9,19,3,1,1,1,2,3,3,3,3,3,3
"7190",5747078,"Darko Lazović","9/15/1990 (32 years old)","WB (L), M (RL)","Hellas Verona","Italian Serie A","SRB","No","8/6/2019","6/30/2024","$475K - $4.7M","Right","Reasonable","Very Strong","5'11""","145 lbs","395","50",132,144,9,13,15,12,13,6,7,12,5,10,13,6,8,14,11,14,9,12,13,12,14,15,9,16,10,13,12,13,15,13,13,10,12,15,14,11,17,9,11,17,11,12,7,11,7,7,14,13,13,2,2,3,1,3,3,3,3,4,2,3
"7191",62013805,"Nemanja Gudelj","11/16/1991 (31 years old)","D (C), DM, M (C)","Sevilla","Spanish First Division","SRB","Yes","6/14/2021","6/30/2026","Not for Sale","Right","Reasonable","Very Strong","6'1""","169 lbs","356","39",141,144,6,10,9,10,14,12,15,15,11,12,14,12,14,13,16,13,15,13,13,13,16,11,13,11,12,15,11,17,12,13,13,16,14,14,14,15,12,7,11,14,17,3,9,14,13,10,16,16,14,3,3,2,2,2,3,2,3,1,2,3
"7192",2000027057,"Samed Baždar","1/31/2004 (19 years old)","AM (RLC), ST (C)","Partizan","Serbian SuperLeague","SRB","Yes","8/10/2022","6/30/2026","$4.3M - $8.2M","Right","Reasonable","Very Strong","6'1""","171 lbs","33","4",114,144,9,10,13,12,12,8,12,11,6,6,12,12,7,12,10,12,11,11,10,12,12,13,9,12,7,11,12,11,12,12,12,12,13,13,11,12,12,12,12,12,12,11,7,14,9,8,12,12,12,3,1,1,3,3,3,3,2,1,3,1
"7193",2000087459,"Jan-Carlo Simić","5/2/2005 (18 years old)","D (C)","AC Milan","Italian Serie A","SRB","Yes","8/25/2022","6/30/2024","$160K - $1.6M","Right","Weak","Very Strong","6'1""","165 lbs","-","-",91,143,3,5,7,6,8,4,12,5,11,13,10,8,12,10,14,12,12,10,9,11,16,8,10,7,11,12,9,12,12,9,11,12,14,12,10,10,8,12,12,15,12,13,4,9,12,6,13,16,14,2,1,4,2,3,2,3,2,1,3,1
"7194",2000214059,"Matija Popović","1/8/2006 (17 years old)","AM (L), ST (C)","Partizan","Serbian SuperLeague","SRB","Yes","6/13/2022","6/30/2025","$170K - $1.7M","Right","Reasonable","Very Strong","6'4""","169 lbs","-","-",100,143,6,9,11,12,11,7,11,10,6,7,10,11,6,11,10,11,10,12,10,11,12,12,10,12,8,11,10,11,12,12,12,11,13,12,11,12,10,12,11,12,12,10,6,10,9,5,12,12,18,1,2,3,2,1,2,1,2,1,3,2
"7195",12056402,"Didier Ndong","6/17/1994 (28 years old)","DM, M (C)","Dijon FCO","French National","GAB","No","7/29/2019","6/30/2024","$0","Right","Fairly Strong","Very Strong","5'10""","165 lbs","252","5",115,140,8,9,11,6,11,9,11,12,9,11,11,10,13,13,15,12,15,12,12,11,14,12,10,12,12,12,10,13,12,13,13,10,13,13,13,13,10,10,10,8,8,10,8,12,13,12,10,15,13,1,1,3,2,3,1,2,3,2,3,4
"7196",85045204,"Yoann Wachter","4/7/1992 (31 years old)","D/WB (R)","St-Pryvé St-Hilaire FC","French National 2 - B","GAB","Yes","8/18/2022","6/30/2024","$12K - $130K","Right Only","Weak","Very Strong","5'10""","143 lbs","148","1",87,110,6,10,9,6,11,1,8,7,6,12,11,6,12,12,10,12,12,10,10,10,6,6,8,7,12,13,12,11,11,12,10,9,12,11,12,7,12,14,9,10,10,9,8,4,10,3,12,10,15,2,2,1,3,1,2,1,2,1,4,2
"7197",2000180156,"Milan Aleksić","8/30/2005 (17 years old)","AM (C), ST (C)","Partizan","Serbian SuperLeague","SRB","No","7/1/2021","6/30/2025","$0","Left","Very Strong","Reasonable","5'10""","154 lbs","-","-",94,142,8,9,12,11,11,6,12,11,2,6,11,9,7,12,12,14,9,13,6,11,6,12,1,14,7,8,11,10,12,11,10,8,11,12,10,9,9,12,11,12,12,11,7,9,5,8,13,9,13,4,2,2,1,2,2,1,3,1,2,2
"7198",2000160511,"Ousmane Diomande","12/14/2003 (19 years old)","D (C)","Sporting CP","Portuguese Premier League","CIV","No","1/31/2023","6/30/2027","$47M - $58M","Right","Fairly Strong","Very Strong","6'3""","189 lbs","26","1",142,169,4,11,13,8,14,4,11,10,9,14,15,5,15,14,10,13,11,16,10,13,15,11,12,7,13,14,16,13,14,13,14,15,18,15,15,16,12,8,16,14,16,12,5,16,6,5,13,15,20,1,2,1,2,1,3,1,2,2,2,3
"7199",13136664,"Franck Kessié","12/19/1996 (26 years old)","DM, M (C)","Barcelona","Spanish First Division","CIV","Yes","6/30/2022","6/30/2026","$21M - $32M","Right","Reasonable","Very Strong","6'0""","196 lbs","278","50",155,165,5,7,12,13,12,6,10,11,8,15,13,18,15,12,16,14,16,14,14,14,17,8,14,13,15,18,12,17,13,13,17,11,17,15,18,18,11,8,11,13,14,12,7,15,13,6,15,17,16,3,2,1,2,1,3,3,2,2,2,1
"7200",2000018781,"Simon Adingra","1/1/2002 (21 years old)","AM (RL), ST (C)","Brighton","English Premier Division","CIV","No","6/24/2022","6/30/2026","$60M - $72M","Right","Weak","Very Strong","5'9""","149 lbs","74","23",136,160,7,12,16,13,14,7,9,8,5,6,12,11,6,14,10,15,11,12,12,10,11,16,8,15,4,12,11,14,16,15,9,8,13,16,13,9,13,11,12,13,8,12,11,9,8,7,12,13,12,2,4,3,2,3,3,1,3,1,3,3
"7201",85136376,"Nicolas Pépé","5/29/1995 (28 years old)","AM (RL)","Arsenal","English Premier Division","CIV","Yes","6/14/2021","6/30/2024","$0","Left","Very Strong","Weak","6'0""","160 lbs","251","69",140,159,12,12,17,13,15,15,8,16,2,4,12,15,4,16,6,12,8,13,8,11,7,18,5,16,6,8,12,8,17,18,13,8,14,15,12,10,7,14,12,12,11,11,8,9,7,7,8,7,7,3,2,3,1,3,1,2,3,1,2,2
"7202",43317933,"Hamed Traorè","2/16/2000 (23 years old)","M (C), AM (LC)","Bournemouth","English Premier Division","CIV","No","7/1/2021","6/30/2028","$27M - $33M","Right","Strong","Very Strong","5'10""","169 lbs","157","19",140,159,12,12,15,14,16,11,4,13,4,6,14,11,8,15,12,13,11,13,11,13,14,16,10,15,7,14,14,13,13,16,15,4,14,13,12,10,15,16,14,15,11,12,8,13,9,6,12,16,18,3,1,2,2,1,2,1,1,4,1,4
"7203",12093353,"Karim Konaté","3/21/2004 (19 years old)","ST (C)","FC RB Salzburg","Austrian Premier Division","CIV","No","1/2/2023","6/30/2027","$20M - $25M","Right","Fairly Strong","Very Strong","5'10""","149 lbs","66","41",128,158,8,9,12,14,12,7,11,10,5,7,9,11,7,12,15,12,16,12,10,11,17,10,9,13,6,11,12,13,17,16,12,6,12,15,12,12,7,9,13,14,9,10,7,11,11,8,11,15,12,1,3,4,3,1,2,2,3,3,1,2
"7204",12094339,"Abakar Sylla","12/25/2002 (20 years old)","D (C)","Club Brugge","Jupiler Pro League","CIV","No","10/1/2021","6/30/2027","$17M - $21M","Left","Very Strong","Reasonable","6'2""","171 lbs","21","-",125,157,8,8,11,8,12,8,14,9,9,13,11,8,13,12,18,11,16,10,9,10,12,11,19,12,11,14,8,14,14,14,15,14,15,15,14,14,11,4,8,13,11,11,5,12,17,14,11,18,13,2,2,2,3,2,2,3,3,3,4,1
"7205",93127195,"Odilon Kossounou","1/4/2001 (22 years old)","D (RC)","Bayer 04","Bundesliga","CIV","No","7/21/2021","6/30/2026","$59M - $74M","Right","Reasonable","Very Strong","6'3""","180 lbs","100","1",134,155,3,8,12,6,11,4,13,6,12,14,13,6,14,11,13,13,15,13,12,13,15,9,10,9,13,14,12,14,13,11,15,16,13,16,13,15,13,13,13,11,11,7,7,10,9,3,13,13,11,3,3,1,4,2,1,1,3,2,3,2
"7206",43425040,"Amad Diallo","7/11/2002 (20 years old)","M (RC), AM (RLC), ST (C)","Man UFC","English Premier Division","CIV","Yes","1/2/2021","6/30/2025","$33M - $51M","Left","Very Strong","Weak","5'8""","149 lbs","54","17",128,155,10,11,16,13,16,12,4,15,2,4,15,8,3,15,12,11,7,10,8,8,17,16,5,12,5,7,13,11,16,16,13,6,15,15,10,8,11,11,16,16,14,13,5,14,8,8,10,18,15,3,2,1,1,2,2,3,1,3,3,2
"7207",2000148508,"Grace Obiang","10/4/2000 (22 years old)","DM, M (C)","IZ Khemisset","Ligue National de Football Amateur 1","GAB","No","1/1/2022","6/30/2024","$20K - $190K","Right","Fairly Strong","Very Strong","6'0""","158 lbs","4","-",75,110,6,4,6,7,13,6,3,8,5,7,13,3,12,13,8,11,8,5,8,13,12,5,7,7,6,7,8,11,13,13,7,8,17,10,7,4,13,15,9,10,12,9,10,11,9,6,20,12,20,1,1,2,3,3,3,3,3,1,2,1
"7208",12092528,"Datro Fofana","12/22/2002 (20 years old)","AM (RL), ST (C)","Chelsea","English Premier Division","CIV","No","1/1/2023","6/30/2029","$14.5M - $22M","Right","Reasonable","Very Strong","5'11""","167 lbs","47","15",128,155,9,8,14,12,12,9,12,10,6,6,11,13,6,12,13,12,9,11,9,9,16,16,7,12,7,10,11,15,16,14,14,12,15,16,12,13,12,10,8,15,11,9,5,14,14,11,12,19,8,2,3,1,3,3,2,4,1,2,2,2
"7209",859510,"Salomon Kalou","8/5/1985 (37 years old)","M/AM (RL), ST (C)","AS Arta","Djiboutian Premier Division","CIV","No","6/13/2022","-","$0","Right","Reasonable","Very Strong","6'0""","169 lbs","474","155",100,155,7,9,12,12,15,11,12,11,6,5,11,16,5,13,9,14,10,12,11,12,10,15,10,13,6,9,13,8,8,10,12,10,15,9,8,10,13,17,11,16,18,12,5,17,6,14,13,14,16,3,3,3,1,1,3,2,2,3,1,1
"7210",28051378,"Wilfried Zaha","11/10/1992 (30 years old)","M (L), AM (RL), ST (C)","Crystal Palace","English Premier Division","CIV","No","6/14/2021","6/30/2026","$39M - $58M","Right","Fairly Strong","Very Strong","6'0""","163 lbs","431","84",150,154,8,11,17,13,14,10,7,14,7,8,11,12,6,15,13,12,11,15,11,14,14,17,13,13,8,12,11,12,15,15,14,11,16,15,14,13,15,7,9,11,15,10,11,16,12,11,15,18,12,3,2,2,1,1,1,3,2,3,1,3
"7211",12078947,"Wilfried Singo","12/25/2000 (22 years old)","D/WB/M (R)","Torino","Italian Serie A","CIV","No","11/24/2020","6/30/2024","$8.6M - $10.5M","Right","Reasonable","Very Strong","6'3""","174 lbs","98","7",134,153,6,12,14,8,11,5,12,7,12,10,13,8,12,12,14,11,11,12,12,11,17,11,6,13,12,12,11,15,16,14,12,13,14,16,13,14,13,10,13,14,13,12,4,11,12,6,12,15,12,1,1,3,2,4,1,2,1,2,3,2
"7212",85051578,"Sébastien Haller","6/22/1994 (28 years old)","ST (C)","Borussia Dortmund","Bundesliga","CIV","Yes","7/1/2022","6/30/2026","$37M - $56M","Right","Reasonable","Very Strong","6'3""","180 lbs","309","122",148,152,3,9,11,16,14,7,16,8,6,7,12,17,6,14,12,15,16,15,15,14,16,14,12,14,7,15,13,15,12,11,17,17,15,13,15,17,5,16,14,14,12,13,8,15,6,6,14,16,14,3,3,3,3,3,2,2,2,2,3,1
"7213",13183075,"Mohammed Diomandé","10/30/2001 (21 years old)","M (C), AM (LC)","FC Nordsjælland","3F Superliga","CIV","No","1/4/2020","12/31/2024","$1.1M - $6.2M","Left","Very Strong","Weak","5'9""","165 lbs","83","11",125,150,13,12,15,12,15,13,12,11,2,4,15,13,4,15,10,14,11,12,14,12,14,15,9,14,5,13,13,13,14,14,13,11,13,14,12,9,12,12,13,14,12,12,5,9,11,6,12,14,12,3,3,2,1,3,2,1,1,2,1,3
"7214",67191910,"Éric Bailly","4/12/1994 (29 years old)","D (C)","Man UFC","English Premier Division","CIV","No","4/26/2021","6/30/2024","$0","Right","Reasonable","Very Strong","6'2""","169 lbs","148","1",137,150,5,4,8,5,12,5,14,5,9,15,12,5,17,12,16,16,18,10,9,8,13,8,7,6,15,13,7,12,15,16,16,14,15,16,16,16,12,13,13,15,12,14,17,14,14,5,9,15,14,2,3,2,2,1,3,2,3,2,1,2
"7215",85009974,"Willy Boly","2/3/1991 (32 years old)","D (C)","Nottm Forest","English Premier Division","CIV","Yes","9/1/2022","6/30/2024","$8M - $12M","Right","Weak","Very Strong","6'5""","213 lbs","278","14",132,150,2,4,12,9,11,3,15,9,5,13,13,5,14,13,17,15,14,13,11,12,13,13,12,9,15,13,11,13,11,11,16,16,10,12,11,17,6,14,14,11,14,9,17,13,13,8,12,15,13,4,1,2,2,3,3,3,3,2,2,2
"7216",12081415,"Jean N'Guessan","4/17/2003 (20 years old)","M (C)","OGC Nice","French Regional 1 - Méditerranée","CIV","No","6/18/2021","6/30/2026","$130K - $1.3M","Right","Weak","Very Strong","5'10""","176 lbs","60","3",115,150,7,9,13,11,13,9,8,13,4,8,13,13,8,14,10,12,13,12,11,13,14,13,10,12,14,15,13,13,12,13,12,9,14,12,12,11,6,11,12,12,13,11,5,11,7,8,13,13,15,1,2,4,1,1,1,3,2,1,2,3
"7217",85094652,"Séko Fofana","5/7/1995 (28 years old)","DM, M (C)","RC Lens","Ligue 1 Uber Eats","CIV","Yes","8/18/2020","6/30/2027","$23M - $35M","Right","Fairly Strong","Very Strong","6'1""","163 lbs","268","32",145,150,6,9,13,13,14,11,11,14,3,10,14,12,12,13,14,13,13,13,13,12,14,12,12,14,12,15,13,18,14,12,14,12,15,14,17,16,12,12,12,16,14,12,7,14,13,4,15,14,12,3,2,1,4,3,1,2,3,2,2,1
"7218",2000298693,"Prince Mouele Mouele","4/14/2005 (18 years old)","AM (L)","CS Bendjé","Gabonese Premier Division","GAB","No","6/13/2022","6/30/2024","$0","Right","Reasonable","Very Strong","5'7""","130 lbs","-","-",50,110,6,10,8,8,11,4,4,5,4,2,8,3,5,7,15,6,6,6,5,7,4,8,10,10,2,6,3,10,12,10,3,4,16,12,6,1,9,16,9,11,9,10,6,9,15,8,15,10,18,2,2,2,3,1,3,4,3,2,1,3
"7219",48042717,"Ibrahim Sangaré","12/2/1997 (25 years old)","DM, M (C)","PSV","Eredivisie","CIV","No","8/7/2022","6/30/2027","$37M - $44M","Right Only","Weak","Very Strong","6'3""","169 lbs","165","11",145,149,9,9,12,7,12,11,15,13,5,14,15,4,15,13,16,13,17,15,11,13,12,13,14,11,15,17,12,17,13,14,15,17,15,12,17,17,16,14,13,13,12,9,5,13,8,7,12,11,13,1,1,2,1,1,3,2,3,3,3,3
"7220",29114989,"Jonathan Bamba","3/26/1996 (27 years old)","AM (RL), ST (C)","LOSC","Ligue 1 Uber Eats","CIV","Yes","6/14/2021","6/30/2027","$20M - $24M","Right","Weak","Very Strong","5'9""","158 lbs","247","40",140,147,11,12,14,13,13,8,5,11,7,7,11,10,7,14,12,14,11,13,14,13,14,12,6,15,7,12,10,13,16,15,14,6,16,15,14,13,14,19,9,13,10,13,7,11,9,5,13,15,8,3,2,1,2,2,1,3,4,1,1,2
"7221",2000205547,"Abdoul Ouattara","10/22/2005 (17 years old)","M/AM (C)","Strasbourg","Ligue 1 Uber Eats","CIV","No","7/1/2022","6/30/2025","$160K - $1.6M","Right","Reasonable","Very Strong","5'11""","152 lbs","-","-",80,146,6,7,10,9,14,7,7,9,1,6,10,5,9,14,11,9,8,8,5,6,8,13,8,7,7,13,14,9,9,13,5,10,10,10,9,4,14,18,11,13,13,11,14,3,10,8,8,10,15,1,1,2,3,1,2,3,3,2,1,2
"7222",2000158118,"Amane Romeo","7/1/2003 (19 years old)","DM, M (C)","BK Häcken","Swedish Premier Division","CIV","No","12/1/2021","12/31/2026","$350K - $3.5M","Right","Reasonable","Very Strong","5'7""","154 lbs","28","2",118,145,6,8,13,9,13,6,8,7,5,12,12,6,12,14,13,12,11,12,12,13,14,13,7,13,13,13,13,13,13,15,12,7,12,12,13,10,8,13,13,12,11,10,5,11,8,5,12,13,13,1,3,2,2,3,1,3,1,1,1,1
"7223",43201838,"Christian Kouamé","12/6/1997 (25 years old)","AM (RL), ST (C)","Fiorentina","Italian Serie A","CIV","Yes","9/1/2020","6/30/2024","$1.1M - $12.5M","Right","Reasonable","Very Strong","6'1""","154 lbs","219","36",134,145,4,8,15,13,13,10,13,10,4,4,11,12,4,13,12,13,14,12,11,12,14,14,7,13,10,12,11,14,17,14,13,13,14,16,12,10,11,12,14,14,11,13,10,12,9,6,12,14,14,2,2,1,1,1,3,3,1,1,1,1
"7224",12021720,"Jean Michaël Séri","7/19/1991 (31 years old)","DM, M (C)","Hull","Sky Bet Championship","CIV","No","7/8/2022","6/30/2025","Not for Sale","Right","Reasonable","Very Strong","5'6""","152 lbs","334","22",124,145,14,12,10,12,15,13,5,12,5,9,16,14,9,15,13,13,14,15,12,13,14,12,10,14,8,17,16,12,12,12,9,5,14,12,11,8,16,13,16,14,12,13,7,13,9,7,11,16,13,1,3,3,3,1,1,3,2,1,4,3
"7225",28084880,"Jérémie Boga","1/3/1997 (26 years old)","AM (LC)","Atalanta","Italian Serie A","CIV","Yes","7/1/2022","6/30/2027","$550K - $8M","Right","Reasonable","Very Strong","5'9""","158 lbs","222","27",138,145,10,12,18,12,16,12,6,14,4,4,13,11,5,17,8,10,8,10,6,10,13,18,7,14,4,10,12,8,17,17,12,4,13,16,11,10,14,14,10,13,10,11,12,12,8,7,9,15,13,1,2,3,2,2,3,3,1,4,2,3
"7226",85057643,"Serge Aurier","12/24/1992 (30 years old)","D/WB (R)","Nottm Forest","English Premier Division","CIV","No","6/7/2023","6/30/2024","$15M - $19M","Right","Weak","Very Strong","5'9""","163 lbs","297","16",134,144,7,12,13,10,15,7,14,9,9,13,13,6,15,12,15,13,15,14,12,12,15,11,10,16,13,15,10,16,14,13,14,9,15,13,15,14,12,12,11,13,11,12,7,14,13,14,12,15,14,1,2,2,3,1,1,1,2,1,3,2
"7227",13136663,"Anderson Niangbo","10/6/1999 (23 years old)","AM (RL), ST (C)","Aqtóbe","Kazakhstan Premier League","CIV","No","1/15/2020","6/30/2024","$475K - $4.7M","Right","Reasonable","Very Strong","5'8""","145 lbs","103","18",120,143,8,9,10,13,11,11,7,7,5,7,11,9,8,10,12,9,11,10,9,10,15,7,5,14,6,11,10,13,16,14,8,8,11,16,13,10,14,10,11,13,10,12,6,12,12,8,11,12,12,3,1,3,3,3,2,2,3,3,4,1
"7228",2000018252,"Bamo Meïté","6/30/2001 (21 years old)","D (C), DM","FC Lorient","Ligue 1 Uber Eats","CIV","Yes","2/20/2023","6/30/2026","$350K - $3.5M","Right","Weak","Very Strong","6'0""","165 lbs","27","1",118,143,10,10,6,7,12,7,13,11,10,12,12,8,13,12,14,12,14,12,9,15,13,5,11,10,12,11,11,13,12,12,12,11,15,13,13,13,12,20,11,14,12,12,8,16,5,7,12,12,7,2,1,2,2,1,3,2,3,3,3,3
"7229",13128644,"Axel Méyé","6/6/1995 (28 years old)","AM (RL), ST (C)","OC Safi","Botola Pro 1","GAB","No","8/26/2022","6/30/2025","$35K - $325K","Right Only","Weak","Very Strong","5'10""","171 lbs","122","36",90,110,3,6,12,12,13,4,11,9,5,4,8,10,7,10,11,12,8,8,10,8,9,12,7,13,9,7,7,14,12,12,14,10,12,13,14,12,6,14,12,10,7,8,5,10,12,5,10,8,14,1,2,3,3,1,3,3,2,4,2,2
"7230",29001331,"Max Gradel","11/30/1987 (35 years old)","M/AM (RL)","Sivasspor","Turkish Super League","CIV","Yes","8/13/2020","6/30/2024","$0","Right","Weak","Very Strong","5'9""","154 lbs","446","109",125,143,13,13,15,11,13,14,9,14,3,5,13,14,6,14,18,13,12,13,12,13,17,15,9,14,8,9,14,13,14,13,13,8,14,13,12,11,13,5,8,11,10,13,8,15,12,9,14,18,16,3,2,2,1,2,4,3,1,3,1,3
"7231",85117459,"Maxwel Cornet","9/27/1996 (26 years old)","M (L), AM (RL), ST (C)","West Ham","English Premier Division","CIV","Yes","8/5/2022","6/30/2027","$41M - $51M","Left","Very Strong","Fairly Strong","5'10""","152 lbs","247","41",138,143,12,11,12,14,12,11,11,10,10,11,12,10,11,12,8,12,13,12,11,11,14,12,6,13,10,13,11,14,15,13,12,10,15,15,13,12,17,14,14,13,10,13,7,13,9,6,12,13,11,2,1,2,1,2,3,2,3,1,2,1
"7232",43424748,"Drissa Camara","2/18/2002 (21 years old)","DM, M (C)","Parma","Italian Serie B","CIV","Yes","5/5/2021","6/30/2024","$375K - $3.7M","Right Only","Weak","Very Strong","5'10""","152 lbs","27","4",109,143,8,11,12,10,12,8,9,11,7,9,14,10,12,13,12,12,12,12,9,12,11,8,8,13,10,13,11,13,13,13,14,9,9,14,13,11,14,11,14,12,14,12,12,12,10,2,13,11,14,2,3,2,2,1,1,3,3,1,1,2
"7233",48036489,"Yves Dabila","1/1/1997 (26 years old)","D (C), DM","Paris FC","Ligue 2 BKT","CIV","No","8/5/2022","6/30/2024","$375K - $1.1M","Right","Weak","Very Strong","6'0""","165 lbs","74","1",110,141,4,5,9,6,12,5,13,8,8,13,13,6,14,12,13,13,14,11,11,12,14,7,8,7,12,12,7,14,12,11,13,12,14,13,13,12,8,13,14,13,13,12,6,1,5,6,11,12,12,3,2,3,2,2,4,3,3,1,2,4
"7234",33066648,"Paul Akouokou","12/20/1997 (25 years old)","DM, M (C)","Real Hispalis","Spanish First Division","CIV","No","9/10/2020","6/30/2028","$130K - $7.2M","Right","Reasonable","Very Strong","5'11""","149 lbs","144","6",126,140,7,7,10,7,11,8,13,9,11,13,10,9,15,11,14,15,14,13,13,11,13,12,10,9,13,14,11,14,14,13,12,11,13,13,15,14,10,7,12,8,11,10,12,11,12,11,12,14,14,2,3,1,4,3,1,2,1,1,2,2
"7235",48043476,"Yahia Fofana","8/21/2000 (22 years old)","GK","Angers SCO","Ligue 2 BKT","CIV","Yes","7/1/2022","6/30/2026","$120K - $8.2M","Right","Weak","Very Strong","6'4""","196 lbs","49","-",115,140,2,3,1,1,7,1,7,1,2,2,10,2,3,8,10,12,12,10,11,10,13,8,8,6,12,10,10,8,10,14,10,14,12,10,11,14,1,10,12,10,11,11,7,12,8,10,12,12,11,11,11,15,11,12,13,13,15,12,12,14
"7236",34000665,"Lamine Koné","2/1/1989 (34 years old)","D (C)","Le Mans FC","French National","CIV","Yes","1/16/2023","6/30/2024","$85K - $250K","Right","Weak","Very Strong","6'1""","182 lbs","340","17",113,140,5,9,9,8,9,6,14,8,7,13,10,6,14,11,14,14,14,13,11,12,14,8,10,8,12,15,8,11,11,8,13,14,13,11,12,16,8,15,15,10,13,8,10,13,13,6,12,13,10,3,3,1,2,1,3,1,3,2,2,4
"7237",12093340,"Abdramane Konaté","6/25/2006 (16 years old)","DM, M (C)","FC San Pédro","Ivorian Ligue 1","CIV","No","6/13/2022","6/30/2026","$35K - $375K","Right Only","Weak","Very Strong","5'6""","149 lbs","-","-",92,140,9,6,6,9,15,9,9,15,6,10,12,3,15,11,5,8,10,6,7,15,17,5,12,10,13,10,12,14,14,12,10,3,15,9,10,4,13,19,11,10,10,10,5,9,14,3,12,9,14,3,1,1,2,3,2,3,3,1,3,3
"7238",29114927,"Jean-Philippe Gbamin","9/25/1995 (27 years old)","D (C), DM, M (C)","Everton","English Premier Division","CIV","Yes","8/2/2019","6/30/2024","$8.2M - $10.5M","Right","Reasonable","Very Strong","6'1""","198 lbs","213","8",120,140,6,10,11,8,11,6,12,11,14,14,12,7,16,11,16,11,14,12,10,11,13,7,11,9,11,13,9,15,11,11,13,14,18,12,15,15,15,15,15,14,12,12,16,14,12,8,15,15,13,1,1,2,2,3,2,1,2,3,3,1
"7239",12021722,"Sékou Sanogo","5/5/1989 (34 years old)","DM, M (C)","Paris FC","Ligue 2 BKT","CIV","No","1/28/2021","6/30/2024","$26K - $250K","Left Only","Very Strong","Weak","6'0""","178 lbs","269","22",117,140,8,9,10,7,12,8,12,12,13,14,10,10,15,10,16,12,16,12,10,10,12,7,10,11,14,16,12,14,13,12,16,11,15,13,14,14,10,9,6,8,8,10,13,12,15,13,12,13,13,1,2,1,2,3,1,2,3,2,1,1
"7240",83284923,"Jovhany","12/24/2000 (22 years old)","ST (C)","Portomosense","Portuguese Leiria First Division","GAB","No","7/1/2022","-","$0","Right","Reasonable","Very Strong","6'2""","185 lbs","60","14",64,109,4,1,12,12,12,2,12,5,4,4,4,8,1,7,6,6,6,10,5,10,10,10,11,11,3,4,4,5,12,8,5,12,13,11,6,7,12,17,11,12,12,13,5,10,9,7,9,11,7,4,3,1,1,1,1,3,1,2,3,3
"7241",12075972,"Aké Loba","4/1/1998 (25 years old)","ST (C)","Mazatlán","Mexican First Division","CIV","No","7/7/2021","12/31/2024","$400K - $3.9M","Right","Fairly Strong","Very Strong","5'11""","171 lbs","166","44",115,140,11,7,12,13,13,11,10,10,8,7,10,9,5,11,5,12,8,10,12,9,7,11,6,13,10,10,11,10,14,15,10,11,8,14,11,11,11,18,11,12,12,9,10,12,5,1,11,13,15,1,1,3,1,3,1,1,2,2,4,3
"7242",49062672,"Sinaly Diomandé","4/9/2001 (22 years old)","D (C)","OL","Ligue 1 Uber Eats","CIV","No","1/28/2021","6/30/2025","$700K - $10M","Right","Weak","Very Strong","6'0""","163 lbs","62","-",124,140,6,8,9,7,11,8,15,8,11,13,13,8,14,12,12,14,15,12,9,11,14,11,10,10,12,14,11,15,14,11,14,14,13,14,13,14,10,11,12,13,9,12,6,12,12,2,11,13,12,3,2,3,2,3,3,2,1,2,3,2
"7243",13133823,"Roger Assalé","11/13/1993 (29 years old)","AM (L), ST (C)","Dijon FCO","French National","CIV","No","1/1/2022","6/30/2024","$20K - $210K","Right","Fairly Strong","Very Strong","5'7""","145 lbs","261","69",105,140,3,9,15,10,14,5,7,13,6,5,11,8,5,14,12,11,9,12,10,8,16,16,7,11,5,10,10,12,14,13,11,5,14,14,11,9,11,10,9,13,13,11,5,11,11,6,10,14,11,2,2,1,2,3,3,3,1,3,1,1
"7244",2000021095,"Chaka Traoré","12/23/2004 (18 years old)","AM (RL)","AC Milan","Italian Serie A","CIV","No","8/29/2021","6/30/2026","$160K - $1.6M","Right","Weak","Very Strong","5'9""","158 lbs","3","-",97,139,11,12,14,10,14,12,5,9,6,4,11,12,5,14,7,10,12,8,6,8,10,14,8,12,6,8,10,7,14,14,9,7,12,12,10,9,12,16,13,14,13,11,8,10,7,7,9,14,16,3,4,3,3,3,3,2,2,3,1,2
"7245",12081410,"Ange Ahoussou","12/22/2003 (19 years old)","D (C)","OGC Nice","French Regional 1 - Méditerranée","CIV","No","1/7/2022","6/30/2025","$0","Left","Very Strong","Weak","6'4""","176 lbs","20","2",96,138,6,5,7,6,8,7,12,3,2,10,11,7,13,3,15,11,11,9,10,13,11,6,9,5,13,7,10,8,11,9,7,16,13,9,12,12,12,17,14,11,10,11,12,11,13,7,12,11,19,2,1,3,3,2,1,1,2,2,2,3
"7246",12093794,"Abdoulaye Djiré","4/17/2006 (17 years old)","DM, M (C)","RC Abidjan","Ivorian Ligue 1","CIV","No","6/13/2022","6/30/2024","$45K - $450K","Right Only","Weak","Very Strong","5'8""","149 lbs","-","-",90,138,9,8,7,10,13,9,9,11,3,11,15,8,12,13,13,9,10,5,11,7,14,5,10,11,9,9,10,14,15,12,10,7,15,14,13,7,14,17,11,11,9,12,15,15,11,8,11,11,16,1,2,1,1,2,1,2,3,2,2,1
"7247",12078200,"Parfait Guiagon","2/2/2001 (22 years old)","M (C), AM (RLC)","Maccabi Tel-Aviv","Israeli Premier League","CIV","No","6/28/2022","5/31/2025","$275K - $2.8M","Right","Fairly Strong","Very Strong","5'7""","147 lbs","89","13",120,138,11,12,15,9,15,11,7,10,4,7,13,4,10,15,11,11,13,12,10,10,15,14,11,11,7,13,14,12,12,14,8,5,14,13,12,9,11,7,10,10,8,5,9,14,11,13,7,16,14,2,2,1,1,3,2,2,3,4,2,1
"7248",2000129308,"Yannick Agnero","2/20/2003 (20 years old)","AM (R), ST (C)","Fremad Amager","2. Division","CIV","No","7/1/2020","6/30/2026","$325K - $3.2M","Left Only","Very Strong","Weak","6'0""","165 lbs","12","-",95,138,7,11,13,13,13,7,11,10,5,3,9,10,3,13,12,12,12,11,12,4,13,15,9,13,4,12,9,12,14,13,6,11,13,14,11,7,12,12,12,14,7,12,13,7,15,7,11,13,10,1,3,2,1,1,1,1,2,3,4,2
"7249",13183071,"Lasso Coulibaly","10/19/2002 (20 years old)","M/AM (C), ST (C)","FC Nordsjælland","3F Superliga","CIV","No","2/24/2021","6/30/2025","$60K - $600K","Right Only","Weak","Very Strong","6'1""","163 lbs","43","2",115,138,9,10,13,11,14,9,10,10,6,10,14,11,9,14,13,13,13,12,13,8,12,11,9,13,11,14,12,14,14,13,12,12,13,15,11,12,15,10,14,13,8,12,6,9,10,6,11,14,12,3,3,2,1,2,2,1,2,3,2,1
"7250",12095242,"Isaac Cissé","10/10/2006 (16 years old)","M (C)","SO Armée","Ivorian Ligue 1","CIV","No","7/1/2021","6/30/2026","$40K - $375K","Right Only","Weak","Very Strong","5'10""","141 lbs","-","-",92,137,8,8,5,9,14,8,5,13,4,11,14,7,8,14,9,8,6,9,9,14,12,6,10,9,6,9,13,13,14,14,8,8,14,14,11,8,10,19,11,10,10,12,10,17,13,5,12,12,14,3,4,2,4,2,1,1,2,1,2,2
"7251",2000306009,"Guy Koumba Lelo","5/16/1998 (25 years old)","DM","Shukura","Georgian National League","GAB","No","6/12/2023","12/31/2023","$5K - $14K","Right","Fairly Strong","Very Strong","6'1""","167 lbs","-","-",65,109,5,5,5,6,6,5,4,9,1,6,8,1,12,8,10,11,7,6,8,11,15,6,5,5,11,7,7,11,13,10,6,13,13,9,13,5,12,12,9,13,10,10,11,8,9,8,10,10,11,1,3,2,1,1,3,3,1,2,3,1
"7252",85057778,"Hassane Kamara","3/5/1994 (29 years old)","D/WB/M/AM (L)","Udinese","Italian Serie A","CIV","Yes","8/23/2022","6/30/2025","$425K - $4.4M","Left Only","Very Strong","Weak","5'6""","147 lbs","204","13",125,136,10,13,14,9,13,10,12,10,6,12,13,11,15,13,13,13,15,13,13,11,11,14,7,12,10,14,13,15,13,13,12,9,15,14,14,10,14,12,14,8,12,11,5,13,15,4,11,14,14,1,2,1,1,3,3,3,1,3,2,1
"7253",63013145,"Milan Škriniar","2/11/1995 (28 years old)","D (C)","Inter","Italian Serie A","SVK","Yes","6/14/2021","6/30/2028","$124M - $149M","Right","Weak","Very Strong","6'2""","180 lbs","315","22",158,168,4,7,9,9,10,4,16,6,11,18,12,10,17,10,17,16,17,12,13,13,18,6,14,9,14,16,9,16,14,11,16,16,15,15,15,18,11,11,12,18,14,11,10,14,12,5,15,17,14,3,2,1,1,2,2,2,2,4,2,1
"7254",63012964,"Stanislav Lobotka","11/25/1994 (28 years old)","DM, M (C)","Parthenope","Italian Serie A","SVK","Yes","3/15/2023","6/30/2027","$71M - $108M","Right","Fairly Strong","Very Strong","5'8""","141 lbs","343","8",156,159,6,11,14,7,17,6,6,9,7,12,17,8,17,17,13,14,15,17,16,15,15,13,10,10,14,17,14,15,13,15,16,7,15,12,16,10,11,16,16,16,14,15,12,12,5,3,15,14,13,3,2,2,2,3,3,1,3,1,2,1
"7255",63002306,"Martin Dúbravka","1/15/1989 (34 years old)","GK","Newcastle","English Premier Division","SVK","Yes","6/14/2021","6/30/2025","$6.8M - $10M","Right","Reasonable","Very Strong","6'3""","182 lbs","332","-",137,150,1,1,1,1,11,2,3,2,5,5,12,3,3,10,9,15,14,12,10,11,15,14,13,3,15,12,12,10,13,12,13,15,14,9,10,12,1,12,16,15,12,12,8,14,10,4,15,14,16,11,14,17,11,16,14,14,5,13,12,15
"7256",63001138,"Juraj Kucka","2/26/1987 (36 years old)","M (C)","Slovan Bratislava","Slovak First Division","SVK","Yes","7/5/2022","6/30/2024","$24K - $240K","Right","Reasonable","Very Strong","6'1""","189 lbs","475","62",123,150,7,8,12,8,11,11,14,14,4,13,14,15,13,12,14,14,17,14,12,13,16,12,13,14,13,14,12,15,9,11,16,13,18,12,11,14,12,8,12,16,16,18,11,12,16,2,11,16,17,3,1,2,2,2,2,2,2,3,2,2
"7257",43461908,"Adam Obert","8/23/2002 (20 years old)","D (LC)","Cagliari","Italian Serie A","SVK","Yes","2/24/2022","6/30/2026","$1M - $10.5M","Left","Very Strong","Weak","6'1""","176 lbs","35","-",121,147,9,12,8,7,11,8,13,8,8,13,12,8,13,12,10,13,14,12,13,12,14,7,8,8,14,12,11,13,13,12,13,14,12,12,13,12,12,19,9,11,14,13,5,12,8,6,13,13,14,1,2,3,3,2,1,1,3,3,4,1
"7258",37076659,"Tomáš Suslov","6/7/2002 (21 years old)","M (C), AM (RLC)","FC Groningen","Keuken Kampioen Divisie","SVK","Yes","1/28/2022","6/30/2026","$425K - $4.2M","Left","Very Strong","Weak","5'9""","143 lbs","88","4",120,145,12,13,13,9,12,12,8,11,7,7,13,12,8,14,16,13,13,12,11,11,12,12,12,13,9,14,13,12,14,13,12,8,14,12,12,11,15,12,9,8,10,8,4,11,13,13,13,15,12,2,3,1,3,3,2,2,2,1,2,3
"7259",5643689,"Filip Holosko","1/17/1984 (39 years old)","AM (RL), ST (C)","Uvaly","Czech Lower Division","SVK","Yes","2/14/2020","-","$0","Right","Fairly Strong","Very Strong","6'1""","187 lbs","403","114",80,145,8,8,10,12,9,6,12,12,8,3,8,13,6,11,7,14,4,13,10,11,7,12,5,14,9,10,7,8,7,9,14,11,17,8,6,9,8,15,15,18,14,10,10,10,2,3,12,5,14,2,3,3,3,4,1,1,1,2,4,1
"7260",63029157,"Dominik Greif","4/6/1997 (26 years old)","GK","Mallorca","Spanish First Division","SVK","Yes","7/4/2021","6/30/2025","$2.4M - $4.9M","Right","Fairly Strong","Very Strong","6'6""","180 lbs","131","-",125,145,5,3,3,3,7,9,1,2,2,3,14,3,2,4,5,14,13,5,10,12,15,3,14,2,12,11,10,10,11,15,11,16,14,10,10,12,12,15,14,12,10,8,11,11,14,6,13,14,13,9,11,14,10,14,12,13,5,12,12,15
"7261",4001874,"Vladimir Weiss","11/30/1989 (33 years old)","AM (RL)","Slovan Bratislava","Slovak First Division","SVK","Yes","2/11/2021","6/30/2024","$65K - $650K","Right","Reasonable","Very Strong","5'8""","156 lbs","264","79",125,145,13,14,16,11,15,12,7,13,5,5,14,13,5,15,12,14,8,7,8,10,12,15,7,14,5,10,16,10,14,17,12,6,12,13,10,11,12,8,7,12,10,11,5,13,14,12,9,15,15,2,2,1,2,2,2,2,1,3,4,3
"7262",2000165853,"Roy Ndoutoumou","11/16/1994 (28 years old)","AM (L), ST (C)","Universitario de Vinto","Bolivian Premier Division","GAB","No","9/1/2021","12/31/2023","$65K - $200K","Right","Reasonable","Very Strong","5'11""","171 lbs","68","17",99,109,10,8,11,10,11,7,12,9,7,7,8,8,10,11,5,11,4,11,6,12,14,8,3,13,10,11,11,12,13,11,11,10,10,12,12,11,11,17,11,10,11,12,5,17,6,7,11,11,19,4,1,4,3,1,1,2,1,1,1,1
"7263",28090964,"Marek Rodák","12/13/1996 (26 years old)","GK","Fulham","English Premier Division","SVK","Yes","5/15/2020","6/30/2024","$8.2M - $12.5M","Right Only","Weak","Very Strong","6'5""","187 lbs","192","-",126,145,2,3,2,1,10,6,1,3,1,3,12,3,2,10,11,12,14,11,10,13,13,1,7,1,14,12,5,13,8,15,14,15,14,8,9,12,1,14,13,13,11,11,5,13,5,1,12,12,12,13,13,15,17,14,13,13,8,14,13,13
"7264",63029353,"Dávid Hancko","12/13/1997 (25 years old)","D (LC), WB (L)","Feyenoord","Eredivisie","SVK","Yes","8/22/2022","6/30/2026","$22M - $27M","Left","Very Strong","Weak","6'2""","174 lbs","171","22",141,145,9,13,14,11,11,10,11,13,10,12,14,13,15,11,7,13,11,13,14,16,12,12,13,11,13,15,13,12,14,12,13,16,10,12,14,12,11,13,15,12,7,13,12,13,8,5,11,12,4,4,1,2,2,1,1,2,2,1,2,3
"7265",63025710,"Denis Vavro","4/10/1996 (27 years old)","D (C)","FC København","3F Superliga","SVK","Yes","7/6/2022","12/31/2026","$550K - $9.4M","Right Only","Weak","Very Strong","6'2""","178 lbs","203","11",128,144,5,10,5,10,10,13,13,14,10,14,12,15,15,11,16,13,16,10,13,10,16,6,7,12,13,14,8,14,12,11,14,16,14,15,15,16,12,10,13,15,13,14,7,13,9,12,12,15,15,1,2,3,3,1,3,1,3,1,1,1
"7266",43143925,"Martin Valjent","12/11/1995 (27 years old)","D (RC)","Mallorca","Spanish First Division","SVK","Yes","2/23/2021","6/30/2025","$5.8M - $10.5M","Right","Reasonable","Very Strong","6'1""","154 lbs","315","9",131,141,4,8,7,7,12,4,15,4,7,14,12,5,14,10,13,13,12,14,14,13,10,11,10,9,14,14,11,14,12,12,13,13,14,13,14,15,14,10,12,13,11,15,5,13,11,5,15,11,15,3,2,1,1,3,2,1,1,3,4,2
"7267",28018617,"Róbert Mak","3/8/1991 (32 years old)","M/AM (RL)","Sydney FC","Isuzu UTE A-League","SVK","Yes","6/30/2022","6/30/2024","$600K - $1.8M","Right","Reasonable","Very Strong","5'10""","165 lbs","265","47",125,140,10,11,11,10,13,10,5,11,6,8,13,12,8,12,9,9,12,11,11,11,9,12,6,13,7,13,10,12,16,16,13,10,13,15,12,10,10,12,10,12,9,10,7,11,4,14,10,15,16,3,3,1,3,3,3,3,1,2,3,3
"7268",2000192797,"Leo Sauer","12/16/2005 (17 years old)","M (RL), AM (RLC)","Zilina","Slovak First Division","SVK","Yes","6/13/2022","6/30/2025","$0","Right Only","Weak","Very Strong","6'0""","163 lbs","5","-",105,140,8,11,13,11,14,10,9,12,10,6,12,6,12,13,12,11,12,12,11,11,10,11,7,12,6,12,10,11,11,13,11,8,10,11,11,8,15,12,12,10,11,11,7,10,5,3,9,9,14,1,3,1,3,3,1,3,3,3,2,2
"7269",2000058518,"Lubomir Belko","2/4/2002 (21 years old)","GK","Zilina","Slovak First Division","SVK","Yes","1/20/2022","6/30/2025","$180K - $1.8M","Right","Reasonable","Very Strong","6'2""","176 lbs","63","-",108,140,3,3,3,3,5,6,1,3,1,3,9,1,3,6,11,9,11,5,13,14,10,1,15,3,13,9,8,8,13,11,9,13,12,12,6,7,11,16,13,10,13,11,11,11,10,8,13,11,12,9,12,14,15,12,14,14,7,12,12,10
"7270",25034467,"Patrik Hrošovský","4/22/1992 (31 years old)","DM, M (C)","KRC Genk","Jupiler Pro League","SVK","Yes","5/9/2023","6/30/2025","Not for Sale","Right","Fairly Strong","Very Strong","5'8""","147 lbs","323","29",130,140,9,11,13,13,13,12,5,13,6,9,14,16,7,14,12,13,13,14,14,15,14,15,8,11,13,11,12,14,12,14,12,7,6,14,13,12,14,11,9,12,13,13,12,10,12,5,14,10,7,2,3,2,1,2,3,2,1,3,3,3
"7271",43123340,"Jakub Hromada","5/25/1996 (27 years old)","DM, M (C)","Slavia Prague","Czech First Division","SVK","Yes","12/4/2022","6/30/2025","$110K - $1.1M","Right","Fairly Strong","Very Strong","5'11""","167 lbs","131","10",110,140,6,8,11,13,15,11,9,11,7,10,15,7,10,13,10,11,9,10,9,12,13,11,10,9,10,10,13,12,12,10,10,8,14,12,11,12,9,12,11,12,14,12,15,10,9,10,11,12,10,1,2,1,3,1,1,4,2,1,2,2
"7272",63038267,"Adrián Kaprálik","6/10/2002 (21 years old)","AM (RL)","Zilina","Slovak First Division","SVK","Yes","5/14/2021","6/30/2024","$40K - $400K","Right","Fairly Strong","Very Strong","5'10""","163 lbs","114","22",110,140,11,11,12,11,10,8,7,9,11,7,9,7,6,10,7,10,7,8,10,8,10,10,3,13,11,12,11,10,15,14,7,9,15,17,8,6,18,14,10,10,10,9,5,12,15,1,7,11,9,2,2,3,2,2,1,2,2,2,3,1
"7273",34012474,"Anthony M'Fa","3/7/1991 (32 years old)","GK","Rodange","Luxembourg Division of Honour","GAB","Yes","7/1/2020","6/30/2023","$0","Right Only","Weak","Very Strong","6'0""","200 lbs","124","-",87,108,4,2,1,1,9,8,3,12,1,2,7,4,3,8,8,12,12,13,12,11,16,8,7,2,11,10,7,8,9,12,14,11,10,8,11,14,1,14,14,14,14,14,5,13,8,6,12,14,14,7,14,10,8,11,10,12,8,9,8,11
"7274",63036085,"David Strelec","4/4/2001 (22 years old)","AM (RC), ST (C)","Spezia","Italian Serie B","SVK","Yes","8/31/2021","6/30/2025","$900K - $1.9M","Left","Very Strong","Fairly Strong","6'1""","160 lbs","84","19",116,139,9,9,13,13,11,8,12,8,8,5,12,8,6,14,11,12,12,12,12,10,13,15,8,13,7,12,12,12,14,12,11,12,15,13,12,12,12,18,14,13,13,11,5,12,11,6,10,13,18,3,1,3,3,4,2,1,3,1,3,4
"7275",63023511,"Ondrej Duda","12/5/1994 (28 years old)","DM, M/AM (C)","Hellas Verona","Italian Serie A","SVK","Yes","9/16/2020","6/30/2026","$300K - $2.9M","Right","Fairly Strong","Very Strong","5'11""","163 lbs","261","36",131,138,13,12,14,10,15,12,8,12,4,10,12,15,12,15,14,11,12,12,11,11,9,15,11,12,12,12,14,15,13,13,12,8,10,12,15,11,8,14,9,11,10,7,10,12,14,10,12,14,13,2,3,2,1,3,1,2,3,2,2,1
"7276",63031763,"Róbert Boženík","11/18/1999 (23 years old)","ST (C)","Feyenoord","Eredivisie","SVK","Yes","1/27/2020","6/30/2027","$210K - $2.1M","Right","Fairly Strong","Very Strong","6'2""","178 lbs","136","32",129,137,6,7,11,16,12,6,14,11,5,7,11,12,6,13,11,15,12,13,14,12,13,12,7,14,7,15,12,12,12,11,15,14,14,12,12,14,5,12,12,16,13,11,7,14,5,5,14,15,11,2,2,2,3,3,2,1,1,2,2,2
"7277",2000250211,"Šimon Faško","4/9/2006 (17 years old)","DM, M (C)","Podbrezova","Slovak First Division","SVK","Yes","7/1/2021","6/30/2025","$35K - $375K","Left","Very Strong","Reasonable","5'8""","141 lbs","13","-",70,137,6,6,7,7,9,6,6,6,1,6,13,5,11,13,9,4,8,8,8,13,18,5,11,3,10,7,12,12,13,13,7,6,16,11,7,7,11,12,12,10,9,10,6,4,10,1,15,12,11,1,1,2,3,2,3,3,3,1,2,3
"7278",2000192180,"Simon Micuda","1/28/2004 (19 years old)","D (R)","Trencin","Slovak First Division","SVK","Yes","7/1/2020","12/31/2024","$16K - $150K","Right","Reasonable","Very Strong","5'10""","165 lbs","18","-",90,137,7,12,9,3,11,3,10,9,6,9,10,3,12,10,15,9,11,10,11,12,1,5,2,6,11,10,7,10,15,12,6,8,8,14,8,13,13,11,11,11,11,12,5,5,11,6,11,12,18,3,1,3,3,3,1,3,1,3,2,2
"7279",63025756,"Adam Jakubech","1/2/1997 (26 years old)","GK","LOSC","Ligue 1 Uber Eats","SVK","Yes","6/6/2020","6/30/2025","$160K - $1.6M","Right Only","Weak","Very Strong","6'2""","187 lbs","99","-",112,136,4,1,2,1,6,9,3,1,1,1,12,2,2,6,10,16,11,12,14,12,7,3,10,2,12,12,10,10,14,10,11,16,10,14,5,9,10,17,11,10,11,14,6,7,11,8,15,12,14,11,8,15,10,12,14,11,5,10,9,12
"7280",28059811,"Albert Rusnák","7/7/1994 (28 years old)","AM (LC)","Seattle","Major League Soccer","SVK","Yes","1/13/2022","12/31/2023","$350K - $3.5M","Right","Fairly Strong","Very Strong","5'9""","163 lbs","267","56",127,136,13,13,13,12,13,12,7,11,5,7,15,14,8,14,13,13,10,10,10,10,11,14,6,12,7,9,14,11,13,14,13,9,14,12,13,9,11,11,12,13,12,11,4,11,8,6,15,13,12,1,1,2,3,1,3,3,2,1,2,2
"7281",43155793,"Lukáš Haraslín","5/26/1996 (27 years old)","M (L), AM (RL)","Sparta Prague","Czech First Division","SVK","Yes","5/20/2022","6/30/2024","$6.2M - $11M","Right","Fairly Strong","Very Strong","6'0""","163 lbs","192","21",134,135,7,11,15,11,15,7,9,11,11,6,12,10,9,16,10,13,15,12,11,13,14,15,8,14,8,11,12,13,14,15,11,12,12,14,12,12,12,12,12,13,10,13,13,12,9,8,12,14,14,3,1,3,3,3,1,4,2,2,3,3
"7282",63036100,"Jakub Kadák","12/14/2000 (22 years old)","AM (C), ST (C)","Luzern","Swiss Super League","SVK","Yes","7/19/2022","6/30/2026","$325K - $3.3M","Right","Fairly Strong","Very Strong","5'10""","149 lbs","91","20",116,135,9,12,15,14,12,11,6,15,7,6,13,6,5,14,11,15,8,13,11,12,3,11,14,12,7,11,14,13,11,8,7,6,14,10,11,9,13,17,9,11,10,14,9,18,10,2,20,11,10,1,2,1,3,1,1,1,2,1,2,3
"7283",63031296,"Matej Oravec","3/30/1998 (25 years old)","D (C), DM","Podbrezova","Slovak First Division","SVK","Yes","7/28/2022","6/30/2025","$140K - $1.4M","Right","Reasonable","Very Strong","6'0""","156 lbs","123","2",105,135,10,7,8,7,8,10,10,9,2,10,14,7,14,11,12,11,11,11,11,10,12,5,8,10,12,13,10,12,11,13,11,12,14,12,15,10,15,15,11,12,9,10,13,11,6,8,10,11,7,1,1,2,2,1,3,1,3,1,2,2
"7284",2000270025,"Josphet Louembet","5/9/2005 (18 years old)","D (C)","MangaSport","Gabonese Premier Division","GAB","No","7/2/2022","6/30/2025","$1.5K - $4.5K","Right","Fairly Strong","Very Strong","6'4""","180 lbs","-","-",66,108,4,2,3,4,7,5,14,2,1,14,7,1,14,6,14,12,8,3,9,12,14,5,3,5,5,6,6,7,9,13,7,11,6,13,8,7,10,10,11,12,10,10,8,13,6,1,8,11,7,2,1,3,3,3,1,3,2,2,4,2
"7285",29000485,"Miroslav Stoch","10/19/1989 (33 years old)","M/AM (RL)","Motorlet","Czech Third Division CFL A","SVK","Yes","9/14/2022","6/30/2024","$35K - $100K","Right","Fairly Strong","Very Strong","5'7""","145 lbs","284","56",108,135,14,15,15,8,14,14,4,18,4,3,14,12,4,15,6,9,3,10,5,10,5,15,9,11,4,6,13,6,14,15,6,6,14,12,9,6,8,12,7,5,12,10,5,12,4,16,10,4,12,3,3,1,2,4,3,1,2,2,3,1
"7286",29156867,"Christián Herc","9/30/1998 (24 years old)","M/AM (C)","Grasshoppers","Swiss Super League","SVK","Yes","7/1/2021","6/30/2025","$0","Right","Reasonable","Very Strong","6'2""","158 lbs","140","20",119,134,4,7,13,9,14,8,9,13,4,9,14,13,11,14,13,13,11,13,8,12,11,14,7,13,11,12,12,13,13,11,13,13,13,13,13,14,15,12,11,12,12,11,9,8,12,6,10,12,7,1,1,2,3,2,2,1,3,2,2,3
"7287",63013052,"Norbert Gyömbér","7/3/1992 (30 years old)","D (C)","Salernitana","Italian Serie A","SVK","Yes","1/13/2023","6/30/2025","$550K - $5.2M","Right Only","Weak","Very Strong","6'2""","174 lbs","267","3",127,133,3,7,10,4,10,3,13,6,10,13,10,5,16,9,14,15,13,12,13,13,17,5,11,3,13,15,5,16,15,13,13,14,12,15,15,13,11,14,15,18,15,14,8,13,15,5,15,12,14,3,3,2,1,1,4,1,3,2,1,2
"7288",38039792,"László Bénes","9/9/1997 (25 years old)","DM, M/AM (C)","HSV","Bundesliga 2","SVK","Yes","7/1/2022","6/30/2026","$600K - $6.2M","Left","Very Strong","Weak","5'11""","158 lbs","162","13",126,132,15,15,12,10,15,15,7,13,6,10,15,14,10,16,13,12,11,14,11,12,12,15,7,12,11,12,16,12,11,14,12,9,11,12,14,8,13,16,10,12,11,10,12,11,8,7,13,13,12,2,2,3,1,2,1,2,1,2,3,2
"7289",2000054390,"Sebastian Kosa","9/13/2003 (19 years old)","D (C), DM","Trnava","Slovak First Division","SVK","Yes","11/5/2021","12/31/2025","$150K - $1.5M","Right","Reasonable","Very Strong","6'3""","176 lbs","67","3",100,132,8,8,5,7,6,8,13,9,4,14,10,3,12,9,13,11,10,8,8,14,2,5,8,8,14,6,10,9,12,8,9,15,15,11,9,7,15,20,9,12,9,12,12,16,5,7,12,11,12,3,2,3,2,2,3,3,2,1,3,1
"7290",2000294098,"Marián Weber","9/25/2005 (17 years old)","AM (L)","Sparta Prague","Czech First Division","SVK","Yes","6/12/2023","6/30/2024","$170K - $1.7M","Left","Very Strong","Fairly Strong","5'8""","136 lbs","2","-",75,131,7,11,13,13,7,6,7,5,6,4,11,3,5,10,9,7,6,8,8,9,4,10,1,7,6,7,5,8,13,13,3,7,14,13,5,4,15,11,11,11,12,9,7,8,12,3,11,11,12,2,3,1,3,3,2,1,4,1,3,2
"7291",63037858,"Matej Trusa","11/29/2000 (22 years old)","ST (C)","Viktoria Plzeň","Czech First Division","SVK","Yes","2/9/2021","6/30/2024","$0","Right","Reasonable","Very Strong","6'0""","158 lbs","91","16",97,130,9,6,6,9,11,6,14,9,5,8,9,7,7,10,11,10,5,9,10,13,10,7,7,13,10,10,5,12,12,9,10,12,6,13,14,11,11,19,9,11,12,10,11,14,6,4,16,12,15,3,2,2,3,2,3,3,4,2,1,3
"7292",7563749,"Peter Pekarík","10/30/1986 (36 years old)","D (RL), WB (R)","Hertha","Bundesliga 2","SVK","Yes","6/14/2021","6/30/2024","$110K - $325K","Right","Reasonable","Very Strong","5'10""","160 lbs","428","9",117,130,4,12,11,6,11,4,10,6,16,12,12,6,13,11,12,14,13,12,14,12,15,8,14,11,12,17,10,16,12,12,13,9,17,13,13,11,13,18,17,18,12,16,6,12,8,3,15,12,14,2,1,3,4,1,1,1,3,2,2,2
"7293",63010764,"Lukáš Štetina","7/28/1991 (31 years old)","D (C)","Trnava","Slovak First Division","SVK","Yes","6/30/2022","6/30/2025","Not for Sale","Right Only","Weak","Very Strong","6'2""","191 lbs","278","12",120,130,3,7,8,6,9,6,14,10,13,15,12,10,11,10,14,10,15,13,14,10,13,12,13,7,12,12,9,10,13,11,17,15,15,11,13,17,8,9,10,14,13,10,6,12,10,8,14,13,11,1,3,4,3,3,3,1,3,2,4,2
"7294",63038264,"Miroslav Gono","11/1/2000 (22 years old)","DM, M/AM (C)","Zilina","Slovak First Division","SVK","Yes","7/24/2018","6/30/2025","$0","Right","Fairly Strong","Very Strong","5'11""","165 lbs","92","1",101,130,5,9,15,10,11,9,10,10,2,6,10,7,12,9,11,13,10,11,12,11,13,11,3,15,13,14,14,12,9,9,15,7,14,10,12,9,16,15,13,13,12,12,6,10,10,5,12,12,13,1,2,4,3,2,3,2,3,1,3,2
"7295",2000298690,"Yves Mbandinga","12/9/2004 (18 years old)","M (C)","CS Bendjé","Gabonese Premier Division","GAB","No","1/1/2021","6/30/2024","$0","Right","Fairly Strong","Very Strong","6'4""","176 lbs","-","-",55,108,5,3,2,6,13,5,5,10,1,4,11,1,8,11,8,4,5,11,3,7,13,5,2,3,6,6,13,11,13,13,6,12,13,13,7,6,10,14,9,13,12,10,6,2,13,7,8,10,16,1,2,2,2,4,1,2,1,3,1,2
"7296",63023419,"Miroslav Káčer","2/2/1996 (27 years old)","M/AM (RC)","Viktoria Plzeň","Czech First Division","SVK","Yes","5/8/2020","6/30/2023","$4.5K - $45K","Right","Fairly Strong","Very Strong","5'7""","169 lbs","255","39",120,130,11,7,10,10,12,8,6,14,11,8,14,8,12,12,8,13,14,11,13,10,14,5,10,12,14,16,12,16,12,10,15,5,15,11,17,10,10,16,11,15,11,14,10,11,5,6,14,10,8,1,3,1,3,2,2,3,2,2,1,1
"7297",63001824,"Jakub Sylvestr","2/2/1989 (34 years old)","ST (C)","Resovia","Polish First Division","SVK","Yes","1/9/2023","6/30/2024","$0 - $40K","Right","Reasonable","Very Strong","5'10""","167 lbs","416","96",99,130,5,9,12,12,12,6,11,8,5,6,12,11,6,12,14,12,12,12,10,9,11,13,6,12,8,7,11,12,13,13,8,9,15,12,13,9,11,13,13,12,14,12,5,11,12,6,12,14,12,2,3,3,3,1,3,1,3,1,3,4
"7298",63031295,"Martin Vantruba","2/7/1998 (25 years old)","GK","Trnava","Slovak First Division","SVK","Yes","6/23/2022","6/30/2025","$14K - $130K","Right Only","Weak","Very Strong","6'5""","171 lbs","71","-",105,130,2,2,3,3,6,2,2,1,10,8,8,4,10,7,7,9,8,9,12,8,12,16,10,4,9,9,2,2,16,14,15,18,13,11,11,14,1,10,11,12,11,8,10,11,10,10,12,14,10,10,13,14,10,12,13,14,10,8,9,16
"7299",7563339,"Erik Jendrisek","10/26/1986 (36 years old)","ST (C)","Liptovsky Mikulas","Slovak Second Division","SVK","Yes","7/22/2022","6/30/2024","$3K - $30K","Left","Very Strong","Reasonable","5'9""","163 lbs","469","130",105,130,7,12,11,15,14,8,9,10,3,6,10,16,6,12,14,11,12,13,10,15,12,12,12,15,7,10,9,12,11,12,13,8,14,10,10,9,9,14,13,15,13,13,3,14,4,6,14,15,12,1,3,1,3,3,3,1,2,2,2,3
"7300",63037865,"Ivan Mesik","6/1/2001 (22 years old)","D (C)","Pescara","Italian Serie C/B","SVK","Yes","1/5/2023","6/30/2024","$325K - $1M","Right","Strong","Very Strong","6'0""","165 lbs","86","2",107,130,7,8,9,3,9,5,12,6,9,13,11,5,12,11,13,13,13,13,13,11,13,8,10,9,13,12,9,13,10,10,13,11,13,10,12,12,14,10,11,12,9,12,5,9,13,7,7,13,10,3,2,3,3,3,1,3,1,2,3,3
"7301",63011865,"Robert Mazan","2/9/1994 (29 years old)","D/WB (L)","Hebar","Bulgarian First League","SVK","Yes","9/7/2022","6/30/2025","$400K - $1.2M","Left","Very Strong","Reasonable","5'10""","158 lbs","224","3",108,130,10,13,13,4,11,9,12,6,8,11,13,7,11,12,14,12,14,10,12,12,13,8,8,10,13,13,12,14,12,11,8,10,14,13,13,10,8,11,14,8,12,10,11,9,10,5,13,9,14,3,3,1,3,2,3,3,1,2,3,2
"7302",2000061414,"Tomáš Rigo","7/3/2002 (20 years old)","M/AM (C)","Slavia Prague","Czech Third Division CFL A","SVK","Yes","8/16/2018","6/30/2024","$0","Right","Reasonable","Very Strong","6'0""","147 lbs","58","10",105,130,9,9,11,12,15,9,7,10,5,10,14,6,11,15,7,10,9,10,10,14,4,13,1,11,11,10,10,13,15,13,10,8,16,15,8,7,13,13,8,10,9,13,8,4,10,3,17,10,13,4,1,2,4,1,3,3,3,1,1,1
"7303",63033455,"Ivan Krajcirik","6/15/2000 (22 years old)","GK","Ruzomberok","Slovak First Division","SVK","Yes","9/7/2022","6/30/2026","$55K - $550K","Right","Reasonable","Very Strong","6'1""","176 lbs","76","-",103,130,3,1,3,1,2,6,1,1,3,1,9,2,1,6,10,8,15,7,9,14,14,3,5,1,12,8,8,6,13,15,8,13,15,11,1,7,10,16,10,11,13,10,12,9,11,4,12,12,14,6,7,14,10,13,12,14,5,11,10,12
"7304",63036070,"Richard Ludha","11/8/2000 (22 years old)","GK","Podbrezova","Slovak First Division","SVK","Yes","1/24/2023","1/31/2025","$180K - $1.8M","Right","Reasonable","Very Strong","6'0""","163 lbs","91","-",110,130,5,3,2,1,1,7,1,2,3,1,8,1,2,6,5,11,15,5,13,13,7,2,6,1,9,9,8,8,13,14,9,5,13,13,4,6,13,14,11,7,11,13,6,16,5,5,12,12,7,10,6,13,8,11,13,12,5,11,13,10
"7305",63032678,"David Šípoš","8/14/1998 (24 years old)","GK","České Budějovice","Czech First Division","SVK","Yes","7/18/2021","6/30/2024","$110K - $1.1M","Right","Reasonable","Very Strong","6'2""","160 lbs","77","-",105,130,5,3,1,3,4,7,1,3,1,2,10,3,2,5,8,13,13,5,11,14,4,2,9,2,9,9,8,8,14,16,9,14,13,13,7,6,11,15,12,11,10,14,9,10,9,7,20,13,18,9,10,14,10,13,7,12,5,10,9,11
"7306",48049837,"Anthony Oyono","4/12/2001 (22 years old)","D/WB/M (R)","Frosinone","Italian Serie A","GAB","Yes","1/31/2022","6/30/2024","$2M - $4.1M","Right","Weak","Very Strong","6'0""","163 lbs","46","-",117,135,10,11,11,8,9,8,10,11,4,11,10,9,12,11,12,12,13,11,10,12,13,8,7,12,12,12,11,12,14,14,11,9,13,14,15,11,12,15,11,11,9,12,7,8,8,4,12,11,8,3,2,1,2,2,3,1,1,2,3,1
"7307",2000270020,"Hants Mbega","10/1/2003 (19 years old)","DM, M (LC), AM (L)","Lambaréné","Gabonese Premier Division","GAB","No","1/1/2022","6/30/2024","$0","Left","Very Strong","Fairly Strong","5'7""","136 lbs","-","-",63,107,5,9,12,9,12,2,4,6,4,5,12,1,11,12,8,3,6,4,6,11,15,13,11,6,5,5,8,10,12,12,5,1,10,12,8,1,14,16,9,10,9,12,9,4,6,2,10,10,11,3,2,2,1,2,1,3,3,2,4,3
"7308",63025586,"Matúš Bero","9/6/1995 (27 years old)","M/AM (C)","Vitesse","Eredivisie","SVK","Yes","6/15/2020","6/30/2025","$4.7M - $7.2M","Right","Fairly Strong","Very Strong","5'11""","178 lbs","249","46",126,130,9,9,13,11,13,9,12,11,8,9,13,15,10,12,17,13,16,11,12,11,13,7,12,12,10,13,12,16,12,12,14,11,12,13,16,13,14,12,7,13,10,12,10,12,14,7,13,12,14,2,3,2,2,4,1,1,2,2,4,1
"7309",67228634,"Achraf Hakimi","11/4/1998 (24 years old)","D/WB/M (R)","Paris SG","Ligue 1 Uber Eats","MAR","Yes","7/6/2021","6/30/2026","$122M - $184M","Right","Reasonable","Very Strong","5'11""","160 lbs","188","26",161,168,7,15,13,13,14,12,8,13,12,10,14,8,13,14,14,13,12,12,10,12,15,14,8,17,10,12,13,13,18,15,14,9,17,20,15,11,15,13,11,14,14,12,5,13,8,10,13,16,15,2,1,1,3,2,2,2,2,4,2,1
"7310",2000055184,"Bilal El Khannouss","5/10/2004 (19 years old)","M (LC), AM (C)","KRC Genk","Jupiler Pro League","MAR","Yes","2/6/2023","6/30/2027","$17M - $26M","Right","Fairly Strong","Very Strong","5'11""","154 lbs","40","1",120,165,11,12,13,8,14,10,8,9,6,5,15,8,6,13,11,12,14,14,12,15,14,14,6,14,6,14,14,14,13,12,5,10,13,14,11,8,12,7,10,10,10,12,8,6,7,5,12,16,8,1,1,1,3,3,4,4,3,2,1,1
"7311",2000054872,"Ez Abde","12/17/2001 (21 years old)","M/AM (RL), ST (C)","Barcelona","Spanish First Division","MAR","Yes","9/1/2022","6/30/2026","$13M - $20M","Right","Fairly Strong","Very Strong","5'10""","160 lbs","114","20",139,161,10,12,16,12,14,10,8,12,8,5,12,12,6,14,11,12,13,11,9,12,14,16,9,13,7,10,11,10,15,16,12,8,15,14,12,9,13,10,9,12,19,13,2,13,12,12,13,15,13,2,3,3,4,1,3,3,1,3,3,1
"7312",37040604,"Hakim Ziyech","3/19/1993 (30 years old)","M/AM (RLC)","Chelsea","English Premier Division","MAR","Yes","7/1/2020","6/30/2025","$0","Left","Very Strong","Reasonable","5'11""","152 lbs","280","85",147,160,14,14,14,10,16,16,10,14,7,6,15,13,6,16,13,17,13,13,10,9,14,17,11,14,6,12,17,12,14,16,12,10,15,13,15,9,15,12,15,15,14,14,6,14,10,12,11,14,14,1,4,1,3,2,3,1,2,3,2,3
"7313",28106999,"Brahim Díaz","8/3/1999 (23 years old)","AM (RC)","R. Madrid","Spanish First Division","MAR","Yes","6/14/2021","6/30/2025","$19.5M - $25M","Right","Strong","Very Strong","5'7""","130 lbs","111","14",147,159,12,12,16,12,15,9,6,12,7,7,14,12,8,16,9,14,14,12,14,12,17,15,8,14,9,14,14,14,16,16,13,7,13,14,12,6,15,11,14,16,13,13,5,13,11,6,12,15,16,1,1,4,2,1,2,1,1,4,2,3
"7314",67229630,"Youssef En-Nesyri","6/1/1997 (26 years old)","ST (C)","Sevilla","Spanish First Division","MAR","No","6/14/2021","6/30/2025","$58M - $88M","Left","Very Strong","Fairly Strong","6'2""","160 lbs","204","61",147,159,9,11,13,14,12,9,15,13,7,5,12,12,6,13,9,15,15,12,13,12,13,12,11,16,6,13,11,15,16,12,12,17,14,15,14,14,9,7,12,12,11,10,9,14,13,9,13,17,9,3,3,2,3,2,2,2,2,1,1,1
"7315",49052370,"Azzedine Ounahi","4/19/2000 (23 years old)","DM, M (C)","OM","Ligue 1 Uber Eats","MAR","No","1/29/2023","6/30/2027","$8.6M - $13M","Right","Reasonable","Very Strong","6'0""","136 lbs","81","8",127,159,7,10,14,7,14,7,11,8,4,12,15,9,11,14,10,12,13,13,11,11,15,14,8,12,12,12,15,13,13,15,11,11,12,13,15,12,11,15,11,12,9,8,5,11,7,4,12,12,12,1,1,1,1,2,1,3,2,3,3,1
"7316",37045879,"Sofyan Amrabat","8/21/1996 (26 years old)","DM, M (C)","Fiorentina","Italian Serie A","MAR","Yes","9/1/2020","6/30/2024","$13.5M - $17M","Right","Reasonable","Very Strong","6'1""","154 lbs","204","4",147,155,10,6,14,7,13,6,7,10,4,12,14,13,15,13,18,16,14,15,14,14,15,12,12,12,14,15,13,17,14,14,16,9,15,14,15,14,14,14,13,15,13,12,6,14,13,11,13,15,16,2,2,2,1,1,2,1,3,1,1,2
"7317",37052470,"Noussair Mazraoui","11/14/1997 (25 years old)","D (RL), WB (R), DM, M (RC)","FC Bayern","Bundesliga","MAR","Yes","7/1/2022","6/30/2026","$20M - $31M","Right","Reasonable","Very Strong","6'0""","143 lbs","169","19",149,155,8,12,14,9,15,7,11,12,12,11,14,10,14,15,13,12,15,13,12,13,12,15,11,14,12,16,14,16,14,15,12,11,11,14,15,10,18,10,13,12,12,15,12,12,7,4,13,15,10,4,3,2,3,1,3,2,3,1,1,3
"7318",48036488,"Yannis N'Gakoutou","9/30/1998 (24 years old)","D/WB (R)","Football Club 93 BBG","French National 2 - D","GAB","Yes","11/1/2022","6/30/2024","$30K - $300K","Right Only","Weak","Very Strong","5'10""","169 lbs","30","-",94,106,8,12,11,6,11,7,8,7,10,11,12,8,10,12,8,9,11,8,11,11,12,5,10,13,11,12,11,13,12,11,13,9,13,13,12,12,13,13,13,12,11,14,7,11,11,7,9,12,20,1,3,3,1,3,1,3,2,4,3,1
"7319",12029963,"Yassine Bounou","4/5/1991 (32 years old)","GK","Sevilla","Spanish First Division","MAR","No","4/19/2022","6/30/2025","Not for Sale","Left","Very Strong","Reasonable","6'3""","176 lbs","268","1",150,155,4,2,1,1,7,9,8,1,2,3,7,3,2,5,7,13,14,14,16,14,13,6,11,2,15,15,8,13,10,13,9,15,11,13,11,14,14,17,12,16,11,14,13,17,2,4,15,12,11,15,9,15,11,16,15,16,4,15,15,14
"7320",37001123,"Nordin Amrabat","3/31/1987 (36 years old)","AM (RLC), ST (C)","AEK","Greek Super League 1","MAR","Yes","8/16/2021","6/30/2024","$70K - $700K","Right","Reasonable","Very Strong","5'10""","169 lbs","467","79",125,155,11,13,14,9,14,10,7,9,4,8,13,15,7,15,16,10,15,10,8,9,15,15,9,13,8,12,13,13,14,12,15,8,16,13,11,15,10,9,10,15,14,10,7,11,12,13,9,14,13,2,1,2,4,2,3,1,3,1,1,1
"7321",2000108547,"Amir Richardson","1/24/2002 (21 years old)","DM, M (C)","Reims","Ligue 1 Uber Eats","MAR","Yes","9/1/2022","6/30/2027","$9.8M - $12.5M","Left","Very Strong","Fairly Strong","6'5""","171 lbs","62","2",122,154,5,4,11,8,12,7,12,7,2,13,14,8,13,14,15,11,13,11,10,14,15,11,7,12,12,13,14,11,12,15,17,17,12,12,12,12,7,14,8,12,13,10,12,10,5,11,14,12,7,2,1,2,1,1,2,2,1,2,1,3
"7322",48038017,"Imrân Louza","5/1/1999 (24 years old)","DM, M/AM (C)","Watford","Sky Bet Championship","MAR","Yes","9/27/2022","6/30/2028","$9.4M - $11.5M","Left","Very Strong","Reasonable","5'10""","143 lbs","99","14",128,153,11,12,12,10,15,11,8,11,6,12,14,10,8,15,11,13,12,13,12,13,15,12,10,13,13,13,15,13,12,13,10,8,11,12,13,11,9,10,13,16,10,16,5,10,8,10,13,14,13,3,3,3,1,4,1,3,3,4,2,3
"7323",2000058232,"Chadi Riad","6/17/2003 (19 years old)","D (C)","Barcelona B","Spanish Federation First Division A","MAR","Yes","7/5/2022","6/30/2024","$28K - $7M","Left","Very Strong","Reasonable","6'2""","178 lbs","36","2",125,152,5,7,10,6,12,5,14,6,9,14,13,7,13,12,14,12,14,12,12,13,14,7,12,8,13,15,12,14,12,11,12,15,14,14,11,13,10,12,14,13,12,11,6,15,12,10,12,13,12,3,3,3,3,2,2,2,1,1,2,1
"7324",67174735,"Munir","9/1/1995 (27 years old)","AM (RL), ST (C)","Getafe","Spanish First Division","MAR","Yes","8/31/2022","6/30/2025","$450K - $4.6M","Left","Very Strong","Weak","5'9""","152 lbs","231","48",131,150,13,13,15,13,15,12,8,13,8,4,13,13,5,16,8,14,7,12,10,13,12,16,8,15,6,11,15,9,14,15,13,8,12,13,12,10,14,11,17,15,10,16,11,14,9,7,10,17,14,1,2,1,1,3,1,3,3,1,1,3
"7325",29117753,"Abderrazak Hamdallah","12/17/1990 (32 years old)","ST (C)","Al-Ittihad","Saudi Professional League","MAR","No","2/2/2023","6/30/2025","$3.8M","Right","Reasonable","Very Strong","6'0""","178 lbs","273","219",135,150,9,8,12,16,14,11,14,12,7,9,11,13,8,13,13,13,14,14,11,13,12,14,10,16,10,8,12,12,12,12,13,14,13,13,14,13,10,5,7,15,13,14,9,13,8,9,14,14,13,2,2,1,2,3,3,1,1,1,3,4
"7326",34001033,"Adel Taarabt","5/24/1989 (34 years old)","M/AM (C)","Al-Nasr (UAE)","UAE Professional League","MAR","Yes","9/25/2022","6/30/2024","$1.5M - $3.2M","Right","Fairly Strong","Very Strong","5'10""","158 lbs","328","49",125,150,12,14,15,8,16,10,6,8,5,8,15,13,10,17,12,12,12,14,9,10,9,16,9,10,8,13,16,9,10,14,15,10,10,12,11,13,11,8,10,7,14,13,7,11,16,15,10,6,10,3,1,1,3,2,1,1,2,1,3,1
"7327",18105831,"Ismael Saibari","1/28/2001 (22 years old)","M (C), AM (RLC), ST (C)","PSV","Eredivisie","MAR","Yes","7/13/2022","6/30/2025","$32M - $40M","Right","Weak","Very Strong","6'1""","169 lbs","73","9",133,149,7,12,14,12,13,10,12,12,10,5,12,10,6,14,9,11,14,12,10,12,13,15,10,12,6,14,15,12,14,13,11,13,13,14,14,9,14,17,1,14,12,11,14,8,8,3,10,9,13,1,1,2,3,2,3,2,2,2,3,1
"7328",2000045698,"Oussama Targhalline","5/20/2002 (21 years old)","DM, M (C)","Havre AC","Ligue 1 Uber Eats","MAR","No","1/7/2023","6/30/2026","$550K - $10.5M","Right","Weak","Very Strong","5'9""","145 lbs","20","1",115,147,10,7,11,8,14,9,6,11,5,10,15,14,11,14,11,12,10,13,13,13,12,11,8,10,11,12,14,11,11,12,13,7,12,12,14,11,12,9,13,13,11,11,13,13,7,6,13,14,14,1,1,3,2,2,3,2,3,1,3,1
"7329",2000224459,"Rody Junior Effaghe","4/11/2004 (19 years old)","AM (RL), ST (C)","Gomel","Belarusian Highest League","GAB","No","3/15/2023","12/31/2023","$6K - $65K","Right Only","Weak","Very Strong","6'1""","167 lbs","14","3",85,105,6,6,14,8,12,6,10,6,6,4,6,6,4,14,8,12,8,8,6,8,14,8,8,13,6,14,6,12,13,12,8,10,12,14,12,8,12,14,13,10,13,13,8,8,8,4,10,12,19,1,2,2,2,3,4,3,1,3,1,3
"7330",85104863,"Sofiane Boufal","9/17/1993 (29 years old)","AM (RLC), ST (C)","Al-Rayyan","Qatar Stars League","MAR","Yes","1/31/2023","5/31/2026","$10.5M - $13M","Right","Reasonable","Very Strong","5'9""","165 lbs","259","38",135,145,12,13,16,12,15,13,7,13,8,6,12,13,5,16,10,11,8,13,11,11,12,17,8,13,6,10,14,8,13,15,17,8,12,14,12,9,14,11,10,12,14,13,10,12,8,9,11,13,13,1,3,3,3,2,4,2,1,2,1,1
"7331",29023774,"Youssef El Arabi","2/3/1987 (36 years old)","ST (C)","Olympiacos","Greek Super League 1","MAR","Yes","6/15/2022","6/30/2024","$110K - $1.1M","Right","Fairly Strong","Very Strong","6'0""","165 lbs","424","222",125,145,6,9,14,15,15,6,14,12,4,6,12,14,6,16,10,14,12,14,11,12,14,15,12,15,7,13,12,12,10,10,14,12,15,10,9,14,9,15,12,16,15,12,5,15,8,8,12,13,15,1,1,1,3,2,3,3,3,2,1,1
"7332",34008669,"Younes Belhanda","2/25/1990 (33 years old)","M/AM (C), ST (C)","Adana D.S.","Turkish Super League","MAR","Yes","7/30/2021","6/30/2024","$3.5M - $6.8M","Right","Weak","Very Strong","5'9""","171 lbs","389","72",130,145,13,13,13,12,14,11,5,13,8,6,14,15,8,17,13,13,13,14,11,15,12,16,5,14,9,14,17,13,12,13,14,9,14,11,12,12,14,8,7,16,16,12,12,14,17,4,14,12,8,2,3,1,3,2,1,1,1,3,2,1
"7333",43391696,"Walid Cheddira","1/22/1998 (25 years old)","ST (C)","Bari","Italian Serie B","MAR","Yes","7/1/2022","6/30/2025","$7.4M - $11M","Right","Reasonable","Very Strong","6'2""","176 lbs","246","61",133,145,7,11,13,14,12,5,12,10,7,6,12,13,12,12,13,12,14,11,12,13,14,5,10,14,7,15,13,17,15,14,14,13,14,15,14,13,12,12,8,13,10,10,7,12,10,7,13,13,12,3,2,4,1,1,3,1,2,1,3,2
"7334",85137101,"Amine Harit","6/18/1997 (25 years old)","M (L), AM (RLC)","Schalke 04","Bundesliga 2","MAR","Yes","6/14/2021","6/30/2026","$5.4M - $10M","Right","Reasonable","Very Strong","5'11""","147 lbs","165","17",137,145,14,11,17,11,15,14,5,11,3,8,15,12,8,17,12,12,9,13,11,13,12,17,4,13,8,12,16,12,15,16,12,8,13,14,12,7,15,11,10,10,10,8,8,12,6,16,14,13,12,1,1,3,1,2,3,1,1,1,4,1
"7335",13199286,"Nayef Aguerd","3/30/1996 (27 years old)","D (C)","West Ham","English Premier Division","MAR","No","6/20/2022","6/30/2027","$37M - $56M","Left Only","Very Strong","Weak","6'2""","167 lbs","186","15",140,144,3,9,10,12,12,4,16,7,11,14,13,9,16,13,11,14,14,15,14,14,12,5,11,9,15,12,13,12,13,12,13,16,12,14,13,12,9,12,13,10,11,13,6,13,7,7,12,12,12,3,1,2,4,2,1,3,2,3,1,4
"7336",18106037,"Anass Zaroury","11/7/2000 (22 years old)","AM (RL)","Burnley","English Premier Division","MAR","Yes","8/30/2022","6/30/2026","$15.5M - $19M","Right","Strong","Very Strong","5'11""","160 lbs","107","21",129,144,9,13,14,12,14,8,5,11,6,7,13,8,5,15,11,13,14,12,12,12,13,16,7,13,8,11,11,11,15,14,10,9,12,14,11,9,11,7,10,8,9,12,10,12,10,6,12,14,14,3,4,2,2,4,4,4,3,3,1,1
"7337",49053187,"Yassine Kechta","2/25/2002 (21 years old)","M/AM (C)","Havre AC","Ligue 1 Uber Eats","MAR","Yes","7/1/2018","6/30/2026","$275K - $2.7M","Right","Weak","Very Strong","5'5""","121 lbs","29","1",121,144,9,7,15,8,15,8,4,9,5,5,13,9,11,14,14,12,13,10,9,15,14,13,7,13,10,14,13,16,13,15,13,3,15,13,15,8,10,15,12,12,11,13,13,10,5,6,12,15,19,1,2,1,1,3,2,1,2,1,2,1
"7338",49037698,"Amine Adli","5/10/2000 (23 years old)","AM (RLC)","Bayer 04","Bundesliga","MAR","Yes","8/26/2021","6/30/2026","$13M - $19.5M","Left","Very Strong","Reasonable","5'9""","158 lbs","89","16",132,144,12,10,15,12,13,12,11,11,6,7,12,10,8,14,13,12,12,12,10,10,14,16,7,12,7,12,12,13,16,16,12,8,13,15,12,9,13,8,7,12,10,12,6,11,11,11,12,16,13,3,2,3,1,1,1,2,1,2,1,1
"7339",2000018847,"Benjamin Bouchouari","11/13/2001 (21 years old)","M/AM (C)","ASSE","French National 3 - Group K","MAR","Yes","8/16/2022","6/30/2025","$300K - $3.1M","Right","Weak","Very Strong","5'5""","143 lbs","99","4",110,142,11,13,14,8,12,11,7,13,7,6,12,7,6,13,12,13,14,10,10,11,14,13,7,12,7,13,13,11,14,13,12,8,13,14,12,8,12,12,7,10,11,11,5,15,6,3,11,12,12,2,2,1,2,1,1,1,3,2,1,2
"7340",13104377,"Johan Lengoualama","9/29/1992 (30 years old)","ST (C)","Al-Qous","Saudi Second Division Group B","GAB","No","8/14/2022","6/30/2023","$20K - $60K","Right Only","Very Weak","Very Strong","6'1""","169 lbs","70","5",90,105,9,8,11,10,10,9,12,9,5,9,10,7,5,11,13,11,13,11,10,10,6,9,10,15,10,9,11,13,12,12,13,14,12,12,12,13,10,11,10,11,12,8,9,16,8,2,16,11,18,3,1,1,3,3,2,1,2,1,1,2
"7341",49039002,"Aïmen Moueffek","4/9/2001 (22 years old)","DM, M (C)","ASSE","Ligue 2 BKT","MAR","Yes","5/27/2021","6/30/2024","$425K - $4.3M","Right Only","Weak","Very Strong","5'10""","160 lbs","56","1",110,142,10,10,11,11,13,10,9,12,5,7,12,10,13,13,5,13,11,12,12,13,5,5,5,11,12,11,15,13,8,12,12,10,14,12,13,9,11,11,1,11,11,10,10,12,11,3,11,12,11,3,1,3,2,4,3,3,3,1,2,3
"7342",37065498,"Zakaria Aboukhlal","2/18/2000 (23 years old)","AM (RL), ST (C)","Toulouse FC","Ligue 1 Uber Eats","MAR","Yes","7/1/2022","6/30/2026","$8.2M - $12M","Left","Very Strong","Fairly Strong","5'10""","160 lbs","149","40",130,141,7,8,12,13,13,8,8,11,5,5,11,11,5,12,12,14,12,11,11,11,14,14,5,13,9,9,11,13,15,14,14,11,12,15,14,13,16,13,6,12,11,11,4,11,5,2,12,11,14,3,3,2,1,3,2,1,2,3,2,1
"7343",85084000,"Fayçal Fajr","8/1/1988 (34 years old)","M/AM (C)","Al-Wehda","Saudi Professional League","MAR","Yes","5/31/2022","6/30/2024","$275K - $2.8M","Right","Fairly Strong","Very Strong","5'10""","154 lbs","429","45",130,140,15,15,13,9,14,14,8,14,5,9,16,13,9,15,15,12,11,13,14,12,17,15,13,13,8,12,15,13,11,12,13,10,14,12,14,12,8,9,11,12,10,13,7,11,9,8,10,15,15,3,2,2,3,3,1,3,2,4,3,1
"7344",18008268,"Omar El Kaddouri","8/21/1990 (32 years old)","M (C), AM (RLC)","PAOK","Greek Super League 1","MAR","Yes","6/14/2021","6/30/2024","$300K - $3.1M","Right","Fairly Strong","Very Strong","6'1""","180 lbs","299","27",120,140,12,13,15,10,14,12,11,12,8,8,15,11,9,15,10,11,9,10,11,11,11,14,12,13,12,11,15,11,10,11,15,12,7,12,11,13,12,8,9,11,12,13,16,13,12,8,10,14,12,3,2,1,1,2,4,1,1,1,2,3
"7345",37064635,"Abdou Harroui","1/13/1998 (25 years old)","DM, M (C)","Sassuolo","Italian Serie A","MAR","Yes","7/1/2022","6/30/2026","$275K - $2.7M","Right","Fairly Strong","Very Strong","5'11""","167 lbs","185","26",125,140,4,7,12,11,12,10,11,13,10,10,13,13,12,13,14,12,14,13,12,13,14,10,10,13,11,15,13,15,12,12,13,11,14,11,14,12,14,14,11,14,14,12,6,12,8,6,12,15,12,1,1,1,2,2,3,3,3,1,4,3
"7346",67061770,"Munir Mohand","5/10/1989 (34 years old)","GK","Al-Wehda","Saudi Professional League","MAR","Yes","6/10/2022","5/31/2024","$5.6M - $8.6M","Right Only","Weak","Very Strong","6'3""","196 lbs","320","-",130,140,4,2,3,3,9,6,4,2,3,1,10,5,2,9,7,12,12,12,11,13,13,4,12,3,14,12,8,12,13,13,12,13,14,14,12,14,13,13,3,11,7,12,5,13,12,6,13,8,8,13,12,14,13,14,13,15,8,12,12,14
"7347",91175740,"Abdelhamid Sabiri","11/28/1996 (26 years old)","M/AM (LC)","Sampdoria","Italian Serie B","MAR","Yes","1/30/2023","6/30/2025","$350K - $7.4M","Right","Fairly Strong","Very Strong","6'1""","176 lbs","155","52",130,140,14,13,13,11,14,15,12,15,6,6,13,15,9,16,16,15,12,13,10,10,12,16,9,13,8,10,15,10,12,15,12,12,13,12,13,12,12,10,8,9,13,6,5,13,10,4,10,15,9,2,2,3,2,3,3,3,2,1,2,2
"7348",2000219705,"Yusi","10/7/2005 (17 years old)","D/WB (L)","R. Madrid C","Spanish Federation Third Group 7","MAR","Yes","7/1/2022","6/30/2024","$230K - $700K","Left","Very Strong","Reasonable","5'7""","136 lbs","-","-",68,139,6,12,7,7,9,2,8,6,2,8,9,5,13,9,11,9,9,8,9,14,17,8,6,5,8,8,8,8,14,12,8,6,12,13,7,2,10,15,4,10,12,11,7,13,8,8,9,12,15,1,2,2,2,2,3,3,3,3,1,2
"7349",43111412,"Adam Masina","1/2/1994 (29 years old)","D (LC), WB (L)","Udinese","Italian Serie A","MAR","Yes","7/18/2022","6/30/2025","$120K - $1.2M","Left Only","Very Strong","Weak","6'3""","191 lbs","233","9",125,139,8,12,11,8,11,9,14,9,14,13,12,7,14,11,15,13,14,11,12,12,14,12,14,13,11,13,11,14,11,13,14,14,14,13,15,14,13,12,18,16,12,14,11,14,12,4,14,12,14,1,3,2,2,1,3,3,1,3,3,3
"7350",85116519,"Romain Saïss","3/26/1990 (33 years old)","D (C), DM","Beşiktaş","Turkish Super League","MAR","Yes","7/1/2022","6/30/2025","Not for Sale","Left","Very Strong","Weak","6'2""","185 lbs","358","24",135,138,2,5,12,4,14,4,15,5,2,15,13,8,15,14,14,14,14,15,15,13,15,8,14,5,14,16,13,15,12,12,14,14,14,10,14,15,12,11,11,15,14,11,7,14,15,10,14,13,13,1,3,1,1,3,1,2,1,1,2,3
"7351",13193934,"Fahd Ndzengue","7/7/2000 (22 years old)","AM (L), ST (C)","Tabor Sežana","Slovenian Second League","GAB","No","2/22/2019","6/30/2025","$35K - $350K","Left","Very Strong","Weak","5'11""","152 lbs","77","6",95,105,10,11,10,11,15,10,14,10,6,8,13,3,8,10,15,11,10,11,6,11,12,10,6,11,11,10,6,10,12,13,11,13,14,12,11,10,13,12,12,11,10,11,12,6,6,8,12,14,7,2,3,2,2,3,3,3,2,3,2,3
"7352",37052200,"Tarik Tissoudali","4/2/1993 (30 years old)","M/AM (RL), ST (C)","AA Gent","Jupiler Pro League","MAR","Yes","12/2/2022","6/30/2026","$550K - $8M","Right","Reasonable","Very Strong","5'9""","154 lbs","247","84",128,138,8,12,15,13,13,8,8,9,8,4,14,10,3,15,10,12,14,14,14,7,9,15,7,12,6,11,14,11,15,13,10,6,10,15,11,9,15,18,6,10,9,8,12,12,12,3,11,12,12,3,3,1,2,2,2,3,3,2,2,3
"7353",37076232,"Oussama El Azzouzi","5/29/2001 (22 years old)","DM, M (C)","Union SG","Jupiler Pro League","MAR","Yes","7/30/2022","6/30/2025","$450K - $4.6M","Right","Reasonable","Very Strong","6'2""","171 lbs","60","1",115,138,7,10,12,8,12,7,13,8,7,10,12,8,13,12,14,13,14,12,12,11,12,8,11,14,12,13,13,13,13,13,12,14,14,13,12,11,12,12,9,13,10,11,5,9,15,8,13,14,15,4,3,3,1,3,1,3,4,3,1,2
"7354",2000267443,"Abdelhamid Ait Boudlal","4/16/2006 (17 years old)","D (C)","Académie Mohammed VI","-","MAR","No","6/13/2022","6/30/2025","$3.5K - $35K","Right","Reasonable","Very Strong","6'3""","176 lbs","-","-",75,138,3,6,1,2,7,1,13,4,3,13,7,1,10,4,9,8,9,3,12,13,7,5,1,4,13,6,6,7,7,9,7,14,7,11,4,9,14,19,3,13,9,11,7,6,13,6,9,10,18,4,2,1,3,2,2,3,2,2,1,3
"7355",2000216339,"Othmane Maamma","10/6/2005 (17 years old)","AM (R)","Montpellier","Ligue 1 Uber Eats","MAR","Yes","7/1/2022","6/30/2025","$140K - $1.4M","Right Only","Weak","Very Strong","5'11""","167 lbs","-","-",81,138,8,10,12,8,11,8,4,9,8,5,8,1,5,11,7,8,9,8,8,7,16,8,7,8,4,9,9,14,13,15,9,5,13,14,10,5,10,12,4,9,9,12,13,10,13,6,16,12,16,1,3,2,3,1,3,1,2,1,3,1
"7356",67258589,"Bilal Kandoussi El Khallak","2/17/2000 (23 years old)","M (L), AM (LC)","A. Baleares","Spanish Federation First Division B","MAR","Yes","1/1/2020","6/30/2024","$0","Right","Weak","Very Strong","5'8""","125 lbs","90","17",94,137,7,10,11,12,12,7,7,9,7,7,9,6,6,9,12,11,9,10,8,13,4,13,3,10,7,8,11,11,13,13,8,1,7,13,8,5,13,14,11,8,9,9,6,5,9,7,12,11,20,2,2,2,2,3,2,1,2,2,2,1
"7357",2000212746,"Samir El Mourabet","10/6/2005 (17 years old)","AM (RC)","Strasbourg","Ligue 1 Uber Eats","MAR","Yes","7/1/2022","6/30/2025","$130K - $1.3M","Left","Very Strong","Reasonable","5'8""","138 lbs","-","-",65,137,7,9,8,9,15,7,7,7,5,3,15,3,9,15,7,8,1,5,8,11,6,13,4,11,8,14,14,9,9,9,8,6,13,9,5,4,6,20,8,12,13,9,14,6,11,3,8,8,7,3,4,1,3,3,2,1,1,1,1,2
"7358",37052727,"Oussama Idrissi","2/26/1996 (27 years old)","M/AM (RL)","Sevilla","Spanish First Division","MAR","Yes","10/4/2020","6/30/2025","$7.2M - $9.2M","Right","Fairly Strong","Very Strong","6'0""","171 lbs","183","41",133,137,12,14,15,12,14,11,6,13,4,5,13,14,6,15,13,13,15,12,12,12,12,16,4,14,5,10,12,13,14,14,13,12,14,14,13,10,10,12,3,14,10,13,3,12,4,3,11,11,16,3,1,2,1,2,2,1,3,1,1,1
"7359",2000120643,"Ibrahim Salah","8/30/2001 (21 years old)","AM (L), ST (C)","Rennes","French National 3 - Group E","MAR","Yes","1/31/2023","6/30/2027","$600K - $5.2M","Right Only","Weak","Very Strong","6'1""","165 lbs","29","6",114,137,9,11,14,10,14,9,7,9,8,7,12,10,7,14,10,12,14,14,11,11,14,15,10,11,6,11,12,11,15,13,7,13,13,15,9,7,11,13,8,11,9,12,6,6,6,7,10,9,12,1,3,3,3,1,1,3,3,2,1,3
"7360",67257704,"Abdelkabir Abqar","3/10/1999 (24 years old)","D (C)","Alavés","Spanish First Division","MAR","No","5/5/2021","6/30/2025","$325K - $3.3M","Right","Reasonable","Very Strong","6'2""","176 lbs","115","2",122,137,6,7,8,7,10,6,12,5,4,14,9,7,13,10,14,12,15,10,13,12,12,6,2,5,13,14,8,15,11,11,10,15,10,13,15,15,16,20,2,14,10,12,5,13,5,2,13,11,8,3,1,1,2,1,1,1,1,4,1,1
"7361",18089606,"Ilias Chair","10/30/1997 (25 years old)","M (C), AM (LC)","QPR","Sky Bet Championship","MAR","Yes","1/29/2021","6/30/2025","$5.8M - $8.6M","Right Only","Weak","Very Strong","5'5""","130 lbs","191","34",125,137,12,13,15,12,15,13,4,14,7,8,13,10,7,14,8,12,13,14,8,12,12,15,8,14,9,11,12,14,13,15,16,5,11,12,14,9,11,10,11,12,12,13,5,12,7,6,12,14,15,1,1,2,2,2,2,2,3,2,3,3
"7362",47079005,"Medwin Bitéghé","9/1/1996 (26 years old)","M/AM (C)","Al-Sahel","Saudi Second Division Group B","GAB","No","6/29/2022","6/30/2023","$45K - $130K","Right","Reasonable","Very Strong","5'11""","160 lbs","91","7",95,105,9,9,8,12,13,9,9,9,5,9,13,9,13,11,5,10,8,10,10,13,15,10,8,11,10,10,10,13,14,12,10,10,14,13,8,7,12,14,11,9,14,12,6,11,10,7,17,9,19,3,3,2,3,4,3,1,3,2,3,4
"7363",85137119,"Fahd Moufi","5/5/1996 (27 years old)","D/WB (R)","PTM","Portuguese Premier League","MAR","Yes","9/29/2020","6/30/2025","$300K - $3M","Right","Weak","Very Strong","5'10""","154 lbs","148","3",127,136,12,14,15,8,13,6,11,7,11,10,12,8,13,15,15,14,12,10,14,12,14,16,8,13,11,13,11,14,14,14,13,8,16,14,13,12,10,13,11,14,14,7,8,12,15,6,12,14,13,2,3,3,2,1,1,1,3,1,3,3
"7364",8826969,"Keylor Navas","12/15/1986 (36 years old)","GK","Nottm Forest","English Premier Division","CRC","Yes","4/26/2021","6/30/2024","$2.6M - $5.4M","Right","Weak","Very Strong","6'1""","176 lbs","335","-",151,167,1,3,3,1,10,2,9,3,1,3,10,3,3,8,11,14,15,13,17,15,16,8,12,3,14,14,8,15,12,16,14,12,16,13,14,13,1,19,16,18,15,16,9,17,4,3,15,15,14,14,12,16,16,15,14,11,4,14,15,10
"7365",80010074,"Joel Campbell","6/26/1992 (30 years old)","M/AM (RL), ST (C)","León","Mexican First Division","CRC","No","6/14/2021","6/30/2026","$550K - $5.4M","Left","Very Strong","Weak","5'10""","154 lbs","322","35",124,150,10,12,16,12,14,10,7,13,4,6,13,14,7,14,10,13,13,13,9,12,13,14,6,14,7,13,13,14,14,14,12,9,12,13,12,11,10,15,15,12,13,14,6,12,9,6,15,13,14,2,1,3,3,2,1,3,3,1,3,2
"7366",80000931,"Celso Borges","5/27/1988 (35 years old)","M (C)","Alajuelense","Primera División de Costa Rica","CRC","No","6/30/2021","5/31/2024","$7K - $75K","Right","Weak","Very Strong","6'2""","167 lbs","472","81",115,142,12,12,10,12,13,12,12,13,2,11,15,14,12,13,12,13,13,12,12,13,12,13,15,13,13,13,14,13,10,10,11,11,14,10,11,12,12,10,16,16,16,10,5,12,10,5,13,14,13,2,3,3,3,3,1,1,1,2,1,3
"7367",80000942,"Giancarlo González","2/8/1988 (35 years old)","D (C)","Alajuelense","Primera División de Costa Rica","CRC","No","7/1/2022","6/30/2024","$20K - $210K","Right","Weak","Very Strong","6'1""","185 lbs","355","17",122,139,3,4,7,7,10,3,15,5,5,14,11,8,15,10,15,14,14,12,11,12,17,11,13,5,14,14,11,13,11,13,14,15,13,11,12,14,12,11,12,15,13,12,5,14,10,6,9,14,14,1,3,3,1,1,3,1,1,2,1,1
"7368",80034923,"Manfred Ugalde","5/25/2002 (21 years old)","AM (RLC), ST (C)","Lommel SK","Belgian Challenger Pro League","CRC","No","7/14/2020","6/30/2026","$425K - $4.3M","Right","Weak","Very Strong","5'8""","156 lbs","113","35",116,137,11,10,13,8,13,9,8,9,8,7,11,14,7,13,18,11,14,11,10,11,15,14,8,14,6,12,12,13,14,13,10,8,13,14,12,13,10,2,7,16,12,9,6,14,14,2,12,13,17,3,2,2,2,2,1,3,1,2,3,1
"7369",2000134444,"Elian Quesada-Thorn","2/19/2005 (18 years old)","D/WB/M/AM (L)","Arsenal","English Premier Division","CRC","Yes","6/13/2022","6/30/2026","$300K - $2.9M","Left","Very Strong","Reasonable","5'10""","163 lbs","-","-",82,137,9,8,7,8,7,9,9,5,6,9,6,2,11,8,11,9,9,11,10,7,14,8,4,16,11,8,11,10,14,8,10,10,9,12,9,10,9,10,8,11,12,11,7,19,9,2,16,11,13,1,3,2,3,1,3,2,1,3,1,3
"7370",80006923,"Bryan Oviedo","2/18/1990 (33 years old)","D/WB/M (L)","Real Salt Lake","Major League Soccer","CRC","No","8/5/2022","12/31/2023","$26K - $275K","Left","Very Strong","Reasonable","5'8""","154 lbs","218","6",114,136,14,14,12,10,13,13,9,13,7,10,13,4,13,14,14,12,12,12,10,11,13,14,5,13,10,14,11,13,12,13,12,7,14,12,13,9,15,15,13,15,10,13,12,13,7,5,11,13,16,1,1,1,3,4,2,1,2,2,2,2
"7371",2000112404,"Jewison Bennette","6/15/2004 (18 years old)","AM (RL)","Sunderland","Sky Bet Championship","CRC","No","8/27/2022","6/30/2026","$7.2M - $11M","Left","Very Strong","Reasonable","5'9""","149 lbs","50","4",114,136,5,12,13,8,10,10,3,8,1,5,9,3,4,11,6,13,14,8,7,7,13,14,5,13,4,8,13,11,17,13,13,8,14,17,10,9,15,4,1,13,10,10,12,14,12,4,9,15,14,3,2,1,2,3,2,1,2,3,2,2
"7372",80011933,"Óscar Duarte","6/3/1989 (34 years old)","D (C)","Al-Wehda","Saudi Professional League","CRC","Yes","6/24/2022","6/30/2024","$2.4M - $4.9M","Right","Reasonable","Very Strong","6'1""","182 lbs","284","17",125,135,8,8,10,9,10,10,15,10,12,15,10,8,14,11,14,13,12,12,12,13,15,11,12,9,14,15,7,15,9,10,12,13,12,12,12,14,7,12,11,14,14,15,12,15,12,10,13,10,14,2,1,1,1,1,4,2,1,3,2,3
"7373",2000261503,"Loic Limagna","2/20/1994 (29 years old)","ST (C)","Bayelsa Utd","Nigerian Premier League","GAB","No","7/1/2022","6/30/2024","$12K - $120K","Right","Reasonable","Very Strong","5'10""","163 lbs","-","-",89,105,6,4,13,13,10,6,13,7,5,6,6,9,5,11,14,8,1,12,7,9,2,11,8,9,7,6,5,8,13,13,7,4,6,13,13,9,11,13,12,11,11,13,14,14,9,2,8,11,18,4,2,2,3,3,1,1,3,2,3,3
"7374",80010050,"David Guzmán","2/18/1990 (33 years old)","DM, M (C)","Saprissa","Primera División de Costa Rica","CRC","No","12/31/2019","6/30/2024","$80K - $800K","Right","Weak","Very Strong","5'9""","174 lbs","363","37",119,135,12,11,10,11,13,11,9,9,8,12,13,13,13,13,16,12,13,15,11,13,11,15,13,12,13,12,10,15,12,13,14,7,14,10,14,13,11,8,13,12,6,14,6,12,12,10,12,12,14,2,3,1,1,2,3,3,2,2,3,1
"7375",80028750,"Juan Pablo Vargas","6/6/1995 (28 years old)","D (C)","Millonarios F.C.","Colombian First Division","CRC","No","1/1/2021","12/31/2023","$150K - $1.5M","Left","Very Strong","Weak","6'4""","194 lbs","187","12",127,135,7,10,9,6,12,3,14,7,10,13,12,8,14,11,12,14,13,11,12,13,13,6,11,8,13,12,10,12,12,12,14,16,12,12,12,14,17,10,12,15,13,12,7,12,8,8,13,13,12,2,2,3,2,2,1,3,2,2,1,1
"7376",80013411,"Francisco Calvo","7/8/1992 (30 years old)","D (C)","Konyaspor","Turkish Super League","CRC","No","7/8/2022","6/30/2024","$275K - $2.7M","Left","Very Strong","Reasonable","5'11""","171 lbs","346","46",125,135,8,8,9,9,9,9,15,7,2,13,12,9,12,12,16,13,15,13,14,11,12,10,14,13,13,13,11,13,13,12,12,11,16,12,16,13,10,11,10,11,12,11,9,11,5,7,13,14,16,3,4,4,2,1,3,3,4,1,2,3
"7377",80034792,"Brandon Aguilera","6/30/2003 (19 years old)","M (C), AM (RLC)","Estoril Praia","Portuguese Premier League","CRC","No","7/17/2022","5/31/2026","$7.8M - $11.5M","Left","Very Strong","Reasonable","5'6""","132 lbs","72","6",100,135,12,11,14,10,13,11,5,10,12,5,13,10,5,14,10,8,10,10,9,9,12,14,8,12,10,10,12,10,12,12,13,8,10,13,8,6,10,11,15,15,10,15,6,9,11,10,10,15,12,1,1,1,2,1,2,1,1,3,2,2
"7378",2000205409,"Enmanuel Chacón","9/16/2003 (19 years old)","DM, M (C)","Cartaginés","Primera División de Costa Rica","CRC","No","7/1/2022","6/30/2024","$350K - $1M","Right","Reasonable","Very Strong","6'0""","160 lbs","15","-",71,134,6,5,3,7,13,6,6,7,4,5,11,3,7,13,12,10,8,6,8,13,13,5,9,7,9,7,8,12,12,11,7,6,13,10,10,5,11,13,3,11,10,12,12,6,7,8,11,9,7,2,1,3,1,1,3,2,2,1,2,1
"7379",5385082,"Christián Bolaños","5/17/1984 (39 years old)","M (R), AM (RC)","Saprissa","Primera División de Costa Rica","CRC","No","12/31/2020","12/31/2023","$12K - $110K","Right","Fairly Strong","Very Strong","5'9""","156 lbs","575","110",114,131,13,14,15,10,16,15,6,12,6,4,15,12,5,16,6,15,7,14,8,8,9,16,5,10,6,10,14,9,11,15,13,8,12,10,9,9,6,14,14,14,8,8,12,13,5,12,7,7,4,1,3,1,3,3,2,1,2,3,1,1
"7380",80026188,"David Ramírez","5/28/1993 (30 years old)","AM (RL), ST (C)","Guadalupe","Liga de Ascenso de Costa Rica","CRC","No","12/31/2021","6/30/2024","$130K - $1.3M","Right Only","Weak","Very Strong","5'9""","152 lbs","228","57",108,130,8,11,14,15,15,9,11,5,8,8,11,8,10,15,10,10,7,15,9,15,11,13,2,15,9,10,7,11,13,13,11,6,15,13,11,7,9,9,12,10,5,15,13,15,9,10,14,14,12,3,3,2,1,2,3,1,3,3,1,4
"7381",80028770,"Ian Smith","3/6/1998 (25 years old)","D/WB/M (R)","Sporting FC (CRC)","Primera División de Costa Rica","CRC","No","11/11/2022","6/30/2024","$110K - $1.1M","Right Only","Weak","Very Strong","5'10""","149 lbs","176","3",110,130,7,12,12,7,10,7,9,8,9,12,11,7,12,11,12,12,9,10,11,11,12,9,6,12,12,12,11,11,15,14,8,11,12,14,13,8,5,12,12,12,12,12,7,11,8,5,12,12,12,2,2,1,3,2,3,3,2,2,3,3
"7382",80000968,"Cristian Gamboa","10/24/1989 (33 years old)","D/WB (R)","VfL Bochum","Bundesliga","CRC","No","7/7/2022","6/30/2024","$110K - $1.1M","Right Only","Weak","Very Strong","5'9""","147 lbs","260","3",119,130,8,11,11,6,12,10,9,8,16,11,10,7,14,12,16,11,14,10,10,10,12,12,12,11,12,14,9,15,15,14,8,9,13,16,14,10,15,7,14,15,10,10,11,12,11,5,11,13,14,4,2,1,2,4,2,3,1,3,2,1
"7383",18107847,"Alexis Gamboa","3/20/1999 (24 years old)","D (LC)","Alajuelense","Primera División de Costa Rica","CRC","No","1/27/2021","6/30/2024","$26K - $250K","Left Only","Very Strong","Weak","6'2""","171 lbs","113","5",101,130,5,12,9,6,11,3,15,4,3,12,10,9,8,11,5,12,11,9,8,14,14,5,8,9,15,9,9,10,12,14,8,10,10,11,10,12,14,4,5,12,11,10,8,10,7,8,10,12,12,2,2,3,3,3,2,1,3,2,2,1
"7384",49053368,"Louis Ameka Autchanga","10/3/1996 (26 years old)","M/AM (R)","MAS Fès","Botola Pro 1","GAB","No","8/22/2021","6/30/2023","$0 - $18K","Right","Reasonable","Very Strong","5'9""","149 lbs","88","5",97,105,9,8,11,12,10,7,11,8,3,3,11,10,4,12,8,7,6,7,7,9,11,9,5,12,4,8,9,11,15,14,13,7,9,14,10,12,10,12,10,8,9,7,11,8,7,10,10,12,11,3,1,3,3,1,1,3,3,2,4,3
"7385",80006910,"Esteban","4/28/1989 (34 years old)","GK","Saprissa","Primera División de Costa Rica","CRC","No","12/31/2022","12/31/2023","$60K - $600K","Right Only","Weak","Very Strong","6'4""","182 lbs","262","-",120,130,2,3,1,1,10,6,5,1,1,2,10,5,2,11,16,13,17,16,12,12,15,14,8,2,13,10,7,14,10,12,13,14,14,8,12,15,10,16,13,12,7,10,12,12,14,4,10,15,17,12,11,13,12,11,12,13,15,9,13,14
"7386",80027474,"Randall Leal","1/14/1997 (26 years old)","M (C), AM (RLC)","Nashville","Major League Soccer","CRC","No","12/10/2021","12/31/2023","$325K - $3.2M","Right Only","Weak","Very Strong","5'7""","147 lbs","188","23",114,128,11,11,14,11,13,9,5,13,6,8,10,9,9,13,15,11,13,12,10,10,9,14,7,11,10,12,12,13,14,14,14,8,13,15,12,10,14,13,7,10,12,13,5,13,11,6,8,14,8,3,2,1,2,2,1,4,2,1,2,1
"7387",80013544,"Ariel Soto","5/14/1992 (31 years old)","D (LC), WB (L)","Sporting FC (CRC)","Primera División de Costa Rica","CRC","No","1/19/2023","12/31/2024","Not for Sale","Left","Very Strong","Reasonable","6'0""","158 lbs","339","13",101,127,5,10,9,6,11,3,11,9,9,11,11,2,11,10,12,12,10,10,11,11,12,11,9,8,12,11,11,11,11,11,10,13,12,12,13,13,13,18,11,11,10,12,13,6,11,2,19,10,11,2,3,3,2,1,4,3,2,1,2,2
"7388",80013377,"John Jairo Ruiz","1/10/1994 (29 years old)","AM (RL)","Herediano","Primera División de Costa Rica","CRC","No","12/7/2019","6/30/2025","$600K - $1.8M","Right","Weak","Very Strong","5'9""","149 lbs","245","53",115,127,5,11,12,12,13,11,10,13,5,6,11,10,7,13,8,12,11,11,12,12,14,13,8,13,7,12,11,14,15,14,12,8,13,14,11,11,8,14,14,10,10,10,8,11,8,7,11,14,12,2,3,3,1,3,2,1,1,3,3,1
"7389",80034709,"Roan Wilson","5/1/2002 (21 years old)","DM, M (C)","Gil Vicente","Portuguese Premier League","CRC","No","1/28/2023","6/30/2025","$650K - $1.5M","Right","Reasonable","Very Strong","6'0""","163 lbs","98","3",102,126,12,12,10,8,11,6,11,10,8,12,12,8,10,10,12,12,13,10,10,11,10,8,8,11,10,13,12,11,11,12,13,13,14,12,12,13,10,11,12,14,14,10,8,10,12,6,12,15,10,1,1,3,3,1,2,3,2,3,3,1
"7390",80006921,"Diego Madrigal","3/19/1989 (34 years old)","M/AM (L), ST (C)","Liberia","Primera División de Costa Rica","CRC","No","5/31/2022","6/30/2024","$60K - $180K","Left","Very Strong","Reasonable","5'7""","136 lbs","279","48",108,126,10,12,13,7,14,10,7,7,10,7,10,8,7,12,8,8,9,9,9,10,13,13,12,11,7,9,12,13,15,15,9,5,11,13,12,6,6,8,4,11,11,11,7,14,13,5,9,12,7,2,3,1,1,2,4,3,3,2,2,1
"7391",80035807,"Carlos Barahona","8/21/2002 (20 years old)","D/WB (RL)","Cartaginés","Primera División de Costa Rica","CRC","No","7/1/2019","5/31/2025","$40K - $400K","Right","Reasonable","Very Strong","5'7""","138 lbs","84","5",75,126,7,13,8,3,10,3,8,7,6,5,8,6,7,10,10,11,9,9,7,7,4,5,8,8,7,9,4,9,15,14,9,8,12,14,9,5,14,9,8,9,9,10,8,8,12,3,9,12,19,4,1,3,1,3,1,2,2,4,2,2
"7392",80001564,"Heiner Mora","6/20/1984 (38 years old)","D (RC), WB/M (R)","Barrio México","Costa Rican Lower Division","CRC","No","6/30/2020","6/30/2024","$0 - $95K","Right","Reasonable","Very Strong","5'10""","160 lbs","253","15",104,125,10,10,11,8,8,8,8,5,10,11,11,9,11,9,12,9,10,12,12,16,13,5,5,9,12,11,9,12,11,13,9,11,15,14,12,10,14,7,11,11,6,10,6,4,11,8,16,12,9,1,1,2,1,2,3,3,3,2,3,2
"7393",80026191,"Jose Guillermo Ortiz","6/20/1992 (30 years old)","AM (RL), ST (C)","Herediano","Primera División de Costa Rica","CRC","No","12/16/2020","6/30/2024","$28K - $300K","Right","Reasonable","Very Strong","5'8""","152 lbs","295","76",111,125,8,11,12,14,11,7,10,9,4,7,10,14,7,12,10,11,11,13,12,13,12,11,9,14,8,12,11,11,13,12,12,8,10,13,12,11,10,6,11,12,6,14,6,12,9,5,14,12,13,1,3,3,2,1,2,2,2,3,2,3
"7394",80001514,"Allen Guevara","4/16/1989 (34 years old)","D/WB/M/AM (R)","Cartaginés","Primera División de Costa Rica","CRC","No","5/31/2020","6/30/2024","$45K - $475K","Right","Reasonable","Very Strong","5'3""","125 lbs","527","71",105,125,10,15,9,13,10,10,6,11,6,10,11,7,12,10,7,12,10,12,12,14,14,7,11,14,9,11,10,12,12,12,11,2,9,13,11,3,14,7,12,12,7,15,15,6,5,7,11,13,14,1,1,2,3,1,2,1,3,1,3,1
"7395",2000245424,"Aimé Mboungui","5/13/2002 (21 years old)","D/WB (R)","CF Mounana","Gabonese Premier Division","GAB","No","6/13/2022","6/30/2024","$0 - $4.5K","Right","Reasonable","Very Strong","5'10""","141 lbs","-","-",71,104,4,10,6,3,12,1,4,6,7,8,7,1,10,8,12,8,8,9,10,7,16,10,1,7,9,8,9,8,14,14,8,5,12,13,13,5,12,18,12,12,11,12,5,6,9,5,13,11,13,3,2,2,3,3,1,3,3,2,1,1
"7396",67269930,"Patrick Sequeira","3/1/1999 (24 years old)","GK","Lugo B","Spanish Federation Third Group 1","CRC","Yes","7/1/2022","6/30/2026","$0","Right Only","Weak","Very Strong","6'3""","154 lbs","45","-",105,125,4,3,2,1,2,7,1,1,2,2,12,2,2,3,11,13,15,9,13,10,10,1,3,2,12,9,8,6,14,6,9,15,8,13,7,7,12,16,9,9,11,13,7,5,12,2,19,11,19,11,7,14,5,11,12,14,5,9,9,14
"7397",80013653,"Kevin Briceño","10/22/1991 (31 years old)","GK","Cartaginés","Primera División de Costa Rica","CRC","No","5/31/2021","6/30/2024","$95K - $275K","Right","Reasonable","Very Strong","6'1""","176 lbs","224","-",107,125,2,2,1,3,5,7,3,1,1,1,17,4,2,9,11,13,14,12,17,17,12,2,6,1,16,12,11,11,14,13,12,14,6,15,9,9,11,8,12,11,9,10,10,15,8,8,9,13,9,3,10,10,9,6,7,8,1,5,6,8
"7398",19107162,"Josue Martínez","3/25/1990 (33 years old)","ST (C)","Escorpiones","Liga de Ascenso de Costa Rica","CRC","No","6/30/2022","6/30/2024","$14K - $150K","Right","Strong","Very Strong","5'10""","163 lbs","336","70",106,124,11,11,12,10,11,9,10,10,8,4,8,7,5,10,5,16,10,11,12,8,5,8,1,17,12,11,13,12,12,13,11,9,14,11,15,10,11,10,6,12,11,11,10,7,10,2,5,11,4,2,3,3,1,3,4,3,2,1,1,2
"7399",80030102,"Jimmy Marín","10/8/1997 (25 years old)","M (RL), AM (RLC)","Orenburg","Russian Premier League","CRC","No","6/30/2022","6/30/2025","$350K - $3.5M","Right","Reasonable","Very Strong","5'7""","136 lbs","212","43",114,123,14,13,11,13,12,14,6,13,4,6,12,8,8,13,13,11,14,8,12,12,15,12,6,12,7,9,13,8,14,14,9,6,9,13,13,4,11,12,4,11,11,11,6,8,11,8,9,13,12,3,3,1,1,1,2,3,3,1,3,1
"7400",80000930,"Michael Barrantes","10/4/1983 (39 years old)","M (LC), AM (C)","Alajuelense","Primera División de Costa Rica","CRC","No","6/7/2023","12/31/2023","$0 - $55K","Left","Very Strong","Reasonable","5'10""","156 lbs","466","76",107,123,13,12,13,11,13,14,8,13,8,9,14,14,7,14,7,12,11,12,12,13,11,15,8,12,9,11,15,10,11,12,10,7,14,11,13,9,10,12,13,14,14,13,11,11,9,7,11,13,14,3,3,2,3,3,2,3,1,1,2,3
"7401",80010053,"Cristopher Meneses","5/2/1990 (33 years old)","D/WB (L)","Sporting FC (CRC)","Primera División de Costa Rica","CRC","No","12/13/2021","6/30/2024","$120K - $350K","Left Only","Very Strong","Weak","5'10""","176 lbs","387","20",103,122,5,12,13,8,12,10,8,12,8,9,13,6,9,13,15,11,12,13,10,10,14,13,9,11,10,14,10,14,14,13,11,8,11,14,13,9,6,16,15,15,10,7,6,12,15,5,12,13,10,3,2,2,3,3,2,1,1,3,1,2
"7402",8825790,"Adrián De Lemos","10/13/1982 (40 years old)","GK","Guastatoya","Liga Nacional de Guatemala","CRC","No","5/31/2019","6/30/2024","$0 - $45K","Right","Reasonable","Very Strong","6'0""","176 lbs","451","-",113,121,3,2,2,2,9,8,2,1,1,1,15,2,1,11,11,15,16,11,14,17,12,3,5,2,14,13,11,11,8,10,8,10,11,8,6,8,14,7,10,13,8,12,7,6,9,10,8,8,9,12,9,8,11,4,17,17,5,5,17,7
"7403",80001556,"Marcos Ureña","3/5/1990 (33 years old)","AM (C), ST (C)","Cartaginés","Primera División de Costa Rica","CRC","No","7/21/2022","6/30/2024","$40K - $375K","Right","Reasonable","Very Strong","5'10""","174 lbs","297","47",101,121,6,10,12,11,8,6,8,12,4,4,12,10,4,10,11,12,10,10,8,9,12,5,5,10,5,14,12,14,14,13,7,8,12,16,12,11,12,14,14,15,7,12,14,12,7,3,7,11,10,2,1,2,6,2,4,1,8,1,1,1
"7404",80032156,"Alonso Martínez","4/14/1994 (29 years old)","M/AM (R)","Lommel SK","Belgian Challenger Pro League","CRC","No","8/18/2021","6/30/2024","$0 - $18K","Right","Reasonable","Very Strong","5'11""","158 lbs","131","30",102,120,11,11,13,8,13,11,6,11,10,8,10,5,5,12,12,12,14,12,10,8,4,14,15,11,7,10,10,10,15,11,8,7,13,14,8,7,12,13,1,9,12,11,14,11,6,5,9,9,8,3,1,2,3,2,3,3,1,2,2,2
"7405",80033048,"Orlando Galo","8/11/2000 (22 years old)","D (R), WB (RL), DM","Herediano","Primera División de Costa Rica","CRC","No","12/31/2018","6/30/2026","$130K - $1.3M","Right Only","Weak","Very Strong","5'9""","156 lbs","146","6",100,120,9,14,8,5,11,9,8,4,8,7,11,2,13,9,12,12,10,10,14,15,9,5,8,9,11,10,11,11,13,15,8,7,10,13,7,8,16,8,6,10,11,11,12,10,9,2,14,13,10,3,3,2,2,1,3,2,3,1,2,2
"7406",13118184,"Franck Engonga","7/26/1993 (29 years old)","DM, M (C)","Darnes","Libyan First Division","GAB","No","7/14/2022","6/30/2024","$0 - $95K","Right","Reasonable","Very Strong","5'6""","158 lbs","144","1",98,104,7,9,8,10,11,9,9,11,5,11,11,5,12,11,15,15,15,11,11,10,6,5,10,10,11,14,8,14,11,15,10,2,15,15,13,5,10,13,11,9,8,11,11,16,8,6,20,14,20,1,3,4,2,1,2,2,3,2,3,2
"7407",80032733,"Luis Díaz","12/6/1998 (24 years old)","M/AM (R)","Columbus","Major League Soccer","CRC","No","7/2/2019","12/31/2023","$300K - $900K","Right","Reasonable","Very Strong","5'11""","160 lbs","150","9",110,120,8,8,12,9,11,9,7,12,6,7,10,9,8,11,11,10,9,10,10,9,11,9,7,11,7,11,10,11,17,12,10,6,10,17,11,9,7,12,9,12,10,13,7,11,9,7,8,9,11,1,1,1,3,3,1,4,2,1,3,1
"7408",78026896,"Kendall Waston","1/1/1988 (35 years old)","D (C)","Saprissa","Primera División de Costa Rica","CRC","No","1/15/2021","12/31/2023","$0 - $110K","Right","Reasonable","Very Strong","6'5""","216 lbs","351","57",117,120,4,5,7,12,10,2,17,2,4,12,10,2,13,10,17,11,15,8,9,10,15,5,16,8,13,12,10,12,8,7,12,19,15,11,15,19,9,6,9,6,15,11,4,14,12,11,10,8,14,1,1,3,2,2,3,2,4,2,1,2
"7409",2000264170,"Christopher Moya","9/1/2004 (18 years old)","GK","Cartaginés","Primera División de Costa Rica","CRC","No","7/1/2022","6/30/2024","$90K - $900K","Right","Reasonable","Very Strong","6'6""","180 lbs","1","-",72,119,4,2,3,2,2,5,1,2,3,3,10,3,3,5,8,9,15,7,6,13,12,3,4,2,11,7,6,6,9,14,4,15,13,10,1,5,10,10,5,12,11,11,5,13,9,4,18,10,17,7,11,13,5,8,13,9,5,7,9,10
"7410",80001031,"Christian Blanco","11/4/1980 (42 years old)","D (C), DM, M (RC)","Golfito","Liga de Ascenso de Costa Rica","CRC","No","7/1/2021","6/30/2024","$1K - $9K","Right","Reasonable","Very Strong","5'5""","138 lbs","153","4",103,119,6,11,5,11,15,8,13,10,11,5,7,4,11,14,12,16,11,12,13,17,12,5,4,12,15,13,13,15,8,8,8,9,13,8,10,8,18,9,12,11,7,13,11,14,9,8,12,13,12,2,3,1,3,1,4,1,2,2,3,2
"7411",80026303,"Dylan Flores","5/30/1993 (30 years old)","M/AM (C)","Cartaginés","Primera División de Costa Rica","CRC","No","6/30/2021","6/30/2024","$40K - $400K","Right","Weak","Very Strong","5'7""","160 lbs","259","34",102,118,10,10,13,14,13,10,8,11,6,5,13,12,5,12,11,13,12,13,11,11,12,13,8,14,8,11,12,12,13,13,11,7,13,13,11,12,13,9,12,12,13,11,4,10,8,3,10,12,12,3,1,3,1,1,3,3,3,1,4,1
"7412",2000018353,"Aarón Suárez","6/27/2002 (20 years old)","AM (RLC)","Alajuelense","Primera División de Costa Rica","CRC","No","7/1/2019","6/30/2026","$650K - $1.5M","Right","Reasonable","Very Strong","5'5""","149 lbs","98","19",105,118,4,7,13,11,14,7,7,8,8,8,14,8,5,13,12,11,7,10,8,14,6,12,10,11,8,9,14,10,14,14,9,5,15,14,13,2,16,8,11,12,11,12,12,4,13,6,13,9,16,2,3,2,3,3,2,1,1,2,3,1
"7413",14063437,"Gabriel Leiva","8/27/1994 (28 years old)","AM (C), ST (C)","Herediano","Primera División de Costa Rica","CRC","No","10/31/2022","12/31/2024","$90K - $275K","Left","Very Strong","Reasonable","6'1""","176 lbs","164","23",102,118,9,9,14,14,11,9,9,8,4,6,11,6,10,12,9,11,10,10,11,11,12,9,12,15,11,10,12,11,12,12,5,12,12,11,13,11,13,4,10,11,11,11,10,19,10,3,13,10,11,4,1,3,1,3,1,1,3,2,1,3
"7414",80013376,"Yeltsin Tejeda","3/17/1992 (31 years old)","DM, M (C)","Herediano","Primera División de Costa Rica","CRC","No","1/24/2019","6/30/2025","Not for Sale","Right","Weak","Very Strong","5'10""","156 lbs","337","17",112,118,10,11,11,8,13,8,11,10,6,12,13,10,14,12,12,13,14,12,12,12,12,8,11,13,10,13,12,14,12,13,13,10,14,11,11,10,1,10,11,12,11,11,8,11,14,6,12,10,12,3,1,2,2,1,1,3,1,3,2,3
"7415",80001499,"Roy Smith","4/19/1990 (33 years old)","D (RC)","Guanacasteca","Primera División de Costa Rica","CRC","No","6/30/2022","6/30/2024","$2K - $22K","Right","Reasonable","Very Strong","6'0""","171 lbs","343","6",96,118,8,11,9,6,10,6,12,6,5,15,10,1,14,8,11,11,10,9,10,15,11,5,7,8,11,9,8,10,12,10,10,10,13,10,10,8,14,12,4,12,13,11,10,10,7,6,18,11,11,3,1,2,3,2,3,4,1,2,2,3
"7416",80012754,"Leonel Moreira","4/2/1990 (33 years old)","GK","Alajuelense","Primera División de Costa Rica","CRC","No","7/1/2021","5/31/2024","$150K - $1.5M","Right","Reasonable","Very Strong","5'9""","154 lbs","446","-",109,117,3,1,1,3,6,6,3,1,3,1,15,1,3,5,8,12,11,10,13,14,11,3,14,2,11,11,10,10,13,13,11,9,11,13,9,9,12,9,10,12,7,15,5,12,7,10,11,12,14,11,7,14,11,16,12,10,5,9,8,9
"7417",85095525,"André Poko","1/1/1993 (30 years old)","DM, M (C)","Al-Khaleej (KSA)","Saudi Professional League","GAB","No","7/28/2022","6/30/2026","$10M - $12M","Right Only","Weak","Very Strong","5'8""","158 lbs","235","7",120,135,7,6,13,6,12,7,9,8,5,12,13,9,13,10,19,14,16,11,11,13,14,11,6,12,14,16,12,18,12,14,14,11,14,12,16,14,14,10,10,14,12,13,7,13,15,4,12,14,7,1,2,2,3,1,1,3,2,2,2,3
"7418",85044567,"Alexander N'Doumbou Qian Jiegei","1/4/1992 (31 years old)","DM, M (RC)","Zhejiang","Chinese Super League","GAB","No","2/22/2023","12/31/2025","Not for Sale","Right","Reasonable","Very Strong","5'10""","154 lbs","169","10",90,104,10,9,9,8,11,12,6,9,5,10,10,8,9,11,12,11,12,12,11,11,13,10,8,11,11,10,10,13,11,13,10,8,15,11,12,9,16,12,9,12,13,14,14,12,9,9,12,14,5,2,3,1,1,3,1,1,1,2,1,3
"7419",80001054,"Jonathan Mcdonald","10/28/1987 (35 years old)","AM (RL), ST (C)","San Carlos","Primera División de Costa Rica","CRC","No","6/30/2022","6/30/2024","$0 - $100K","Right","Weak","Very Strong","5'8""","152 lbs","414","155",105,117,7,9,12,11,13,8,9,11,7,6,8,14,9,11,15,9,10,11,11,10,12,11,8,10,9,14,10,15,14,11,13,8,11,14,13,8,15,20,12,12,10,10,5,12,6,6,8,10,12,1,2,1,1,2,3,2,2,3,1,1
"7420",16202373,"Dominik Szoboszlai","10/25/2000 (22 years old)","M/AM (RLC)","RB Leipzig","Bundesliga","HUN","Yes","1/1/2021","6/30/2028","$70M - $84M","Right","Reasonable","Very Strong","6'1""","163 lbs","160","44",154,170,16,13,13,11,15,16,7,15,5,8,16,16,10,16,12,13,12,14,12,13,16,16,13,14,9,14,15,15,14,12,13,11,15,17,16,11,12,8,8,14,15,12,6,15,7,10,14,18,14,1,2,3,3,2,1,1,2,2,1,2
"7421",91011532,"Willi Orbán","11/3/1992 (30 years old)","D (C)","RB Leipzig","Bundesliga","HUN","Yes","4/8/2021","6/30/2025","$23M - $35M","Right","Fairly Strong","Very Strong","6'1""","191 lbs","317","36",149,152,3,7,8,9,11,3,17,7,8,16,13,8,16,11,15,14,17,13,14,14,17,8,16,9,15,15,12,16,11,10,16,15,17,12,14,16,10,13,12,19,16,18,8,15,10,5,17,14,7,3,3,1,1,3,2,2,2,4,1,2
"7422",2000011147,"Miloš Kerkez","11/7/2003 (19 years old)","D/WB/M (L)","AZ","Eredivisie","HUN","Yes","1/29/2022","6/30/2027","$14M - $18M","Left Only","Very Strong","Weak","5'9""","156 lbs","63","3",130,151,6,12,13,7,12,8,5,10,10,11,12,7,14,13,15,14,16,13,12,11,16,12,7,14,10,15,11,17,15,14,12,10,15,15,14,11,12,5,12,13,9,8,4,13,10,7,12,15,12,3,4,1,2,3,2,1,3,2,1,2
"7423",7523651,"Balázs Dzsudzsák","12/23/1986 (36 years old)","M (C), AM (RLC)","Debrecen","Hungarian Division I","HUN","Yes","9/23/2020","6/30/2024","$8K - $80K","Left","Very Strong","Fairly Strong","5'10""","158 lbs","456","118",117,151,14,13,12,12,13,14,5,12,9,6,14,14,8,14,11,13,11,14,12,13,16,12,17,13,11,11,16,11,9,11,11,7,9,11,9,7,13,9,9,15,16,18,7,15,8,12,12,10,7,3,3,1,3,3,1,2,1,2,3,4
"7424",85030227,"Loïc Nego","1/15/1991 (32 years old)","D/WB/M/AM (R)","Fehérvár","Hungarian Division I","HUN","Yes","6/14/2021","6/30/2024","$85K - $850K","Right","Reasonable","Very Strong","5'11""","156 lbs","274","34",124,148,8,10,12,11,12,7,6,6,4,9,12,7,13,12,12,14,13,15,15,13,17,10,6,13,10,16,8,16,14,12,9,11,15,14,15,8,16,17,14,19,18,16,3,15,8,2,16,8,15,1,3,3,1,1,1,2,4,3,2,1
"7425",28018193,"Péter Gulácsi","5/6/1990 (33 years old)","GK","RB Leipzig","Bundesliga","HUN","Yes","5/7/2021","6/30/2025","Not for Sale","Right Only","Weak","Very Strong","6'3""","189 lbs","334","-",134,146,1,1,2,1,9,1,7,3,3,1,11,3,1,9,10,16,14,13,15,13,12,4,15,3,13,14,11,12,8,14,14,16,12,10,10,14,1,18,14,17,12,15,10,13,4,5,14,12,14,12,15,15,11,15,12,14,8,12,12,13
"7426",38039385,"Roland Sallai","5/22/1997 (26 years old)","M (R), AM (RLC)","SC Freiburg","Bundesliga","HUN","Yes","3/8/2021","6/30/2025","$14M - $17M","Right","Fairly Strong","Very Strong","6'0""","165 lbs","208","30",137,145,11,13,14,12,14,12,12,10,8,8,14,12,8,14,13,13,12,13,10,12,12,14,7,15,8,12,14,11,14,15,12,12,14,14,13,11,17,10,8,8,10,8,8,14,9,12,12,16,15,1,3,2,3,1,1,1,1,3,3,3
"7427",38059041,"Botond Balogh","6/6/2002 (21 years old)","D (C)","Parma","Italian Serie B","HUN","Yes","5/5/2021","6/30/2025","$2.6M - $5.2M","Right Only","Weak","Very Strong","6'2""","176 lbs","22","-",108,144,5,5,7,5,10,6,13,6,5,13,11,5,13,11,11,14,15,9,12,11,13,9,9,7,11,13,8,13,13,12,13,14,10,12,11,13,6,12,14,14,11,14,6,13,8,3,10,12,12,3,3,2,3,1,4,1,1,1,1,3
"7428",2000298764,"Hunor Németh","3/16/2007 (16 years old)","DM, M (C)","FC København","3F Superliga","HUN","Yes","3/16/2022","6/30/2025","$220K - $2.2M","Left","Very Strong","Weak","5'5""","116 lbs","-","-",80,141,7,7,12,7,13,6,7,10,2,7,14,1,13,12,15,11,8,5,9,14,13,6,10,9,6,13,12,13,11,8,12,6,14,11,10,1,11,16,3,13,10,11,9,12,12,8,10,15,15,2,2,1,1,4,1,1,3,4,1,2
"7429",85145065,"Denis Bouanga","11/11/1994 (28 years old)","M (L), AM (RL), ST (C)","LAFC","Major League Soccer","GAB","Yes","8/4/2022","12/31/2025","$12.5M - $15M","Right","Weak","Very Strong","5'11""","156 lbs","269","87",135,135,12,12,15,15,14,14,8,13,5,5,12,14,5,14,12,13,8,14,11,13,14,14,8,14,8,10,12,14,15,13,12,10,14,14,14,11,13,11,12,13,9,11,7,11,10,10,13,15,12,1,1,2,3,2,2,1,3,2,2,3
"7430",2000006377,"Géza Dávid Turi","10/6/2001 (21 years old)","DM, M (C)","Víkingur G.","Faroese Premier League","HUN","Yes","2/24/2022","11/30/2023","$10K - $35K","Right","Strong","Very Strong","6'0""","158 lbs","125","5",108,140,8,8,11,10,12,10,9,12,9,11,12,10,11,9,9,11,13,12,9,14,7,7,7,7,14,14,12,10,10,10,11,11,12,11,11,9,8,15,5,10,11,13,10,12,6,6,13,13,17,1,2,3,1,2,2,2,2,1,3,2
"7431",38008003,"Dénes Dibusz","11/16/1990 (32 years old)","GK","Ferencváros","Hungarian Division I","HUN","Yes","11/17/2022","6/30/2027","Not for Sale","Right","Reasonable","Very Strong","6'2""","178 lbs","393","-",129,140,4,3,1,3,8,7,2,2,3,3,8,5,1,7,10,13,14,13,13,12,13,3,13,2,14,8,5,8,11,14,12,12,12,12,11,12,11,15,12,13,13,15,8,14,12,3,13,11,10,11,12,16,10,13,9,15,10,14,11,13
"7432",38045397,"András Schäfer","4/13/1999 (24 years old)","DM, M (C)","Union Berlin","Bundesliga","HUN","Yes","1/21/2022","6/30/2025","$4.1M - $8M","Right","Reasonable","Very Strong","5'10""","154 lbs","127","10",130,140,12,10,13,9,13,8,12,12,8,12,12,8,13,13,13,13,16,12,14,13,16,12,12,15,12,18,12,16,12,13,12,11,12,13,15,11,16,15,14,15,13,12,12,13,11,4,13,12,12,2,1,3,2,1,4,1,1,2,3,1
"7433",16147693,"Attila Szalai","1/20/1998 (25 years old)","D (LC)","Fenerbahçe","Turkish Super League","HUN","Yes","1/18/2021","6/30/2026","$13M - $16M","Left","Very Strong","Reasonable","6'4""","196 lbs","203","11",131,138,3,10,10,6,11,5,14,7,10,13,12,7,13,11,15,13,17,12,12,13,16,7,14,8,14,13,11,16,11,10,15,16,12,13,13,16,9,12,10,17,10,12,8,10,8,6,12,14,16,1,3,2,3,3,3,3,1,1,3,3
"7434",29168560,"Callum Styles","3/27/2000 (23 years old)","WB (L), DM, M/AM (LC)","Barnsley","Sky Bet League One","HUN","Yes","9/1/2022","6/30/2025","$240K - $2.4M","Left","Very Strong","Fairly Strong","5'7""","141 lbs","178","10",114,137,12,12,12,9,10,9,8,11,7,9,12,8,12,12,13,12,13,14,11,10,13,11,5,12,11,11,12,13,12,11,12,8,14,10,13,10,15,12,10,15,11,13,6,12,7,4,11,14,14,3,2,1,3,1,2,1,2,3,2,2
"7435",38053059,"Mihály Kata","4/13/2002 (21 years old)","DM, M (C)","MTK","Hungarian Division I","HUN","Yes","4/6/2023","6/30/2026","$65K - $650K","Right","Reasonable","Very Strong","5'9""","165 lbs","106","3",113,135,5,6,11,7,11,6,11,12,3,10,13,3,12,12,13,13,14,11,11,12,13,9,14,12,12,14,12,15,11,13,13,8,13,11,15,11,10,14,11,12,10,9,8,2,10,5,13,13,9,3,1,3,1,1,1,1,1,1,1,1
"7436",2000110556,"Krisztián Lisztes","5/6/2005 (18 years old)","AM (LC)","Ferencváros","Hungarian Division I","HUN","Yes","6/13/2022","6/30/2026","$550K - $10.5M","Right","Reasonable","Very Strong","6'0""","163 lbs","48","13",95,135,10,11,14,13,12,11,7,10,10,4,12,9,5,13,11,9,11,13,7,9,11,13,9,11,6,11,12,10,12,14,14,9,9,12,7,5,13,11,5,12,12,11,9,10,15,8,8,11,11,3,2,1,3,1,1,3,1,3,4,1
"7437",91153905,"Palkó Dárdai","4/24/1999 (24 years old)","M (RC), AM (RLC)","Fehérvár","Hungarian Division I","HUN","Yes","1/5/2021","6/30/2025","$550K - $1.6M","Left","Very Strong","Weak","5'11""","147 lbs","106","17",117,135,14,10,13,11,13,13,7,13,6,8,13,11,8,13,13,11,12,11,10,11,15,12,8,12,8,13,13,13,14,13,10,8,12,14,13,8,14,12,16,14,12,15,9,14,6,5,12,13,10,1,3,4,1,1,2,3,3,3,1,1
"7438",38000461,"Ádám Bogdán","9/27/1987 (35 years old)","GK","Ferencváros","Hungarian Division I","HUN","Yes","6/30/2019","6/30/2024","$40K - $120K","Right","Weak","Very Strong","6'4""","198 lbs","172","-",105,135,1,3,1,1,8,1,3,1,1,1,9,1,3,10,12,12,14,10,10,10,8,4,7,4,9,8,6,8,9,13,12,15,12,9,12,15,1,14,13,13,9,11,10,9,6,7,9,10,11,13,11,12,14,14,14,13,4,12,14,13
"7439",38031743,"András Radó","9/9/1993 (29 years old)","AM (RLC), ST (C)","Vasas","Hungarian Division II","HUN","Yes","7/20/2020","6/30/2024","$24K - $250K","Right","Fairly Strong","Very Strong","5'7""","132 lbs","338","98",103,135,12,11,13,12,12,11,5,10,2,3,12,15,4,13,9,11,10,12,11,11,9,14,9,11,6,6,12,6,14,11,9,4,9,13,10,5,10,10,13,12,11,13,8,12,8,8,11,8,12,2,1,2,2,2,3,2,1,1,2,1
"7440",58096177,"Guélor Kanga","9/1/1990 (32 years old)","M/AM (C)","Crvena zvezda","Serbian SuperLeague","GAB","No","10/10/2022","6/30/2025","Not for Sale","Right","Reasonable","Very Strong","5'6""","154 lbs","303","71",124,132,12,12,14,12,16,13,5,15,3,7,16,15,8,16,17,12,11,17,8,8,14,17,4,10,11,11,16,13,12,13,13,5,11,11,13,10,9,8,5,7,11,8,7,13,16,15,12,14,11,1,2,1,1,3,2,2,3,2,1,2
"7441",38000407,"Dániel Böde","10/24/1986 (36 years old)","D/AM (C), ST (C)","Paks","Hungarian Division I","HUN","Yes","7/12/2019","6/30/2024","$500 - $3.5K","Right","Reasonable","Very Strong","6'3""","207 lbs","472","152",93,135,4,7,9,12,11,7,15,10,5,7,11,11,8,10,13,12,15,14,13,13,16,9,16,7,9,12,8,8,6,6,11,14,10,6,8,16,10,12,11,13,13,17,8,14,11,8,13,13,13,1,3,2,2,2,1,3,3,1,1,1
"7442",133491,"Péter Halmosi","9/25/1979 (43 years old)","M/AM (L)","Király SE","Hungarian Lower Division","HUN","Yes","7/1/2020","6/30/2024","$0","Left","Very Strong","Reasonable","6'0""","163 lbs","546","125",76,135,12,14,12,9,13,10,11,6,12,10,13,10,11,14,11,10,9,13,12,11,14,13,15,9,10,11,13,7,6,10,11,8,10,5,7,4,13,10,9,12,14,10,4,15,6,11,10,10,8,3,1,4,2,4,2,1,2,3,1,3
"7443",38059244,"Péter Baráth","2/21/2002 (21 years old)","DM, M/AM (C)","Ferencváros","Hungarian Division III - Southwest","HUN","Yes","5/1/2023","6/30/2025","$240K - $2.4M","Right","Fairly Strong","Very Strong","6'1""","171 lbs","96","11",102,134,7,8,9,10,10,7,10,7,7,9,11,9,11,10,12,11,12,11,12,13,14,8,6,13,11,13,11,13,12,11,10,11,10,12,10,9,16,13,12,13,16,14,4,10,7,4,12,12,12,1,3,1,3,1,3,1,2,4,3,1
"7444",38020190,"Zsolt Kalmár","6/9/1995 (28 years old)","M/AM (C)","Dun. Streda","Slovak First Division","HUN","Yes","6/15/2020","6/30/2025","$180K - $1.8M","Right","Fairly Strong","Very Strong","6'1""","171 lbs","211","54",125,133,12,12,11,12,15,13,9,15,8,8,15,12,7,14,11,15,10,14,12,14,12,10,11,14,9,17,15,14,9,9,14,13,13,10,11,10,14,17,13,13,11,10,4,11,9,5,12,15,12,3,2,1,2,2,2,3,3,2,3,3
"7445",2000036439,"Zsombor Gruber","9/7/2004 (18 years old)","AM (LC), ST (C)","Csákvár","Hungarian Division II","HUN","Yes","6/13/2022","6/30/2024","$100K - $1M","Left","Very Strong","Reasonable","6'0""","147 lbs","60","9",89,132,7,9,13,11,12,10,5,10,3,5,10,8,4,13,6,13,10,10,7,8,9,13,6,13,8,13,12,13,12,12,7,11,12,12,8,7,12,18,1,11,11,10,5,9,13,1,9,10,15,1,1,2,1,3,3,3,2,1,3,2
"7446",38048142,"Bendegúz Bolla","11/22/1999 (23 years old)","D/WB (R)","Wolves","English Premier Division","HUN","Yes","7/17/2021","6/30/2024","$550K - $5.4M","Right","Reasonable","Very Strong","5'11""","158 lbs","171","16",118,132,12,12,12,7,12,6,7,12,12,11,12,5,11,12,12,13,10,12,12,12,12,11,4,13,11,12,11,14,14,13,14,12,11,14,13,8,8,15,15,12,8,10,8,9,6,6,9,13,14,3,3,3,2,2,1,1,3,1,1,3
"7447",18110543,"András Németh","11/9/2002 (20 years old)","ST (C)","HSV","Bundesliga 2","HUN","Yes","1/27/2023","6/30/2026","$170K - $1.7M","Right","Fairly Strong","Very Strong","6'2""","171 lbs","37","6",110,131,3,7,12,12,13,8,13,8,6,6,11,12,7,13,7,13,11,12,11,10,14,13,8,13,6,12,11,13,12,11,12,13,13,13,11,12,4,16,14,12,11,8,6,12,2,8,12,13,15,1,3,3,3,2,3,1,2,1,1,1
"7448",2000098662,"Zalán Vancsa","10/27/2004 (18 years old)","AM (RL), ST (C)","Lommel SK","Belgian Challenger Pro League","HUN","Yes","1/31/2022","6/30/2024","$170K - $1.7M","Right","Strong","Very Strong","5'9""","154 lbs","50","4",100,131,10,11,13,12,12,10,7,10,5,4,10,7,4,12,14,13,8,9,8,10,12,9,2,11,8,9,11,8,13,13,11,6,14,13,8,5,10,10,1,12,10,9,13,8,5,5,10,12,17,4,2,1,3,1,3,2,3,2,3,3
"7449",38047960,"Tamás Kiss","11/24/2000 (22 years old)","AM (RLC)","Puskás Akadémia","Hungarian Division I","HUN","Yes","7/1/2018","6/30/2026","$95K - $950K","Right","Fairly Strong","Very Strong","5'6""","143 lbs","136","11",106,130,11,12,12,7,14,8,11,11,4,4,12,9,7,14,8,13,11,9,7,10,12,13,10,13,9,9,13,13,14,14,8,4,11,13,11,7,10,18,4,10,8,11,6,5,7,6,9,12,12,2,2,1,2,1,2,3,3,2,1,4
"7450",37010037,"Kenneth Otigba","8/29/1992 (30 years old)","D (C)","Vasas","Hungarian Division II","HUN","Yes","9/22/2020","6/30/2024","$170K - $500K","Right","Reasonable","Very Strong","6'2""","189 lbs","202","19",100,130,3,5,7,6,9,5,14,8,11,13,9,6,13,9,13,10,13,10,10,11,13,6,10,10,13,14,9,13,9,8,11,14,11,9,12,14,5,11,12,12,11,12,12,11,5,8,13,12,14,3,2,1,1,3,1,2,3,3,2,1
"7451",2000098555,"Alex Moussounda","10/10/2000 (22 years old)","D (C), DM","Aris Limassol","Cypriot First Division","GAB","No","8/6/2021","5/31/2024","$45K - $475K","Right Only","Weak","Very Strong","6'0""","171 lbs","37","-",95,131,8,9,6,8,12,10,12,9,5,8,12,6,14,10,15,12,11,9,12,12,10,5,12,10,12,10,7,12,12,12,11,12,14,12,7,6,16,10,11,13,9,11,15,4,11,3,20,9,14,3,1,2,1,2,1,3,1,3,3,3
"7452",38001846,"Tamás Kádár","3/14/1990 (33 years old)","D (LC), WB (L)","Paks","Hungarian Division I","HUN","Yes","6/30/2022","6/30/2024","$28K - $300K","Left Only","Very Strong","Weak","6'2""","185 lbs","280","3",107,130,5,11,10,5,12,5,13,9,13,11,13,8,13,11,14,12,17,12,10,12,14,10,12,8,13,13,12,14,8,9,14,14,10,9,13,14,10,15,8,10,12,10,12,10,9,5,10,10,12,3,3,2,3,3,1,1,1,3,1,2
"7453",28019755,"Balázs Megyeri","3/31/1990 (33 years old)","GK","Debrecen","Hungarian Division I","HUN","Yes","7/29/2022","6/30/2024","$30K - $325K","Right","Weak","Very Strong","6'2""","196 lbs","195","-",118,130,4,2,3,1,8,6,3,3,2,1,9,2,2,9,12,12,14,9,12,11,13,1,14,1,12,12,10,10,11,10,12,14,11,10,10,12,14,14,13,15,12,13,12,12,6,3,13,15,16,13,10,16,10,13,12,14,6,10,12,12
"7454",38034947,"Martin Ádám","11/6/1994 (28 years old)","AM (C), ST (C)","Ulsan","Hana 1Q K LEAGUE 1","HUN","Yes","7/11/2022","12/31/2024","$60K - $600K","Left","Very Strong","Reasonable","6'3""","200 lbs","267","92",129,129,6,8,10,13,13,9,16,13,4,8,11,15,8,14,11,12,13,14,13,14,12,7,12,13,9,12,13,12,9,8,12,16,10,9,12,17,12,10,12,12,10,8,8,8,9,5,8,11,8,3,1,4,4,2,3,3,3,3,3,3
"7455",2000191908,"Michael Okeke","10/16/2005 (17 years old)","M (C)","Man City","English Premier Division","HUN","Yes","7/1/2022","6/30/2024","$220K - $2.2M","Right","Fairly Strong","Very Strong","6'0""","156 lbs","-","-",74,128,8,8,12,7,15,5,8,12,4,10,14,4,9,13,13,11,6,9,10,11,10,7,1,10,7,9,6,9,9,14,9,11,13,10,5,5,13,20,11,12,10,13,5,16,6,5,11,10,18,3,3,1,3,3,4,3,1,2,1,1
"7456",2000228178,"Áron Yaakobishvili","3/6/2006 (17 years old)","GK","Barcelona","Spanish First Division","HUN","Yes","6/1/2022","6/30/2025","$230K - $2.3M","Right","Reasonable","Very Strong","6'1""","156 lbs","-","-",85,128,3,2,1,3,10,6,7,3,3,1,10,6,3,7,11,9,11,9,9,10,14,11,9,2,10,8,10,8,11,13,10,12,14,9,8,9,2,14,12,14,14,12,6,14,8,8,14,12,14,8,11,12,11,10,9,13,5,9,9,11
"7457",38003943,"Máté Pátkai","3/6/1988 (35 years old)","DM, M (C)","Vasas","Hungarian Division II","HUN","Yes","9/23/2020","6/30/2024","$1.5K - $16K","Right","Reasonable","Very Strong","5'8""","154 lbs","397","60",94,128,5,10,12,10,13,7,12,11,4,11,13,7,11,12,13,10,13,12,11,11,16,8,12,12,13,14,9,13,9,11,10,6,12,8,10,8,10,11,11,18,17,15,12,14,15,6,15,8,18,3,1,1,2,1,2,3,1,2,2,3
"7458",38041617,"Dániel Gazdag","3/2/1996 (27 years old)","M/AM (C), ST (C)","Philadelphia","Major League Soccer","HUN","Yes","1/4/2023","12/31/2025","$7.6M - $9.2M","Right","Reasonable","Very Strong","5'10""","167 lbs","265","58",127,127,13,11,14,13,14,12,7,13,10,7,15,18,8,15,8,12,7,14,11,12,14,17,10,12,7,10,14,12,11,13,13,9,16,13,14,10,11,17,7,11,12,13,12,15,11,4,14,12,9,2,3,3,2,1,3,2,1,2,1,2
"7459",38059112,"Áron Csongvai","10/31/2000 (22 years old)","D (C), DM, M (C)","Fehérvár","Hungarian Division I","HUN","Yes","2/14/2023","6/30/2026","$180K - $1.8M","Right","Reasonable","Very Strong","6'1""","171 lbs","141","18",107,127,6,8,11,9,12,12,11,8,5,11,12,10,12,12,9,12,12,11,12,12,13,5,14,12,13,13,8,12,10,12,11,12,13,12,12,10,18,10,12,13,12,15,6,12,7,4,13,11,12,2,3,3,3,1,3,1,3,3,1,3
"7460",38059212,"Krisztofer Horváth","1/8/2002 (21 years old)","AM (LC), ST (C)","Kecskeméti TE","Hungarian Division I","HUN","Yes","8/18/2022","6/30/2025","$80K - $800K","Right","Weak","Very Strong","6'1""","180 lbs","77","27",107,127,8,9,14,12,13,11,6,11,8,6,13,14,6,13,8,12,9,13,12,13,15,14,5,11,10,6,13,7,13,14,12,7,12,13,11,9,12,12,13,14,11,12,10,12,10,8,12,14,12,2,3,1,2,2,2,2,1,1,1,3
"7461",38047789,"Norbert Szendrei","3/27/2000 (23 years old)","M/AM (C)","ZTE","Hungarian Division I","HUN","Yes","7/1/2022","6/30/2026","$450K - $1.4M","Right","Reasonable","Very Strong","6'0""","160 lbs","112","4",100,126,7,11,12,10,13,6,10,11,7,9,12,4,9,12,12,11,11,8,8,10,12,9,9,12,10,12,10,11,12,13,11,11,11,12,12,9,11,13,3,11,11,11,12,10,9,4,10,11,14,2,2,2,3,3,3,2,3,1,1,3
"7462",34010356,"Bruno Ecuélé Manga","7/16/1988 (34 years old)","D (C)","ASM Belfort","French National 3 - Group I","GAB","Yes","1/31/2023","6/30/2024","$0 - $110K","Right","Weak","Very Strong","6'2""","189 lbs","438","17",106,130,5,9,7,7,12,7,14,8,10,13,11,8,12,12,12,12,13,13,8,11,14,8,13,11,12,13,11,13,9,11,13,14,12,9,12,13,11,16,15,14,14,13,7,11,13,5,13,12,12,3,3,3,2,3,3,2,2,1,3,1
"7463",38044160,"Kevin Csoboth","6/20/2000 (22 years old)","M/AM (RL)","Újpest","Hungarian Division I","HUN","Yes","8/11/2022","6/30/2025","$200K - $2M","Right","Weak","Very Strong","5'10""","156 lbs","64","12",115,126,8,12,15,12,13,8,8,9,3,7,10,8,6,14,9,10,7,9,8,10,12,14,9,13,5,8,10,10,15,15,10,10,13,15,12,8,10,8,8,12,10,5,7,12,6,8,9,16,14,4,3,1,2,2,1,2,3,2,1,2
"7464",28000417,"Zoltán Stieber","10/16/1988 (34 years old)","M (RL), AM (RLC)","MTK","Hungarian Division I","HUN","Yes","1/24/2022","6/30/2024","$22K - $65K","Left","Very Strong","Weak","5'9""","147 lbs","331","55",95,125,14,15,13,12,13,13,5,11,7,6,13,10,7,14,12,12,7,13,12,11,12,14,5,13,7,12,13,12,10,10,10,6,10,9,10,7,13,14,14,13,9,7,4,11,6,7,13,17,15,2,1,3,1,3,2,3,2,2,1,1
"7465",16159906,"Barnabás Varga","10/25/1994 (28 years old)","ST (C)","Ferencváros","Hungarian Division I","HUN","Yes","6/1/2023","6/30/2025","$500K - $5.2M","Right","Reasonable","Very Strong","6'2""","171 lbs","314","194",119,125,4,8,11,13,13,8,17,6,4,5,8,16,6,13,10,14,12,14,12,11,13,13,12,13,8,11,9,12,11,13,12,16,10,12,11,11,3,8,8,13,10,12,9,12,11,6,12,11,13,2,2,2,1,1,1,3,2,3,3,3
"7466",38041619,"Patrik Demjén","3/22/1998 (25 years old)","GK","MTK","Hungarian Division I","HUN","Yes","6/12/2023","6/30/2026","$35K - $350K","Right","Reasonable","Very Strong","6'2""","169 lbs","224","-",113,125,3,1,2,1,10,6,1,2,1,3,12,1,1,11,5,12,11,12,11,12,12,1,12,3,12,8,11,11,11,13,12,13,13,9,10,11,13,19,5,12,11,12,7,12,7,5,11,11,16,11,8,14,8,13,12,10,11,12,12,12
"7467",38034285,"László Kleinheisler","4/8/1994 (29 years old)","M/AM (RLC)","Panathinaikos","Greek Super League 1","HUN","Yes","1/12/2023","6/30/2026","$1.6M - $3.4M","Right","Reasonable","Very Strong","5'8""","154 lbs","255","33",120,125,12,11,13,12,13,12,7,14,8,10,12,10,9,14,17,11,16,11,10,9,17,14,10,13,8,13,12,16,14,14,16,7,15,13,12,11,15,7,10,10,13,13,4,14,10,10,12,16,11,1,3,3,3,2,2,3,1,3,3,2
"7468",38037430,"Szilveszter Hangya","1/2/1994 (29 years old)","D/WB (L)","Fehérvár","Hungarian Division I","HUN","Yes","2/5/2021","6/30/2024","$50K - $500K","Left Only","Very Strong","Weak","5'9""","160 lbs","202","4",102,125,13,12,10,8,12,13,7,11,8,9,11,7,11,10,10,12,14,9,11,11,9,8,3,13,11,14,11,15,13,13,10,8,14,13,13,7,7,16,7,15,12,12,8,5,9,8,11,13,15,3,4,2,1,3,3,1,2,3,3,1
"7469",38017704,"Lukács Bőle","3/27/1990 (33 years old)","M (L), AM (LC)","Paks","Hungarian Division I","HUN","Yes","6/13/2022","6/30/2024","$30K - $300K","Left Only","Very Strong","Weak","5'7""","145 lbs","268","35",106,125,13,12,14,11,12,11,10,10,12,4,13,10,9,13,11,10,13,12,12,10,12,11,13,12,10,11,13,14,13,13,13,7,13,12,11,9,9,12,12,14,11,13,10,12,8,7,15,13,11,2,1,2,2,2,1,1,2,4,2,2
"7470",38019996,"Bence Batik","11/8/1993 (29 years old)","D (C)","Puskás Akadémia","Hungarian Division I","HUN","Yes","8/5/2022","6/30/2025","$110K - $1.1M","Right","Weak","Very Strong","6'3""","194 lbs","243","21",107,125,3,6,5,8,8,3,13,4,7,11,10,8,13,8,13,12,14,10,10,12,13,12,12,14,13,14,8,15,10,11,13,15,10,10,13,14,10,19,8,12,7,10,13,11,11,8,11,13,17,1,2,3,1,3,3,1,3,1,1,1
"7471",38039302,"Zsombor Berecz","12/13/1995 (27 years old)","DM, M/AM (C)","Vasas","Hungarian Division II","HUN","Yes","8/22/2022","6/30/2027","$100K - $1M","Right","Fairly Strong","Very Strong","5'11""","154 lbs","266","33",110,125,10,10,12,9,11,10,9,13,10,10,13,9,12,12,12,10,11,11,9,12,13,11,12,10,8,13,13,13,11,12,11,10,13,11,14,10,12,11,12,13,11,17,10,10,12,4,11,11,12,3,1,1,1,3,4,3,2,2,1,3
"7472",38000424,"Krisztián Németh","1/5/1989 (34 years old)","ST (C)","MTK","Hungarian Division I","HUN","Yes","6/17/2022","6/30/2024","$12K - $110K","Right","Fairly Strong","Very Strong","5'11""","158 lbs","239","66",109,125,8,9,12,15,12,11,11,12,4,5,11,12,7,14,9,14,10,13,13,11,11,13,8,13,8,10,12,9,10,12,13,9,8,10,9,10,13,12,11,12,10,10,15,11,6,10,11,16,16,1,3,2,1,1,3,1,3,2,2,3
"7473",79034187,"Julio Enciso","1/23/2004 (19 years old)","AM (RLC)","Brighton","English Premier Division","PAR","No","6/17/2022","6/30/2026","$100M - $125M","Right","Fairly Strong","Very Strong","5'9""","158 lbs","75","22",135,166,7,12,16,14,13,9,8,16,8,6,13,12,6,16,7,8,14,11,10,8,11,14,6,13,8,10,12,17,16,15,14,7,14,14,14,10,11,12,6,11,12,10,11,12,8,8,8,12,8,2,1,3,3,2,3,2,3,2,3,1
"7474",14001323,"Raúl Bobadilla","6/18/1987 (35 years old)","AM (C), ST (C)","Schaffhausen","Swiss Challenge League","PAR","No","3/2/2022","6/30/2024","$2K - $20K","Right","Fairly Strong","Very Strong","5'11""","194 lbs","386","117",99,145,10,12,12,14,14,12,13,12,8,5,13,10,9,13,16,12,18,12,8,9,12,17,6,13,7,8,11,15,8,8,16,10,8,8,8,13,10,6,6,8,9,7,13,12,13,18,12,14,10,3,2,4,3,3,2,2,1,1,3,2
"7475",13174975,"Rominigue Kouamé","12/17/1996 (26 years old)","D/WB (L), DM, M (C)","Troyes","Ligue 2 BKT","MLI","No","6/28/2021","6/30/2024","$325K - $3.1M","Left","Very Strong","Reasonable","5'10""","149 lbs","148","4",122,130,7,12,12,8,14,8,12,11,7,10,14,7,12,13,10,11,12,10,11,12,11,10,10,10,10,13,9,13,13,14,12,12,14,13,16,13,6,18,13,12,11,12,6,11,9,2,12,12,7,3,2,1,1,1,3,3,3,1,3,2
"7476",59006269,"Henrikh Mkhitaryan","1/21/1989 (34 years old)","DM, M/AM (C)","Inter","Italian Serie A","ARM","No","7/1/2022","6/30/2024","$4.9M - $9.4M","Right","Strong","Very Strong","5'10""","165 lbs","469","146",153,165,11,12,13,14,16,11,10,14,4,8,15,13,12,16,14,16,11,13,12,16,17,14,10,16,10,15,15,12,13,15,13,8,17,14,12,10,17,14,13,19,12,6,10,12,6,10,13,17,17,1,1,2,2,1,1,1,2,3,1,1
"7477",14046847,"Lucas Zelarayán","6/20/1992 (30 years old)","AM (C)","Columbus","Major League Soccer","ARM","No","12/2/2021","12/31/2024","$350K - $3.5M","Right","Fairly Strong","Very Strong","5'9""","160 lbs","284","68",140,150,13,14,16,13,15,16,3,15,11,4,15,12,8,15,10,12,9,12,12,12,15,14,14,14,8,13,13,11,14,15,13,7,12,14,13,12,10,8,10,13,12,15,9,14,7,5,13,12,11,2,2,3,1,2,3,2,2,3,3,2
"7478",58147629,"Eduard Spertsyan","6/7/2000 (23 years old)","M/AM (C)","Krasnodar","Russian Premier League","ARM","No","1/1/2021","6/30/2026","$6M - $11M","Right","Fairly Strong","Very Strong","5'10""","145 lbs","145","36",134,142,15,13,13,15,14,15,8,13,10,10,14,14,8,15,13,12,10,12,12,14,12,12,13,16,11,13,14,9,13,14,11,8,11,12,13,7,10,12,7,13,11,14,3,10,10,2,14,10,18,2,2,1,1,3,2,4,2,1,3,3
"7479",2000182149,"Georgy Arutyunyan","8/9/2004 (18 years old)","D (C)","Krasnodar","Russian Premier League","ARM","No","7/1/2021","6/30/2026","$2.1M - $4.3M","Right","Reasonable","Very Strong","6'2""","180 lbs","12","-",89,136,6,6,10,7,11,6,12,8,8,11,12,3,12,10,12,8,10,8,14,11,10,6,4,9,12,10,7,11,10,11,14,14,11,11,11,13,10,13,12,12,11,11,8,1,11,1,11,12,19,3,1,3,2,2,3,3,1,2,3,4
"7480",58133443,"Nair Tiknizyan","5/12/1999 (24 years old)","D/WB/M/AM (L)","Lokomotiv Moscow","Russian Premier League","ARM","No","8/4/2021","6/30/2026","$300K - $3.1M","Left","Very Strong","Weak","5'11""","174 lbs","83","7",120,135,11,11,12,9,12,10,18,7,5,10,11,4,13,10,12,11,10,11,12,11,12,7,12,8,11,15,9,15,13,14,15,10,17,13,14,11,16,14,13,12,11,15,7,10,5,5,14,10,19,3,2,3,1,1,1,2,2,1,2,2
"7481",92057768,"Sargis Adamyan","5/23/1993 (30 years old)","AM (RL), ST (C)","1. FC Köln","Bundesliga","ARM","Yes","7/1/2022","6/30/2026","$475K - $4.7M","Right","Fairly Strong","Very Strong","6'0""","165 lbs","284","70",122,132,8,10,13,11,12,8,10,10,8,8,12,12,10,13,14,12,12,11,9,11,12,13,7,13,8,11,12,14,14,13,12,10,12,14,12,10,10,8,10,8,9,10,10,12,9,9,8,11,10,2,2,3,2,2,3,1,1,2,2,2
"7482",37005653,"Aras Özbiliz","3/9/1990 (33 years old)","AM (RL)","Urartu Ye.","Armenian High League","ARM","Yes","1/16/2023","6/30/2024","$45K - $140K","Left","Very Strong","Fairly Strong","5'9""","154 lbs","124","22",110,130,13,13,14,11,15,16,6,15,6,6,13,12,7,15,6,12,10,13,10,11,9,15,4,12,5,10,12,7,13,13,9,7,8,12,5,9,12,10,13,6,10,6,11,12,9,16,10,10,10,2,1,1,3,1,4,4,3,1,2,1
"7483",59117815,"Vahan Bichakhchyan","7/9/1999 (23 years old)","M/AM (RC)","Pogoń","PKO Bank Polski Ekstraklasa","ARM","No","1/10/2022","6/30/2025","$100K - $1M","Left","Very Strong","Fairly Strong","5'8""","147 lbs","130","31",116,130,9,11,10,14,13,10,8,16,5,9,12,11,8,12,5,13,15,13,9,11,5,14,8,14,5,15,10,12,13,12,13,7,10,12,12,11,10,15,11,11,11,15,4,9,8,3,13,12,14,2,1,1,2,2,3,2,2,2,3,1
"7484",59148305,"Levon Vardanyan","11/2/2003 (19 years old)","ST (C)","Noah","Armenian High League","ARM","No","7/1/2022","6/30/2025","$0","Right","Reasonable","Very Strong","6'2""","174 lbs","84","16",73,129,6,3,13,13,12,6,13,7,4,6,7,8,2,11,5,8,5,9,6,8,10,11,9,12,7,6,4,7,12,8,7,12,13,8,5,7,9,10,11,11,9,11,6,10,15,3,10,14,13,2,1,2,1,1,1,2,1,1,2,3
"7485",120550,"Roque Santa Cruz","8/16/1981 (41 years old)","ST (C)","Libertad","Paraguay First Division Primera División","PAR","Yes","12/31/2021","12/31/2024","$18K - $170K","Right","Fairly Strong","Very Strong","6'3""","207 lbs","611","173",112,145,5,7,12,14,13,5,14,9,6,3,12,10,5,13,9,13,12,15,11,13,12,10,14,12,5,11,12,9,13,7,16,15,6,9,7,16,3,14,9,14,15,13,17,11,11,3,9,13,18,3,2,3,3,3,2,3,3,1,2,2
"7486",2000218949,"Garnik Minasyan","7/12/2005 (17 years old)","DM","Urartu Ye.","-","ARM","No","7/1/2022","6/30/2024","$30K - $95K","Right","Fairly Strong","Very Strong","6'0""","160 lbs","-","-",80,128,7,6,6,11,11,7,7,12,1,9,10,5,14,8,15,6,8,6,6,14,9,5,6,12,13,13,12,12,11,9,14,8,11,10,7,7,12,19,11,10,11,10,11,16,5,7,7,12,7,1,1,2,1,3,2,1,3,2,2,1
"7487",14135256,"Norberto Briasco","2/29/1996 (27 years old)","AM (RL), ST (C)","Boca","Argentine Premier Division","ARM","No","6/17/2021","12/31/2025","$500K - $5.2M","Right","Reasonable","Very Strong","6'0""","176 lbs","124","12",121,126,7,12,14,12,11,6,13,11,3,4,11,12,3,9,8,8,13,13,12,11,12,11,11,13,6,14,10,14,14,14,13,13,10,14,14,13,5,9,10,11,9,10,14,11,10,8,12,11,15,1,1,3,4,1,1,1,2,3,3,1
"7488",76046307,"Jordy Monroy","1/3/1996 (27 years old)","D/WB (R)","Independiente Medellín","Colombian First Division","ARM","No","7/19/2022","12/31/2023","$3K - $28K","Right","Weak","Very Strong","6'1""","154 lbs","194","3",115,125,11,13,11,8,12,7,10,8,13,12,11,7,11,12,10,12,10,11,12,12,13,8,4,10,14,12,11,13,13,12,12,13,12,12,13,12,10,11,8,11,11,12,9,11,8,8,11,11,7,3,2,3,3,2,2,2,3,3,2,1
"7489",58135283,"Artur Galoyan","6/25/1999 (23 years old)","M (C), AM (RLC)","Alania","Russian First Division","ARM","No","7/8/2022","6/30/2025","$65K - $650K","Right","Reasonable","Very Strong","5'9""","143 lbs","168","32",111,125,12,10,12,12,12,13,8,12,9,8,12,11,8,13,8,9,8,11,9,12,17,11,10,12,9,8,13,9,13,15,11,8,12,12,13,6,13,13,8,14,8,12,7,11,6,1,14,10,10,4,2,2,1,3,1,2,1,1,1,1
"7490",59130514,"Zhirayr Shaghoyan","4/10/2001 (22 years old)","AM (L), ST (C)","Ararat-Armenia","Armenian High League","ARM","No","6/15/2020","6/30/2025","$35K - $350K","Right","Weak","Very Strong","5'9""","152 lbs","140","70",99,123,12,11,13,10,13,12,8,10,5,6,11,4,8,13,7,10,6,10,8,9,10,14,8,11,8,10,11,10,13,13,11,7,6,14,10,7,14,15,12,13,11,11,14,13,13,6,8,11,15,3,3,2,1,3,1,1,3,2,1,3
"7491",59026442,"Varazdat Haroyan","8/24/1992 (30 years old)","D (C)","Astana","Kazakhstan Premier League","ARM","No","3/21/2023","12/31/2024","$120K - $1.2M","Right","Weak","Very Strong","6'1""","165 lbs","282","13",115,122,6,7,11,9,10,6,12,6,6,12,10,7,13,8,17,13,17,10,14,12,16,7,9,9,13,12,6,15,12,11,13,12,12,13,11,16,10,8,13,13,7,15,9,16,14,15,13,14,13,2,3,4,4,2,3,1,1,2,1,3
"7492",2000030028,"Edgar Sevikyan","8/8/2001 (21 years old)","AM (RC)","Pari NN","Russian Premier League","ARM","No","6/30/2022","6/10/2025","$275K - $2.8M","Left","Very Strong","Weak","5'9""","152 lbs","55","4",103,122,10,10,13,9,12,11,8,13,5,6,12,11,6,13,8,11,9,12,9,11,12,14,7,17,7,11,12,11,14,13,11,7,11,12,10,7,8,12,11,9,11,10,8,12,7,3,12,15,10,1,2,1,1,2,2,2,3,2,2,3
"7493",2000065729,"Grant-Leon Ranos","7/20/2003 (19 years old)","AM (RL), ST (C)","FC Bayern II","German Regional Division Bavaria","ARM","Yes","6/13/2022","6/30/2025","$275K - $850K","Right","Fairly Strong","Very Strong","5'11""","160 lbs","45","23",108,122,11,11,12,13,12,12,12,11,6,4,12,13,4,12,11,13,10,11,10,10,13,13,6,13,4,12,12,11,12,12,12,10,13,13,11,10,16,15,16,12,12,10,6,12,4,8,13,13,11,2,2,1,3,2,1,3,3,1,3,3
"7494",59025441,"Hovhannes Hambardzumyan","10/4/1990 (32 years old)","D/WB (R)","Anorthosi","Cypriot First Division","ARM","No","3/15/2022","5/31/2024","$150K - $450K","Right","Weak","Very Strong","5'10""","152 lbs","322","49",110,121,8,12,10,8,10,9,8,14,9,13,11,8,14,9,12,11,14,12,9,12,12,10,6,8,10,13,8,13,14,13,13,10,12,13,14,11,8,10,13,14,12,12,6,10,12,4,12,12,14,3,1,1,3,2,3,1,3,1,1,3
"7495",59041454,"Taron Voskanyan","2/22/1993 (30 years old)","D (C)","Alashkert","Armenian High League","ARM","No","6/14/2021","6/30/2024","$14K - $140K","Right","Weak","Very Strong","6'0""","165 lbs","267","7",100,121,5,6,7,6,8,6,13,6,6,13,9,7,12,6,11,10,14,11,12,11,11,7,11,5,13,15,6,13,13,9,13,11,12,12,13,12,5,12,14,13,12,13,6,9,6,4,11,11,12,4,3,1,1,3,2,3,2,2,2,2
"7496",79030884,"Richard Sánchez","3/29/1996 (27 years old)","DM, M (C)","América","Mexican First Division","PAR","No","8/24/2019","6/30/2024","$800K - $9.4M","Right","Fairly Strong","Very Strong","5'9""","163 lbs","203","20",134,145,13,7,12,12,14,16,9,16,14,12,14,10,12,14,12,13,14,13,12,13,12,11,11,15,13,13,14,14,13,13,13,7,12,13,12,9,13,10,7,12,13,11,10,12,11,7,13,12,13,3,1,2,1,1,3,2,2,2,2,1
"7497",59034042,"Tigran Barseghyan","9/22/1993 (29 years old)","AM (RC)","Slovan Bratislava","Slovak First Division","ARM","No","1/1/2022","12/31/2024","$130K - $1.3M","Right","Fairly Strong","Very Strong","5'10""","165 lbs","227","64",121,121,10,15,14,12,11,10,11,13,6,4,13,11,4,13,11,12,9,12,10,13,10,13,7,13,5,13,12,15,13,12,11,10,15,13,12,11,12,19,11,11,11,11,12,12,11,1,9,11,20,3,3,2,3,2,4,3,2,1,1,2
"7498",58058773,"Khoren Bairamyan","1/7/1992 (31 years old)","WB (L), M (LC), AM (L)","Rostov","Russian Premier League","ARM","No","6/14/2021","6/30/2025","Not for Sale","Right","Fairly Strong","Very Strong","5'7""","138 lbs","227","16",116,121,11,10,11,11,12,12,5,10,5,6,13,12,11,11,12,11,13,11,12,11,15,12,5,11,12,14,12,13,13,13,11,6,13,13,13,5,18,8,15,15,4,15,5,6,6,13,15,13,18,3,1,2,3,2,3,2,3,1,3,2
"7499",78007261,"Mauro Guevgeozian","5/10/1986 (37 years old)","ST (C)","Fénix","Uruguayan First Division","ARM","No","1/9/2023","12/31/2023","$2.5K - $7K","Right","Reasonable","Very Strong","6'0""","174 lbs","365","149",105,121,8,10,10,13,11,9,15,8,6,7,12,13,6,11,13,11,14,11,12,10,8,11,12,12,7,9,9,12,9,10,15,13,12,10,10,14,8,8,10,5,10,10,12,13,13,7,10,7,13,3,3,1,2,3,3,3,3,1,3,2
"7500",2000028327,"Styopa Mkrtchyan","2/17/2003 (20 years old)","D (C)","BKMA","Armenian High League","ARM","No","8/1/2019","6/30/2024","$1.5K - $16K","Left","Very Strong","Weak","6'3""","191 lbs","54","4",94,120,5,6,7,7,10,6,13,8,6,12,10,10,12,10,15,10,14,9,9,10,14,8,7,9,11,12,10,10,8,8,15,15,14,11,11,15,8,13,12,10,13,10,9,10,11,5,8,13,12,2,2,4,1,1,3,1,2,3,4,3
"7501",49053829,"Gor Manvelyan","4/9/2002 (21 years old)","M/AM (C)","FC Nantes","French National 3 - Group D","ARM","Yes","7/1/2021","6/30/2024","$230K - $700K","Right","Reasonable","Very Strong","5'9""","136 lbs","-","-",95,120,10,11,12,11,12,12,7,9,6,8,12,10,6,12,8,11,12,10,11,11,13,10,8,11,9,12,13,12,11,11,9,7,11,11,11,9,11,17,12,13,12,14,4,10,8,6,11,13,18,2,3,2,3,1,1,3,4,2,2,1
"7502",71087785,"Artur Avagimian","1/16/1997 (26 years old)","M (LC), AM (RLC)","Chornomorets","Ukrainian Premier League","ARM","No","1/10/2022","6/30/2025","$75K - $220K","Right","Reasonable","Very Strong","5'7""","147 lbs","99","17",108,120,12,10,13,11,12,11,9,12,5,8,12,11,7,13,8,12,9,9,10,11,13,12,6,9,8,12,12,12,13,13,12,6,12,12,12,10,13,15,11,13,11,13,9,13,6,3,14,12,9,1,1,3,3,2,3,3,2,2,1,1
"7503",59025451,"Artak Dashyan","11/20/1989 (33 years old)","DM, M (C)","Pyunik","Armenian High League","ARM","No","7/1/2021","6/30/2024","$1K - $8K","Left Only","Very Strong","Weak","5'11""","169 lbs","256","32",93,120,10,12,12,12,13,14,11,15,9,9,12,13,9,12,13,11,12,12,12,10,13,10,12,8,7,12,11,13,12,10,12,9,15,12,12,13,11,16,13,13,12,12,9,10,6,4,13,14,11,2,1,1,3,2,1,3,1,1,1,1
"7504",59135821,"Ugochukwu Iwu","11/28/1999 (23 years old)","DM, M (C)","Urartu Ye.","Armenian High League","ARM","No","8/7/2020","6/30/2025","$55K - $160K","Right Only","Weak","Very Strong","5'10""","160 lbs","146","15",101,119,7,7,8,8,12,8,9,7,9,13,13,6,14,10,9,12,14,12,11,9,12,5,8,11,13,10,12,14,13,13,11,9,12,11,14,9,15,16,10,13,10,12,13,13,7,5,11,12,16,3,2,1,2,1,2,2,2,2,1,2
"7505",2000028346,"Artur Serobyan","7/2/2003 (19 years old)","AM (RL)","Ararat-Armenia","Armenian High League","ARM","No","7/1/2019","6/30/2024","$14K - $130K","Left","Very Strong","Reasonable","5'11""","176 lbs","69","9",100,119,11,12,14,11,13,13,5,13,4,4,12,12,4,14,8,7,8,11,8,9,10,13,5,11,5,7,12,8,12,13,13,6,13,13,11,10,10,13,12,10,12,9,8,14,5,6,14,13,7,1,1,2,3,3,2,2,1,3,2,1
"7506",7522089,"Yeghia Yavrunyan","10/18/1981 (41 years old)","ST (C)","Akhlamov","Russian Lower Division","ARM","No","6/14/2021","-","$0","Right","Reasonable","Very Strong","5'10""","180 lbs","273","108",79,116,6,8,9,10,12,3,13,9,1,3,11,11,6,11,9,12,11,11,8,12,11,9,4,12,10,12,11,12,7,9,14,9,2,8,12,15,11,10,15,11,5,1,3,10,7,11,10,5,16,2,2,2,3,3,1,2,1,3,1,2
"7507",79010306,"Gustavo Gómez","5/6/1993 (30 years old)","D (C)","SEP","Brazilian National First Division","PAR","No","7/28/2020","12/31/2026","$9.8M - $15M","Right","Weak","Very Strong","6'1""","182 lbs","244","21",144,144,5,9,8,7,11,7,16,6,11,15,11,13,15,11,14,16,17,13,13,13,16,5,17,8,16,16,10,16,13,11,13,14,16,12,15,16,7,8,8,14,11,8,7,10,15,14,13,16,13,1,1,1,2,3,2,2,3,1,3,2
"7508",59138862,"Narek Grigoryan","6/17/2001 (21 years old)","AM (RLC)","Urartu Ye.","Armenian High League","ARM","No","6/13/2022","6/30/2024","$45K - $475K","Left","Very Strong","Reasonable","5'11""","169 lbs","127","36",99,115,11,11,12,12,12,11,8,11,3,6,10,11,7,13,9,11,8,11,11,10,12,12,5,11,8,10,12,10,13,13,9,7,13,13,9,8,14,12,12,12,10,12,7,10,7,8,10,10,10,2,4,2,1,3,3,2,2,1,3,1
"7509",59026444,"Kamo Hovhannisyan","10/5/1992 (30 years old)","D/WB/M/AM (R)","Astana","Kazakhstan Premier League","ARM","No","1/1/2022","12/31/2024","$100K - $1M","Right","Weak","Very Strong","5'10""","154 lbs","341","44",109,115,5,9,11,5,9,3,6,5,11,10,9,5,11,8,12,9,13,7,10,11,12,7,5,6,9,13,7,14,15,12,9,7,14,15,14,9,14,14,14,13,12,9,6,10,11,7,10,12,19,1,2,2,3,3,3,2,1,2,1,2
"7510",68005756,"André Calisir","6/13/1990 (32 years old)","D (RC), DM","IF Brommapojkarna","Swedish Premier Division","ARM","Yes","2/21/2023","12/31/2025","Not for Sale","Right","Weak","Very Strong","5'11""","167 lbs","312","7",106,115,9,11,6,6,11,7,12,7,9,13,11,8,12,11,13,12,15,12,11,12,12,3,13,9,12,13,12,13,10,9,12,12,10,11,12,13,13,16,13,14,12,14,12,9,9,2,10,11,15,3,1,1,3,1,3,2,2,3,3,2
"7511",59009847,"Artak Yedigaryan","3/18/1990 (33 years old)","D (L), DM, M (RLC)","Alashkert","Armenian High League","ARM","No","7/1/2021","6/30/2024","$3.5K - $35K","Right","Reasonable","Very Strong","5'9""","167 lbs","335","47",108,114,4,11,7,12,11,10,4,12,8,11,11,5,12,9,12,10,14,11,11,12,15,9,12,8,10,14,12,14,13,11,12,5,14,13,12,12,15,9,11,14,12,14,4,13,12,3,11,15,12,1,1,2,4,2,1,3,3,2,2,1
"7512",96150944,"Vahe Mnatsakanyan","9/13/2002 (20 years old)","DM, M (C)","ŁKS Łódź","Polish Second Division","ARM","Yes","3/9/2023","6/30/2024","$26K - $275K","Right","Weak","Very Strong","6'2""","171 lbs","58","1",66,114,5,4,4,7,9,2,6,5,4,7,11,5,12,14,6,8,7,8,8,14,5,5,6,7,10,7,6,11,13,12,6,14,15,11,6,7,12,19,9,10,11,11,8,12,9,2,16,10,12,3,3,1,2,1,2,1,3,1,2,1
"7513",59006474,"Zaven Badoyan","12/22/1989 (33 years old)","M (RL), AM (RLC)","Aqjaıyq","Kazakhstan First League","ARM","No","4/12/2022","12/31/2023","$0","Left","Very Strong","Fairly Strong","5'9""","152 lbs","309","59",86,114,7,9,10,11,9,11,2,8,3,2,10,12,5,12,12,8,6,9,8,9,14,14,10,9,2,8,10,10,13,12,5,4,15,11,11,7,11,16,12,14,10,11,4,13,6,3,13,12,20,1,3,3,3,1,1,2,4,2,3,1
"7514",27070244,"Edgar Babayan","10/28/1995 (27 years old)","M (RL), AM (RLC)","Randers FC","3F Superliga","ARM","Yes","7/1/2022","6/30/2025","$130K - $1.3M","Left","Very Strong","Weak","5'11""","165 lbs","176","24",110,113,7,12,14,11,13,12,4,12,3,5,12,11,6,13,10,13,9,9,9,11,9,14,6,12,5,10,11,10,15,12,10,8,12,13,11,11,8,7,9,10,9,10,10,7,6,5,10,9,14,3,3,1,2,2,3,3,1,3,1,1
"7515",59136633,"Grenik Petrosyan","12/5/2001 (21 years old)","ST (C)","BKMA","Armenian High League","ARM","No","6/13/2022","6/30/2024","$45K - $140K","Right","Fairly Strong","Very Strong","5'9""","156 lbs","78","21",70,112,5,4,6,13,10,6,9,2,2,5,5,8,1,11,12,7,3,10,3,11,14,11,3,13,7,6,6,7,13,13,7,8,5,13,10,7,11,14,11,10,11,10,10,4,5,5,10,10,18,1,3,1,2,2,1,1,3,1,1,2
"7516",59006230,"Hrayr Mkoyan","9/2/1986 (36 years old)","D (C)","Ararat","Armenian High League","ARM","No","7/28/2020","6/30/2024","$0","Right","Weak","Very Strong","6'0""","171 lbs","376","9",98,112,5,10,6,5,8,8,12,13,8,13,10,7,12,11,13,11,16,9,10,10,17,6,13,4,11,12,6,13,12,8,12,13,15,13,11,13,7,12,14,15,12,11,4,13,9,12,14,17,13,2,2,1,2,1,3,1,3,2,1,3
"7517",59074269,"Alik Arakelyan","5/21/1996 (27 years old)","D (L), M (RL)","L. A. Goris","Armenian First League","ARM","No","2/27/2023","6/30/2025","$14K - $40K","Left","Very Strong","Fairly Strong","5'6""","136 lbs","234","26",88,112,9,12,9,5,13,7,4,9,7,8,5,3,11,9,9,8,8,9,9,12,5,6,11,8,8,9,10,9,14,14,9,4,8,14,13,1,13,14,12,10,11,11,6,3,9,3,17,11,8,2,2,3,2,1,4,1,3,4,2,1
"7518",79010425,"Lorenzo Melgarejo","8/10/1990 (32 years old)","M/AM (L)","Libertad","Paraguay First Division Primera División","PAR","No","7/8/2021","6/30/2024","$275K - $850K","Left Only","Very Strong","Weak","5'10""","171 lbs","324","92",124,143,10,10,14,14,15,9,13,11,10,11,12,12,10,11,13,13,14,13,11,9,14,13,8,13,10,14,11,16,15,12,13,14,12,14,12,12,17,12,7,13,13,9,13,12,12,5,12,13,13,2,1,3,1,4,4,1,3,2,1,3
"7519",18081081,"Solomon Udo","7/15/1995 (27 years old)","M (C)","Ararat-Armenia","Armenian High League","ARM","No","1/30/2022","6/30/2024","$0","Right","Weak","Very Strong","6'0""","163 lbs","197","10",88,111,7,7,4,6,9,7,4,6,1,7,14,3,9,12,6,13,3,7,5,13,8,5,9,10,7,8,10,13,14,13,8,6,14,13,10,7,12,12,10,13,11,13,5,5,15,2,8,11,20,3,1,3,1,1,3,4,1,2,4,3
"7520",59110990,"Narek Aslanyan","1/4/1996 (27 years old)","M (RC), AM (C)","Sevan FC","Armenian Lower League","ARM","No","1/21/2021","6/30/2024","$0 - $35K","Right","Strong","Very Strong","5'10""","158 lbs","120","7",78,111,6,7,8,8,13,6,6,6,1,7,10,1,7,13,12,6,8,4,7,13,19,13,9,7,8,7,10,12,13,10,7,7,12,9,7,4,15,18,14,12,11,13,7,8,14,1,15,10,10,3,1,3,2,1,2,1,1,4,1,2
"7521",58159071,"Eduard Bagrintsev","1/13/2003 (20 years old)","WB/M (R), AM (RLC)","Dubnica","Slovak Lower Division","ARM","No","9/6/2022","6/30/2024","$4K - $40K","Right","Reasonable","Very Strong","5'9""","163 lbs","17","2",76,111,7,7,13,6,10,5,3,7,4,4,8,4,6,10,7,8,7,9,8,8,10,9,14,9,8,7,6,9,13,8,9,8,11,12,9,9,13,16,11,8,8,11,6,11,10,2,12,12,12,1,3,2,1,3,1,4,3,2,1,3
"7522",58032460,"Aram Hayrapetyan","11/22/1986 (36 years old)","GK","Maqtaaral","Kazakhstan Premier League","ARM","No","2/6/2023","12/31/2024","Not for Sale","Right","Fairly Strong","Very Strong","6'4""","191 lbs","286","1",95,110,3,1,1,2,3,5,1,2,2,1,8,3,3,5,15,12,12,6,10,13,4,3,10,1,10,9,7,8,9,16,9,11,12,7,8,7,10,20,9,13,10,8,13,1,10,1,11,13,13,11,9,7,6,13,12,14,5,10,14,13
"7523",59046714,"Gor Malakyan","6/12/1994 (29 years old)","DM, M (LC), AM (L)","Ararat","Armenian High League","ARM","No","6/30/2021","6/30/2024","$0 - $65K","Right","Weak","Very Strong","5'9""","160 lbs","216","11",86,110,5,7,11,5,11,6,6,8,7,9,9,8,10,12,14,9,14,8,12,10,15,10,8,13,10,11,10,15,13,12,7,5,15,13,9,8,10,10,10,10,11,11,13,3,10,6,12,12,7,2,2,2,1,3,2,1,2,2,3,1
"7524",71036296,"Gegham Kadimyan","10/19/1992 (30 years old)","AM (L)","FC Van","Armenian High League","ARM","No","3/21/2023","6/30/2024","$28K - $275K","Right","Reasonable","Very Strong","6'0""","176 lbs","260","33",88,110,12,12,12,10,9,13,8,12,6,2,12,9,3,12,8,10,12,13,7,13,17,14,15,12,7,9,13,11,10,11,10,13,13,11,9,11,8,10,13,15,5,14,14,12,3,8,13,11,13,3,1,2,2,1,1,2,2,2,1,4
"7525",59034226,"Rumyan Hovsepyan","11/13/1991 (31 years old)","DM, M (C)","FC Van","Armenian High League","ARM","No","2/15/2023","6/30/2025","Not for Sale","Right","Weak","Very Strong","6'1""","176 lbs","273","34",93,109,7,7,10,9,11,7,12,10,4,11,12,7,13,11,12,11,13,10,13,11,12,9,12,9,10,12,12,12,12,9,13,14,12,12,12,13,12,14,11,11,11,9,4,12,8,8,12,14,20,3,1,2,3,1,3,3,1,1,1,4
"7526",59074260,"Hayk Galstyan","3/23/1998 (25 years old)","M (RL), AM (RLC)","Mika","Armenian First League","ARM","Yes","7/24/2022","6/30/2024","$0","Left","Very Strong","Reasonable","5'10""","160 lbs","32","5",74,109,6,5,10,9,10,6,6,8,6,5,8,7,4,11,13,9,12,9,8,10,10,15,6,10,6,7,6,11,13,12,8,7,12,12,7,6,11,10,10,13,10,14,4,11,12,5,12,16,11,3,2,3,3,3,3,3,1,3,1,1
"7527",58158836,"Sergey Kochkanyan","5/5/2003 (20 years old)","D (R), DM, M/AM (R)","Dinamo Stavropol","Russian Second Division B - Group 1","ARM","No","7/22/2022","6/30/2025","$0 - $26K","Right","Fairly Strong","Very Strong","6'0""","158 lbs","26","5",63,109,5,9,7,11,6,5,5,4,5,7,7,2,10,9,8,6,7,3,5,12,7,15,1,6,7,6,7,7,13,12,4,9,12,13,11,3,10,12,8,12,11,11,7,19,10,1,10,12,17,2,3,3,3,3,1,3,4,1,2,4
"7528",2000162362,"Gabriel Papian","4/30/2004 (19 years old)","DM, M/AM (C)","Vejle","3F Superliga","ARM","Yes","1/25/2023","-","$0","Right","Weak","Very Strong","6'0""","174 lbs","-","-",71,109,8,12,9,8,12,9,9,8,6,8,12,11,8,12,5,14,9,12,10,11,9,11,7,12,11,11,13,4,6,9,9,11,9,7,7,9,11,12,12,10,12,10,14,13,5,6,9,8,12,1,3,1,1,1,2,2,3,1,1,1
"7529",14077429,"Andrés Cubas","5/22/1996 (27 years old)","DM, M (C)","Vancouver","Major League Soccer","PAR","No","4/28/2022","12/31/2027","$3.6M - $7.2M","Right","Reasonable","Very Strong","5'7""","132 lbs","172","5",122,142,5,10,10,7,13,8,3,11,4,14,14,6,14,12,12,16,14,15,11,12,14,11,7,10,13,13,13,16,14,13,8,4,13,13,15,10,13,12,15,10,10,15,13,11,8,5,13,14,12,3,2,1,2,4,3,1,3,3,3,1
"7530",2000229917,"Arsen Samsonyan","4/30/2006 (17 years old)","GK","Pyunik","Armenian High League","ARM","No","6/13/2022","6/30/2025","$14K - $40K","Right","Reasonable","Very Strong","6'1""","154 lbs","-","-",50,109,3,1,3,3,1,4,1,3,2,1,9,3,3,4,6,4,5,4,10,12,14,3,4,2,5,5,4,4,9,11,5,8,12,11,4,3,7,12,14,13,11,11,6,8,12,2,14,12,20,5,6,12,6,9,12,12,5,5,6,11
"7531",85078058,"Riyad Mahrez","2/21/1991 (32 years old)","M (R), AM (RL)","Man City","English Premier Division","ALG","Yes","6/14/2021","6/30/2025","$33M - $49M","Left","Very Strong","Reasonable","5'10""","147 lbs","390","92",160,165,15,17,17,16,20,14,8,13,4,5,16,13,8,19,6,13,7,16,12,14,13,17,5,15,5,13,17,11,14,17,15,9,14,14,13,8,10,15,9,13,9,12,6,15,7,8,13,15,8,2,3,2,2,1,4,3,1,4,3,1
"7532",2000100062,"Badredine Bouanani","12/8/2004 (18 years old)","AM (R)","OGC Nice","Ligue 1 Uber Eats","ALG","Yes","1/1/2023","6/30/2027","$15M - $22M","Left","Very Strong","Weak","5'8""","143 lbs","19","-",115,164,9,8,15,13,12,7,5,11,3,6,11,8,6,15,8,11,13,12,12,11,15,12,6,13,14,14,11,13,14,14,12,9,16,13,13,12,10,13,14,15,13,12,6,14,10,8,14,13,13,1,3,1,1,3,3,2,2,1,1,1
"7533",48032338,"Ismaël Bennacer","12/1/1997 (25 years old)","DM, M (C)","AC Milan","Italian Serie A","ALG","Yes","1/12/2023","6/30/2027","$21M - $31M","Left","Very Strong","Reasonable","5'9""","154 lbs","208","8",152,162,13,12,15,9,16,13,7,14,6,13,16,11,16,15,13,14,15,16,14,14,15,13,11,12,15,16,14,14,14,15,16,7,13,13,13,12,12,12,14,15,14,12,12,14,14,6,16,16,17,2,3,4,1,3,1,2,4,3,1,2
"7534",12031625,"Islam Slimani","6/18/1988 (34 years old)","ST (C)","RSC Anderlecht","Jupiler Pro League","ALG","No","1/31/2023","6/30/2024","$800K - $1.8M","Right","Reasonable","Very Strong","6'2""","182 lbs","336","133",130,156,8,10,11,14,12,9,16,9,5,6,14,13,8,12,17,16,18,14,12,14,16,13,12,14,10,15,13,15,9,11,15,15,8,9,12,15,5,7,7,12,14,14,8,14,16,15,13,14,12,1,2,1,1,1,2,3,2,1,2,3
"7535",34002647,"Yacine Brahimi","2/8/1990 (33 years old)","M (L), AM (RLC)","Al-Gharafa","Qatar Stars League","ALG","Yes","6/20/2022","6/30/2024","$425K - $4.4M","Right","Reasonable","Very Strong","5'9""","152 lbs","355","88",135,155,14,11,18,13,16,15,5,12,4,5,15,15,6,18,10,12,8,14,11,12,12,19,14,14,6,8,15,10,14,15,16,7,13,13,12,8,13,11,11,15,9,10,7,13,6,9,12,16,14,1,1,1,1,3,2,1,1,1,1,4
"7536",49060523,"Farès Chaïbi","11/28/2002 (20 years old)","M (C), AM (RLC)","Toulouse FC","Ligue 1 Uber Eats","ALG","Yes","2/23/2022","6/30/2025","$11.5M - $14.5M","Right","Reasonable","Very Strong","6'0""","158 lbs","36","5",127,155,15,11,13,11,14,13,8,11,6,8,14,11,10,15,11,12,12,13,11,13,16,15,6,12,9,13,14,12,14,14,12,10,14,13,13,11,16,13,12,12,12,12,7,13,6,9,12,13,15,1,3,1,2,3,3,2,2,3,1,1
"7537",34000674,"Sofiane Feghouli","12/26/1989 (33 years old)","DM, M/AM (C)","Fatih Karagümrük","Turkish Super League","ALG","Yes","1/12/2023","6/30/2024","$100K - $1M","Right","Fairly Strong","Very Strong","5'10""","156 lbs","371","53",105,155,12,14,13,12,14,12,9,12,7,3,14,12,6,15,12,14,10,13,11,14,13,16,8,13,8,13,14,7,10,9,13,7,10,8,6,12,11,12,8,12,10,9,13,10,14,16,11,16,11,4,2,2,1,2,4,3,3,1,2,2
"7538",49047581,"Rayan Aït-Nouri","6/6/2001 (22 years old)","D/WB (L)","Wolves","English Premier Division","ALG","Yes","7/9/2021","6/30/2026","$72M - $87M","Left","Very Strong","Reasonable","5'11""","154 lbs","88","3",132,153,11,14,15,10,14,7,11,9,8,12,13,8,14,15,11,13,13,13,12,12,15,15,7,14,14,12,13,13,14,13,12,10,12,14,13,11,10,11,13,13,12,14,10,11,8,8,14,13,11,2,3,2,1,2,1,3,2,2,2,3
"7539",85051536,"Faouzi Ghoulam","2/1/1991 (32 years old)","D/WB (L)","Angers SCO","Ligue 2 BKT","ALG","Yes","1/31/2023","6/30/2025","$450K - $4.6M","Left Only","Very Strong","Weak","6'0""","176 lbs","254","4",118,151,13,15,12,8,14,11,11,12,16,12,14,10,14,14,11,13,12,13,13,12,15,11,7,14,13,14,11,16,11,11,13,12,5,12,10,12,12,12,13,17,14,14,15,13,12,12,12,14,14,1,1,3,1,2,3,4,3,2,2,1
"7540",79000020,"Pablo Aguilar","4/2/1987 (36 years old)","D (C)","Sportivo Luqueño","Paraguay First Division Primera División","PAR","No","12/15/2022","12/31/2024","Not for Sale","Right","Reasonable","Very Strong","5'11""","169 lbs","554","48",116,142,6,8,9,8,10,8,13,8,13,14,9,6,14,9,13,13,13,11,11,11,15,8,13,7,13,14,10,13,12,11,14,13,9,11,12,13,8,10,7,14,14,9,14,11,12,5,11,12,13,2,3,3,1,1,2,3,1,4,1,3
"7541",48044735,"Amine Gouiri","2/16/2000 (23 years old)","AM (L), ST (C)","Rennes","Ligue 1 Uber Eats","ALG","Yes","9/1/2022","6/30/2027","$35M - $44M","Right","Weak","Very Strong","5'11""","158 lbs","116","37",138,149,8,12,15,15,15,13,11,15,4,4,13,14,4,15,13,13,14,14,13,13,16,16,10,15,9,15,14,14,14,14,15,12,15,14,13,13,11,14,5,16,16,14,7,15,8,8,13,15,16,4,3,1,1,3,1,1,2,4,1,4
"7542",13227048,"Hicham Boudaoui","9/23/1999 (23 years old)","DM, M (RC)","OGC Nice","Ligue 1 Uber Eats","ALG","No","1/25/2023","6/30/2027","$10M - $15.5M","Right","Reasonable","Very Strong","5'9""","134 lbs","127","9",135,149,10,12,14,8,14,8,7,11,4,13,15,10,13,14,9,12,13,13,12,13,15,16,10,12,12,15,14,15,13,14,12,7,15,13,16,11,15,10,15,15,16,15,9,15,5,8,15,14,15,1,3,4,4,1,1,3,3,4,3,1
"7543",85079680,"Aïssa Mandi","10/22/1991 (31 years old)","D (RLC)","Villarreal","Spanish First Division","ALG","Yes","7/1/2021","6/30/2025","$8.6M - $13M","Right","Reasonable","Very Strong","6'0""","171 lbs","350","22",139,148,6,15,11,5,12,6,14,5,12,15,14,6,15,12,15,15,16,12,13,12,16,7,12,12,14,14,13,14,13,13,14,13,15,14,13,14,15,14,14,15,13,16,8,14,13,7,13,13,9,3,4,1,2,3,3,1,3,1,3,3
"7544",48031455,"Houssem Aouar","6/30/1998 (24 years old)","M/AM (C)","OL","Ligue 1 Uber Eats","ALG","Yes","6/14/2021","6/30/2028","$12M - $15M","Right","Reasonable","Very Strong","5'9""","154 lbs","178","30",136,148,13,10,15,11,17,13,7,9,5,10,16,12,8,16,9,12,10,14,11,12,12,15,13,14,12,15,16,10,13,15,12,7,14,13,13,9,15,13,12,13,13,17,8,15,8,6,12,13,14,2,2,1,3,2,1,2,3,1,2,3
"7545",48036788,"Saïd Benrahma","8/10/1995 (27 years old)","AM (RLC)","West Ham","English Premier Division","ALG","Yes","1/29/2021","6/30/2026","$41M - $62M","Right","Fairly Strong","Very Strong","5'8""","147 lbs","256","58",139,148,10,12,17,13,17,13,8,11,6,5,12,16,6,17,10,11,11,13,11,12,14,18,6,14,6,10,12,13,14,15,13,7,14,14,14,9,12,12,13,14,14,12,5,11,4,6,11,13,13,4,2,3,2,1,3,4,1,1,2,3
"7546",12038706,"Ramy Bensebaïni","4/16/1995 (28 years old)","D (LC), WB (L)","Borussia M'gladbach","Bundesliga","ALG","No","6/14/2021","6/30/2027","$22M - $33M","Left","Very Strong","Reasonable","6'2""","187 lbs","219","23",145,148,4,13,12,10,13,11,16,8,14,13,13,17,15,13,16,14,16,14,12,13,16,13,13,14,13,13,12,13,13,11,15,16,12,15,16,14,14,6,6,11,11,11,10,14,15,14,13,16,13,3,3,2,3,3,1,1,2,3,1,3
"7547",2000184286,"Mohamed Belloumi","6/1/2002 (21 years old)","AM (R)","Farense","Portuguese Premier League","ALG","No","2/27/2022","6/30/2026","$375K - $3.7M","Left","Very Strong","Reasonable","5'10""","145 lbs","29","3",122,145,10,11,15,13,14,9,8,13,6,6,12,11,9,14,13,12,12,13,9,10,14,16,6,13,6,12,13,13,14,14,14,7,12,14,11,6,12,12,10,13,14,11,4,12,9,6,11,14,14,2,1,1,2,1,1,1,1,2,1,1
"7548",85059211,"Andy Delort","10/9/1991 (31 years old)","ST (C)","FC Nantes","Ligue 1 Uber Eats","ALG","Yes","8/28/2021","6/30/2026","$700K - $5.4M","Right","Weak","Very Strong","5'11""","182 lbs","380","121",140,145,4,12,12,15,13,13,15,15,8,7,12,14,7,13,15,14,16,13,12,12,15,15,15,14,14,15,15,15,13,12,15,15,15,14,13,16,8,12,12,14,12,8,9,15,13,14,14,15,13,3,2,3,3,2,3,3,3,2,1,1
"7549",12038997,"Youcef Belaïli","3/14/1992 (31 years old)","M/AM (L)","AC Ajaccio","Ligue 2 BKT","ALG","No","10/12/2022","6/30/2025","$9.2M - $11M","Right","Reasonable","Very Strong","5'10""","165 lbs","196","59",135,145,11,13,15,13,15,12,8,14,4,7,14,12,7,15,13,14,11,12,12,13,10,12,10,13,11,12,13,12,14,14,12,9,12,14,13,11,12,9,11,11,13,10,9,14,10,12,12,12,12,2,3,2,3,1,3,1,2,2,1,1
"7550",13195823,"Youcef Atal","5/17/1996 (27 years old)","D/WB/M (R)","OGC Nice","Ligue 1 Uber Eats","ALG","No","6/15/2020","6/30/2024","$11M - $14M","Right","Fairly Strong","Very Strong","5'9""","141 lbs","151","16",134,144,8,12,15,11,13,7,6,12,8,10,12,8,12,15,16,12,14,11,10,10,15,16,8,14,12,13,12,15,16,14,11,6,13,15,14,10,15,12,13,15,13,14,14,14,13,11,14,14,12,2,2,1,2,1,4,1,2,3,1,3
"7551",5280525,"Cristian Riveros","10/16/1982 (40 years old)","DM, M (C)","Libertad","Paraguay First Division Primera División","PAR","No","1/18/2022","12/31/2024","$35K - $100K","Right","Reasonable","Very Strong","5'10""","169 lbs","605","59",111,142,8,8,8,12,13,8,14,8,8,14,13,12,13,9,14,15,15,13,13,12,12,8,14,8,14,15,10,14,9,10,14,12,13,8,11,12,13,10,15,15,14,14,7,15,13,4,13,10,6,1,2,3,1,3,1,3,1,1,1,3
"7552",28117411,"Yasser Larouci","1/1/2001 (22 years old)","D/WB/AM (L)","Troyes","Ligue 2 BKT","ALG","Yes","7/28/2021","6/30/2026","$190K - $1.9M","Left","Very Strong","Weak","5'9""","154 lbs","42","1",120,143,7,13,12,7,12,7,10,10,8,10,12,8,10,11,11,12,10,11,11,11,12,12,9,13,10,14,11,14,15,12,12,10,11,15,13,10,11,13,11,12,12,10,7,11,8,8,12,13,13,2,3,1,3,2,2,1,1,3,2,1
"7553",43153070,"Mohamed Fares","2/15/1996 (27 years old)","D/WB/M/AM (L)","Lazio","Italian Serie A","ALG","Yes","10/1/2020","6/30/2025","$130K - $1.3M","Left","Very Strong","Reasonable","6'0""","165 lbs","129","5",120,140,10,13,12,10,12,7,14,9,5,10,12,12,12,13,10,12,12,10,10,10,13,15,8,13,12,12,11,12,14,12,11,10,12,14,12,12,17,11,10,13,12,9,15,12,10,9,11,14,14,3,2,1,3,3,1,4,2,2,2,1
"7554",85031826,"Rachid Ghezzal","5/9/1992 (31 years old)","M/AM (RC)","Beşiktaş","Turkish Super League","ALG","Yes","8/11/2021","6/30/2024","$400K - $8.2M","Left","Very Strong","Weak","6'0""","143 lbs","227","29",125,140,15,16,14,12,16,12,6,14,2,3,16,15,5,17,12,14,10,14,14,16,12,16,8,13,6,14,17,12,12,13,10,8,10,10,10,10,13,14,14,12,12,14,16,13,10,12,10,14,12,1,2,1,2,2,2,1,2,1,3,4
"7555",8449112,"Ryad Boudebouz","2/19/1990 (33 years old)","M (C), AM (RC)","Al-Ahli (KSA)","Saudi Professional League","ALG","Yes","9/8/2022","6/30/2024","$0","Left","Very Strong","Fairly Strong","5'10""","163 lbs","444","61",125,140,17,15,15,12,16,16,7,14,6,3,14,18,4,15,8,12,10,14,10,12,13,16,6,14,6,11,15,7,12,13,12,9,14,12,12,11,12,12,12,10,10,10,6,13,8,13,10,16,14,2,1,1,3,2,1,4,2,1,1,3
"7556",12042506,"Baghdad Bounedjah","11/30/1991 (31 years old)","ST (C)","Al-Sadd","Qatar Stars League","ALG","No","2/12/2020","5/31/2024","$5.6M - $8.4M","Right","Weak","Very Strong","6'0""","167 lbs","233","183",130,140,5,8,12,14,14,8,14,13,6,6,11,16,6,14,14,14,14,15,11,13,12,12,11,13,7,12,13,13,13,13,14,13,13,14,14,14,8,8,9,12,11,7,8,12,7,12,11,14,11,2,3,4,3,3,2,1,3,3,2,4
"7557",2000069643,"Mohamed Amoura","5/9/2000 (23 years old)","AM (RL), ST (C)","Lugano","Swiss Super League","ALG","No","8/26/2021","6/30/2025","$425K - $4.3M","Right","Weak","Very Strong","5'7""","136 lbs","90","29",130,139,8,10,14,11,14,9,5,11,5,4,12,11,7,14,13,13,10,13,11,12,13,14,7,12,6,12,11,15,17,16,10,4,14,16,12,6,13,19,7,11,12,11,9,9,7,4,11,9,15,1,1,1,2,2,2,1,1,1,1,1
"7558",919764,"Carl Medjani","5/15/1985 (38 years old)","D (C), DM","Olympique Salaise Rhodia","French Regional 1 - Auvergne Rhône Alpes - Group B","ALG","Yes","2/7/2020","-","$0","Right","Weak","Very Strong","6'0""","169 lbs","386","18",95,138,4,7,7,6,9,4,14,7,7,12,12,7,12,11,12,12,18,12,12,11,16,7,14,6,13,14,10,10,7,6,12,12,14,9,7,14,12,11,10,14,13,13,6,14,14,12,14,16,8,3,3,1,3,1,2,2,3,3,2,1
"7559",37055855,"Ramiz Zerrouki","5/26/1998 (25 years old)","DM, M (C)","FC Twente","Eredivisie","ALG","Yes","6/15/2020","6/30/2025","$0","Right","Weak","Very Strong","6'0""","174 lbs","126","4",130,137,13,11,12,7,12,14,11,12,4,14,14,9,12,14,15,13,15,14,14,14,15,9,14,12,14,14,12,16,10,13,13,11,15,11,15,12,11,11,12,14,17,10,7,13,12,4,13,10,20,3,2,2,4,2,2,3,2,3,2,2
"7560",48034668,"Adam Ounas","11/11/1996 (26 years old)","AM (RLC), ST (C)","LOSC","Ligue 1 Uber Eats","ALG","Yes","9/1/2022","6/30/2024","$300K - $8.2M","Left","Very Strong","Reasonable","5'8""","143 lbs","150","18",129,137,11,12,16,12,14,7,5,11,4,4,13,10,4,15,8,11,8,12,11,10,12,16,8,13,5,10,12,11,16,14,10,6,14,15,11,7,13,10,11,10,11,9,13,13,10,10,11,14,11,3,1,3,1,2,3,2,2,2,1,2
"7561",28085752,"Nabil Bentaleb","11/24/1994 (28 years old)","DM, M (C)","Angers SCO","Ligue 2 BKT","ALG","Yes","1/6/2022","6/30/2025","$500K - $9.6M","Left","Very Strong","Fairly Strong","6'2""","171 lbs","190","17",131,136,9,11,13,10,14,10,8,13,9,12,14,17,13,15,14,13,15,13,11,11,12,13,12,12,12,12,13,14,12,12,15,14,14,11,14,12,8,8,12,11,13,8,11,13,13,15,11,14,14,3,3,1,3,3,3,1,1,1,2,1
"7562",79000983,"Gatito Fernández","3/29/1988 (35 years old)","GK","BOT","Brazilian National First Division","PAR","Yes","1/1/2023","12/31/2024","Not for Sale","Right Only","Weak","Very Strong","6'3""","176 lbs","317","-",128,141,1,2,3,2,8,7,4,3,2,3,7,2,3,10,15,13,14,12,15,15,14,10,12,1,14,12,7,15,10,11,10,16,9,10,9,12,8,12,10,13,14,12,17,19,12,8,16,12,15,11,13,14,12,14,11,16,14,13,13,12
"7563",8442537,"Foued Kadir","12/5/1983 (39 years old)","DM, M/AM (C)","FC Martigues","French National","ALG","Yes","9/21/2018","6/30/2024","$10K - $35K","Right","Weak","Very Strong","5'10""","160 lbs","426","60",95,136,11,10,12,11,12,12,8,12,7,5,12,12,8,12,8,12,10,12,11,11,12,12,13,12,8,12,12,11,10,11,11,9,12,11,11,10,10,15,14,12,11,12,13,13,8,7,12,14,19,1,3,3,3,3,2,2,2,1,3,3
"7564",12039221,"Sid Ahmed Aouedj","7/2/1991 (31 years old)","M (L), AM (LC), ST (C)","Al-Ansar","Saudi Second Division Group B","ALG","No","7/7/2022","6/30/2024","$750K - $1.6M","Left Only","Very Strong","Very Weak","5'9""","160 lbs","206","25",105,135,10,11,15,11,15,11,10,11,4,3,12,12,4,15,11,12,11,8,8,9,12,15,10,15,4,12,15,8,15,15,7,8,9,13,10,8,12,11,12,9,9,12,7,11,8,6,11,14,16,1,3,1,2,4,4,3,3,1,2,3
"7565",13232010,"Mohamed Tougai","1/22/2000 (23 years old)","D (C)","ES Tunis","Ligue Professionnelle 1","ALG","No","12/28/2019","6/30/2025","$325K - $3.4M","Right","Reasonable","Very Strong","6'3""","187 lbs","72","3",123,135,4,7,9,6,11,3,14,6,7,12,13,9,14,12,13,14,16,13,13,13,14,7,12,8,13,13,11,12,13,11,12,14,14,12,13,13,12,20,14,12,11,11,9,14,8,4,14,14,11,1,3,1,3,1,2,2,2,1,3,2
"7566",2000028670,"Abderrahim Deghmoum","12/2/1998 (24 years old)","M (RL), AM (RLC)","Al-Masry","Egyptian Premier League","ALG","No","8/25/2022","7/31/2025","$170K - $1.7M","Left Only","Very Strong","Weak","5'10""","132 lbs","82","7",115,135,9,12,14,9,12,8,12,12,12,7,11,5,9,12,13,10,11,11,13,13,10,13,4,12,7,13,12,14,14,12,11,13,5,16,13,8,14,13,10,11,10,10,13,3,12,5,12,14,20,3,2,1,3,2,2,2,3,3,2,3
"7567",12002680,"Hilal Soudani","11/25/1987 (35 years old)","AM (R), ST (C)","Maribor","Slovenian First League","ALG","No","6/12/2023","6/30/2025","Not for Sale","Left","Very Strong","Reasonable","6'0""","171 lbs","373","156",117,135,10,12,14,14,14,7,12,13,5,5,12,14,5,14,13,13,12,12,12,12,15,15,10,14,7,9,12,12,12,12,13,10,9,12,11,12,9,11,11,17,14,14,16,14,13,3,12,14,15,3,2,2,4,3,1,1,1,3,1,1
"7568",43252697,"Mehdi Léris","5/23/1998 (25 years old)","M/AM (RL)","Sampdoria","Italian Serie B","ALG","Yes","8/12/2019","6/30/2024","$1.1M - $2.3M","Right","Reasonable","Very Strong","6'1""","163 lbs","127","4",125,135,11,15,13,10,14,10,10,10,4,6,12,10,9,14,10,12,12,10,10,10,8,16,10,14,10,13,11,13,14,15,12,11,13,14,12,9,16,17,12,11,12,12,4,12,4,9,12,14,13,1,3,1,3,2,3,1,1,1,2,1
"7569",2000006105,"Jaouen Hadjam","3/26/2003 (20 years old)","D/WB (L)","FC Nantes","French National 3 - Group D","ALG","Yes","1/17/2023","6/30/2027","$6M - $11M","Left","Very Strong","Reasonable","6'0""","182 lbs","53","-",113,135,11,13,13,7,13,3,8,9,6,11,14,7,12,14,11,11,13,10,10,10,13,13,7,11,9,13,12,14,14,13,12,11,13,13,12,13,12,11,11,12,10,12,5,10,12,8,11,10,14,1,2,1,1,1,1,1,1,1,2,2
"7570",85077478,"Yassine Benzia","9/8/1994 (28 years old)","M/AM (C)","Qarabağ","Azeri Premier League","ALG","Yes","1/26/2023","6/30/2025","$200K - $2M","Right","Reasonable","Very Strong","5'10""","169 lbs","181","21",114,135,5,11,15,8,15,10,10,8,5,6,13,13,7,15,11,10,10,12,8,8,12,14,10,12,9,11,15,12,13,14,14,9,11,13,12,11,14,14,13,12,10,15,8,8,11,8,11,14,9,1,2,2,3,3,1,1,2,3,2,1
"7571",12043455,"Zinedine Ferhat","3/1/1993 (30 years old)","WB/M/AM (RL)","Alanyaspor","Turkish Super League","ALG","No","7/22/2022","6/30/2024","$0","Right","Reasonable","Very Strong","6'0""","169 lbs","306","29",115,134,14,14,13,10,12,13,7,7,8,7,14,12,8,14,10,13,12,14,12,12,13,13,10,13,7,13,14,12,12,12,13,10,12,12,12,12,12,10,10,13,10,9,6,11,8,8,12,13,11,2,2,4,3,3,3,4,3,2,1,2
"7572",2000107106,"Yannis Lagha","6/21/2004 (18 years old)","AM (RL), ST (C)","OL","Ligue 1 Uber Eats","ALG","Yes","6/13/2022","6/30/2025","$230K - $2.3M","Right Only","Weak","Very Strong","5'8""","136 lbs","-","-",88,134,7,12,8,12,11,7,13,8,4,5,13,11,6,12,5,12,7,11,5,8,11,9,8,12,7,7,8,12,14,12,8,8,13,13,7,7,10,12,2,11,11,11,10,6,10,7,18,11,17,1,2,2,3,4,1,1,3,2,2,1
"7573",2000017278,"Ramón Sosa","8/31/1999 (23 years old)","AM (RL)","Talleres","Argentine Premier Division","PAR","No","1/26/2023","12/31/2026","$750K - $7.6M","Right","Weak","Very Strong","5'10""","167 lbs","135","20",129,140,13,11,15,9,10,11,9,10,2,7,11,12,9,13,9,10,11,12,11,10,10,13,5,14,9,10,11,13,16,14,11,10,12,16,16,9,11,10,8,12,14,10,12,9,7,4,12,9,14,2,1,1,1,3,3,2,2,1,1,3
"7574",29188479,"Billal Brahimi","3/14/2000 (23 years old)","AM (RL), ST (C)","OGC Nice","Ligue 1 Uber Eats","ALG","Yes","1/28/2022","6/30/2026","$160K - $1.6M","Left","Very Strong","Reasonable","6'0""","165 lbs","80","15",122,133,9,11,14,11,13,10,9,14,6,6,12,7,5,13,8,10,11,10,10,10,16,14,8,11,10,10,13,11,14,13,13,11,13,15,13,12,11,14,16,15,14,12,6,12,7,6,13,14,13,3,1,2,3,2,2,3,1,2,3,4
"7575",13200891,"Hamza Mouali","1/16/1998 (25 years old)","D (L)","MC Alger","Algerian League 1","ALG","No","2/1/2023","6/30/2026","$4.5K - $45K","Left Only","Very Strong","Weak","5'10""","154 lbs","137","9",106,133,10,14,13,9,12,12,7,11,9,10,12,8,12,13,13,11,14,12,10,11,12,14,10,14,9,12,13,14,14,13,10,7,12,14,13,8,12,16,5,11,10,9,11,12,13,2,12,14,8,3,1,2,3,3,2,2,1,3,2,1
"7576",48044415,"Yanis Hamache","7/13/1999 (23 years old)","D/WB/M/AM (L)","Dnipro-1","Ukrainian Premier League","ALG","Yes","9/1/2022","6/30/2026","$375K - $3.7M","Left","Very Strong","Weak","5'10""","182 lbs","84","9",120,133,14,15,13,13,13,16,10,15,11,9,12,12,12,14,12,12,12,11,13,9,12,12,8,13,9,10,14,12,14,12,14,8,11,14,12,12,13,10,11,11,13,11,6,11,13,16,12,15,9,3,3,3,2,3,2,1,2,2,2,3
"7577",2000134657,"Imran Moussaoui","12/2/2004 (18 years old)","D (L)","OM","Ligue 1 Uber Eats","ALG","Yes","7/1/2020","6/30/2024","$180K - $550K","Left","Very Strong","Reasonable","5'6""","134 lbs","-","-",65,133,6,13,4,6,12,2,8,4,6,11,4,6,10,8,12,7,9,6,7,12,16,8,9,6,11,8,5,8,13,11,8,5,8,14,8,3,7,12,8,11,11,11,11,4,7,1,11,12,9,3,1,1,3,2,2,2,1,1,1,1
"7578",13176429,"Abderrahmane Meziane","3/7/1994 (29 years old)","M/AM (L)","USM Alger","Algerian League 1","ALG","No","8/25/2021","6/30/2025","$0","Right Only","Weak","Very Strong","5'6""","143 lbs","155","25",110,130,8,11,14,9,13,10,6,11,8,5,11,7,6,13,10,12,8,13,12,10,11,16,11,13,5,12,10,14,14,14,11,7,10,14,12,8,12,12,4,11,9,11,8,9,5,5,15,12,7,1,1,2,1,1,1,3,3,2,1,1
"7579",8635478,"Abdelmoumene Djabou","1/31/1987 (36 years old)","M (R), AM (RC)","ES Sétif","Algerian League 1","ALG","No","3/25/2021","6/30/2024","$0 - $30K","Left","Very Strong","Reasonable","5'5""","134 lbs","323","54",97,130,10,12,14,8,15,11,5,11,3,4,14,12,4,16,6,12,7,12,8,10,12,15,8,14,4,12,14,7,12,14,7,6,8,12,7,5,11,13,15,9,11,12,12,12,6,6,12,14,8,2,1,3,3,2,1,1,2,1,3,2
"7580",12093921,"Zineddine Belaïd","3/20/1999 (24 years old)","D (C)","USM Alger","Algerian League 1","ALG","No","7/1/2020","6/30/2026","$95K - $275K","Right Only","Weak","Very Strong","6'2""","176 lbs","107","8",115,130,5,6,7,8,10,5,13,6,6,12,12,12,14,11,13,12,14,11,12,12,4,7,12,6,13,13,11,14,12,11,13,15,14,13,13,13,9,12,9,12,12,12,7,13,12,7,13,9,11,1,3,1,3,2,2,3,3,1,3,3
"7581",8430841,"Raïs M'Bolhi","4/25/1986 (37 years old)","GK","Al-Qadsiah","Saudi First Division League","ALG","Yes","9/9/2022","6/30/2023","$10K - $30K","Right Only","Weak","Very Strong","6'3""","182 lbs","272","-",108,130,2,2,2,3,8,2,5,3,3,2,7,2,1,6,10,12,14,14,13,10,5,1,10,3,10,12,8,10,11,14,13,16,16,10,9,14,1,7,11,14,10,8,5,15,11,8,14,15,7,9,12,15,18,12,12,9,10,12,12,11
"7582",12038241,"Farouk Chafaï","6/23/1990 (32 years old)","D (C)","Damac","Saudi Professional League","ALG","No","2/13/2023","6/30/2025","Not for Sale","Right Only","Weak","Very Strong","6'0""","167 lbs","294","31",115,130,4,6,6,4,9,7,15,8,11,14,9,7,15,11,16,15,16,11,11,12,6,11,11,9,11,12,9,15,10,10,13,14,12,11,13,13,7,17,12,10,10,13,8,12,11,1,13,10,15,3,1,1,3,3,2,1,3,3,3,2
"7583",12041559,"Raouf Benguit","4/4/1996 (27 years old)","M/AM (C)","Raja Casablanca","Botola Pro 1","ALG","No","8/2/2022","6/30/2025","$0","Right","Weak","Very Strong","5'7""","127 lbs","130","9",113,130,12,11,12,10,15,10,7,10,5,9,14,11,11,14,13,12,12,13,12,12,13,15,10,13,11,13,14,12,14,13,11,6,11,12,11,6,12,8,3,11,9,8,5,12,16,7,10,11,10,1,1,3,1,1,3,2,4,1,1,3
"7584",79024232,"Miguel Almirón","2/10/1994 (29 years old)","M (RL), AM (RLC)","Newcastle","English Premier Division","PAR","No","2/24/2023","6/30/2026","$83M - $125M","Left Only","Very Strong","Weak","5'9""","154 lbs","279","50",147,158,10,11,14,13,12,10,6,10,4,8,13,11,12,12,7,14,13,12,12,12,12,13,6,15,12,15,13,20,16,16,12,6,15,17,15,10,14,12,13,14,8,12,11,13,9,8,14,10,14,3,2,2,3,1,1,1,3,2,3,3
"7585",79012588,"Ángel Romero","7/4/1992 (30 years old)","M/AM (RL), ST (C)","COR","Brazilian National First Division","PAR","No","12/15/2022","12/31/2024","$550K - $5.2M","Right","Reasonable","Very Strong","5'9""","154 lbs","276","63",125,140,7,10,12,12,12,14,12,10,7,7,12,10,8,14,15,13,13,12,11,11,13,15,12,14,10,12,13,12,13,14,11,10,14,13,14,11,11,11,7,17,12,12,9,14,13,15,11,12,13,1,4,2,3,3,3,3,1,3,3,4
"7586",49048899,"Mehdi Dorval","2/9/2001 (22 years old)","D (RL), WB/M (L)","Bari","Italian Serie B","ALG","Yes","7/2/2022","6/30/2026","$150K - $1.5M","Right","Strong","Very Strong","5'9""","165 lbs","67","1",116,130,6,14,13,7,11,8,11,9,12,11,12,8,10,11,9,10,10,9,10,11,8,7,7,13,11,13,12,12,13,12,14,11,13,13,13,10,12,12,11,10,10,10,10,11,8,5,9,12,16,2,3,1,1,3,1,1,4,2,2,2
"7587",13158264,"Patson Daka","10/9/1998 (24 years old)","ST (C)","Leicester","Sky Bet Championship","ZAM","No","7/1/2021","6/30/2026","$17M - $25M","Right","Reasonable","Very Strong","6'0""","158 lbs","162","69",128,165,6,8,10,15,13,7,10,11,6,8,10,9,8,12,5,12,13,13,13,10,16,11,9,11,11,13,12,14,16,14,13,12,13,16,12,11,6,15,12,13,11,12,6,11,5,6,11,14,13,2,3,2,2,1,2,3,1,1,3,2
"7588",13205265,"Lameck Banda","1/29/2001 (22 years old)","AM (RL)","Salento","Italian Serie A","ZAM","No","8/4/2022","6/30/2026","$5M - $9.4M","Right","Reasonable","Very Strong","5'7""","152 lbs","104","12",128,144,8,12,16,10,15,9,7,7,7,7,9,11,7,14,13,10,11,9,9,9,13,12,8,13,8,10,10,10,16,16,12,9,12,16,12,9,7,12,14,13,12,12,5,11,5,5,11,13,12,3,1,2,2,1,2,1,3,3,2,2
"7589",13191598,"Edward Chilufya","9/17/1999 (23 years old)","AM (RL), ST (C)","FC Midtjylland","3F Superliga","ZAM","No","1/30/2022","12/31/2026","$275K - $2.7M","Right Only","Weak","Very Strong","5'7""","143 lbs","101","15",118,140,6,11,14,12,12,5,10,11,7,5,11,9,4,14,11,9,11,9,9,10,15,15,6,11,6,12,8,13,17,14,12,8,12,16,10,9,9,14,14,15,12,15,12,10,8,6,10,12,12,1,1,3,1,4,2,1,3,3,2,1
"7590",58135578,"Fashion Sakala","3/14/1997 (26 years old)","AM (RL), ST (C)","Rangers","cinch Premiership","ZAM","No","7/1/2021","5/31/2026","$650K - $11M","Right Only","Weak","Very Strong","5'10""","163 lbs","188","60",125,135,9,8,14,12,14,10,12,9,5,5,10,12,6,13,12,11,11,9,8,9,14,15,6,12,6,11,8,12,16,15,14,9,17,16,14,10,14,19,18,20,11,8,6,13,2,5,13,10,17,3,2,4,1,2,3,2,3,1,1,3
"7591",2000239001,"Aaron Simpasa","11/22/2006 (16 years old)","D/WB/AM (R)","Kafue Celtic","Zambian Lower Division","ZAM","No","11/22/2021","6/30/2026","$6K - $16K","Right","Fairly Strong","Very Strong","5'1""","125 lbs","-","-",82,134,4,9,11,6,8,8,4,7,1,7,8,2,9,9,10,11,10,6,6,6,14,13,6,9,8,13,9,13,12,13,8,3,10,11,13,7,18,19,10,12,12,9,5,16,15,3,14,14,8,1,1,3,1,3,1,2,3,3,3,3
"7592",13203374,"Kings Kangwa","4/6/1999 (24 years old)","DM, M/AM (C)","Crvena zvezda","Serbian SuperLeague","ZAM","No","6/5/2022","6/30/2026","$400K - $4.1M","Right","Weak","Very Strong","5'6""","141 lbs","80","13",122,132,12,12,14,9,13,14,7,13,7,10,14,12,12,13,12,12,11,13,12,13,16,12,7,10,10,12,13,13,15,14,13,6,12,14,14,8,13,10,11,10,9,9,12,13,12,1,13,9,13,1,1,1,2,1,3,2,2,4,1,1
"7593",2000164083,"Joseph Banda","12/17/2005 (17 years old)","AM (RL)","Atletico Lusaka","Zambian First Division","ZAM","No","6/13/2022","6/30/2024","$1K - $8K","Right","Reasonable","Very Strong","5'6""","127 lbs","7","-",83,131,11,8,13,12,13,12,5,12,1,5,10,14,2,12,11,8,8,8,8,6,12,16,3,10,3,7,11,12,13,14,14,4,10,12,7,10,16,4,11,11,9,13,5,8,5,5,13,12,15,3,1,1,2,3,2,3,2,3,2,1
"7594",89061857,"Justin Shonga","11/5/1996 (26 years old)","ST (C)","Nkwazi","Zambian Premier League","ZAM","No","9/1/2022","6/30/2025","$0","Right","Reasonable","Very Strong","5'10""","143 lbs","108","23",96,130,3,6,11,13,12,12,9,10,5,7,8,11,5,12,8,11,5,13,11,12,14,11,7,12,5,13,13,11,14,11,13,5,13,12,11,9,9,12,11,7,14,6,10,13,6,12,14,12,12,3,1,1,3,1,3,4,2,1,2,2
"7595",85029659,"Stoppila Sunzu","6/22/1989 (33 years old)","D (C)","JN Xingzhou","Chinese National First Division","ZAM","No","4/18/2023","12/31/2023","$16K - $160K","Right","Weak","Very Strong","6'3""","200 lbs","214","16",120,128,4,7,8,7,11,5,15,8,11,14,9,6,14,11,15,13,16,10,11,10,14,8,13,8,11,12,8,13,12,11,14,15,15,12,8,16,10,13,11,12,10,12,7,13,15,8,15,14,14,2,2,2,1,2,3,2,2,2,1,1
"7596",67181404,"Antonio Sanabria","3/4/1996 (27 years old)","ST (C)","Torino","Italian Serie A","PAR","Yes","1/31/2021","6/30/2025","$6.6M - $10M","Right","Reasonable","Very Strong","5'11""","167 lbs","229","63",136,140,5,9,12,15,15,11,16,11,4,5,12,13,6,14,13,13,12,12,11,12,13,14,9,15,5,13,12,11,15,15,13,13,13,13,12,12,11,12,13,14,11,12,10,8,9,8,12,13,11,1,1,1,2,3,2,3,2,1,2,2
"7597",2000221981,"Rickson Ngambi","12/20/2004 (18 years old)","ST (C)","FC Muza","Zambian Premier League","ZAM","No","7/1/2022","6/30/2025","$12K - $35K","Left Only","Very Strong","Very Weak","5'7""","134 lbs","-","-",82,125,7,6,14,14,9,12,7,10,5,3,11,8,7,12,5,12,4,11,5,11,14,9,9,13,6,8,8,12,14,14,14,5,12,14,14,3,8,13,11,11,11,11,5,1,7,1,9,11,7,1,2,2,2,2,2,2,1,3,1,3
"7598",2000050385,"Golden Mafwenta","1/15/2001 (22 years old)","D (C), DM, M (C)","Vyškov","Czech Second Division","ZAM","No","8/20/2021","6/30/2024","$240K - $750K","Right Only","Weak","Very Strong","5'10""","165 lbs","29","2",88,124,3,7,7,5,8,5,8,5,6,13,12,4,12,8,12,13,12,11,13,9,8,6,9,5,12,13,11,14,12,12,11,10,15,13,13,11,14,16,11,11,13,10,11,8,6,6,14,9,7,3,1,1,3,1,3,2,2,3,2,2
"7599",2000030300,"Francisco Mwepu","2/29/2000 (23 years old)","AM (C), ST (C)","Cádiz B","Spanish Federation Second Group 4","ZAM","No","6/30/2022","6/30/2025","$28K - $275K","Right","Reasonable","Very Strong","5'10""","154 lbs","45","8",102,124,5,5,10,11,11,6,7,10,5,6,9,6,7,12,6,9,11,12,9,10,6,6,6,15,7,12,9,12,15,12,11,11,13,14,12,14,3,11,10,12,11,12,11,12,5,6,10,12,14,2,1,4,3,2,2,2,1,2,1,3
"7600",2000146429,"Miguel Chaiwa","4/7/2004 (19 years old)","D (R), DM, M/AM (C)","Young Boys","Swiss Promotion League","ZAM","No","6/13/2022","6/30/2027","$1.5M - $3.2M","Right Only","Weak","Very Strong","5'10""","160 lbs","17","-",108,123,6,7,12,6,13,5,8,6,7,11,13,9,12,13,10,13,10,13,12,10,11,10,7,11,12,13,13,14,12,13,10,10,13,12,14,8,14,14,13,11,11,15,5,14,8,6,12,10,10,3,2,3,2,2,2,2,1,3,2,2
"7601",2000108261,"Mannah Chiwisa","12/12/2003 (19 years old)","DM, M (C)","Atalanta","Italian Serie C/A","ZAM","No","2/23/2023","6/30/2026","$500K - $1.5M","Left Only","Very Strong","Weak","5'10""","165 lbs","21","-",91,123,6,7,10,7,10,8,10,9,9,10,11,9,11,9,9,12,9,12,11,11,11,5,10,9,13,13,10,12,10,11,12,11,15,11,13,12,10,13,10,13,11,10,4,11,5,3,13,12,13,1,3,1,3,3,3,1,1,4,3,2
"7602",5690915,"James Chamanga","2/2/1980 (43 years old)","AM (L), ST (C)","Red Arrows","Zambian Premier League","ZAM","No","1/1/2019","6/30/2024","$0 - $2K","Right","Reasonable","Very Strong","6'1""","176 lbs","413","150",95,122,3,9,11,12,12,6,8,7,5,3,8,12,5,12,12,12,13,12,5,12,15,4,8,14,8,11,13,14,10,12,12,9,20,11,12,12,11,8,13,20,12,15,8,11,6,7,19,10,15,1,1,2,3,1,2,2,2,2,4,2
"7603",2000165890,"Kingstone Mutandwa","1/5/2003 (20 years old)","ST (C)","Atletico Lusaka","Zambian First Division","ZAM","No","8/1/2021","6/30/2024","$0","Right","Reasonable","Very Strong","5'11""","171 lbs","22","15",80,120,5,5,8,12,10,5,11,9,4,5,9,8,6,10,13,10,15,12,10,11,13,14,5,9,7,11,8,12,11,8,12,11,11,12,10,11,11,19,10,11,13,12,6,11,6,6,18,17,11,3,1,1,2,2,1,2,2,3,2,2
"7604",13138875,"Clatous Chama","6/18/1991 (31 years old)","AM (LC), ST (C)","Simba","Tanzanian Mainland Premier Division","ZAM","No","1/14/2022","6/30/2024","$22K - $230K","Right Only","Weak","Very Strong","5'8""","154 lbs","229","37",115,120,12,14,14,9,11,12,6,12,3,5,13,11,5,15,10,10,9,15,13,13,15,14,8,13,9,11,14,12,13,13,12,11,15,12,13,11,15,11,11,13,9,10,7,12,12,8,11,9,20,1,2,3,3,3,2,1,3,2,3,3
"7605",2000227231,"Amon Chulu","5/1/2005 (18 years old)","D/WB (L)","Nkana","Zambian Premier League","ZAM","No","6/13/2022","6/30/2024","$2K - $18K","Left","Very Strong","Reasonable","5'6""","152 lbs","-","-",81,120,8,12,7,6,12,4,9,1,9,11,11,9,14,11,13,9,10,10,11,10,13,5,2,7,8,10,10,10,11,15,12,7,12,11,9,3,12,13,10,9,11,13,5,9,6,1,9,10,8,2,3,1,1,1,2,3,2,1,3,1
"7606",59092467,"Lubambo Musonda","3/1/1995 (28 years old)","D (R), WB (RL), M (R)","AC Horsens","NordicBet Liga","ZAM","No","8/17/2021","6/30/2024","$60K - $600K","Right","Fairly Strong","Very Strong","5'7""","152 lbs","226","25",113,120,9,11,14,8,13,8,8,11,7,8,11,11,9,14,12,10,11,9,11,11,13,11,7,11,10,11,8,13,13,12,11,6,14,14,14,7,15,13,14,13,15,7,5,13,8,5,9,11,13,1,3,3,1,4,3,1,2,2,3,3
"7607",19184434,"Carlos Coronel","12/29/1996 (26 years old)","GK","New York","Major League Soccer","PAR","No","12/16/2021","12/31/2024","$14K - $7.2M","Right","Reasonable","Very Strong","6'4""","194 lbs","166","-",126,140,3,3,7,1,10,4,4,13,15,3,12,5,3,9,11,10,14,10,12,9,12,3,10,1,14,14,9,13,11,13,16,18,14,12,13,16,1,12,12,12,11,10,6,10,6,6,9,9,15,16,12,14,11,10,14,13,4,11,13,15
"7608",59028017,"Chisamba Lungu","1/31/1991 (32 years old)","M (LC), AM (RL)","Atletico Lusaka","Zambian First Division","ZAM","No","6/12/2023","6/30/2024","$4K - $12K","Right","Weak","Very Strong","5'10""","149 lbs","230","9",84,120,11,10,13,8,13,8,7,9,6,5,12,12,7,14,9,9,9,12,12,10,2,13,5,10,6,7,13,8,10,13,13,6,10,10,8,7,13,16,9,11,11,10,13,10,5,6,14,11,20,1,1,2,4,3,1,3,3,1,1,2
"7609",83137947,"Moses Phiri","6/3/1993 (30 years old)","AM (RL)","Simba","Tanzanian Mainland Premier Division","ZAM","No","6/15/2022","6/30/2024","$14K - $130K","Right Only","Very Weak","Very Strong","5'7""","163 lbs","179","57",104,120,11,12,13,13,11,9,12,12,6,9,12,12,8,11,11,8,10,11,8,9,14,12,6,12,7,8,12,11,14,14,11,12,14,14,13,8,12,11,13,10,7,7,10,10,8,13,12,11,12,4,3,1,1,1,1,3,2,1,3,1
"7610",13116654,"Evans Kangwa","10/9/1992 (30 years old)","AM (RLC), ST (C)","QD Hainiu","Chinese Super League","ZAM","No","2/23/2023","12/31/2024","$240K - $2.4M","Right","Reasonable","Very Strong","5'9""","154 lbs","211","39",107,119,9,8,11,11,11,9,7,11,6,4,10,13,8,11,12,10,10,11,9,9,12,12,8,10,7,9,7,10,15,14,11,8,13,15,12,8,12,11,13,11,11,11,8,11,7,6,12,9,10,3,3,2,1,3,3,3,1,4,1,3
"7611",83191692,"Emmanuel Banda","9/29/1997 (25 years old)","M/AM (C)","Rijeka","Croatian First League","ZAM","No","1/3/2023","6/30/2025","$140K - $1.4M","Left Only","Very Strong","Weak","5'10""","160 lbs","128","16",112,119,12,12,13,13,14,12,10,14,5,6,13,11,7,14,12,12,11,14,14,13,13,13,7,13,7,14,13,13,13,13,11,9,13,13,12,10,10,13,14,13,12,7,3,13,8,13,11,14,13,1,1,1,2,1,3,1,2,2,2,1
"7612",13117841,"Nathan Sinkala","11/22/1990 (32 years old)","DM, M (C)","Zesco United","Zambian Premier League","ZAM","No","7/1/2022","6/30/2024","$8K - $24K","Right","Fairly Strong","Very Strong","5'11""","158 lbs","207","16",97,118,5,4,10,7,12,6,11,6,8,11,12,11,13,13,13,12,14,12,10,11,4,9,6,10,12,13,10,12,11,11,13,10,14,10,11,9,1,20,14,15,15,12,7,15,13,5,12,8,12,1,1,3,3,1,2,4,1,4,3,1
"7613",2000037834,"John Chishimba","7/19/2002 (20 years old)","D/WB (L)","Zesco United","Zambian Premier League","ZAM","No","1/10/2023","6/30/2026","$0 - $60K","Left","Very Strong","Reasonable","6'2""","171 lbs","12","1",90,117,12,11,11,5,10,10,9,6,8,8,10,6,10,10,6,7,10,9,7,11,4,9,10,12,8,12,11,9,14,11,4,14,15,11,10,8,12,15,12,10,10,9,5,2,11,6,10,12,9,2,2,3,3,3,3,2,3,3,1,2
"7614",20035023,"Benson Sakala","9/12/1996 (26 years old)","DM, M (C)","Příbram","Czech Second Division","ZAM","No","7/29/2022","6/30/2024","$0","Right Only","Weak","Very Strong","5'11""","167 lbs","27","1",100,117,8,10,11,7,11,6,10,9,6,11,13,7,9,11,11,13,12,11,12,12,14,7,14,12,12,15,12,13,13,11,12,11,13,12,14,12,16,14,10,16,9,11,7,12,10,4,13,12,20,3,1,2,2,4,1,3,2,3,3,4
"7615",215675,"Spencer Sautu","10/5/1994 (28 years old)","AM (RL)","Green Eagles","Zambian Premier League","ZAM","No","6/30/2022","6/30/2024","$1.5K - $14K","Right","Weak","Very Strong","5'3""","127 lbs","4","2",90,116,8,12,13,10,12,5,6,12,3,5,13,11,6,14,7,7,12,9,10,8,13,12,6,12,10,11,14,11,13,13,10,6,7,13,10,5,11,10,11,13,9,9,10,11,6,3,10,10,17,3,3,2,3,3,3,3,2,1,1,1
"7616",13173883,"Lawrence Mulenga","8/21/1998 (24 years old)","GK","Power Dynamos","Zambian Premier League","ZAM","No","6/15/2020","6/30/2025","$2.5K - $26K","Left Only","Very Strong","Weak","6'3""","176 lbs","-","-",104,116,4,2,1,2,9,8,1,2,1,2,8,1,1,7,7,11,15,7,13,13,14,1,5,1,11,8,7,7,11,16,6,15,10,10,7,6,11,19,13,11,12,12,6,17,13,5,14,14,8,10,8,13,8,12,9,12,5,7,9,13
"7617",2000051208,"Frederick Mulambia","7/10/2002 (20 years old)","M/AM (RC)","Power Dynamos","Zambian Premier League","ZAM","No","7/1/2020","12/1/2023","$0 - $45K","Right","Reasonable","Very Strong","5'9""","156 lbs","-","-",97,116,9,9,15,11,15,9,9,13,9,10,15,5,11,15,9,7,8,10,5,10,17,13,6,15,10,10,9,13,14,9,8,9,8,11,9,7,14,10,11,13,12,11,7,9,11,7,10,9,12,2,1,2,1,2,3,3,1,1,2,2
"7618",115460,"Paulo da Silva","2/1/1980 (43 years old)","D (C)","Independiente (PAR)","Paraguay Second Division Intermedia","PAR","No","1/1/2023","12/31/2023","$0 - $8K","Right","Reasonable","Very Strong","5'11""","167 lbs","678","40",91,140,7,7,8,6,10,7,12,9,9,12,11,8,12,9,10,12,13,9,11,11,10,6,16,5,12,12,8,9,8,8,14,12,7,7,11,13,7,13,13,10,10,8,13,10,11,4,11,7,7,2,2,3,3,3,2,2,1,2,2,2
"7619",2000084002,"Joshua Mutale","1/24/2002 (21 years old)","M (L), AM (RLC)","Power Dynamos","Zambian Premier League","ZAM","No","7/1/2020","11/1/2025","$0 - $50K","Right","Reasonable","Very Strong","5'3""","143 lbs","-","-",92,116,11,9,12,10,13,11,5,10,5,6,9,8,3,12,9,11,6,9,10,10,6,13,7,13,7,12,11,14,13,13,12,6,14,12,10,5,14,13,11,12,15,8,7,13,4,7,14,12,19,1,2,1,3,2,3,1,3,2,1,1
"7620",2000221834,"James Kalimina","8/30/2005 (17 years old)","ST (C)","Green Buffaloes","Zambian Premier League","ZAM","No","7/1/2022","6/30/2024","$0 - $45K","Right","Reasonable","Very Strong","5'9""","143 lbs","-","-",68,116,5,5,13,13,13,5,11,6,2,4,6,5,2,12,9,8,7,10,6,8,13,12,7,7,5,5,6,6,13,12,6,4,9,11,7,6,7,14,9,12,9,8,13,8,13,1,7,11,12,3,3,2,3,2,1,2,1,3,1,1
"7621",2000238999,"Emmanuel Mwanza","12/25/2006 (16 years old)","AM (RL), ST (C)","Kafue Celtic","Zambian Lower Division","ZAM","No","6/13/2022","6/30/2026","$500 - $6K","Right Only","Weak","Very Strong","5'5""","141 lbs","-","-",80,116,9,9,9,10,10,8,11,11,5,7,8,8,5,11,12,10,11,8,7,8,14,15,4,9,6,7,9,13,13,13,12,8,10,12,10,8,9,12,9,10,12,13,12,17,13,7,10,13,9,2,2,2,3,2,2,3,1,1,4,3
"7622",13148065,"Saith Sakala","7/17/1996 (26 years old)","AM (R), ST (C)","Al-Lewa","Saudi Second Division Group A","ZAM","No","1/28/2022","6/30/2024","$425K - $1.3M","Right Only","Weak","Very Strong","5'10""","154 lbs","133","21",95,115,8,10,14,11,14,8,11,10,3,8,10,6,8,9,12,13,9,11,8,13,10,8,7,14,8,8,7,10,12,11,9,8,15,13,14,8,12,15,13,13,12,10,11,5,6,2,19,11,12,3,2,2,1,2,3,1,1,2,2,1
"7623",13229166,"Kelvin Kampamba","11/24/1996 (26 years old)","M (R), AM (RLC)","Zesco United","Zambian Premier League","ZAM","No","9/8/2020","6/30/2024","$0 - $110K","Right","Weak","Very Strong","5'7""","158 lbs","51","15",108,115,12,13,14,12,13,13,5,12,15,6,13,13,3,13,5,12,12,12,10,12,14,15,10,12,7,12,15,7,13,13,13,5,17,12,11,6,15,4,6,15,16,10,3,13,3,15,14,14,13,1,1,1,4,2,1,3,3,2,1,3
"7624",2000074629,"Songa Chipyoka","9/28/2004 (18 years old)","M/AM (RL)","Zesco United","Zambian Premier League","ZAM","No","6/20/2022","6/30/2026","$12K - $35K","Right Only","Weak","Very Strong","5'7""","125 lbs","18","1",84,115,11,10,12,8,12,12,4,10,3,3,12,9,3,10,7,10,6,10,10,8,18,13,5,10,7,11,12,8,14,15,13,3,10,14,7,2,14,16,15,10,11,7,10,5,3,4,10,15,15,2,3,2,2,1,2,1,2,3,2,3
"7625",65039954,"Augustine Mulenga","1/17/1990 (33 years old)","AM (RC), ST (C)","NAPSA Stars","Zambian Premier League","ZAM","No","10/8/2022","6/30/2024","$0","Right","Fairly Strong","Very Strong","5'9""","152 lbs","102","18",100,115,7,7,12,8,13,11,5,13,5,5,10,10,7,11,12,7,8,8,8,13,1,9,12,10,7,8,9,8,16,12,9,5,11,13,8,7,11,11,11,14,13,11,9,4,13,1,6,13,15,3,2,2,1,2,1,1,1,1,2,3
"7626",13210149,"Ghampani Lungu","9/19/1998 (24 years old)","AM (LC), ST (C)","SuperSport Utd","South African Premier Soccer League","ZAM","No","8/8/2018","6/30/2024","$35K - $110K","Either","Very Strong","Very Strong","5'10""","165 lbs","113","15",108,115,7,11,13,13,9,7,9,8,7,5,13,7,8,10,9,11,4,12,8,10,3,12,8,12,8,8,8,9,13,13,8,8,15,13,13,12,13,19,12,11,11,15,10,16,14,3,12,11,14,3,2,4,2,3,4,2,1,2,1,2
"7627",13147182,"Rodrick Kabwe","11/30/1992 (30 years old)","WB (L), DM, M/AM (LC)","Sekhukhune Utd","South African Premier Soccer League","ZAM","No","7/1/2021","6/30/2024","$0 - $95K","Left","Very Strong","Fairly Strong","5'9""","152 lbs","122","16",100,115,8,10,11,6,12,14,8,11,8,10,10,7,8,11,6,9,10,11,11,9,12,6,15,10,11,11,9,11,13,7,7,9,13,12,12,10,9,17,10,12,11,10,8,7,7,8,10,12,12,1,3,1,1,3,1,1,3,1,2,4
"7628",93013461,"Rodgers Kola","6/4/1989 (34 years old)","AM (R), ST (C)","Azam FC","Tanzanian Mainland Premier Division","ZAM","No","7/19/2021","6/30/2024","$20K - $60K","Right","Reasonable","Very Strong","6'2""","171 lbs","258","72",95,115,6,11,12,12,10,6,12,8,1,2,11,9,7,11,11,9,9,7,9,9,8,13,8,11,3,11,8,9,13,11,12,13,13,11,12,10,12,4,10,10,11,6,10,12,6,4,12,9,8,2,2,2,3,3,3,1,1,3,2,3
"7629",8836015,"Víctor Ayala","1/1/1988 (35 years old)","DM, M (C)","Tacuary","Paraguay First Division Primera División","PAR","No","1/1/2023","12/31/2023","$1.5K - $14K","Right","Weak","Very Strong","5'9""","185 lbs","384","37",105,140,15,15,11,8,12,14,7,14,8,11,12,11,11,13,14,12,13,12,12,12,13,12,11,11,10,12,12,15,12,11,14,8,7,10,11,12,15,7,8,9,9,13,13,11,13,5,8,9,13,3,3,3,2,2,3,3,3,1,2,1
"7630",13202551,"Isaac Shamujompa","10/12/1994 (28 years old)","D (C)","Zanaco","Zambian Premier League","ZAM","No","8/22/2021","6/30/2024","$1.5K - $14K","Right Only","Very Weak","Very Strong","6'2""","185 lbs","93","7",91,115,3,5,4,6,9,5,13,4,4,12,11,12,12,5,13,12,14,8,11,11,15,6,14,5,12,6,4,10,10,7,13,12,14,10,12,13,17,16,12,9,10,10,11,10,15,8,12,11,12,3,1,2,1,3,3,1,3,1,1,1
"7631",2000073503,"George Nyimbili","12/27/2001 (21 years old)","ST (C)","Jumulo","Zambian First Division","ZAM","No","2/1/2021","6/30/2024","$1K - $8K","Right","Reasonable","Very Strong","5'9""","134 lbs","1","-",79,114,6,7,12,13,12,6,12,5,3,4,7,7,1,13,9,6,6,10,7,11,14,15,11,13,7,6,6,7,13,13,7,5,15,13,6,8,11,17,12,11,12,12,13,7,7,5,13,10,14,2,1,2,3,2,1,2,3,2,3,1
"7632",2000157163,"Christopher Muhango","10/3/2000 (22 years old)","D (C)","Zanaco","Zambian Premier League","ZAM","No","7/1/2020","6/30/2024","$1.5K - $16K","Right","Reasonable","Very Strong","6'1""","171 lbs","16","2",88,113,3,4,3,7,8,5,10,7,2,14,8,4,14,6,6,12,9,8,7,14,3,5,14,7,14,4,6,8,9,12,8,10,10,12,9,8,15,12,10,10,14,14,8,5,11,7,14,9,8,3,2,4,3,1,3,1,2,2,2,1
"7633",2000239017,"Samson Ngulube","12/1/2005 (17 years old)","D (L)","Kafue Celtic","Zambian Lower Division","ZAM","No","6/13/2022","6/30/2024","$5K - $14K","Left Only","Very Strong","Weak","5'8""","145 lbs","-","-",75,113,9,9,9,6,13,10,10,1,9,8,10,5,11,11,7,11,10,11,9,13,8,8,3,9,9,14,8,13,11,10,10,4,17,10,14,6,10,7,12,8,11,9,5,11,8,3,15,12,12,1,2,3,3,1,1,2,3,1,3,1
"7634",13137409,"Fackson Kapumbu","10/6/1990 (32 years old)","D/WB (L)","Red Arrows","Zambian Premier League","ZAM","No","3/1/2023","6/30/2024","$5K - $14K","Left Only","Very Strong","Very Weak","5'10""","158 lbs","37","1",89,112,10,12,4,4,11,11,7,7,12,12,11,10,12,5,8,11,12,10,11,11,14,8,12,13,12,10,10,10,12,12,11,7,11,13,11,9,3,10,10,9,14,11,5,12,8,7,13,10,14,1,2,1,2,3,2,2,3,3,2,1
"7635",13147179,"Toaster Nsabata","11/24/1993 (29 years old)","GK","Sekhukhune Utd","South African Premier Soccer League","ZAM","No","8/3/2021","6/30/2024","$4.5K - $45K","Right","Reasonable","Very Strong","6'0""","165 lbs","77","-",102,112,4,2,3,1,3,8,1,2,3,2,10,3,2,6,12,11,13,9,7,11,14,1,7,2,10,9,8,6,11,14,9,6,11,12,8,7,12,12,13,12,11,14,9,1,12,2,20,12,10,10,6,14,6,10,13,14,5,10,9,11
"7636",2000032258,"Martin Njobvu","11/26/2001 (21 years old)","ST (C)","Green Buffaloes","Zambian Premier League","ZAM","No","9/1/2021","6/30/2024","$0 - $50K","Right","Reasonable","Very Strong","5'11""","167 lbs","-","-",86,111,7,5,14,14,12,7,11,8,4,5,5,4,3,12,7,13,8,9,3,11,19,11,5,13,6,7,3,8,13,11,8,7,7,11,13,10,10,12,10,12,10,11,10,14,7,6,12,9,10,3,2,3,3,3,1,4,1,2,2,2
"7637",2000166830,"Elliot Kampukesa","7/30/2003 (19 years old)","M/AM (L), ST (C)","Nchanga Rangers","Zambian First Division","ZAM","No","7/1/2020","6/30/2025","$0 - $40K","Left","Very Strong","Fairly Strong","5'10""","147 lbs","-","-",78,111,6,11,10,11,13,6,8,6,4,5,10,3,7,11,8,7,6,6,3,9,3,11,4,11,5,7,7,8,13,13,6,8,8,13,4,6,11,14,12,13,11,12,12,17,12,8,9,11,11,2,3,3,3,1,1,3,1,1,1,1
"7638",2000248916,"Mathews Chabala","2/1/2002 (21 years old)","D (C)","Nchanga Rangers","Zambian First Division","ZAM","No","7/1/2021","6/30/2026","$0","Right","Reasonable","Very Strong","5'11""","163 lbs","-","-",87,110,3,6,3,8,10,2,15,3,7,9,10,6,14,7,13,7,10,6,8,15,12,5,13,8,12,8,7,10,11,12,9,7,10,12,6,9,13,20,9,8,10,9,14,2,10,5,9,9,15,3,1,1,2,1,3,1,3,2,1,2
"7639",29219123,"Chanka Zimba","12/29/2001 (21 years old)","ST (C)","Cardiff","Sky Bet Championship","ZAM","No","8/24/2021","6/30/2024","$500 - $6K","Right","Weak","Very Strong","5'11""","147 lbs","26","1",72,110,8,10,8,7,8,10,8,8,5,8,7,10,8,8,13,8,10,7,7,7,13,12,5,11,10,8,8,13,12,12,12,13,10,12,12,13,13,10,11,13,11,10,7,9,12,5,8,9,16,3,1,2,3,2,2,4,2,4,2,1
"7640",79031726,"Roberto Fernández","6/7/2000 (23 years old)","D (C)","Dinamo Moscow","Russian Premier League","PAR","No","7/26/2022","6/10/2027","$26K - $6.2M","Left","Very Strong","Reasonable","6'2""","185 lbs","89","4",117,140,7,8,9,10,11,7,15,7,8,13,12,10,12,9,14,12,15,10,12,10,13,9,8,10,12,12,9,16,13,10,14,14,12,13,14,13,9,9,7,12,12,13,8,11,12,4,11,11,10,1,3,3,3,3,4,3,3,3,2,1
"7641",2000051482,"Albert Kangwanda","4/7/1999 (24 years old)","M (RLC), AM (RL)","Red Arrows","Zambian Premier League","ZAM","No","1/1/2023","6/30/2024","$0","Left Only","Very Strong","Weak","5'11""","171 lbs","14","1",97,110,5,11,12,11,11,13,7,12,5,4,8,11,5,12,11,10,8,10,12,11,15,11,7,10,5,10,10,12,13,11,14,10,10,13,10,13,15,20,8,12,11,5,11,10,11,1,20,19,20,2,1,3,2,1,2,1,1,1,4,3
"7642",28095352,"David Brooks","7/8/1997 (25 years old)","M (R), AM (RC)","Bournemouth","English Premier Division","WAL","No","8/22/2022","6/30/2026","$22M - $32M","Left","Very Strong","Reasonable","5'8""","143 lbs","119","18",132,164,9,11,15,13,14,10,8,8,4,7,14,8,9,15,6,14,6,14,9,13,14,18,5,15,8,12,15,15,14,16,15,6,11,15,12,7,6,13,13,14,14,14,10,9,3,4,12,16,10,3,2,3,1,2,1,2,3,2,2,3
"7643",29189400,"Brennan Johnson","5/23/2001 (22 years old)","AM (RC), ST (C)","Nottm Forest","English Premier Division","WAL","No","7/1/2022","6/30/2026","$38M - $58M","Right","Reasonable","Very Strong","5'11""","160 lbs","128","34",135,162,8,13,14,13,12,11,8,10,5,7,14,14,6,13,6,11,12,13,10,12,12,13,10,12,8,12,12,13,16,13,12,8,14,15,13,9,9,12,10,12,14,13,3,13,5,3,13,12,11,1,3,3,1,3,2,1,1,3,2,2
"7644",29000737,"Aaron Ramsey","12/26/1990 (32 years old)","M (C), AM (RC)","OGC Nice","Ligue 1 Uber Eats","WAL","No","8/1/2022","6/30/2025","Not for Sale","Right","Reasonable","Very Strong","5'10""","167 lbs","373","50",138,160,11,13,14,11,16,8,6,14,4,9,15,10,11,16,10,15,13,13,14,15,13,16,13,17,13,15,14,12,11,13,14,8,8,11,13,11,16,14,14,12,16,16,14,16,6,5,14,8,9,1,2,3,2,1,2,2,2,2,1,3
"7645",29175064,"Ethan Ampadu","9/14/2000 (22 years old)","D (C), DM, M (C)","Chelsea","English Premier Division","WAL","Yes","6/14/2021","6/30/2027","$10M - $15M","Right","Fairly Strong","Very Strong","6'0""","171 lbs","97","-",135,152,6,9,9,6,12,6,12,5,12,14,13,7,15,11,12,14,16,15,13,13,12,7,11,7,14,13,13,13,13,11,15,13,13,14,13,12,15,15,13,14,15,8,9,13,8,7,12,14,10,3,1,1,2,2,2,2,1,3,4,3
"7646",29007955,"Joe Allen","3/14/1990 (33 years old)","DM, M (C)","Swansea","Sky Bet Championship","WAL","No","7/8/2022","6/30/2024","$90K - $900K","Right","Reasonable","Very Strong","5'6""","136 lbs","457","31",119,152,12,10,12,9,15,7,7,8,3,11,14,6,13,13,14,14,14,12,13,13,15,12,10,11,11,16,14,15,12,13,14,6,15,10,12,8,11,12,15,16,11,15,17,15,6,2,12,13,10,3,3,1,1,1,3,1,3,3,3,4
"7647",28115792,"Neco Williams","4/13/2001 (22 years old)","D/WB (RL)","Nottm Forest","English Premier Division","WAL","No","7/11/2022","6/30/2026","$43M - $66M","Right","Reasonable","Very Strong","6'0""","158 lbs","58","3",127,150,8,14,13,11,14,7,11,12,10,11,12,6,13,13,13,10,12,11,10,10,14,11,6,11,10,14,12,14,14,13,13,11,15,14,14,11,8,12,12,14,12,16,10,10,8,8,11,14,14,1,1,2,4,3,2,3,1,3,2,3
"7648",28094856,"Daniel James","11/10/1997 (25 years old)","M/AM (RL)","Leeds","Sky Bet Championship","WAL","No","8/31/2021","6/30/2026","$8.2M - $12.5M","Right","Weak","Very Strong","5'7""","167 lbs","135","16",129,149,4,11,13,7,11,4,5,8,2,5,8,10,6,11,14,10,16,6,9,5,15,12,4,12,6,16,7,18,19,16,12,6,15,19,16,5,12,14,11,14,14,12,5,13,12,5,9,15,5,3,3,2,2,3,1,3,2,2,3,1
"7649",2000216562,"Omari Benjamin","12/4/2005 (17 years old)","AM (RL), ST (C)","Arsenal","English Premier Division","WAL","No","7/1/2022","6/30/2024","$24K - $5.8M","Right","Reasonable","Very Strong","6'0""","167 lbs","-","-",75,146,7,7,8,10,8,7,8,9,5,7,7,5,4,8,10,10,8,9,9,8,15,5,13,10,7,13,10,15,15,8,10,10,11,13,8,12,8,12,10,11,9,13,11,9,10,7,11,10,16,1,1,2,3,3,4,1,3,2,3,2
"7650",28126168,"Ed Turns","10/18/2002 (20 years old)","D (C)","Brighton","English Premier Division","WAL","No","12/13/2021","6/30/2024","$95K - $950K","Right","Fairly Strong","Very Strong","6'0""","171 lbs","16","2",98,146,5,6,7,8,13,5,10,6,6,9,15,9,13,13,12,10,15,15,12,8,14,7,13,7,9,14,15,15,13,12,9,8,13,13,13,10,14,14,11,11,9,11,9,7,15,3,6,10,11,1,3,4,3,1,1,3,1,3,3,1
"7651",79013838,"Fabián Balbuena","8/23/1991 (31 years old)","D (C)","Dinamo Moscow","Russian Premier League","PAR","No","6/30/2021","6/30/2025","Not for Sale","Right","Reasonable","Very Strong","6'2""","194 lbs","295","19",127,140,6,7,6,7,10,7,14,6,8,15,10,6,15,10,13,15,13,13,13,13,14,5,15,8,14,13,8,13,10,10,14,14,11,10,13,15,8,10,12,13,12,12,12,12,12,14,12,18,14,1,3,2,3,1,2,1,1,2,2,2
"7652",28049754,"Ben Davies","4/24/1993 (30 years old)","D (LC), WB (L)","Tottenham","English Premier Division","WAL","No","7/25/2022","6/30/2025","$33M - $50M","Left","Very Strong","Weak","6'0""","167 lbs","279","9",144,145,11,12,12,8,13,13,15,7,11,13,14,10,15,13,13,15,18,13,11,14,15,9,12,13,15,15,12,16,12,13,13,12,14,13,16,14,15,17,14,15,12,13,9,10,6,4,14,13,14,1,1,2,1,1,2,2,1,2,3,3
"7653",29134274,"Chris Mepham","11/5/1997 (25 years old)","D (C)","Bournemouth","English Premier Division","WAL","No","9/6/2022","6/30/2025","$23M - $35M","Right","Reasonable","Very Strong","6'3""","165 lbs","140","3",130,145,4,5,11,7,12,5,13,4,4,13,12,4,15,13,12,15,14,13,14,13,16,6,12,6,15,14,11,14,12,9,14,15,14,12,13,15,6,16,15,15,14,14,3,14,5,4,13,14,12,3,2,1,2,2,2,1,2,3,1,2
"7654",29058892,"Danny Ward","6/22/1993 (29 years old)","GK","Leicester","Sky Bet Championship","WAL","No","4/15/2021","6/30/2025","$3.6M","Right","Weak","Very Strong","6'3""","194 lbs","99","-",124,145,4,1,1,2,10,8,1,3,2,1,10,1,3,10,12,13,13,13,14,12,14,3,7,1,12,12,11,11,12,12,12,12,13,11,13,13,11,16,12,16,12,14,8,16,10,8,12,13,10,12,13,12,9,12,11,13,6,13,13,13
"7655",28100477,"Joe Rodon","10/22/1997 (25 years old)","D (C)","Tottenham","English Premier Division","WAL","No","10/16/2020","6/30/2025","$6.4M - $7.6M","Right","Fairly Strong","Very Strong","6'4""","167 lbs","95","1",135,144,4,7,9,5,11,3,14,4,10,13,11,5,14,12,13,14,16,12,12,13,15,9,13,9,13,14,10,14,13,13,11,16,12,14,13,15,5,10,11,14,8,10,14,12,6,8,14,15,8,1,3,3,1,1,3,3,2,1,1,2
"7656",2000301021,"Will Sweet","10/2/2006 (16 years old)","D (RC)","Arsenal","English Premier Division","WAL","No","6/12/2023","6/30/2025","$1.2M - $2.6M","Right","Reasonable","Very Strong","6'3""","165 lbs","-","-",64,142,4,9,4,5,8,1,9,7,1,9,9,5,15,13,10,4,9,10,7,8,9,5,6,6,14,7,8,8,7,9,8,13,15,6,9,6,13,16,10,10,9,12,12,8,13,8,8,11,14,2,1,1,2,2,2,2,1,2,3,3
"7657",2000271959,"Gabriele Biancheri","9/18/2006 (16 years old)","AM (R), ST (C)","Man UFC","English Premier Division","WAL","Yes","2/28/2023","6/30/2025","$450K - $4.5M","Right","Reasonable","Very Strong","5'9""","136 lbs","-","-",68,142,8,11,13,9,10,4,6,6,2,4,11,5,6,11,5,4,5,10,6,9,6,14,11,9,6,6,7,7,12,11,2,6,15,12,7,6,11,15,12,11,11,9,8,12,12,8,10,9,12,1,3,3,1,3,2,1,3,3,3,2
"7658",2000141316,"Luke Harris","4/3/2005 (18 years old)","M/AM (C)","Fulham","English Premier Division","WAL","No","3/14/2023","6/30/2026","$8.2M - $12.5M","Right","Reasonable","Very Strong","5'4""","136 lbs","3","-",93,142,12,11,12,14,8,10,5,14,4,8,13,9,8,10,5,10,9,10,11,10,15,12,10,11,6,10,10,12,15,7,11,4,11,12,11,10,11,11,11,10,14,12,5,10,14,3,10,12,12,1,3,3,1,2,1,1,3,4,2,2
"7659",95040497,"Sorba Thomas","1/25/1999 (24 years old)","WB/M/AM (RL)","Huddersfield","Sky Bet Championship","WAL","No","5/19/2022","6/30/2026","$3.7M - $7.4M","Right","Reasonable","Very Strong","6'1""","176 lbs","169","11",117,140,16,12,13,7,11,14,6,7,8,6,11,12,7,12,13,8,4,11,9,10,12,11,5,12,9,11,11,11,15,13,13,9,12,14,12,11,13,4,5,8,14,12,5,5,13,9,10,11,12,3,1,2,2,4,3,3,3,3,1,3
"7660",28115832,"Dylan Levitt","11/17/2000 (22 years old)","M (C)","Dundee United","cinch Championship","WAL","No","7/7/2022","5/31/2025","$120K - $1.2M","Right","Reasonable","Very Strong","5'11""","160 lbs","62","10",116,140,13,8,10,13,14,12,5,15,9,7,16,10,12,15,5,13,6,14,11,13,14,12,5,12,8,11,14,9,12,13,10,5,15,12,13,9,10,16,15,14,12,14,4,8,9,5,7,15,8,3,1,3,2,2,3,1,1,3,1,3
"7661",28111474,"Rabbi Matondo","9/9/2000 (22 years old)","M/AM (RL)","Rangers","cinch Premiership","WAL","No","7/12/2022","5/31/2026","$21M - $32M","Right","Reasonable","Very Strong","5'9""","145 lbs","86","12",123,140,11,11,14,11,12,6,5,10,5,6,12,8,7,14,12,13,6,9,6,4,8,15,3,13,5,8,13,9,18,15,9,6,12,18,10,11,10,10,12,5,9,8,13,12,8,15,6,8,12,1,2,1,3,3,4,3,3,3,2,3
"7662",79025925,"Walter González","6/21/1995 (27 years old)","ST (C)","Santa Clara","Portuguese Second League","PAR","No","6/15/2020","12/31/2024","$750K - $1.6M","Right","Reasonable","Very Strong","6'0""","185 lbs","179","44",124,140,5,7,11,14,12,7,14,12,4,5,13,12,6,11,14,12,14,13,12,12,15,12,8,14,7,14,11,15,14,12,14,14,12,13,13,13,6,11,8,14,14,11,7,16,13,11,14,12,18,2,3,2,2,1,2,1,3,2,2,3
"7663",28094949,"Harry Wilson","3/22/1997 (26 years old)","AM (RLC)","Fulham","English Premier Division","WAL","No","7/24/2021","6/30/2026","$54M - $65M","Left","Very Strong","Reasonable","5'8""","141 lbs","198","48",139,140,14,15,15,13,14,14,5,13,3,7,15,15,9,15,11,12,12,15,9,15,15,15,12,14,8,13,15,13,14,14,14,6,13,14,13,8,9,13,10,14,10,16,8,12,5,8,12,14,11,3,2,4,3,1,3,1,1,4,3,3
"7664",28058330,"Tom Lawrence","1/13/1994 (29 years old)","M (L), AM (RLC)","Rangers","cinch Premiership","WAL","No","7/8/2022","5/31/2025","$140K - $7.6M","Right","Fairly Strong","Very Strong","5'11""","165 lbs","280","55",122,139,12,12,15,13,13,12,9,12,1,6,12,14,8,14,14,12,8,12,9,9,15,14,12,13,5,8,12,7,13,13,12,8,13,13,11,8,12,15,10,10,11,14,14,12,14,12,12,15,12,1,3,2,3,2,1,3,2,3,1,1
"7665",2000288694,"George Morgan","9/8/2006 (16 years old)","ST (C)","Everton","English Premier Division","WAL","No","6/12/2023","6/30/2025","$325K - $3.3M","Right","Reasonable","Very Strong","6'0""","180 lbs","-","-",70,139,5,2,13,13,13,6,8,7,1,5,7,6,1,11,13,13,8,12,7,11,14,11,4,5,5,6,7,11,11,10,11,9,9,9,13,8,10,11,11,13,11,12,12,13,5,8,10,11,18,1,3,2,3,3,3,3,1,2,2,1
"7666",2000282899,"Rhys Thomas","11/5/2006 (16 years old)","D (R)","Man City","English Premier Division","WAL","No","6/12/2023","6/30/2027","$100K - $1M","Right","Reasonable","Very Strong","5'9""","138 lbs","-","-",61,138,5,9,5,5,4,1,6,4,5,5,6,1,11,1,13,8,8,4,10,12,14,5,9,1,6,6,4,6,13,13,6,8,9,13,10,6,10,20,8,9,11,11,15,1,13,1,15,11,10,1,1,2,3,3,3,2,1,2,1,4
"7667",29193986,"Rhys Norrington-Davies","4/22/1999 (24 years old)","D (LC), WB (L)","Sheff Utd","English Premier Division","WAL","No","12/10/2020","6/30/2024","$7M - $10.5M","Left","Very Strong","Reasonable","5'11""","158 lbs","130","2",126,138,10,13,13,7,11,8,11,5,10,11,12,6,13,12,16,12,14,12,11,12,13,9,8,12,12,14,10,15,14,13,13,9,15,13,15,13,9,12,12,11,12,11,3,12,11,4,13,11,3,3,1,2,3,2,2,2,2,3,2,3
"7668",29001407,"Sam Vokes","10/21/1989 (33 years old)","ST (C)","Wycombe","Sky Bet League One","WAL","No","4/24/2023","6/30/2024","$5K - $55K","Right","Fairly Strong","Very Strong","6'2""","167 lbs","529","116",106,138,4,10,8,12,14,6,16,10,7,10,13,14,7,13,16,13,16,14,12,12,12,10,13,13,6,18,8,15,6,8,15,15,12,8,13,14,9,15,12,15,13,12,5,12,6,12,13,12,13,2,2,3,1,2,1,2,3,1,1,4
"7669",5006568,"Wayne Hennessey","1/24/1987 (36 years old)","GK","Nottm Forest","English Premier Division","WAL","No","7/15/2022","6/30/2024","$24K","Right","Fairly Strong","Very Strong","6'5""","198 lbs","326","-",110,138,5,2,1,2,7,9,1,1,3,2,14,1,2,6,12,13,12,9,12,11,13,1,7,6,12,11,6,10,10,13,12,16,11,11,10,15,10,13,13,13,11,13,7,12,8,6,11,13,13,13,14,12,16,15,13,10,4,11,8,14
"7670",28109135,"Ben Cabango","5/30/2000 (23 years old)","D (C)","Swansea","Sky Bet Championship","WAL","No","3/18/2021","6/30/2025","$400K - $3.9M","Right Only","Weak","Very Strong","6'3""","187 lbs","148","8",118,138,4,6,7,9,9,4,16,5,10,14,10,5,15,8,14,14,16,9,12,11,13,7,12,7,15,12,9,14,10,9,7,15,12,11,13,16,2,13,10,12,9,14,5,14,16,12,11,10,4,3,1,4,2,3,3,1,1,2,2,2
"7671",28127368,"Chem Campbell","12/30/2002 (20 years old)","M/AM (RLC)","Wolves","English Premier Division","WAL","No","10/13/2022","6/30/2026","$140K - $1.4M","Right","Fairly Strong","Very Strong","6'1""","158 lbs","23","3",106,137,12,11,12,9,12,11,7,12,5,6,12,9,7,12,12,10,8,10,7,10,12,14,7,12,6,7,11,9,13,14,13,12,12,13,11,9,12,5,9,12,12,11,8,12,12,12,10,10,12,3,1,2,2,3,2,1,2,2,1,3
"7672",29140223,"Regan Poole","6/18/1998 (24 years old)","D (RC), WB (R)","Lincoln","Sky Bet League One","WAL","No","1/30/2021","6/30/2026","$120K - $1.2M","Right","Reasonable","Very Strong","6'0""","163 lbs","208","4",115,137,4,11,10,7,11,5,12,8,12,12,12,6,13,12,10,13,11,12,12,12,15,8,15,10,13,14,10,13,11,11,11,13,15,12,14,13,14,12,10,15,13,10,7,10,11,5,12,14,13,1,1,2,2,1,2,2,2,2,3,4
"7673",79035404,"Erik López","11/27/2001 (21 years old)","AM (R), ST (C)","Atlanta United","Major League Soccer","PAR","No","1/1/2021","12/31/2025","$220K - $2.2M","Right","Fairly Strong","Very Strong","5'9""","152 lbs","71","7",109,140,5,10,13,10,11,6,12,9,3,7,10,10,9,11,13,8,11,12,7,8,11,12,2,13,7,12,10,14,15,14,12,5,11,13,11,6,12,14,7,7,12,10,10,9,13,4,10,14,13,2,3,3,1,1,3,2,1,2,2,1
"7674",2000036945,"Ben Lloyd","3/14/2005 (18 years old)","M/AM (C)","Swansea","Sky Bet Championship","WAL","No","4/20/2023","6/30/2026","$800K - $1.7M","Left","Very Strong","Reasonable","5'10""","143 lbs","-","-",85,136,6,10,12,9,12,7,5,10,4,6,10,10,8,12,11,12,10,11,9,9,13,12,11,12,8,12,13,11,11,11,12,7,12,10,10,6,14,8,10,11,13,15,7,10,8,6,12,15,11,1,2,2,1,1,1,1,1,2,2,2
"7675",29084583,"Louis Thompson","12/19/1994 (28 years old)","D (C), DM, M (C)","Portsmouth","Sky Bet League One","WAL","No","8/10/2021","6/30/2025","$20K - $210K","Right Only","Weak","Very Strong","5'11""","165 lbs","185","8",106,136,8,8,11,10,11,7,11,9,5,13,12,8,14,13,15,13,15,10,11,10,15,9,10,11,13,13,10,15,11,11,12,10,12,11,14,11,11,12,12,16,10,14,13,12,4,2,13,13,9,1,1,3,2,3,1,1,1,2,3,2
"7676",28011264,"Adam Matthews","1/13/1992 (31 years old)","D (RL), WB (R)","Omonoia","Cypriot First Division","WAL","No","7/6/2022","5/31/2024","$55K - $550K","Right","Reasonable","Very Strong","5'10""","156 lbs","328","7",110,136,9,11,10,7,11,11,8,10,13,13,11,10,12,11,8,12,10,11,10,12,9,10,7,11,9,11,10,14,13,10,14,10,9,12,14,13,12,15,15,9,11,13,13,9,5,3,10,10,8,1,1,4,3,1,2,3,3,2,1,1
"7677",28105799,"Tyler Roberts","1/12/1999 (24 years old)","AM (RLC), ST (C)","Leeds","Sky Bet Championship","WAL","No","6/15/2020","6/30/2025","$95K - $950K","Right","Reasonable","Very Strong","5'11""","165 lbs","164","21",113,136,3,9,12,12,12,8,10,10,5,3,11,10,4,12,13,11,10,10,9,11,14,12,8,12,5,14,10,12,13,13,12,10,13,14,14,13,12,14,12,13,13,11,15,11,8,4,10,12,8,1,1,2,3,2,3,1,2,1,3,1
"7678",28029911,"Paul Dummett","9/26/1991 (31 years old)","D (LC)","Newcastle","English Premier Division","WAL","No","6/14/2021","6/30/2025","$800K - $5.6M","Left","Very Strong","Weak","6'0""","180 lbs","231","5",127,135,10,12,10,5,11,10,14,5,6,13,10,3,15,10,15,14,15,11,14,12,12,6,12,12,14,17,8,15,14,11,12,12,11,13,15,13,9,14,14,15,11,15,12,14,12,3,15,11,12,2,2,1,2,3,4,1,3,3,1,2
"7679",28055992,"Jonny Williams","10/9/1993 (29 years old)","M/AM (LC)","Swindon","Sky Bet League Two","WAL","No","8/13/2021","6/30/2024","$45K - $450K","Right","Reasonable","Very Strong","5'6""","141 lbs","267","20",98,135,11,10,13,9,13,10,7,9,4,6,14,10,7,13,6,12,12,12,12,12,11,13,11,11,7,12,12,11,10,12,12,6,12,11,10,8,8,12,13,13,12,14,17,12,6,5,12,12,9,3,1,1,1,4,3,2,3,4,2,2
"7680",29191224,"Jack Vale","3/3/2001 (22 years old)","AM (LC), ST (C)","Blackburn","Sky Bet Championship","WAL","No","10/24/2022","6/30/2025","$55K - $550K","Right","Reasonable","Very Strong","6'1""","154 lbs","31","1",106,135,7,8,11,12,12,7,10,11,7,7,12,12,7,12,11,11,11,11,10,11,12,10,8,13,8,12,12,14,13,12,12,12,12,12,13,12,12,12,10,14,11,12,12,12,4,4,10,11,10,2,2,4,3,3,1,2,1,2,1,2
"7681",2000191802,"Lewis Koumas","9/19/2005 (17 years old)","AM (RLC), ST (C)","Liverpool","English Premier Division","WAL","Yes","1/11/2023","6/30/2025","$120K - $1.2M","Right","Reasonable","Very Strong","5'10""","145 lbs","-","-",76,135,5,8,9,12,13,3,8,6,4,6,10,4,7,13,8,6,4,12,7,8,10,11,11,7,5,13,11,13,13,6,7,5,11,12,6,3,8,17,10,9,9,10,6,11,10,5,10,10,18,2,3,4,1,3,1,4,2,2,1,3
"7682",8607450,"Andy King","10/29/1988 (34 years old)","DM, M/AM (C)","Bristol City","Sky Bet Championship","WAL","No","6/12/2023","6/30/2024","$0 - $35K","Right","Reasonable","Very Strong","6'0""","163 lbs","401","58",105,135,9,9,9,10,11,10,11,10,4,12,11,7,10,12,6,13,9,14,13,14,12,9,13,12,13,15,11,14,8,12,11,11,10,7,10,9,6,19,15,17,11,16,14,16,3,1,12,12,14,2,2,1,3,1,3,1,3,2,4,3
"7683",2000309010,"Charlie Stevens","5/31/2007 (16 years old)","DM, M/AM (C)","Bournemouth","English Premier Division","WAL","No","6/12/2023","6/30/2025","$230K - $2.3M","Right","Strong","Very Strong","5'10""","138 lbs","-","-",70,134,7,7,14,9,13,7,7,6,1,9,12,6,9,14,5,9,8,8,7,12,16,13,5,9,7,8,9,9,9,12,8,9,15,9,4,5,20,13,10,11,12,10,10,16,7,6,10,12,13,1,3,3,3,2,1,1,4,2,1,2
"7684",79013323,"Bruno Valdez","10/6/1992 (30 years old)","D (C)","Boca","Argentine Premier Division","PAR","No","1/17/2023","12/31/2025","$180K - $1.8M","Right","Fairly Strong","Very Strong","6'0""","171 lbs","360","30",124,139,4,6,8,9,10,6,15,6,9,15,10,10,14,11,13,13,15,11,7,10,13,6,12,11,15,13,8,13,14,12,14,13,9,13,14,12,14,8,8,11,13,11,13,13,15,9,11,11,13,1,2,3,2,1,3,2,2,1,2,4
"7685",28122158,"Rubin Colwill","4/27/2002 (21 years old)","M/AM (C)","Cardiff","Sky Bet Championship","WAL","No","8/30/2021","6/30/2024","$1.3M - $13M","Right","Reasonable","Very Strong","6'2""","176 lbs","60","5",113,134,12,11,13,12,14,12,12,11,7,10,12,11,10,13,8,11,10,12,12,9,8,13,10,12,11,12,13,12,10,14,15,10,11,12,12,13,14,12,14,13,11,15,14,9,8,6,9,12,13,1,3,2,3,3,1,1,2,2,3,3
"7686",89038587,"Kieffer Moore","8/8/1992 (30 years old)","ST (C)","Bournemouth","English Premier Division","WAL","No","1/31/2022","6/30/2025","$7.4M - $9.4M","Right","Reasonable","Very Strong","6'5""","182 lbs","348","116",125,132,7,10,11,13,13,8,15,12,9,10,12,14,8,12,14,13,14,13,12,12,16,11,11,14,11,14,11,13,11,8,13,17,16,12,13,15,13,13,13,13,15,12,8,14,13,4,13,15,14,3,2,3,1,3,2,1,1,3,3,3
"7687",2000226061,"Charlie Crew","6/15/2006 (16 years old)","DM, M/AM (C)","Leeds","Sky Bet Championship","WAL","No","7/1/2022","6/30/2024","$7M - $8.4M","Right","Reasonable","Very Strong","6'0""","154 lbs","-","-",85,132,3,5,8,12,13,6,4,8,5,8,10,4,13,10,6,9,8,5,3,10,19,10,4,3,9,7,12,12,13,13,12,6,12,13,7,6,10,13,8,13,11,12,8,12,6,5,8,12,16,1,2,3,3,3,3,2,1,1,3,3
"7688",28087373,"Connor Roberts","9/23/1995 (27 years old)","D/WB (R)","Burnley","English Premier Division","WAL","No","8/31/2021","6/30/2025","$12.5M - $15M","Right","Reasonable","Very Strong","5'9""","156 lbs","245","16",130,132,13,12,8,9,12,11,10,8,18,12,12,5,13,11,14,12,13,11,14,11,18,11,10,14,12,16,11,16,12,13,11,9,19,12,18,9,15,5,6,19,12,16,2,16,10,13,12,12,11,2,1,3,2,3,1,2,1,3,3,3
"7689",2000019643,"Fin Stevens","4/10/2003 (20 years old)","D (R)","Brentford","English Premier Division","WAL","No","6/7/2022","6/30/2027","$220K - $2.2M","Right","Reasonable","Very Strong","5'8""","154 lbs","21","1",113,132,11,12,12,8,12,8,11,8,11,11,12,6,12,12,12,12,13,12,12,12,14,11,8,7,12,12,13,13,13,13,12,7,12,13,13,11,12,14,13,13,12,10,4,14,7,3,14,12,14,1,2,1,2,2,3,4,4,3,3,4
"7690",29186945,"Terry Taylor","6/29/2001 (21 years old)","DM, M (C)","Burton","Sky Bet League One","WAL","No","2/1/2021","6/30/2023","$190K - $550K","Left","Very Strong","Reasonable","6'1""","176 lbs","71","-",100,132,11,10,11,9,12,8,8,9,7,10,12,10,10,12,11,12,11,12,12,10,11,10,12,11,10,12,11,13,12,10,11,10,13,11,14,10,11,19,10,13,10,10,8,12,10,5,12,10,10,3,2,2,1,2,2,3,2,1,4,1
"7691",28109701,"Ben Woodburn","10/15/1999 (23 years old)","M (C), AM (RLC), ST (C)","Preston","Sky Bet Championship","WAL","No","5/16/2023","6/30/2024","$2.1M - $4.4M","Right Only","Weak","Very Strong","5'9""","160 lbs","100","5",111,132,8,11,13,11,13,9,9,8,5,8,14,11,8,14,9,12,8,14,12,10,15,14,7,14,9,12,13,10,13,15,13,9,11,12,9,9,12,15,12,14,14,15,13,12,7,7,12,15,14,1,1,1,1,3,4,2,3,1,2,1
"7692",5131427,"James Chester","1/23/1989 (34 years old)","D (C)","Derby","Sky Bet League One","WAL","No","7/6/2022","6/30/2024","$2K - $22K","Right","Reasonable","Very Strong","5'11""","165 lbs","386","20",107,131,4,5,7,6,12,4,14,4,8,14,11,7,14,11,13,11,15,14,13,10,14,2,14,10,14,15,9,13,7,11,12,12,4,8,9,14,13,15,14,15,13,14,18,14,8,3,12,11,10,1,2,1,3,2,2,1,1,3,3,3
"7693",2000270998,"Thomas Woodward","11/5/2006 (16 years old)","AM (L)","Swansea","Sky Bet Championship","WAL","No","6/12/2023","6/30/2025","$130K - $1.3M","Right","Reasonable","Very Strong","6'0""","147 lbs","-","-",60,130,5,6,13,10,13,2,7,5,5,5,13,4,6,13,5,6,4,3,6,6,15,13,1,13,4,6,5,10,13,9,4,9,13,13,5,4,9,14,12,12,8,11,7,6,13,7,9,11,11,2,2,3,3,3,3,1,1,2,1,1
"7694",74032588,"Ryan Hedges","7/8/1995 (27 years old)","AM (RLC)","Blackburn","Sky Bet Championship","WAL","No","1/28/2022","6/30/2025","$100K - $7M","Left Only","Very Strong","Weak","6'1""","143 lbs","240","25",117,130,12,12,13,9,13,12,9,10,4,7,13,10,7,13,9,8,7,12,9,11,13,14,12,13,10,15,13,14,13,14,14,11,15,13,15,10,15,15,15,17,12,14,7,10,4,5,10,12,12,3,3,2,1,2,3,3,1,3,3,2
"7695",956742,"Lucas Barrios","11/13/1984 (38 years old)","ST (C)","Sportivo Trinidense","Paraguay First Division Primera División","PAR","No","1/1/2023","12/31/2024","Not for Sale","Right","Fairly Strong","Very Strong","6'2""","191 lbs","469","184",112,153,6,7,11,14,13,8,15,10,5,3,13,13,6,13,14,13,13,14,12,13,13,13,11,14,6,11,11,11,11,9,14,13,13,8,8,14,6,11,8,8,14,7,14,11,11,13,10,11,13,3,2,1,1,3,3,1,1,3,3,2
"7696",79000598,"Marcelo Estigarribia","9/21/1987 (35 years old)","M (LC)","Sportivo Ameliano","Paraguay First Division Primera División","PAR","Yes","12/31/2022","12/31/2023","$0 - $95K","Left Only","Very Strong","Weak","5'11""","167 lbs","354","22",111,138,12,13,12,8,13,13,4,12,1,10,11,13,8,13,14,10,12,10,13,13,8,12,10,13,10,12,12,14,13,12,13,9,12,13,12,8,14,8,7,13,8,12,11,8,13,7,9,13,13,2,1,1,2,2,3,3,2,2,2,1
"7697",28029495,"Joe Walsh","5/13/1992 (31 years old)","D (C)","Lincoln","Sky Bet League One","WAL","No","8/13/2020","6/30/2024","$7K - $70K","Left","Very Strong","Reasonable","5'11""","154 lbs","264","13",101,130,3,6,8,8,10,6,13,9,8,13,12,5,14,12,10,10,11,11,11,10,13,8,12,10,14,13,9,12,10,9,10,12,9,9,12,13,12,15,13,15,12,13,19,13,4,4,13,10,12,3,1,1,2,2,1,1,2,4,1,1
"7698",2000014205,"Martin Vitík","1/21/2003 (20 years old)","D (C), DM","Sparta Prague","Czech First Division","CZE","Yes","1/26/2023","6/30/2026","$7.2M - $8.8M","Right Only","Weak","Very Strong","6'4""","185 lbs","71","5",119,164,8,10,5,6,13,10,14,11,2,12,12,4,13,11,13,12,12,13,11,9,4,14,8,10,15,11,14,10,15,11,11,15,12,13,13,16,8,14,10,14,11,12,14,10,7,2,19,11,10,2,2,1,2,3,3,4,1,4,2,3
"7699",25039108,"Jiří Pavlenka","4/14/1992 (31 years old)","GK","SV Werder","Bundesliga","CZE","Yes","5/17/2022","6/30/2024","$150K - $7.4M","Right Only","Weak","Very Strong","6'5""","178 lbs","294","-",130,160,4,2,2,2,7,6,9,1,1,2,9,2,3,7,11,12,15,11,13,12,13,5,12,1,14,12,8,12,9,16,13,18,14,10,10,15,13,17,15,17,14,15,8,16,6,5,11,15,14,12,10,15,13,15,10,12,6,12,12,15
"7700",25041687,"Tomáš Souček","2/27/1995 (28 years old)","DM, M (C)","West Ham","English Premier Division","CZE","Yes","7/24/2020","6/30/2024","$37M - $46M","Right","Reasonable","Very Strong","6'4""","189 lbs","262","51",140,155,2,8,10,14,9,2,18,12,2,14,10,13,15,11,15,14,15,15,15,15,16,5,12,14,15,17,10,18,13,9,15,17,18,12,19,16,18,9,17,16,14,15,10,14,10,8,14,13,11,2,4,2,2,2,2,3,2,1,2,1
"7701",25042141,"Patrik Schick","1/24/1996 (27 years old)","ST (C)","Bayer 04","Bundesliga","CZE","Yes","5/26/2022","6/30/2027","$51M - $61M","Left","Very Strong","Reasonable","6'3""","191 lbs","201","69",150,155,4,8,14,15,16,12,16,12,6,6,12,12,6,16,11,15,13,14,13,13,13,15,12,15,7,11,12,12,14,14,14,16,11,15,12,15,8,17,12,14,10,10,13,14,6,12,14,14,12,2,2,1,2,1,2,3,3,1,2,3
"7702",31041522,"Adam Hložek","7/25/2002 (20 years old)","AM (RLC), ST (C)","Bayer 04","Bundesliga","CZE","Yes","7/1/2022","6/30/2027","$17M - $25M","Right","Fairly Strong","Very Strong","6'2""","185 lbs","129","36",129,152,11,10,13,12,12,12,13,12,7,6,12,12,7,13,12,11,12,12,10,10,12,15,7,11,6,11,12,11,15,12,13,13,12,15,12,14,7,13,13,12,10,7,11,11,9,8,12,16,10,3,2,1,1,1,1,1,2,4,2,1
"7703",25002958,"Tomáš Vaclík","3/29/1989 (34 years old)","GK","Huddersfield","Sky Bet Championship","CZE","Yes","2/1/2023","6/30/2025","Not for Sale","Right","Reasonable","Very Strong","6'2""","180 lbs","416","-",122,150,5,5,8,3,10,5,2,2,2,2,11,9,9,10,6,13,11,14,12,13,14,8,9,5,15,16,10,8,9,11,12,13,10,8,12,12,1,17,15,16,13,15,15,12,8,4,14,12,13,12,6,14,10,13,13,15,8,14,11,12
"7704",28118905,"Matěj Kovář","5/17/2000 (23 years old)","GK","Man UFC","English Premier Division","CZE","Yes","9/9/2022","6/30/2025","$7M - $8.4M","Right","Reasonable","Very Strong","6'5""","196 lbs","51","-",125,150,2,3,3,3,12,1,7,2,2,3,12,1,3,12,12,12,13,13,12,11,14,6,11,6,12,11,11,12,9,15,12,17,15,10,10,13,1,14,12,13,11,9,3,13,5,6,13,17,17,12,12,14,10,13,13,13,8,11,12,15
"7705",5640417,"Tomáš Hübschman","9/4/1981 (41 years old)","D (C), DM, M (C)","Jablonec","Czech First Division","CZE","Yes","6/14/2021","6/30/2024","$65K - $200K","Right","Strong","Very Strong","5'11""","169 lbs","519","10",113,150,6,9,9,7,13,9,11,10,8,13,11,13,16,13,15,14,15,14,13,13,17,7,12,10,15,13,10,15,7,8,10,12,13,8,8,11,12,8,17,17,12,18,8,15,7,9,15,18,19,1,3,3,2,1,3,3,1,3,1,3
"7706",16282755,"Adam Stejskal","3/28/2002 (21 years old)","GK","FC RB Salzburg","Austrian Premier Division","CZE","Yes","7/26/2018","6/30/2026","$70K - $700K","Right","Weak","Very Strong","6'2""","178 lbs","36","-",110,146,2,5,5,2,8,4,6,7,11,5,8,3,3,9,8,9,14,9,10,10,14,1,6,3,17,12,9,13,9,11,13,15,13,12,13,12,3,12,9,10,12,10,5,6,7,7,12,15,12,11,11,12,9,11,11,11,8,9,10,13
"7707",79003362,"Hernán Pérez","2/25/1989 (34 years old)","M/AM (RL)","General Caballero (JLM)","Paraguay First Division Primera División","PAR","Yes","12/31/2022","12/31/2023","$12K - $130K","Right","Reasonable","Very Strong","5'11""","169 lbs","335","43",117,138,9,12,14,11,12,9,9,11,7,8,13,8,8,12,9,11,9,13,10,11,16,13,9,14,8,14,11,14,14,13,11,9,11,13,13,9,14,12,7,15,14,10,13,9,10,6,9,15,12,2,3,3,2,1,3,3,1,3,1,2
"7708",2000226596,"Joeri Jesse Heerkens","5/8/2006 (17 years old)","GK","Sparta Prague","Czech First Division","CZE","Yes","7/19/2022","6/30/2025","$170K - $1.7M","Right","Reasonable","Very Strong","6'2""","165 lbs","-","-",73,146,3,1,2,2,1,7,1,2,3,1,10,2,3,1,13,9,11,3,6,13,14,3,4,1,7,7,6,6,10,11,7,10,13,9,3,6,11,14,10,13,10,12,6,5,9,8,12,12,18,10,10,13,5,8,9,13,5,10,9,5
"7709",25019899,"Vladimír Darida","8/8/1990 (32 years old)","DM, M/AM (C)","Aris","Greek Super League 1","CZE","Yes","1/1/2023","6/30/2025","Not for Sale","Right","Fairly Strong","Very Strong","5'8""","147 lbs","321","44",125,145,12,11,11,10,12,12,6,13,7,8,13,13,10,13,14,12,13,13,14,12,15,10,15,13,11,18,12,20,11,13,13,7,18,11,15,7,16,17,15,17,12,13,10,16,3,3,17,14,15,4,1,2,1,3,1,3,3,3,3,3
"7710",43108622,"Marek Havlík","7/8/1995 (27 years old)","DM, M (C)","Slovácko","Czech First Division","CZE","Yes","5/27/2022","6/30/2024","$275K - $2.7M","Left","Very Strong","Reasonable","5'9""","160 lbs","329","30",122,145,14,9,12,9,13,11,7,7,6,13,12,12,10,13,6,13,14,12,10,13,13,14,7,13,14,9,10,13,15,15,10,6,6,15,16,10,8,10,12,12,12,12,12,10,7,10,11,12,10,1,1,1,2,3,1,1,2,1,3,1
"7711",43207792,"Jakub Jankto","1/19/1996 (27 years old)","M (RLC), AM (RL)","Getafe","Spanish First Division","CZE","Yes","8/21/2021","6/30/2025","$400K - $4M","Left","Very Strong","Reasonable","6'0""","163 lbs","218","23",129,145,12,15,12,14,12,10,10,14,12,10,12,10,12,13,13,12,13,14,12,12,15,14,15,14,13,14,13,12,12,13,13,10,12,14,13,10,16,12,13,14,12,13,5,11,12,10,12,13,14,1,1,1,1,1,3,2,3,2,1,4
"7712",25061896,"David Zima","11/8/2000 (22 years old)","D (C)","Torino","Italian Serie A","CZE","Yes","8/31/2021","6/30/2025","$700K - $11M","Right","Reasonable","Very Strong","6'3""","176 lbs","64","-",121,145,4,6,7,7,11,6,14,6,10,14,12,7,13,10,8,12,13,12,11,13,13,13,8,8,12,13,8,9,13,11,14,15,12,13,13,15,9,9,15,12,11,12,10,12,6,8,13,13,10,2,1,1,2,3,3,1,1,1,2,1
"7713",5646200,"David Limberský","10/6/1983 (39 years old)","D/WB (L)","Domažlice","Czech Third Division CFL A","CZE","Yes","7/3/2021","6/30/2024","$0 - $35K","Right","Fairly Strong","Very Strong","5'11""","174 lbs","455","23",99,145,13,13,12,10,14,13,12,14,9,13,12,15,16,14,14,13,13,14,12,14,16,14,13,7,13,12,12,14,6,8,13,8,9,9,6,10,12,8,10,13,12,18,11,15,14,15,15,13,4,1,2,3,1,1,2,1,3,2,2,2
"7714",25061822,"David Pech","2/22/2002 (21 years old)","D/WB/M/AM (R)","Slavia Prague","Czech Third Division CFL A","CZE","Yes","1/25/2023","6/30/2027","$22K - $5.6M","Right","Reasonable","Very Strong","5'10""","165 lbs","61","7",115,142,8,8,16,10,13,7,6,9,7,10,10,10,10,12,5,9,11,11,12,10,7,12,7,8,10,10,10,14,14,15,11,8,10,14,14,12,15,10,13,10,14,12,10,10,6,7,12,13,17,3,3,1,3,3,2,3,1,1,1,2
"7715",2000252741,"Daniel Rus","2/2/2006 (17 years old)","ST (C)","Sparta Prague","Czech First Division","CZE","Yes","7/19/2022","6/30/2024","$950K - $2M","Right","Reasonable","Very Strong","6'1""","163 lbs","4","-",85,141,6,5,11,13,9,6,13,7,6,5,7,3,4,13,9,9,6,9,4,13,13,13,9,9,7,6,7,8,13,13,7,9,8,13,13,6,8,15,15,13,10,10,8,3,8,1,7,10,11,1,3,2,3,2,2,1,2,3,3,3
"7716",25055083,"Ladislav Krejčí","4/20/1999 (24 years old)","D (C), DM","Sparta Prague","Czech First Division","CZE","Yes","3/21/2021","6/30/2025","$350K - $3.4M","Left Only","Very Strong","Weak","6'3""","191 lbs","126","30",129,140,7,7,12,11,12,9,15,12,8,14,14,13,14,12,12,13,16,14,14,12,16,11,16,8,9,13,10,17,13,12,15,14,12,13,16,15,14,9,9,13,12,14,8,13,14,8,14,14,10,1,2,3,1,1,1,2,1,1,2,2
"7717",25045644,"Alex Král","5/19/1998 (25 years old)","DM, M (C)","Spartak Moscow","Russian Premier League","CZE","Yes","6/15/2020","6/30/2024","$350K - $7.8M","Right","Reasonable","Very Strong","6'1""","176 lbs","144","1",132,140,3,8,13,7,13,4,13,9,6,13,14,6,13,13,12,15,14,15,14,13,15,12,12,11,13,16,13,15,12,12,14,13,14,13,16,13,14,10,14,14,12,11,6,13,7,5,13,13,7,2,3,3,2,2,2,1,3,4,3,1
"7718",79025853,"Juan Escobar","7/11/1995 (27 years old)","D (RC)","Cruz Azul","Mexican First Division","PAR","No","6/5/2019","6/30/2025","$90K - $275K","Right Only","Weak","Very Strong","5'10""","163 lbs","279","16",132,138,9,9,8,10,15,11,14,11,12,14,13,9,14,12,14,15,14,13,14,13,13,10,11,9,16,15,13,15,13,12,10,12,12,13,14,12,14,10,12,13,13,12,6,13,15,7,13,12,12,3,3,3,3,3,3,2,2,3,2,2
"7719",25034217,"Michal Trávník","5/17/1994 (29 years old)","DM, M/AM (C)","Sparta Prague","Czech First Division","CZE","Yes","7/1/2019","6/30/2024","$300K - $900K","Right","Fairly Strong","Very Strong","5'9""","149 lbs","260","24",120,140,14,12,13,12,14,14,12,10,4,9,13,15,12,14,14,11,14,11,13,11,12,14,9,12,13,9,14,13,12,14,13,8,8,12,11,9,15,10,10,11,11,11,12,8,13,9,10,11,10,2,2,1,1,3,3,2,4,2,3,1
"7720",25034256,"Ondřej Kolář","10/17/1994 (28 years old)","GK","Slavia Prague","Czech First Division","CZE","Yes","2/13/2020","6/30/2024","$160K - $1.6M","Right Only","Weak","Very Strong","6'4""","178 lbs","184","1",120,140,2,1,3,1,11,4,4,2,8,8,11,3,7,11,3,12,12,13,12,11,14,15,10,2,11,9,8,1,12,11,16,16,14,9,10,14,1,10,16,14,12,14,6,11,10,8,10,16,10,16,18,15,10,14,15,14,13,8,12,15
"7721",25062517,"Michal Ševčík","8/13/2002 (20 years old)","M/AM (C)","Brno","Czech Second Division","CZE","Yes","7/1/2019","6/30/2024","$0","Left","Very Strong","Fairly Strong","6'0""","158 lbs","78","18",112,140,13,10,11,11,12,13,5,12,5,6,13,11,8,15,6,12,9,10,10,12,14,12,11,10,11,10,13,10,13,12,8,5,14,13,13,10,12,18,11,8,13,9,13,11,4,5,12,16,11,2,2,3,2,1,2,1,2,4,2,2
"7722",25049956,"Matěj Chaluš","2/2/1998 (25 years old)","D (C)","FC Groningen","Keuken Kampioen Divisie","CZE","Yes","2/2/2022","12/31/2025","$70K - $700K","Right","Weak","Very Strong","6'3""","196 lbs","149","4",108,140,7,8,7,8,11,5,12,7,9,12,10,8,12,10,14,11,13,8,11,11,12,9,13,11,11,13,11,13,11,11,9,15,15,13,12,15,11,10,14,12,8,13,9,12,12,7,10,12,9,3,2,3,1,2,3,1,3,1,1,1
"7723",2000052691,"Daniel Samek","2/19/2004 (19 years old)","DM, M (C)","Salento","Italian Serie A","CZE","Yes","7/30/2022","6/30/2027","$300K - $2.9M","Right Only","Weak","Very Strong","6'0""","176 lbs","26","4",107,140,13,7,12,7,11,11,8,13,9,8,13,11,10,13,7,14,8,11,12,13,11,12,11,11,13,13,13,11,12,11,13,11,9,11,12,12,10,20,12,11,12,12,8,6,5,1,12,10,7,2,1,3,3,4,2,1,1,3,2,3
"7724",25018650,"Ladislav Krejčí","7/5/1992 (30 years old)","D/WB/M/AM (L)","Sparta Prague","Czech First Division","CZE","Yes","8/4/2020","6/30/2024","$0","Left","Very Strong","Reasonable","5'10""","134 lbs","247","31",123,140,13,13,14,9,12,13,8,9,4,6,13,13,10,14,8,11,11,11,12,10,12,14,10,14,7,15,13,15,14,13,11,8,10,13,12,10,16,15,15,16,10,16,11,12,8,1,10,10,12,3,4,1,1,3,3,3,1,2,1,1
"7725",25034173,"Lukáš Masopust","2/12/1993 (30 years old)","D/WB/M/AM (R)","Slavia Prague","Czech First Division","CZE","Yes","7/29/2022","6/30/2025","$7.2M - $8.6M","Right","Fairly Strong","Very Strong","5'10""","167 lbs","248","34",128,140,10,12,14,12,13,11,7,11,3,9,12,12,13,12,12,12,15,10,12,13,13,15,8,11,12,12,13,13,13,11,12,8,14,13,14,13,15,9,8,9,11,11,6,9,12,15,13,13,8,2,2,1,3,2,1,2,3,3,3,3
"7726",25062133,"David Jurásek","8/7/2000 (22 years old)","D/WB (L)","Slavia Prague","Czech First Division","CZE","Yes","2/9/2022","6/30/2025","$15.5M - $19M","Left Only","Very Strong","Weak","6'0""","167 lbs","105","9",132,140,9,15,11,10,13,6,10,7,4,13,13,6,13,13,16,12,14,13,15,12,14,14,12,10,12,13,14,14,15,13,12,11,11,14,14,13,15,14,15,15,14,14,10,16,13,6,14,12,10,3,2,2,3,3,4,1,3,1,1,3
"7727",25040431,"Antonín Barák","12/3/1994 (28 years old)","M/AM (C)","Fiorentina","Italian Serie A","CZE","Yes","1/31/2023","6/30/2027","$6M - $7.4M","Left","Very Strong","Reasonable","6'3""","189 lbs","234","45",135,140,10,11,14,14,15,12,14,13,4,8,15,14,12,14,11,14,13,13,12,13,13,14,13,16,9,15,13,14,11,11,14,14,14,12,13,15,11,15,12,14,10,15,12,14,11,5,14,14,13,3,3,2,2,2,1,3,3,1,2,3
"7728",5653962,"Marek Suchý","3/29/1988 (35 years old)","D (C)","Mladá Boleslav","Czech First Division","CZE","Yes","7/1/2021","6/30/2024","$60K - $600K","Right","Reasonable","Very Strong","6'0""","185 lbs","433","17",125,140,4,4,6,6,9,6,15,7,8,15,11,6,15,8,13,15,17,14,12,14,14,4,15,8,14,14,5,11,10,8,16,12,12,11,14,15,4,16,13,16,12,16,9,13,14,7,11,15,14,3,1,2,2,2,4,1,4,2,3,3
"7729",79011895,"Robert Piris Da Motta","7/26/1994 (28 years old)","DM, M (C)","Cerro Porteño","Paraguay First Division Primera División","PAR","No","1/17/2022","12/31/2024","$70K - $700K","Right","Reasonable","Very Strong","5'10""","160 lbs","301","13",123,138,7,7,8,8,9,6,9,9,5,14,12,13,16,8,15,13,15,13,13,13,12,7,11,9,14,14,9,16,12,11,15,11,13,12,16,13,14,9,7,9,12,11,7,11,15,8,13,14,12,3,2,1,1,2,3,1,1,1,1,1
"7730",25038517,"Vladimír Coufal","8/22/1992 (30 years old)","D/WB (R)","West Ham","English Premier Division","CZE","Yes","10/2/2021","6/30/2024","$30M - $36M","Right","Weak","Very Strong","5'9""","167 lbs","294","10",137,140,7,13,9,10,11,8,15,10,15,14,10,12,15,10,14,11,17,11,15,13,17,6,12,11,13,14,9,16,13,13,16,10,14,14,16,14,12,8,9,12,16,13,7,16,12,10,17,13,9,1,2,1,3,3,1,2,2,1,2,2
"7731",5646282,"Michal Kadlec","12/13/1984 (38 years old)","D (C)","Slovácko","Czech First Division","CZE","Yes","5/3/2023","6/30/2024","$14K - $130K","Left","Very Strong","Weak","6'0""","165 lbs","458","24",112,140,12,15,8,12,11,14,13,14,11,13,12,14,13,11,12,14,14,13,12,14,10,8,10,10,15,16,8,11,8,7,13,12,15,9,7,11,12,16,16,17,15,13,7,12,7,3,10,12,15,3,1,3,2,1,4,2,1,1,3,3
"7732",5651558,"Jiří Kladrubský","11/19/1985 (37 years old)","D (LC), DM","České Budějovice","Czech First Division","CZE","Yes","6/14/2021","6/30/2024","$0 - $55K","Right","Reasonable","Very Strong","6'2""","171 lbs","324","27",96,140,9,10,9,6,9,10,9,12,11,12,11,12,12,12,12,12,6,9,13,13,14,12,10,9,13,10,7,10,11,9,13,11,8,10,10,11,13,10,9,12,12,18,12,15,13,6,13,10,7,3,3,1,2,2,4,1,1,1,3,1
"7733",5640442,"Marek Matějovský","12/20/1981 (41 years old)","M/AM (C)","Mladá Boleslav","Czech First Division","CZE","Yes","6/14/2021","6/30/2024","$16K - $160K","Right","Fairly Strong","Very Strong","5'11""","169 lbs","511","23",113,139,13,13,12,10,16,16,6,13,5,9,15,14,11,15,12,17,7,15,12,16,13,16,14,11,13,13,17,11,6,7,11,8,6,7,5,9,5,10,16,17,10,15,14,13,13,8,12,13,11,2,1,2,1,2,3,3,1,1,3,2
"7734",25019787,"Pavel Kadeřábek","4/25/1992 (31 years old)","D/WB (R)","TSG Hoffenheim","Bundesliga","CZE","Yes","1/27/2022","6/30/2025","Not for Sale","Right","Reasonable","Very Strong","6'0""","178 lbs","328","23",132,139,6,15,11,8,11,7,14,11,16,12,11,8,12,11,13,13,15,11,12,12,16,10,12,15,13,15,11,17,13,11,16,13,12,13,16,13,10,17,14,16,12,17,13,14,12,3,13,15,12,1,3,1,4,1,2,2,1,1,2,3
"7735",37062676,"Michal Sadílek","5/31/1999 (24 years old)","D/WB (L), DM, M (LC)","FC Twente","Eredivisie","CZE","Yes","7/1/2022","6/30/2024","$6.4M - $9.6M","Left","Very Strong","Reasonable","5'7""","134 lbs","105","11",126,138,8,9,11,7,13,8,7,9,6,11,14,11,10,13,15,12,15,11,13,13,13,10,12,13,11,15,12,16,12,12,14,9,14,13,15,9,11,13,8,12,12,11,6,12,10,5,13,13,14,4,3,3,1,1,2,1,1,2,2,2
"7736",2000254164,"Daniel Švancara","1/3/2007 (16 years old)","M (R), AM (RL)","Brno","Czech Second Division","CZE","Yes","2/21/2023","6/30/2025","$85K - $850K","Left","Very Strong","Reasonable","5'3""","110 lbs","-","-",58,138,6,11,10,11,9,5,3,5,4,4,8,3,4,13,8,6,3,2,6,9,14,13,4,8,5,6,7,8,12,9,6,1,6,11,12,1,9,19,11,14,11,10,8,15,5,2,6,14,10,1,3,4,3,1,1,3,1,2,2,1
"7737",25057908,"Tomáš Čvančara","8/13/2000 (22 years old)","AM (R), ST (C)","Sparta Prague","Czech First Division","CZE","Yes","1/26/2022","6/30/2025","$7M - $10.5M","Right","Reasonable","Very Strong","6'3""","189 lbs","95","38",125,138,4,9,12,14,13,12,13,11,7,5,11,13,6,13,15,12,14,13,12,12,16,16,11,12,6,15,10,15,13,12,13,15,12,14,11,14,11,8,10,12,12,11,8,11,9,11,12,16,13,2,2,3,1,3,1,4,2,3,3,2
"7738",43474384,"Lukáš Vorlický","1/18/2002 (21 years old)","M (C), AM (LC)","Atalanta","Italian Serie A","CZE","Yes","7/24/2020","6/30/2025","$250K - $2.5M","Right","Reasonable","Very Strong","6'1""","167 lbs","3","-",105,138,8,11,12,11,13,10,7,12,4,5,12,9,5,13,7,13,8,13,12,9,14,14,7,10,5,9,13,11,12,13,12,12,15,13,11,13,11,9,12,15,14,13,5,12,7,7,11,15,13,3,1,4,1,3,3,2,1,3,3,1
"7739",2000056909,"Lukáš Mašek","5/8/2004 (19 years old)","M/AM (C)","Mladá Boleslav","Czech Third Division CFL B","CZE","Yes","7/1/2019","6/30/2024","$900K - $1.9M","Right","Fairly Strong","Very Strong","6'0""","163 lbs","51","8",85,138,6,4,10,9,13,6,2,8,1,6,10,6,8,12,10,10,8,7,7,9,6,13,11,13,6,4,8,6,13,13,7,6,11,13,8,4,14,17,11,10,10,11,8,10,9,6,6,12,20,2,2,1,1,2,3,3,1,2,3,1
"7740",8827714,"Osvaldo Martínez","4/8/1986 (37 years old)","M/AM (C)","Sportivo Luqueño","Paraguay First Division Primera División","PAR","No","12/10/2022","12/31/2024","Not for Sale","Right","Fairly Strong","Very Strong","5'6""","156 lbs","588","91",111,138,15,11,13,11,13,13,6,11,4,7,15,13,6,15,4,12,8,12,13,13,15,14,9,14,7,14,14,14,14,14,8,5,8,11,11,6,5,15,14,12,13,13,6,13,5,5,12,13,14,2,2,2,4,2,3,3,1,3,3,2
"7741",25006446,"Theodor Gebre Selassie","12/24/1986 (36 years old)","D/WB (R)","Slovan Liberec","Czech First Division","CZE","Yes","7/1/2021","6/30/2024","$26K - $250K","Right","Reasonable","Very Strong","5'11""","163 lbs","451","34",119,137,7,11,12,8,12,6,14,10,13,9,10,7,10,11,11,10,14,12,14,12,12,9,13,14,10,14,8,16,14,12,12,10,18,14,14,11,13,15,18,17,12,16,10,13,9,2,15,11,14,2,3,1,1,2,3,1,2,3,3,2
"7742",25002927,"Václav Pilař","10/13/1988 (34 years old)","M/AM (RL)","Viktoria Plzeň","Czech First Division","CZE","Yes","7/1/2022","6/30/2024","$0","Right","Reasonable","Very Strong","5'7""","149 lbs","274","41",113,137,11,11,16,14,16,10,5,15,8,6,11,10,8,14,14,12,8,11,11,9,14,16,8,15,8,9,9,14,12,14,12,3,12,13,9,7,12,8,15,13,10,12,16,14,8,4,11,13,9,2,1,2,2,1,1,2,3,1,2,2
"7743",2000058361,"Kryštof Daněk","1/5/2003 (20 years old)","M (C), AM (RC)","Sparta Prague","Czech Second Division","CZE","Yes","7/1/2022","6/30/2026","$0","Left","Very Strong","Reasonable","6'0""","156 lbs","85","9",110,136,9,9,14,11,14,9,9,10,7,5,11,6,11,14,8,9,8,10,4,9,14,13,1,8,10,10,14,13,15,14,13,12,10,14,9,12,18,16,8,9,10,10,13,13,9,5,20,10,17,1,1,4,1,4,1,3,3,3,1,3
"7744",25017284,"Matěj Vydra","5/1/1992 (31 years old)","AM (LC), ST (C)","Viktoria Plzeň","Czech First Division","CZE","Yes","1/23/2023","6/30/2025","Not for Sale","Right","Fairly Strong","Very Strong","5'11""","156 lbs","353","89",128,136,8,10,12,14,13,12,10,12,6,5,12,17,7,13,13,13,12,11,11,11,10,12,9,13,7,13,12,14,15,12,12,10,13,14,12,10,14,14,10,11,11,9,5,13,6,8,10,14,14,2,1,3,2,1,3,2,2,3,1,3
"7745",25022748,"Tomáš Koubek","8/26/1992 (30 years old)","GK","Augsburg","Bundesliga","CZE","Yes","8/7/2019","6/30/2024","$300K - $3.1M","Right Only","Weak","Very Strong","6'6""","216 lbs","227","-",122,136,2,1,5,1,8,2,2,2,6,6,9,5,8,8,12,12,13,10,12,12,13,5,12,6,13,10,8,8,8,16,12,17,13,9,8,16,1,8,11,8,9,15,6,11,10,12,11,8,6,12,12,15,12,14,10,12,8,13,12,15
"7746",2000053725,"Lukáš Endl","6/17/2003 (19 years old)","D (C)","Brno","Czech Second Division","CZE","Yes","9/1/2022","6/30/2025","$1.2M - $2.5M","Right","Weak","Very Strong","6'3""","176 lbs","54","2",86,136,7,7,8,3,7,2,14,9,1,12,9,6,12,7,11,12,10,7,8,7,14,5,10,8,11,12,10,10,10,10,12,10,13,12,8,14,8,18,12,10,9,10,14,14,12,3,8,12,8,1,3,2,1,1,1,1,1,4,1,2
"7747",25009592,"Václav Kadlec","5/20/1992 (31 years old)","AM (RLC), ST (C)","Viktoria Žižkov","Czech Second Division","CZE","Yes","9/2/2022","6/30/2024","$26K - $250K","Right","Fairly Strong","Very Strong","5'11""","163 lbs","227","56",80,136,6,9,11,11,11,10,8,9,4,5,11,13,5,12,12,11,14,9,7,9,12,13,6,11,4,9,7,8,11,9,9,7,12,11,6,9,13,13,12,11,8,8,6,13,8,8,9,13,5,2,2,4,3,1,1,2,1,3,3,3
"7748",2000226595,"Roman Horák","2/25/2005 (18 years old)","DM, M (C)","Sparta Prague","Czech First Division","CZE","Yes","7/19/2022","6/30/2024","$60K - $600K","Right","Fairly Strong","Very Strong","6'2""","169 lbs","-","-",82,136,6,3,4,7,13,6,6,7,6,8,13,6,13,12,8,10,8,3,6,12,12,6,11,8,6,6,13,11,11,13,6,13,5,13,7,5,14,11,11,10,12,9,5,8,5,6,10,10,18,2,3,2,3,1,1,3,1,2,1,3
"7749",5640676,"David Kobylík","6/27/1981 (41 years old)","M/AM (C)","Frenštát","Czech Fourth Division F","CZE","Yes","6/14/2021","6/30/2024","$0 - $14K","Right","Strong","Very Strong","5'10""","160 lbs","358","30",80,135,13,12,11,8,11,14,7,9,9,5,11,11,6,12,9,10,13,7,9,10,11,16,10,10,7,10,12,7,9,9,6,8,12,9,7,4,9,13,13,12,10,16,12,13,12,9,12,13,12,1,3,3,2,4,2,1,1,3,3,3
"7750",2000119695,"Kevin Huňa","4/24/2005 (18 years old)","AM (C), ST (C)","Sigma Olomouc","Czech First Division","CZE","Yes","9/2/2022","6/30/2025","$55K - $550K","Right","Strong","Very Strong","5'10""","154 lbs","-","-",80,135,6,8,10,11,9,5,7,8,4,6,8,3,4,11,12,4,6,5,7,8,14,14,11,11,9,7,11,8,13,10,7,8,8,13,14,7,12,16,14,12,13,10,12,11,15,6,19,15,12,1,2,3,4,3,1,2,3,2,2,1
"7751",79031722,"Luis Zárate","2/25/2000 (23 years old)","D (C)","Olimpia","Paraguay First Division Primera División","PAR","No","1/1/2021","12/31/2025","$140K - $1.4M","Right","Reasonable","Very Strong","6'2""","165 lbs","41","2",114,138,10,9,7,5,12,11,12,7,6,12,12,7,12,8,15,11,14,12,11,9,13,7,9,9,10,14,11,14,13,12,14,14,13,12,13,13,7,7,7,7,9,14,10,11,15,5,10,10,20,1,2,3,4,1,2,3,2,3,2,2
"7752",25019682,"Tomáš Kalas","5/15/1993 (30 years old)","D (RC)","Bristol City","Sky Bet Championship","CZE","Yes","7/1/2019","6/30/2025","$120K - $1.2M","Right Only","Weak","Very Strong","6'0""","176 lbs","331","4",113,135,3,8,10,6,11,3,12,6,17,13,11,7,12,11,14,12,16,12,11,10,14,7,12,8,13,16,9,14,13,11,12,13,13,15,13,14,14,14,14,15,12,10,8,10,10,8,13,13,12,1,3,1,3,2,2,2,1,2,1,2
"7753",85111795,"Serhou Guirassy","3/12/1996 (27 years old)","ST (C)","Rennes","Ligue 1 Uber Eats","GUI","Yes","8/27/2020","6/30/2027","$7.6M - $9.6M","Right","Reasonable","Very Strong","6'2""","180 lbs","223","65",148,152,4,7,13,16,14,13,15,13,6,5,12,16,6,13,12,15,14,14,13,14,15,13,11,15,6,14,12,14,13,12,15,15,14,15,15,15,8,12,12,15,14,14,10,12,8,8,16,16,13,1,1,2,1,1,2,2,3,4,2,1
"7754",48036643,"Mouctar Diakhaby","12/19/1996 (26 years old)","D (C), DM","Valencia","Spanish First Division","GUI","Yes","1/16/2023","6/30/2027","$20M - $25M","Right","Weak","Very Strong","6'4""","176 lbs","161","8",142,149,6,6,12,7,11,6,16,6,6,14,13,10,14,10,14,13,15,14,12,13,15,8,13,8,15,14,12,15,13,12,14,16,15,13,16,16,8,12,15,16,13,12,5,13,12,8,12,14,15,1,3,1,3,2,2,3,2,1,1,1
"7755",49055608,"Saïdou Sow","7/4/2002 (20 years old)","D (C)","ASSE","French National 3 - Group K","GUI","Yes","5/26/2021","6/30/2026","$130K - $7.2M","Right","Weak","Very Strong","6'0""","165 lbs","53","2",110,146,5,7,11,6,10,5,13,7,10,14,8,8,15,10,12,12,14,11,12,11,15,8,10,12,13,12,9,13,11,11,13,12,14,13,12,12,10,12,12,10,13,13,7,14,10,7,11,14,14,4,1,2,2,2,3,3,1,3,1,2
"7756",67279753,"Ilaix Moriba","1/19/2003 (20 years old)","DM, M/AM (C)","RB Leipzig","Bundesliga","GUI","Yes","8/31/2021","6/30/2026","$8.2M - $10M","Right","Fairly Strong","Very Strong","6'1""","160 lbs","73","3",125,144,12,10,14,10,14,11,12,13,6,9,13,11,13,15,16,11,15,12,10,12,13,16,7,12,10,11,13,13,12,13,14,12,12,13,13,12,12,8,7,8,7,9,8,10,12,16,10,11,8,3,2,3,3,1,2,3,3,2,1,2
"7757",13194004,"Seydouba Cissé","2/10/2001 (22 years old)","M (RC)","Leganés","Spanish Second Division","GUI","No","2/24/2022","6/30/2026","$6.4M","Right","Reasonable","Very Strong","5'10""","158 lbs","70","8",115,142,4,12,13,13,14,4,11,7,3,9,13,8,10,12,8,13,12,10,13,10,10,12,10,12,12,13,15,13,14,13,12,6,13,12,13,13,12,10,12,10,12,9,10,13,8,7,12,15,14,3,1,4,2,1,2,3,3,4,3,3
"7758",13158286,"Morlaye Sylla","7/27/1998 (24 years old)","M (C), AM (LC)","Arouca","Portuguese Premier League","GUI","No","6/24/2022","6/30/2025","$95K - $6.8M","Right","Reasonable","Very Strong","5'7""","141 lbs","80","10",133,140,14,13,14,12,14,15,7,15,11,11,14,17,9,14,15,11,12,12,8,12,13,14,9,14,11,12,15,15,12,13,14,7,14,12,14,14,14,19,12,13,7,11,11,13,7,5,13,7,11,3,2,3,1,2,2,3,3,1,1,2
"7759",89058721,"Mady Camara","2/28/1997 (26 years old)","DM, M (C)","Olympiacos","Greek Super League 1","GUI","No","2/12/2021","6/30/2024","$7M - $8.6M","Right","Reasonable","Very Strong","6'0""","178 lbs","174","17",130,140,7,10,13,10,12,8,9,10,8,12,13,8,14,13,16,12,16,12,11,12,15,10,9,13,11,13,12,16,15,13,13,11,16,14,16,14,12,13,9,13,12,8,7,12,15,8,12,15,14,3,1,2,3,2,2,2,2,2,1,2
"7760",2000259250,"Moussa Soumah","12/31/2006 (16 years old)","AM (C)","Borussia Dortmund","Bundesliga","GUI","No","1/1/2023","6/30/2025","$475K - $4.7M","Left","Very Strong","Reasonable","5'7""","125 lbs","-","-",76,138,6,3,8,11,13,6,6,10,3,6,7,4,7,13,12,4,7,7,3,13,5,13,9,4,7,7,13,12,11,12,7,3,7,12,12,1,11,20,12,10,10,10,10,13,6,6,17,8,15,2,2,3,3,3,3,3,1,2,1,3
"7761",13194490,"Mohamed Camara","8/28/1997 (25 years old)","D (C)","Young Boys","Swiss Super League","GUI","No","5/14/2021","6/30/2024","$6.6M - $10M","Right","Reasonable","Very Strong","6'3""","176 lbs","119","8",135,138,5,7,10,7,11,6,15,7,8,14,12,3,15,12,14,13,14,12,10,12,13,7,14,10,12,12,10,13,13,12,14,16,14,14,15,15,12,12,19,14,11,11,5,13,12,6,14,13,13,2,3,2,4,1,1,3,2,1,1,2
"7762",79031786,"Miguel Martínez","9/29/1998 (24 years old)","GK","Cerro Porteño","Paraguay First Division Primera División","PAR","No","2/1/2020","12/31/2025","$120K - $1.2M","Right","Reasonable","Very Strong","6'2""","171 lbs","63","-",105,138,3,1,1,3,7,5,1,3,2,1,14,2,1,8,6,10,15,9,9,10,14,1,6,1,14,9,8,8,12,13,11,11,9,8,12,11,12,10,13,10,10,13,11,9,7,7,7,10,8,12,11,13,13,8,12,13,15,14,13,8
"7763",2000163008,"Ousmane Coumbassa","7/27/2001 (21 years old)","DM, M (C)","O. Béja","Ligue Professionnelle 1","GUI","No","9/1/2021","6/30/2025","$350K - $3.5M","Right Only","Weak","Very Strong","5'10""","160 lbs","34","1",100,136,5,8,10,6,11,5,6,7,4,11,12,6,14,10,14,15,14,10,13,9,19,11,13,11,12,15,11,15,13,13,12,7,14,13,14,8,8,11,11,12,11,12,15,9,12,8,13,11,13,3,2,2,3,3,2,3,2,1,4,2
"7764",67213719,"Sory Kaba","4/10/1995 (28 years old)","ST (C)","Cardiff","Sky Bet Championship","GUI","No","6/15/2020","6/30/2024","$190K - $1.9M","Right","Reasonable","Very Strong","6'3""","176 lbs","209","72",122,135,4,9,9,11,10,6,14,9,6,6,10,12,6,12,14,14,15,13,11,12,14,12,9,13,10,14,9,16,12,14,15,16,15,13,15,16,9,13,11,14,8,8,6,9,13,10,12,16,10,1,1,2,2,3,1,2,4,3,1,3
"7765",49038311,"Mohamed Bayo","6/4/1998 (25 years old)","AM (RL), ST (C)","LOSC","Ligue 1 Uber Eats","GUI","Yes","7/13/2022","6/30/2027","$10M - $12.5M","Right","Weak","Very Strong","6'2""","167 lbs","137","54",126,135,8,11,12,14,11,10,13,8,9,9,12,13,7,13,10,13,13,15,13,13,10,12,11,13,12,9,8,12,12,11,14,14,14,13,13,15,10,12,12,13,10,14,9,11,9,8,13,12,11,1,3,3,3,3,2,3,1,1,2,3
"7766",2000144627,"Dembo Sylla","11/10/2002 (20 years old)","D/WB/M (R)","Laval MFC","Ligue 2 BKT","GUI","Yes","7/1/2019","6/30/2026","$130K - $1.3M","Right","Weak","Very Strong","5'9""","149 lbs","30","-",107,134,10,15,11,5,14,10,7,10,8,11,11,6,14,16,14,14,10,12,8,13,13,5,14,9,12,11,9,9,12,12,10,8,9,13,11,10,12,11,12,13,12,12,5,14,6,7,12,9,19,2,3,1,1,2,3,3,1,1,1,2
"7767",2000247701,"Moussa Conté","4/15/2004 (19 years old)","DM, M (C)","CS Sfax","Ligue Professionnelle 1","GUI","No","1/31/2023","6/30/2026","$3.4M - $6.8M","Right","Fairly Strong","Very Strong","6'0""","176 lbs","15","-",106,134,8,11,10,9,13,5,11,9,2,9,14,10,12,13,13,11,12,11,9,12,9,7,10,12,10,13,12,12,10,9,12,14,13,12,11,12,15,18,11,11,8,12,9,9,9,7,12,11,7,2,2,2,3,4,4,1,2,1,1,3
"7768",2000159355,"Ibrahim Diakité","10/31/2003 (19 years old)","D/WB (R)","Reims","French National 3 - Group I","GUI","Yes","1/12/2023","6/30/2026","$190K - $1.9M","Right","Weak","Very Strong","5'10""","163 lbs","13","-",95,132,7,11,10,5,11,4,9,5,10,10,12,5,10,11,13,11,12,8,11,12,11,5,10,10,11,11,11,10,13,9,10,10,13,10,10,10,13,19,12,11,12,11,7,1,10,6,10,11,11,2,2,2,2,2,2,3,1,1,1,1
"7769",25062818,"Cheick Conde","7/26/2000 (22 years old)","DM, M (C)","Zürich","Swiss Super League","GUI","No","6/22/2022","6/30/2026","$400K - $4M","Right","Reasonable","Very Strong","6'1""","160 lbs","107","1",116,131,7,7,11,6,13,6,14,10,5,13,12,7,13,11,14,13,14,13,12,12,5,8,9,11,11,14,12,14,12,10,15,13,16,12,15,14,17,20,10,12,10,10,6,5,12,8,20,12,11,2,3,2,2,3,1,3,2,2,1,2
"7770",67055998,"Florentin Pogba","8/19/1990 (32 years old)","D (LC)","Kolkata","Indian National Division","GUI","Yes","6/25/2022","5/31/2024","$0 - $120K","Left Only","Very Strong","Weak","6'4""","205 lbs","234","9",110,130,5,11,9,8,12,12,15,10,8,12,10,6,11,12,12,11,15,11,12,11,15,7,13,10,12,13,11,14,12,12,16,14,14,12,14,16,10,12,11,12,8,15,7,13,7,7,12,14,8,1,1,3,2,3,2,2,2,3,3,1
"7771",2000168273,"Moustapha Cissé","9/14/2003 (19 years old)","ST (C)","Südtirol","Italian Serie B","GUI","No","8/12/2022","6/30/2025","$1.3M - $2.8M","Right","Reasonable","Very Strong","6'0""","165 lbs","21","3",101,130,6,8,11,12,11,6,10,8,6,5,10,9,5,11,8,13,11,12,10,11,16,12,7,12,6,9,8,12,12,11,13,12,14,13,12,13,8,18,12,16,14,8,6,13,8,7,13,17,18,1,2,2,3,4,2,1,3,1,3,3
"7772",2000098063,"Naby Camara","12/3/2001 (21 years old)","DM, M (C)","CS Sfax","Ligue Professionnelle 1","GUI","No","9/15/2020","6/30/2024","$100K - $1M","Left Only","Very Strong","Weak","5'10""","156 lbs","38","1",100,130,8,11,13,7,14,6,5,7,10,12,14,5,12,14,10,11,8,12,9,11,11,14,4,12,10,13,12,12,12,13,13,6,12,11,12,7,13,12,12,10,10,9,7,4,9,7,12,11,8,3,2,2,1,3,3,2,1,2,1,2
"7773",2000184179,"Milciades Adorno","1/27/2005 (18 years old)","ST (C)","Sportivo Ameliano","Paraguay First Division Primera División","PAR","No","1/1/2022","12/31/2025","$75K - $750K","Right","Reasonable","Very Strong","5'9""","158 lbs","11","1",94,138,10,9,8,11,10,10,12,7,2,9,9,8,9,9,12,9,14,9,9,8,12,7,7,12,7,13,9,14,12,11,12,12,13,12,11,12,12,16,12,12,11,9,5,12,9,1,9,9,9,1,2,2,4,3,2,3,3,1,2,2
"7774",36515298,"François Kamano","5/1/1996 (27 years old)","AM (RL), ST (C)","Lokomotiv Moscow","Russian Premier League","GUI","No","8/17/2020","6/30/2023","$50K - $500K","Right","Reasonable","Very Strong","5'9""","167 lbs","229","42",120,130,9,8,13,11,12,9,6,10,5,3,11,12,9,13,9,10,8,11,12,10,11,14,8,11,6,9,11,10,15,16,11,9,14,15,13,10,12,16,13,8,11,10,12,11,7,6,9,15,14,1,1,3,2,1,2,3,3,3,4,1
"7775",34008678,"Fodé Koita","10/21/1990 (32 years old)","ST (C)","Trabzonspor","Turkish Super League","GUI","Yes","6/28/2021","6/30/2024","$0","Left","Very Strong","Reasonable","6'1""","189 lbs","259","43",105,130,1,7,11,14,13,5,16,10,1,5,11,12,5,14,12,13,13,13,11,13,15,13,6,13,8,9,12,8,11,12,10,14,13,7,10,14,5,14,14,9,13,9,13,14,12,9,10,15,7,2,2,2,1,1,3,1,1,3,2,2
"7776",85125565,"Issiaga Sylla","1/1/1994 (29 years old)","D/WB (L)","Montpellier","Ligue 1 Uber Eats","GUI","No","1/31/2023","6/30/2025","$5.6M - $10.5M","Left","Very Strong","Weak","5'11""","165 lbs","263","11",127,130,9,10,12,10,11,9,13,9,13,13,11,7,13,11,13,13,14,11,10,11,12,8,6,11,13,14,9,15,15,14,13,13,14,14,15,14,8,12,12,14,9,13,7,12,13,5,12,12,14,3,3,2,2,2,2,3,2,2,3,4
"7777",13193997,"Aguibou Camara","5/20/2001 (22 years old)","M (C), AM (RLC)","Atromitos","Greek Super League 1","GUI","No","7/13/2021","6/30/2025","$2.4M - $4.9M","Right","Reasonable","Very Strong","5'6""","121 lbs","45","8",115,130,12,12,14,9,12,12,5,10,2,10,12,8,10,13,14,11,12,11,8,9,13,13,7,12,9,12,12,15,14,16,13,7,15,12,14,6,11,8,12,13,12,10,6,12,10,6,11,13,14,2,1,4,2,1,1,4,2,3,2,1
"7778",67158500,"Bouba","6/1/1993 (30 years old)","GK","Los Garres","Spanish Territorial Preferente Murcia","GUI","No","1/2/2021","6/30/2024","$0 - $75K","Right","Reasonable","Very Strong","6'0""","167 lbs","201","-",80,128,3,2,1,3,1,4,1,1,1,1,5,1,2,3,12,9,13,5,9,13,9,2,13,1,9,7,6,6,12,13,7,6,15,13,4,4,13,14,9,9,11,11,6,9,11,3,20,12,20,12,12,13,12,9,10,13,5,10,6,11
"7779",13205357,"Tidiane Doumbouya","8/2/2002 (20 years old)","M (C)","SCC Mohammedia","Botola Pro 1","GUI","No","7/1/2020","6/30/2024","$210K - $600K","Right","Reasonable","Very Strong","5'6""","134 lbs","-","-",86,128,4,6,12,7,12,6,5,10,6,8,13,2,11,13,13,7,2,6,6,13,9,5,8,10,8,7,13,12,11,8,13,4,11,10,13,3,12,18,9,12,12,10,9,5,9,3,16,7,8,2,2,2,1,1,1,3,2,1,3,1
"7780",2000227523,"Lass Kourouma","3/30/2004 (19 years old)","DM, M/AM (C)","Levante B","Spanish Federation Third Group 6","GUI","No","7/1/2022","6/30/2025","$14K - $140K","Right","Reasonable","Very Strong","5'11""","169 lbs","-","-",78,127,6,3,14,14,14,7,7,14,1,9,14,5,12,14,15,10,8,5,9,13,7,13,7,6,7,13,7,9,11,7,5,11,6,10,8,5,12,16,11,11,11,13,8,13,7,2,12,11,14,3,3,3,3,3,3,2,3,2,3,3
"7781",49048389,"Amadou Traoré","7/3/2002 (20 years old)","M/AM (R)","Sporting KC","Major League Soccer","GUI","Yes","1/16/2023","11/30/2023","$0","Right Only","Weak","Very Strong","5'10""","171 lbs","31","-",95,125,8,11,13,8,13,10,6,7,4,5,10,9,5,14,6,10,9,9,8,9,12,12,7,12,7,8,10,10,14,14,12,8,12,13,9,9,15,18,10,13,12,11,8,4,6,2,11,10,9,3,3,3,3,1,2,3,4,3,1,1
"7782",13222415,"Naby Youssouf Oularé","8/6/2002 (20 years old)","D (RC)","Boluspor","Turkish 1. League","GUI","No","8/5/2022","6/30/2027","$14K - $130K","Right","Reasonable","Very Strong","6'2""","176 lbs","27","3",90,125,7,14,8,5,12,3,11,7,9,10,11,7,10,10,14,13,8,8,10,9,4,5,9,12,9,10,10,11,12,10,13,14,15,10,10,14,12,14,12,9,13,10,12,3,8,6,10,12,19,1,3,2,3,2,2,3,2,3,2,3
"7783",85065524,"Julian Jeanvier","3/31/1992 (31 years old)","D (C)","AJ Auxerre","Ligue 2 BKT","GUI","Yes","8/2/2022","6/30/2023","$14K - $140K","Right","Weak","Very Strong","6'1""","185 lbs","185","11",117,125,5,9,10,7,12,5,14,7,10,12,12,7,13,12,12,12,15,12,12,11,15,8,11,7,13,13,11,13,12,11,15,14,15,13,13,14,12,11,11,12,12,13,14,13,13,5,12,14,11,3,1,2,2,2,1,3,3,3,2,1
"7784",79028813,"Cristhian Paredes","5/18/1998 (25 years old)","DM, M (C)","Portland","Major League Soccer","PAR","No","3/2/2022","12/31/2025","$1.5M - $3.2M","Right","Reasonable","Very Strong","5'11""","160 lbs","148","14",110,137,11,8,9,7,12,7,11,13,9,12,12,8,11,15,11,13,11,13,10,10,13,8,8,13,11,11,12,12,13,13,11,11,15,13,11,10,14,13,9,12,13,13,8,12,9,8,11,12,11,3,1,3,4,3,1,2,3,1,3,2
"7785",93124091,"Ousmane Camara","12/28/1998 (24 years old)","AM (RLC)","Dinamo Tb.","Georgian National League","GUI","No","1/1/2022","12/31/2024","$35K - $350K","Right","Fairly Strong","Very Strong","5'6""","149 lbs","131","26",97,125,5,6,12,7,11,6,6,7,5,3,7,6,4,12,8,7,6,7,8,7,13,15,4,10,4,10,8,10,17,16,11,5,12,14,10,7,9,9,11,11,11,9,13,13,6,3,8,12,12,2,1,1,3,3,1,3,2,2,3,2
"7786",83240716,"Ibrahima Camará","1/25/1999 (24 years old)","DM, M (C)","BVT","Portuguese Premier League","GUI","No","8/30/2022","6/30/2026","$300K - $3M","Right","Reasonable","Very Strong","6'3""","171 lbs","102","3",115,125,10,10,11,8,12,10,10,12,7,12,11,7,11,13,13,13,12,11,13,11,12,11,8,11,12,13,12,11,11,10,12,16,15,13,15,16,5,13,15,7,10,12,5,8,10,7,12,16,14,3,2,2,3,1,1,3,3,1,1,2
"7787",2000102719,"Abdoulaye Kamara","11/6/2004 (18 years old)","DM, M (C)","Borussia Dortmund","Bundesliga","GUI","Yes","7/23/2021","6/30/2025","$150K - $1.5M","Right","Reasonable","Very Strong","6'0""","169 lbs","34","1",98,124,8,7,12,7,13,7,9,8,6,11,13,8,12,13,14,9,12,11,9,9,13,12,8,8,12,11,12,12,12,13,12,11,9,12,12,11,10,8,9,8,9,11,13,15,8,10,12,12,7,2,2,3,3,1,1,2,1,1,3,2
"7788",18110634,"Amadou Keita","10/28/2001 (21 years old)","M (C), AM (R)","Eupen","Jupiler Pro League","GUI","Yes","7/1/2019","6/30/2026","$180K - $1.8M","Right","Weak","Very Strong","5'7""","171 lbs","1","-",91,123,9,11,10,8,15,9,7,11,2,9,13,2,10,13,11,10,12,7,5,11,8,13,14,15,12,10,11,14,12,11,10,6,8,11,11,2,15,17,10,12,11,9,6,13,9,5,12,11,16,2,1,2,3,1,1,3,2,2,2,1
"7789",2000276153,"M'bemba Bangoura","12/13/2003 (19 years old)","AM (R)","Teungueth FC","Senegalese Ligue 1","GUI","No","7/1/2021","6/30/2025","$0","Right Only","Weak","Very Strong","5'7""","147 lbs","8","-",88,122,11,11,12,9,10,5,2,9,3,3,9,8,5,12,14,8,7,8,9,7,14,16,6,10,2,10,9,11,16,14,8,6,10,12,11,8,10,16,13,15,10,12,10,8,9,1,11,12,19,3,2,4,3,3,3,1,1,2,2,3
"7790",85050640,"Mohamed Yattara","7/28/1993 (29 years old)","ST (C)","Pau FC","Ligue 2 BKT","GUI","No","8/16/2022","6/30/2025","$110K - $1.1M","Left","Very Strong","Reasonable","6'1""","174 lbs","237","48",107,121,5,7,12,12,11,7,12,12,5,6,9,10,5,12,11,10,14,11,10,8,11,12,7,14,7,10,10,13,13,12,13,12,13,14,13,13,5,10,10,8,10,12,10,14,9,8,11,13,7,1,3,4,3,2,3,2,1,4,2,2
"7791",43223311,"Amadou Diawara","7/17/1997 (25 years old)","DM, M (C)","RSC Anderlecht","Jupiler Pro League","GUI","Yes","8/31/2022","6/30/2025","$6M - $7.4M","Right","Reasonable","Very Strong","6'0""","167 lbs","164","4",120,121,7,8,11,7,15,7,10,8,8,13,12,8,13,12,13,14,13,15,10,10,15,8,8,9,15,13,12,12,12,13,17,11,15,11,15,14,8,12,11,15,11,12,8,7,14,7,9,14,16,4,1,2,1,3,1,1,4,3,1,3
"7792",85145735,"Ernest Seka","6/22/1987 (35 years old)","D (C)","Poissy FC","French Regional 1 - Paris Ile de France - Group A","GUI","Yes","7/30/2022","-","$0","Right Only","Weak","Very Strong","6'1""","196 lbs","394","16",100,121,3,6,6,5,10,5,14,5,4,12,9,7,12,8,14,13,12,13,10,11,15,8,13,6,13,12,8,13,10,12,13,13,14,10,12,13,7,10,8,14,13,12,6,11,12,10,11,14,16,1,1,2,3,2,1,1,3,3,3,1
"7793",2000198491,"Florent Guilavogui","7/8/2006 (16 years old)","D (C)","QRM","Ligue 2 BKT","GUI","No","7/1/2022","6/30/2026","$30K - $300K","Right Only","Weak","Very Strong","6'0""","176 lbs","-","-",70,121,7,5,6,1,8,4,12,1,3,12,8,1,11,6,15,5,9,8,5,14,13,5,13,4,11,7,6,5,10,13,8,12,13,13,5,7,11,15,12,11,10,10,10,11,6,6,18,15,16,3,4,3,2,3,2,3,1,1,2,2
"7794",67179381,"Jose Kante","9/27/1990 (32 years old)","AM (RC), ST (C)","Urawa","J1 League","GUI","Yes","3/13/2023","1/31/2025","Not for Sale","Right","Reasonable","Very Strong","6'0""","176 lbs","274","85",119,120,4,8,13,11,14,5,13,4,8,6,12,13,7,14,13,12,8,9,13,12,12,14,5,15,6,12,12,14,11,13,15,12,9,11,12,14,11,14,14,9,10,7,11,9,5,4,12,9,14,4,3,3,3,2,2,1,3,3,3,3
"7795",79029254,"Mathías Villasanti","1/24/1997 (26 years old)","DM, M (C)","GRE","Brazilian National First Division","PAR","No","8/12/2021","12/31/2024","$5.8M - $8.8M","Right","Reasonable","Very Strong","5'10""","156 lbs","177","12",130,137,6,11,12,11,13,7,13,12,10,13,13,8,13,13,14,14,14,13,12,13,13,9,13,12,13,15,12,15,13,13,13,12,14,13,14,12,15,8,8,14,12,12,4,13,13,1,14,12,8,3,4,1,3,3,3,3,3,1,2,2
"7796",13173997,"Aboubacar Bangoura","7/7/1994 (28 years old)","ST (C)","AS Kaloum","Guinean Premier Division","GUI","No","7/1/2019","6/30/2024","$9K - $28K","Right","Reasonable","Very Strong","6'1""","169 lbs","-","-",82,120,6,6,11,13,12,4,11,7,3,4,7,7,1,7,10,8,6,13,7,12,2,12,6,9,7,2,5,7,13,13,7,10,12,13,7,6,12,12,11,9,11,11,13,14,14,1,11,10,20,2,1,3,2,3,3,2,1,2,2,1
"7797",2000016986,"Yakhouba Barry","4/17/1998 (25 years old)","AM (R), ST (C)","Horoya AC","Guinean Premier Division","GUI","No","7/1/2021","6/30/2026","$0 - $100K","Right","Reasonable","Very Strong","6'2""","189 lbs","-","-",110,120,9,11,11,14,12,9,10,10,2,9,13,8,9,13,8,10,8,13,9,14,3,12,12,11,10,13,10,11,11,10,14,10,11,10,10,14,12,20,12,13,12,11,12,1,8,8,17,12,13,3,2,3,1,4,1,4,3,3,2,2
"7798",85046982,"Guy Michel Landel","7/3/1990 (32 years old)","M (C)","Boluspor","Turkish 1. League","GUI","Yes","7/27/2022","6/30/2024","$30K - $300K","Right","Reasonable","Very Strong","5'8""","154 lbs","253","30",100,120,7,9,12,11,13,9,8,12,5,4,13,8,9,13,11,10,11,11,11,7,13,15,7,13,9,10,12,14,14,15,8,7,13,12,16,9,10,15,15,13,14,12,10,10,10,7,11,14,14,4,1,1,3,2,2,3,1,3,2,3
"7799",13200571,"Aly Soumah","1/10/2000 (23 years old)","M (L), AM (RL)","ES Sahel","Ligue Professionnelle 1","GUI","No","7/1/2018","6/30/2024","$1.5K - $14K","Left Only","Very Strong","Weak","5'9""","152 lbs","31","3",98,120,7,11,13,9,10,7,9,11,7,5,11,10,5,12,11,12,8,9,9,9,7,14,9,10,5,10,11,10,14,13,9,11,12,14,11,7,14,19,12,12,11,12,13,4,11,4,10,13,7,1,2,2,2,1,1,2,2,1,1,1
"7800",59134622,"Ibrahima Sory Soumah","1/1/1998 (25 years old)","DM, M (C)","Sokolov","Czech Lower Division","GUI","No","3/1/2023","6/30/2024","$20K - $190K","Right Only","Weak","Very Strong","6'1""","163 lbs","17","2",92,120,6,6,8,8,10,8,8,8,4,12,12,4,13,10,14,12,14,10,10,11,14,6,10,6,12,15,8,14,11,10,11,11,14,11,13,12,8,19,13,12,13,6,5,12,8,5,13,12,10,2,2,3,2,3,1,3,2,1,1,2
"7801",2000098005,"Ousmane Camara","1/23/2001 (22 years old)","AM (R), ST (C)","Sharjah","UAE Professional League","GUI","No","10/4/2022","5/31/2026","$2.9M - $6M","Right","Weak","Very Strong","6'0""","171 lbs","58","12",105,120,7,8,10,12,10,5,10,9,6,8,9,6,7,11,13,11,13,11,9,12,13,12,7,12,9,12,9,12,14,12,13,12,12,14,13,12,13,11,15,15,11,11,15,4,7,2,20,16,9,1,3,1,3,1,1,3,1,2,1,3
"7802",48044086,"Abdoulaye Sylla","4/10/2000 (23 years old)","D (RC)","Seraing FC","Belgian Challenger Pro League","GUI","No","2/27/2022","6/30/2024","$150K - $1.5M","Right","Weak","Very Strong","5'11""","158 lbs","26","-",105,120,5,12,8,3,8,3,14,7,4,13,5,8,12,4,11,11,10,6,12,14,14,5,11,8,10,8,5,9,14,14,9,9,14,14,9,7,16,20,10,14,12,11,8,4,12,4,9,11,11,1,1,1,3,2,3,3,2,3,3,4
"7803",13158291,"Moussa Pinpin Camara","11/27/1998 (24 years old)","GK","Horoya AC","Guinean Premier Division","GUI","No","6/15/2020","6/30/2025","$2K - $20K","Right","Reasonable","Very Strong","6'1""","169 lbs","-","-",104,120,4,1,2,1,6,6,1,3,1,3,8,2,1,3,13,10,12,9,10,14,16,3,5,1,10,9,8,7,12,12,8,9,12,13,7,7,12,15,12,11,9,11,7,4,12,7,20,12,15,10,5,14,5,12,14,11,5,7,14,14
"7804",43393512,"Ibrahim Karamoko","7/23/2001 (21 years old)","DM, M (C)","EA Guingamp","French National 2 - C","GUI","Yes","7/8/2022","6/30/2026","$0","Right","Weak","Very Strong","6'2""","156 lbs","19","-",91,120,6,8,10,8,11,7,11,10,11,10,12,11,11,11,16,9,13,9,8,9,15,8,8,8,11,8,9,12,12,11,10,11,15,13,11,9,16,15,11,13,11,12,3,12,7,6,10,11,12,3,2,3,1,1,3,1,3,2,2,1
"7805",2000312675,"Sory Traoré","3/18/2005 (18 years old)","AM (RL)","Horoya AC","Guinean Premier Division","GUI","No","9/21/2022","6/30/2024","$1K - $8K","Left","Very Strong","Reasonable","5'10""","149 lbs","-","-",80,119,7,12,9,13,14,7,2,8,7,7,14,2,8,14,12,8,6,7,7,9,3,13,2,13,5,8,8,11,10,13,8,4,9,13,7,5,12,16,12,9,10,12,11,19,8,2,9,13,18,2,1,1,2,1,3,1,1,2,3,1
"7806",8828106,"Oscar Cardozo","5/20/1983 (40 years old)","ST (C)","Libertad","Paraguay First Division Primera División","PAR","Yes","6/14/2021","12/31/2024","Not for Sale","Left","Very Strong","Reasonable","6'4""","216 lbs","585","297",116,150,9,12,12,16,14,14,14,15,9,6,13,15,5,14,11,15,11,14,10,11,10,11,13,13,6,11,13,8,8,8,15,15,12,8,12,15,4,12,13,13,16,10,8,12,8,11,9,16,11,3,2,2,2,1,3,2,2,2,2,1
"7807",79000041,"Marcos Cáceres","5/5/1986 (37 years old)","D (RC)","Guaraní (PAR)","Paraguay First Division Primera División","PAR","No","7/1/2021","12/31/2024","Not for Sale","Right Only","Weak","Very Strong","6'1""","180 lbs","421","22",117,137,8,8,7,7,12,7,13,8,13,14,10,8,13,9,13,13,14,11,14,11,16,9,10,8,13,11,6,13,12,11,14,14,14,13,14,13,11,11,11,13,13,14,14,13,13,8,13,12,14,2,1,1,1,1,2,2,1,2,1,2
"7808",50053162,"Ousmane Kanté","9/21/1989 (33 years old)","D (C)","Paris FC","Ligue 2 BKT","GUI","Yes","7/1/2018","6/30/2024","$28K - $300K","Right Only","Weak","Very Strong","6'0""","178 lbs","205","16",110,119,6,8,7,5,10,4,13,6,6,13,10,7,13,8,14,11,15,12,12,10,14,7,14,7,12,13,8,12,12,11,14,12,14,12,13,15,7,11,10,11,12,10,8,15,12,3,11,13,11,2,2,2,3,2,2,3,3,3,3,1
"7809",2000195626,"Yankuba Minteh","7/22/2004 (18 years old)","M/AM (RL)","OB","3F Superliga","GAM","No","8/19/2022","12/31/2024","$5.2M - $7.8M","Left","Very Strong","Fairly Strong","5'11""","143 lbs","17","4",125,163,12,11,14,9,13,11,7,9,7,3,11,6,3,13,13,14,10,10,9,8,12,13,5,12,4,11,12,11,17,15,10,8,12,17,10,7,10,14,12,9,6,10,5,10,9,12,12,14,13,3,2,3,3,2,1,2,1,3,1,3
"7810",13227297,"James Gomez","11/14/2001 (21 years old)","D (C)","AC Horsens","NordicBet Liga","GAM","No","1/20/2020","6/30/2024","$1.4M - $3M","Right","Reasonable","Very Strong","6'2""","176 lbs","75","2",114,150,5,5,6,5,9,5,14,5,9,12,10,6,13,8,13,12,14,11,12,12,15,4,10,7,11,11,9,14,12,11,12,15,15,14,13,15,6,10,14,12,13,10,4,13,6,4,13,14,13,3,3,1,2,2,1,1,1,1,1,4
"7811",43372270,"Musa Barrow","11/14/1998 (24 years old)","AM (LC), ST (C)","Bologna","Italian Serie A","GAM","No","7/1/2021","6/30/2024","$6.8M - $10.5M","Right","Reasonable","Very Strong","6'0""","167 lbs","163","30",135,145,14,14,14,13,14,12,12,14,5,4,13,12,5,14,9,12,10,12,11,11,8,14,7,13,4,13,12,11,15,14,14,11,13,15,13,11,13,12,14,16,11,12,5,10,10,8,9,10,14,2,1,2,2,4,3,2,1,3,2,1
"7812",43474378,"Ebrima Colley","2/1/2000 (23 years old)","AM (RLC), ST (C)","Atalanta","Italian Serie A","GAM","No","7/24/2019","6/30/2025","$130K - $1.3M","Right","Reasonable","Very Strong","5'11""","165 lbs","66","2",110,142,7,9,14,8,12,10,8,9,3,4,11,7,5,11,8,10,9,11,11,10,16,13,7,13,4,9,10,11,14,15,12,7,15,13,12,9,13,11,13,17,15,14,5,12,7,7,11,16,15,4,1,2,2,1,2,2,2,2,2,2
"7813",13227290,"Alieu Fadera","11/3/2001 (21 years old)","AM (L)","Zulte Waregem","Belgian Challenger Pro League","GAM","No","8/4/2021","6/30/2026","$275K - $8.2M","Right","Reasonable","Very Strong","5'11""","167 lbs","85","14",117,140,11,12,14,13,13,11,9,9,11,10,11,8,9,11,18,11,14,10,10,11,16,11,6,14,9,15,10,14,13,12,12,13,10,13,13,10,17,17,10,9,9,12,10,12,11,6,11,12,7,2,3,1,4,1,1,2,2,2,2,1
"7814",43617224,"Ebrima Darboe","6/6/2001 (22 years old)","DM, M (C)","AS Roma","Italian Serie A","GAM","No","12/29/2021","6/30/2026","$140K - $1.4M","Right","Reasonable","Very Strong","5'9""","152 lbs","6","-",112,140,6,7,12,9,14,6,7,7,6,11,15,8,9,13,12,12,13,12,9,11,13,8,3,10,14,13,12,14,12,14,11,9,14,11,14,8,10,14,14,13,13,10,5,13,10,4,11,17,14,1,2,4,2,1,1,2,4,2,2,2
"7815",12094515,"Salim Ceesay","11/24/2004 (18 years old)","M (RC)","Wallidan FC","Gambian Premier Division","GAM","No","7/1/2020","6/30/2024","$7K - $70K","Right","Reasonable","Very Strong","6'4""","176 lbs","-","-",82,138,7,9,10,9,14,7,7,14,3,9,12,3,14,14,6,6,8,5,6,11,13,5,10,12,8,9,11,12,12,9,10,15,9,11,8,6,14,14,12,12,10,13,12,14,15,2,10,12,17,1,1,3,2,2,1,2,3,2,2,3
"7816",2000179791,"Sellou Jallow","6/16/2006 (16 years old)","M/AM (C)","Banjul Hawks","Gambian Second Division","GAM","No","6/13/2022","6/30/2026","$1K - $12K","Left","Very Strong","Reasonable","5'8""","132 lbs","-","-",70,137,6,5,13,8,13,4,5,8,3,6,13,1,7,13,14,9,4,8,4,12,15,13,1,12,6,11,13,8,8,11,7,5,8,11,6,3,9,17,13,11,11,11,5,9,8,6,10,11,9,3,2,1,4,3,1,3,2,1,2,2
"7817",2000293280,"Buba Diabbassey","1/1/2007 (16 years old)","AM (C), ST (C)","St. Gallen","Swiss Super League","GAM","No","6/12/2023","6/30/2026","$65K - $650K","Left","Very Strong","Reasonable","6'0""","145 lbs","-","-",68,136,6,7,11,14,14,6,8,8,5,6,9,4,4,13,5,7,7,6,7,12,12,12,5,13,5,7,6,12,11,10,13,9,13,11,7,3,5,18,11,11,11,13,13,1,5,8,6,11,18,3,2,2,1,1,1,1,1,2,1,3
"7818",79031724,"Alexis Duarte","3/12/2000 (23 years old)","D (C)","Spartak Moscow","Russian Premier League","PAR","No","1/24/2023","6/30/2027","$4.9M - $7.4M","Right","Reasonable","Very Strong","6'1""","167 lbs","99","1",122,137,6,5,7,4,9,3,15,9,4,12,12,9,14,9,12,13,13,13,13,13,12,8,10,8,13,12,9,13,11,12,14,12,11,11,13,11,9,12,9,12,12,14,11,11,12,7,12,11,8,4,1,2,2,3,2,2,3,3,1,3
"7819",93049245,"Noah Sonko Sundberg","6/6/1996 (27 years old)","D (C)","Levski","Bulgarian First League","GAM","Yes","1/1/2022","6/30/2025","$1M - $2.2M","Right","Weak","Very Strong","6'2""","185 lbs","221","12",123,135,5,9,8,7,10,7,14,9,14,13,11,8,13,11,12,13,13,13,16,13,13,8,11,9,14,14,10,12,12,9,11,14,12,13,13,14,8,7,9,13,13,9,6,15,12,6,14,14,14,1,2,2,1,2,3,1,3,2,4,2
"7820",219033,"Alasana Manneh","4/8/1998 (25 years old)","DM, M (C)","OB","3F Superliga","GAM","No","8/31/2022","6/30/2025","$750K - $1.6M","Left","Very Strong","Reasonable","5'9""","158 lbs","147","13",110,135,12,10,11,11,13,11,7,12,9,10,13,9,12,13,12,12,12,12,12,11,13,13,12,12,12,13,12,12,12,13,11,7,11,12,12,8,11,11,11,12,12,11,10,13,9,6,10,10,12,2,1,4,2,1,1,2,2,2,4,2
"7821",13115373,"Omar Colley","10/24/1992 (30 years old)","D (C)","Beşiktaş","Turkish Super League","GAM","No","2/9/2023","6/30/2025","$5M - $9.6M","Left","Very Strong","Weak","6'3""","191 lbs","313","15",125,135,1,2,8,5,8,1,16,4,2,14,8,4,14,10,14,12,14,12,14,12,14,4,12,2,14,14,7,14,12,12,15,16,15,11,15,16,10,14,14,15,12,15,4,12,12,10,14,15,13,3,2,3,2,1,1,3,3,1,2,3
"7822",93038245,"Modou Barrow","10/13/1992 (30 years old)","AM (RL)","Al-Ahli (KSA)","Saudi Professional League","GAM","Yes","1/16/2023","6/30/2025","$18M - $21M","Left","Very Strong","Reasonable","5'10""","132 lbs","331","80",130,135,9,13,15,12,12,7,6,12,4,5,13,11,5,13,11,11,12,12,11,12,10,15,7,13,5,10,11,9,16,13,13,6,13,17,12,8,8,5,9,8,9,8,8,12,6,16,12,10,13,1,2,1,3,1,4,3,2,2,3,1
"7823",2000278644,"Ebrima Ndow","1/4/2004 (19 years old)","ST (C)","Moreirense","Portuguese Premier League","GAM","No","2/1/2023","6/30/2026","$0 - $85K","Right Only","Weak","Very Strong","6'2""","176 lbs","-","-",85,134,6,6,13,12,13,6,13,7,1,5,6,2,5,13,10,9,8,12,7,13,18,13,9,13,5,6,7,7,13,13,3,9,17,13,7,7,9,17,9,11,12,13,11,14,8,6,19,9,10,4,1,2,1,3,3,3,1,1,1,3
"7824",2000195673,"Lamin Dukureh","8/30/2006 (16 years old)","AM (RL), ST (C)","PSV Wellingara","Gambian Second Division","GAM","No","7/1/2021","6/30/2026","$40K - $120K","Right","Weak","Very Strong","5'4""","123 lbs","-","-",81,133,8,9,11,9,10,12,5,12,11,4,11,11,6,10,16,11,8,12,12,9,16,14,8,12,2,10,8,12,13,10,7,4,10,10,8,8,18,16,10,12,8,18,10,12,2,4,12,6,10,3,3,3,2,1,2,3,3,1,2,2
"7825",2000195678,"Dawda Sankareh","7/21/2006 (16 years old)","AM (C)","PSV Wellingara","Gambian Second Division","GAM","No","7/1/2021","6/30/2026","$0 - $140K","Right","Weak","Very Strong","5'10""","143 lbs","-","-",82,133,8,8,12,8,15,8,4,10,6,4,14,4,8,13,8,8,6,8,4,15,11,11,10,10,7,14,14,10,10,13,8,11,12,12,6,5,8,11,12,10,12,13,7,11,5,2,9,10,8,3,1,1,2,3,3,3,2,1,3,2
"7826",2000283008,"Habib Camara","11/25/2005 (17 years old)","D (C)","Banjul Hawks","Gambian Second Division","GAM","No","7/1/2022","6/30/2024","$20K - $210K","Right Only","Weak","Very Strong","6'2""","180 lbs","-","-",95,132,2,6,9,5,10,5,11,6,2,16,11,10,11,10,12,9,11,10,12,11,12,5,11,7,14,11,9,10,11,8,10,13,11,10,8,12,9,15,16,18,18,10,2,16,12,8,12,14,12,2,1,1,2,2,3,1,2,3,1,1
"7827",13109649,"Hamza Barry","10/15/1994 (28 years old)","DM, M/AM (C)","Vejle","3F Superliga","GAM","No","8/22/2022","6/30/2024","$900K - $1.9M","Right","Fairly Strong","Very Strong","5'9""","160 lbs","227","23",114,132,9,8,12,9,13,10,9,12,7,9,14,10,10,13,8,13,11,11,10,12,10,12,6,13,10,12,13,11,12,12,9,8,14,12,12,7,12,10,10,10,10,5,5,9,6,4,9,12,13,4,2,1,1,2,1,2,1,1,3,3
"7828",2000195662,"Haruna Rashid Njie","9/23/2005 (17 years old)","DM, M (C)","Gunjur Utd","Gambian Second Division","GAM","No","7/1/2021","-","$0","Right Only","Weak","Very Strong","5'7""","145 lbs","-","-",83,131,2,5,8,8,11,8,8,9,6,10,11,10,12,11,16,12,16,10,11,10,12,6,10,9,9,10,10,12,11,10,13,11,10,12,10,13,12,12,10,14,11,12,10,15,8,1,14,11,19,3,2,3,3,1,3,1,1,2,2,2
"7829",14043370,"Héctor Villalba","7/26/1994 (28 years old)","M (R), AM (RL), ST (C)","Libertad","Paraguay First Division Primera División","PAR","No","1/31/2020","12/31/2024","$160K - $1.6M","Right Only","Weak","Very Strong","5'9""","165 lbs","255","55",120,137,12,13,14,12,12,13,7,15,4,7,11,5,5,13,14,9,6,10,12,9,7,14,7,13,7,7,12,12,17,15,12,7,7,14,12,7,12,15,7,10,9,14,13,15,7,10,7,15,12,3,3,3,3,1,2,1,2,2,3,3
"7830",13161991,"Assan Ceesay","3/17/1994 (29 years old)","AM (RL), ST (C)","Salento","Italian Serie A","GAM","No","7/1/2022","6/30/2024","$300K - $2.9M","Left","Very Strong","Reasonable","6'2""","165 lbs","210","58",125,130,5,8,12,13,10,4,11,9,4,5,11,10,6,10,11,13,12,13,11,11,14,14,5,12,7,13,7,14,16,12,14,14,15,17,13,14,12,12,12,14,1,12,9,9,7,5,13,13,13,2,1,1,3,2,2,1,2,3,2,2
"7831",92083800,"Bakery Jatta","6/6/1998 (25 years old)","M/AM (RL)","HSV","Bundesliga 2","GAM","Yes","6/15/2020","6/30/2024","$425K - $4.1M","Right","Fairly Strong","Very Strong","6'0""","174 lbs","193","40",125,130,5,11,14,9,10,4,12,8,12,8,11,7,12,10,15,10,16,9,8,9,16,13,5,12,8,11,11,16,15,12,11,11,14,17,14,12,14,12,10,12,13,12,7,11,10,7,11,14,14,4,4,1,1,2,2,1,2,4,1,1
"7832",13198478,"Muhammed Badamosi","12/27/1998 (24 years old)","AM (C), ST (C)","Čukarički","Serbian SuperLeague","GAM","No","6/1/2023","6/30/2025","$300K - $2.9M","Right","Weak","Very Strong","6'6""","187 lbs","126","20",120,130,6,9,11,12,10,4,14,11,3,8,10,9,8,12,14,12,14,11,8,12,12,11,7,15,11,12,11,14,13,13,14,17,11,13,13,14,10,11,12,11,10,14,12,9,12,8,12,11,10,1,3,1,1,4,1,3,3,1,3,4
"7833",23294637,"Bubacarr Trawally","11/10/1994 (28 years old)","AM (RLC), ST (C)","Hammarby IF","Swedish Premier Division","GAM","No","3/31/2022","12/31/2023","$35K - $110K","Right","Reasonable","Very Strong","6'1""","154 lbs","185","91",96,129,9,9,12,10,11,11,10,12,7,7,9,12,5,12,13,9,11,11,9,11,8,17,5,11,6,8,9,8,12,11,9,12,12,13,11,9,7,7,7,8,10,8,17,14,5,6,9,9,9,3,2,2,3,3,3,1,3,1,1,2
"7834",93100468,"Jesper Ceesay","10/20/2001 (21 years old)","DM, M (C)","IFK Norrköping","Swedish Premier Division","GAM","Yes","3/21/2023","12/31/2025","$190K - $1.9M","Right","Reasonable","Very Strong","6'4""","176 lbs","62","-",109,129,7,10,11,6,12,8,9,8,7,11,13,8,12,12,15,12,12,12,12,11,13,9,8,10,12,13,10,14,13,12,11,15,12,13,14,12,12,10,8,12,12,10,5,8,14,7,12,13,10,3,2,2,1,3,2,3,1,1,2,1
"7835",2000186838,"Jesús Gómez","12/1/2005 (17 years old)","ST (C)","Falcons FC","Gambian Premier Division","GAM","No","7/1/2021","6/30/2024","$0 - $140K","Right","Fairly Strong","Very Strong","5'10""","138 lbs","-","-",81,129,4,4,9,13,13,6,8,3,3,5,4,9,3,9,5,10,5,12,4,8,14,9,11,11,7,7,6,11,13,13,12,7,16,13,6,3,8,17,11,11,11,11,11,13,15,3,12,12,11,2,2,2,1,1,3,2,2,1,3,3
"7836",2000263258,"Oumar Faye","12/24/2002 (20 years old)","M (C)","ASC Jaraaf","Senegalese Ligue 1","GAM","No","6/30/2022","6/30/2024","$0","Right Only","Weak","Very Strong","5'11""","178 lbs","15","1",94,128,14,11,8,14,14,13,2,12,2,4,16,14,2,12,10,12,6,15,12,12,8,18,10,6,2,12,13,11,10,16,14,6,10,9,9,16,2,9,10,18,15,16,2,10,2,12,16,8,8,2,3,1,3,2,2,1,2,3,1,3
"7837",53114986,"Sheriff Sinyan","7/19/1996 (26 years old)","D (C), DM, M (C)","Molde","Norwegian Premier Division","GAM","Yes","6/30/2020","12/31/2024","$110K - $1.1M","Right","Reasonable","Very Strong","6'2""","185 lbs","142","19",115,128,8,7,9,10,12,8,12,7,7,12,11,6,15,10,11,12,14,13,9,10,14,11,8,7,11,13,8,12,13,12,13,15,14,15,12,14,12,13,14,16,12,9,15,12,12,10,14,13,13,2,1,1,1,3,3,3,1,2,3,3
"7838",13187263,"Ablie Jallow","11/14/1998 (24 years old)","AM (RLC)","FC Metz","Ligue 1 Uber Eats","GAM","No","8/19/2022","6/30/2025","$300K - $3M","Left","Very Strong","Fairly Strong","5'5""","136 lbs","117","25",122,128,9,11,13,12,12,11,9,14,8,7,11,10,8,13,9,13,12,14,13,12,13,11,9,12,8,12,13,13,13,14,14,4,11,13,12,10,10,12,11,13,14,10,9,13,9,7,12,13,12,2,1,1,3,2,1,2,1,3,2,1
"7839",2000045287,"Bamba Susso","10/9/2002 (20 years old)","AM (RL), ST (C)","Pisa","Italian Serie B","GAM","Yes","9/15/2020","6/30/2025","$14K - $140K","Right Only","Weak","Very Strong","6'1""","163 lbs","57","17",95,128,5,6,9,11,9,5,11,7,5,5,9,8,8,9,13,11,10,12,9,9,11,7,5,16,13,7,8,13,12,11,13,13,11,13,12,13,11,11,12,10,10,11,11,10,10,11,10,12,13,2,3,4,1,3,1,3,4,1,1,3
"7840",79024221,"Junior Alonso","2/9/1993 (30 years old)","D (LC)","Krasnodar","Russian Premier League","PAR","No","1/12/2022","6/30/2025","$5.2M - $9.6M","Left","Very Strong","Fairly Strong","6'1""","182 lbs","309","16",133,137,6,12,7,7,10,11,13,10,14,15,12,11,14,11,14,13,16,13,13,12,13,6,13,10,15,13,11,14,12,10,14,12,15,12,14,13,13,7,9,14,12,14,7,11,14,8,14,11,12,1,2,1,3,2,3,3,3,1,3,2
"7841",83160151,"Maudo","9/30/1997 (25 years old)","D (C)","Slovan Bratislava","Slovak First Division","GAM","No","12/31/2021","12/31/2024","$20K - $200K","Right Only","Weak","Very Strong","6'2""","194 lbs","103","4",107,127,7,8,6,6,11,6,13,7,7,12,10,5,12,11,13,12,12,11,11,12,14,6,8,6,12,13,11,13,11,10,14,15,14,12,13,14,10,10,11,14,14,10,10,7,5,5,10,14,14,3,2,1,1,3,2,3,1,3,3,2
"7842",13230311,"Saikou Touray","6/6/2000 (23 years old)","DM, M/AM (C)","Grenoble","Ligue 2 BKT","GAM","No","7/19/2022","6/30/2025","$70K - $700K","Right","Fairly Strong","Very Strong","5'9""","160 lbs","103","2",103,126,7,10,11,7,12,10,6,8,7,11,13,5,11,11,12,10,13,10,9,7,4,11,6,11,10,12,11,14,12,13,13,7,13,13,12,13,14,11,13,10,12,12,14,7,11,3,10,14,13,2,1,1,3,3,4,1,1,2,3,3
"7843",18113439,"Abdoulie Sanyang","5/8/1999 (24 years old)","AM (RL), ST (C)","Grenoble","Ligue 2 BKT","GAM","No","6/29/2022","6/30/2026","$95K - $950K","Left Only","Very Strong","Weak","5'8""","152 lbs","83","10",112,126,7,11,14,11,14,9,6,9,6,5,11,9,6,13,15,10,14,12,10,8,10,15,5,7,7,11,10,12,15,12,8,7,13,15,11,7,12,10,14,12,12,11,7,9,11,2,13,14,19,2,3,2,1,1,2,3,3,2,1,1
"7844",98030722,"Saidy Janko","10/22/1995 (27 years old)","D/WB (R)","Valladolid","Spanish Second Division","GAM","Yes","10/1/2020","6/30/2025","$150K - $1.5M","Right","Reasonable","Very Strong","5'11""","176 lbs","164","2",121,126,5,11,12,4,12,5,8,8,12,10,10,4,11,13,11,12,12,11,9,10,11,12,4,13,10,12,10,14,15,13,13,10,13,16,15,12,13,12,12,12,8,10,9,8,4,10,12,14,8,1,3,2,1,2,1,1,2,2,1,2
"7845",12080083,"Dembo Darboe","8/17/1998 (24 years old)","ST (C)","Astana","Kazakhstan Premier League","GAM","No","8/2/2022","5/31/2024","$600K - $5.2M","Right Only","Weak","Very Strong","6'1""","171 lbs","120","50",116,125,6,10,13,15,12,8,11,12,6,5,12,14,5,10,11,13,11,13,9,12,4,11,8,13,10,8,8,10,14,13,14,13,12,14,10,14,8,17,8,13,9,12,5,12,12,7,14,9,12,2,2,1,1,1,3,3,3,1,4,2
"7846",13109635,"Yusupha Njie","3/1/1994 (29 years old)","AM (LC), ST (C)","BVT","Portuguese Premier League","GAM","No","7/1/2018","6/30/2025","$95K - $950K","Right","Fairly Strong","Very Strong","6'2""","169 lbs","199","38",120,125,10,11,15,13,14,8,11,10,5,4,11,12,7,15,10,12,7,14,8,11,10,16,8,12,7,10,13,13,13,13,13,12,10,13,11,10,11,13,7,11,14,12,15,11,6,5,11,11,13,1,2,3,3,1,1,3,1,3,3,1
"7847",93101764,"Yahya Kalley","3/20/2001 (22 years old)","D/WB/M (L)","IFK Norrköping","Swedish Premier Division","GAM","Yes","8/31/2021","6/30/2025","$120K - $1.2M","Left Only","Very Strong","Weak","6'1""","165 lbs","50","-",106,125,7,11,12,6,11,7,10,7,8,10,12,7,11,12,14,11,12,11,11,11,13,11,7,10,9,12,11,13,14,12,11,12,12,14,13,10,11,7,12,12,10,13,7,6,12,7,11,12,12,1,1,4,3,3,3,1,1,1,2,1
"7848",95031723,"Ebou Adams","1/15/1996 (27 years old)","DM, M/AM (C)","Cardiff","Sky Bet Championship","GAM","No","7/1/2022","6/30/2025","$140K - $1.4M","Right","Weak","Very Strong","5'8""","141 lbs","216","12",113,125,6,7,10,6,10,6,12,7,5,11,10,6,15,9,12,13,15,9,9,9,17,8,12,8,10,12,11,16,13,13,11,16,15,12,16,17,11,6,6,17,13,18,5,13,7,3,12,12,14,1,2,3,2,1,2,3,3,1,2,3
"7849",13231924,"Kajally Drammeh","10/10/2003 (19 years old)","M/AM (R)","Cape Town City","South African Premier Soccer League","GAM","No","7/1/2021","6/30/2025","$0 - $75K","Left","Very Strong","Reasonable","5'10""","154 lbs","14","1",105,125,9,13,15,11,15,9,9,10,7,8,14,5,8,11,9,11,4,5,10,11,14,9,10,9,7,10,11,13,14,14,15,9,12,12,8,5,14,14,13,11,13,11,7,12,7,6,10,10,9,1,1,3,3,2,3,3,1,2,1,3
"7850",2000195393,"Abdoulie Manneh","9/29/2005 (17 years old)","M/AM (C)","Wallidan FC","Gambian Premier Division","GAM","No","7/1/2021","6/30/2024","$75K - $220K","Right","Reasonable","Very Strong","5'9""","143 lbs","-","-",80,125,4,7,13,5,15,6,6,10,8,3,14,4,9,15,5,10,6,10,9,14,16,13,10,9,10,14,10,10,10,12,7,5,11,12,6,5,11,16,12,13,10,11,10,10,10,6,5,10,8,2,2,2,1,3,1,2,3,4,2,2
"7851",79030877,"Robert Morales","3/17/1999 (24 years old)","ST (C)","Cerro Porteño","Paraguay First Division Primera División","PAR","No","12/31/2018","12/31/2025","$650K - $1.4M","Right","Reasonable","Very Strong","5'10""","163 lbs","60","28",124,137,10,11,12,14,12,7,11,13,4,6,8,10,7,12,8,12,13,13,10,13,11,12,6,15,7,11,8,14,16,14,11,10,11,13,10,11,11,13,8,11,13,11,15,11,10,7,9,10,20,3,3,2,2,1,3,1,3,2,3,4
"7852",2000250478,"Mahmudu Bajo","8/15/2004 (18 years old)","DM","Podbrezova","Slovak First Division","GAM","No","6/12/2023","6/30/2025","$200K - $2M","Right","Reasonable","Very Strong","5'10""","154 lbs","-","-",90,125,4,6,8,9,14,8,8,5,6,7,11,2,13,13,5,11,9,5,9,14,16,5,9,8,14,9,12,12,11,13,8,5,11,13,7,7,13,16,11,11,11,11,7,8,10,6,13,14,17,2,1,2,1,3,2,3,3,2,2,1
"7853",12002387,"Momodou Ceesay","12/24/1988 (34 years old)","ST (C)","Fortune FC","Gambian Premier Division","GAM","No","5/5/2021","6/30/2024","$1K - $10K","Right Only","Weak","Very Strong","6'5""","191 lbs","227","42",98,125,8,8,11,8,9,11,15,12,8,12,11,11,5,13,13,11,11,11,8,7,12,4,5,6,11,10,6,14,10,5,16,19,5,12,11,17,4,12,11,10,8,12,8,8,8,5,7,9,8,3,2,2,2,3,2,3,2,4,2,3
"7854",12094506,"Sadi Gaye","10/19/2000 (22 years old)","D (C)","Wallidan FC","Gambian Premier Division","GAM","No","7/1/2020","6/30/2024","$18K - $180K","Right","Fairly Strong","Very Strong","6'5""","200 lbs","-","-",88,124,6,3,6,5,8,9,10,8,4,11,10,6,10,9,8,8,10,8,9,11,13,2,8,10,11,10,9,12,11,8,12,16,8,11,8,12,8,13,13,13,11,11,8,10,10,1,8,9,10,3,1,3,3,1,3,2,3,1,2,1
"7855",43131104,"Ali Sowe","6/14/1994 (28 years old)","ST (C)","Rostov","Russian Premier League","GAM","Yes","6/10/2021","6/10/2025","$550K - $5.6M","Right","Reasonable","Very Strong","6'3""","185 lbs","272","84",120,124,5,6,12,14,10,5,13,10,8,4,10,12,8,11,12,12,12,10,10,9,17,10,10,15,8,16,8,18,12,12,15,15,17,15,14,14,9,9,10,13,10,14,8,12,7,13,10,14,13,2,1,1,1,3,1,2,3,1,1,1
"7856",43390484,"Musa Juwara","12/26/2001 (21 years old)","M (R), AM (RL), ST (C)","OB","3F Superliga","GAM","No","6/30/2022","6/30/2025","$0","Left Only","Very Strong","Weak","5'7""","136 lbs","19","1",106,123,5,8,12,6,12,6,4,9,4,2,9,11,4,12,12,10,8,6,7,9,10,13,5,14,4,11,9,10,17,15,6,4,12,17,12,5,12,11,14,12,7,12,7,12,8,4,9,7,8,3,2,2,3,1,3,3,2,1,1,3
"7857",2000250480,"Adama Bojang","5/28/2004 (19 years old)","ST (C)","Steve Biko","Gambian Premier Division","GAM","No","7/1/2021","6/30/2024","$0","Right Only","Weak","Very Strong","6'3""","171 lbs","-","-",97,121,6,10,11,12,12,8,10,11,3,6,9,11,4,12,8,11,10,12,12,12,16,10,9,13,6,12,11,12,14,13,11,10,10,12,12,10,8,18,12,10,11,10,10,18,8,1,16,14,10,3,3,1,2,2,2,3,3,2,1,2
"7858",12008161,"Pa Modou","12/26/1989 (33 years old)","D (LC), WB (L)","Dietikon","Swiss First League Classic Group 2","GAM","No","5/19/2021","6/30/2024","$7K - $20K","Left","Very Strong","Reasonable","5'9""","174 lbs","354","35",80,121,9,12,11,8,12,6,12,8,12,11,11,12,12,12,12,11,13,10,10,11,9,12,14,12,11,12,9,11,7,9,9,7,8,7,6,10,14,13,11,15,9,11,12,11,7,6,10,9,13,3,1,1,1,3,2,3,1,1,2,1
"7859",2000195624,"Seedy Kinteh","2/28/2005 (18 years old)","D (C)","PSV Wellingara","Gambian Second Division","GAM","No","7/1/2022","6/30/2024","$12K - $120K","Right","Fairly Strong","Very Strong","6'0""","165 lbs","-","-",80,121,4,1,5,4,9,1,14,7,1,14,14,4,14,10,15,8,12,7,10,14,11,5,10,4,9,7,7,8,9,10,8,9,15,9,5,7,9,14,10,10,11,11,10,8,12,1,14,13,20,3,2,1,1,1,3,2,2,1,1,3
"7860",2000084627,"Lamin Saidy","6/17/2001 (21 years old)","GK","Real de Banjul","Gambian Premier Division","GAM","No","7/1/2020","6/30/2024","$6K - $60K","Right","Reasonable","Very Strong","6'0""","167 lbs","-","-",85,121,4,3,1,3,5,8,1,3,3,2,14,3,1,4,9,9,9,3,8,14,6,3,11,3,14,8,7,7,13,8,8,9,12,11,2,7,12,16,11,11,10,11,11,11,5,6,13,11,10,12,6,13,5,11,10,11,5,9,10,14
"7861",12094393,"Mustapha Manneh","7/22/2000 (22 years old)","D (C)","Banjul Hawks","Gambian Second Division","GAM","No","7/1/2020","6/30/2024","$45K - $140K","Right","Fairly Strong","Very Strong","6'2""","165 lbs","-","-",85,121,4,2,2,1,8,1,12,5,3,13,8,4,13,5,8,9,9,3,8,13,12,5,1,6,10,6,6,8,11,12,7,15,9,12,5,6,12,19,11,10,10,13,13,11,6,6,20,10,9,3,3,3,3,2,1,2,1,1,1,2
"7862",79024554,"Carlos González","2/4/1993 (30 years old)","ST (C)","Tijuana","Mexican First Division","PAR","No","6/1/2023","6/30/2025","$650K - $6.4M","Right","Reasonable","Very Strong","6'0""","169 lbs","305","106",129,137,8,9,11,14,13,11,15,13,10,6,10,11,7,12,12,15,16,13,12,13,14,15,12,14,7,12,12,13,12,10,15,13,14,13,14,14,5,10,12,12,11,10,10,10,13,7,13,11,14,3,1,3,1,3,1,2,3,1,2,3
"7863",93108784,"Lamin Sarr","3/11/2001 (22 years old)","GK","Eskilsminne IF","Swedish First Division South","GAM","Yes","2/8/2023","11/30/2024","$0 - $75K","Right Only","Weak","Very Strong","6'1""","154 lbs","40","-",84,120,3,1,5,3,6,5,1,1,1,2,5,3,3,6,10,9,12,8,9,9,12,2,7,2,10,10,5,9,11,13,11,14,12,10,12,11,12,10,10,12,12,10,5,5,7,6,11,11,14,9,12,13,7,12,10,11,11,10,9,13
"7864",98040383,"Gregor Kobel","12/6/1997 (25 years old)","GK","Borussia Dortmund","Bundesliga","SUI","Yes","7/1/2021","6/30/2026","$42M - $52M","Right Only","Weak","Very Strong","6'5""","194 lbs","183","-",155,162,3,1,9,5,11,6,7,6,10,6,13,4,6,12,16,15,16,16,13,13,18,10,16,8,16,12,12,16,9,16,14,17,12,10,11,15,1,12,12,17,14,12,8,15,6,7,16,17,15,13,15,17,8,16,13,13,12,16,13,15
"7865",98003821,"Granit Xhaka","9/27/1992 (30 years old)","DM, M (C)","Arsenal","English Premier Division","SUI","Yes","6/14/2021","6/30/2026","$14.5M - $17.5M","Left","Very Strong","Reasonable","6'1""","176 lbs","414","36",150,160,13,12,12,11,16,15,12,17,7,11,18,11,12,17,17,15,16,15,12,14,16,13,17,11,12,17,16,16,10,10,15,13,15,12,16,14,11,7,9,13,10,12,7,12,17,12,15,14,10,3,3,1,2,1,1,2,3,3,1,3
"7866",69000199,"Yann Sommer","12/17/1988 (34 years old)","GK","FC Bayern","Bundesliga","SUI","Yes","1/19/2023","6/30/2025","Not for Sale","Right","Reasonable","Very Strong","6'0""","174 lbs","523","-",152,160,1,4,7,4,12,3,6,7,12,6,13,6,6,12,13,13,15,15,14,13,16,10,16,8,16,15,12,13,11,16,12,13,18,11,12,11,1,14,12,20,13,13,6,18,8,6,15,16,13,11,18,18,8,16,13,15,10,13,12,11
"7867",2000255637,"Elio Rufener","2/12/2007 (16 years old)","DM, M (C)","Young Boys","Swiss Super League","SUI","Yes","7/1/2022","6/30/2026","$3.9M - $7.6M","Left Only","Very Strong","Weak","5'9""","141 lbs","-","-",84,159,9,9,12,5,12,9,6,8,1,5,13,13,9,12,9,13,9,12,10,13,14,12,11,13,10,13,13,11,8,11,11,9,14,9,11,7,10,12,14,16,12,12,14,14,7,3,14,14,13,3,3,3,4,2,3,1,2,1,2,1
"7868",98003827,"Xherdan Shaqiri","10/10/1991 (31 years old)","AM (RLC)","Chicago","Major League Soccer","SUI","Yes","2/9/2022","12/31/2024","Not for Sale","Left Only","Very Strong","Weak","5'7""","158 lbs","367","75",136,159,14,16,15,12,17,14,6,14,6,6,15,15,7,15,11,12,11,16,12,14,12,16,11,14,8,11,16,9,13,15,17,6,12,13,14,13,9,15,12,11,13,12,14,16,11,15,11,15,14,2,1,2,1,3,4,3,3,2,1,3
"7869",84152512,"Fabian Rieder","2/16/2002 (21 years old)","M/AM (C)","Young Boys","Swiss Super League","SUI","Yes","7/7/2022","6/30/2025","$11M - $17M","Left","Very Strong","Reasonable","5'10""","163 lbs","94","10",131,158,12,12,14,8,15,13,8,12,5,7,14,12,11,15,13,14,10,15,14,15,15,13,10,13,10,14,13,14,12,13,12,9,14,13,14,10,14,12,11,15,16,14,9,13,13,12,13,14,11,3,3,3,1,2,1,2,2,3,4,2
"7870",98040226,"Noah Okafor","5/24/2000 (23 years old)","AM (RL), ST (C)","FC RB Salzburg","Austrian Premier Division","SUI","Yes","6/15/2020","6/30/2027","$11M - $16.5M","Right","Fairly Strong","Very Strong","6'1""","176 lbs","124","30",138,157,8,12,14,15,14,7,9,11,7,7,12,8,7,15,12,13,12,12,11,11,11,13,8,15,7,11,12,13,15,12,12,12,12,15,13,13,12,11,10,12,7,13,7,12,7,7,13,13,16,1,2,1,2,3,3,4,4,3,3,1
"7871",98031331,"Manuel Akanji","7/19/1995 (27 years old)","D (RC)","Man City","English Premier Division","SUI","Yes","8/31/2022","6/30/2027","$48M - $61M","Right","Fairly Strong","Very Strong","6'2""","200 lbs","229","10",154,156,4,8,11,6,13,9,13,11,12,15,13,8,16,12,13,15,16,16,15,13,14,9,10,9,13,14,13,13,14,13,13,15,13,15,14,17,13,12,14,17,13,11,12,16,8,6,14,16,12,3,1,3,1,3,2,2,2,3,3,1
"7872",84161623,"Aurèle Amenda","7/31/2003 (19 years old)","D (C)","Young Boys","Swiss Promotion League","SUI","Yes","12/21/2021","6/30/2025","$9.6M - $12M","Right Only","Weak","Very Strong","6'4""","198 lbs","44","1",119,154,3,4,7,4,9,4,14,5,6,12,10,6,15,9,11,12,13,12,11,12,10,7,11,6,12,12,9,12,12,10,16,16,14,14,13,17,5,13,10,13,9,12,13,12,9,6,13,12,8,2,1,1,2,1,3,2,1,2,1,2
"7873",79012587,"Oscar Romero","7/4/1992 (30 years old)","M (LC), AM (C)","Boca","Argentine Premier Division","PAR","No","2/18/2022","12/31/2025","$240K - $2.4M","Left","Very Strong","Weak","5'9""","163 lbs","268","35",126,136,14,12,14,12,15,13,7,14,11,8,15,14,8,15,12,12,13,12,11,13,12,17,7,14,8,13,14,12,12,15,11,8,13,13,13,9,12,13,12,14,11,14,8,10,10,6,11,13,14,2,1,1,2,2,2,1,1,1,1,1
"7874",69005372,"Roman Bürki","11/14/1990 (32 years old)","GK","St. Louis CITY","Major League Soccer","SUI","Yes","7/1/2022","12/31/2025","Not for Sale","Right Only","Weak","Very Strong","6'2""","187 lbs","403","-",133,153,4,1,3,2,9,8,7,1,3,2,13,1,3,12,16,12,16,16,10,9,12,3,14,1,10,15,11,12,12,14,16,13,16,11,12,15,14,10,9,17,5,11,7,10,13,13,9,16,9,16,17,17,9,17,15,13,16,9,9,16
"7875",2000198456,"Junior Zé","3/22/2006 (17 years old)","AM (L)","Basel","Swiss Super League","SUI","Yes","6/13/2022","6/30/2026","$850K - $11.5M","Right Only","Weak","Very Strong","5'10""","152 lbs","10","-",95,152,7,8,14,8,12,6,6,8,4,3,10,7,4,13,8,10,6,11,8,8,11,16,6,10,5,11,8,12,15,13,10,9,13,14,11,8,10,11,7,10,13,12,10,13,8,9,19,12,7,3,2,3,2,1,2,1,2,2,3,2
"7876",98006034,"Remo Freuler","4/15/1992 (31 years old)","DM, M (C)","Nottm Forest","English Premier Division","SUI","Yes","8/14/2022","6/30/2025","Not for Sale","Right","Reasonable","Very Strong","5'11""","176 lbs","397","41",136,152,8,12,13,11,14,8,9,11,6,10,14,11,12,12,14,14,14,13,13,14,15,12,12,12,12,15,14,16,13,13,14,10,15,12,16,12,14,13,13,16,14,12,6,13,9,7,14,14,13,2,3,2,2,3,3,2,1,2,2,3
"7877",98029385,"Breel Embolo","2/14/1997 (26 years old)","M (R), AM (RC), ST (C)","AS Monaco","Ligue 1 Uber Eats","SUI","Yes","7/15/2022","6/30/2026","$41M - $50M","Right","Reasonable","Very Strong","6'2""","194 lbs","237","65",146,151,6,8,14,14,12,7,14,12,6,7,13,12,8,14,16,14,16,12,12,12,15,15,6,15,7,15,14,16,14,13,16,14,14,15,14,17,14,9,10,8,11,12,10,14,12,17,13,14,14,2,2,2,3,3,2,1,1,3,3,1
"7878",98034601,"Denis Zakaria","11/20/1996 (26 years old)","DM, M (C)","Juventus","Italian Serie A","SUI","Yes","1/31/2022","6/30/2026","$19.5M - $23M","Right","Weak","Very Strong","6'3""","189 lbs","199","16",142,150,5,8,14,10,13,6,11,11,12,13,13,8,16,13,17,14,16,12,12,11,15,12,11,14,14,16,12,17,14,13,15,15,15,15,17,15,9,14,12,15,11,10,9,14,13,6,14,16,13,4,1,2,1,2,2,3,3,3,2,1
"7879",84154064,"Zeki Amdouni","12/4/2000 (22 years old)","AM (LC), ST (C)","Basel","Swiss Super League","SUI","Yes","5/2/2023","6/30/2027","$12.5M - $19M","Right","Strong","Very Strong","6'1""","174 lbs","160","52",135,149,7,8,15,13,13,9,12,12,4,5,12,14,6,15,9,16,8,14,12,14,14,14,7,16,6,13,13,12,11,13,13,12,13,12,13,12,12,15,11,15,14,12,8,12,7,5,12,13,13,3,3,1,2,2,1,1,2,1,3,2
"7880",2000260105,"Agon Rexhaj","3/24/2007 (16 years old)","AM (R)","Basel","Swiss Super League","SUI","Yes","8/19/2022","6/30/2026","$2.9M - $5.8M","Left","Very Strong","Reasonable","5'10""","138 lbs","-","-",77,149,5,8,11,11,10,2,7,7,1,5,13,5,7,13,12,7,8,5,4,6,11,13,8,13,1,7,8,11,13,13,13,4,8,13,6,4,9,14,11,11,11,11,10,9,13,4,9,10,19,2,4,2,2,1,3,3,2,2,4,2
"7881",98003635,"Ricardo Rodríguez","8/25/1992 (30 years old)","D (LC), WB (L)","Torino","Italian Serie A","SUI","Yes","9/1/2020","6/30/2024","$6.4M - $8.2M","Left","Very Strong","Weak","6'0""","169 lbs","366","22",139,149,13,14,10,8,13,14,14,12,16,13,13,13,14,13,11,15,14,13,13,14,14,10,12,11,14,14,12,12,13,13,14,12,17,12,13,13,13,19,17,16,18,12,9,14,6,4,14,14,18,3,2,1,3,2,2,4,3,3,1,3
"7882",2000198458,"Demir Xhemalija","6/7/2006 (17 years old)","DM, M (C)","Basel","Swiss Super League","SUI","Yes","6/13/2022","6/30/2025","$350K - $3.6M","Right Only","Weak","Very Strong","5'11""","158 lbs","1","-",85,148,10,9,11,6,12,7,8,11,3,7,12,6,8,12,12,12,11,13,9,12,14,10,10,9,9,12,12,11,11,11,11,11,13,11,12,10,9,15,11,13,11,11,15,7,10,8,14,9,15,3,1,4,2,3,1,1,2,2,4,1
"7883",84151691,"Simon Sohm","4/11/2001 (22 years old)","DM, M (C)","Parma","Italian Serie B","SUI","Yes","10/4/2020","6/30/2025","$375K - $3.7M","Right","Reasonable","Very Strong","6'2""","187 lbs","96","1",124,147,8,12,12,7,12,7,12,9,8,13,13,8,14,12,16,14,15,15,11,12,13,10,7,10,13,15,13,13,12,11,14,13,13,12,14,15,14,13,14,15,12,13,10,12,11,5,13,13,12,2,1,3,3,2,1,2,1,1,1,3
"7884",79002787,"Darío Lezcano","6/30/1990 (32 years old)","ST (C)","Colo Colo","Chilean First Division","PAR","No","1/29/2023","12/31/2024","Not for Sale","Right","Fairly Strong","Very Strong","5'10""","174 lbs","399","108",118,136,12,8,12,12,13,13,15,12,6,5,12,14,7,12,14,13,17,12,11,11,16,10,7,14,6,12,14,15,11,11,13,12,8,12,10,13,6,6,5,11,13,12,16,14,10,14,9,14,12,2,2,1,3,1,3,1,1,2,1,1
"7885",98007212,"Fabian Schär","12/20/1991 (31 years old)","D (C)","Newcastle","English Premier Division","SUI","Yes","4/29/2022","6/30/2024","$42M - $64M","Right","Fairly Strong","Very Strong","6'2""","185 lbs","305","31",147,147,6,9,12,10,14,12,15,12,8,16,15,14,16,13,17,15,15,15,14,13,12,9,11,9,15,16,15,12,10,10,12,14,12,13,13,15,4,16,14,15,14,12,10,14,15,6,12,13,10,3,1,1,3,1,4,2,1,2,1,1
"7886",2000198455,"Noah Streit","10/11/2005 (17 years old)","AM (RL)","Basel","Swiss Promotion League","SUI","Yes","5/23/2023","6/30/2025","$130K - $1.3M","Right Only","Weak","Very Strong","5'10""","152 lbs","2","-",83,147,6,7,13,8,12,6,6,7,2,4,9,6,6,12,11,9,8,10,8,10,3,14,7,10,5,12,8,13,13,13,9,9,14,13,11,7,14,13,9,14,12,13,13,8,8,5,9,12,10,3,3,3,3,3,2,2,2,3,4,1
"7887",2000055604,"Roggerio Nyakossi","1/13/2004 (19 years old)","D (C)","OM","French National 3 - Group A","SUI","Yes","7/19/2022","6/30/2026","$150K - $6.8M","Right Only","Very Weak","Very Strong","6'4""","200 lbs","16","1",89,147,3,5,8,4,9,4,12,4,6,11,10,5,12,9,12,10,13,10,9,10,14,7,11,9,11,12,8,12,10,9,12,16,15,10,10,15,13,17,12,10,14,10,10,4,7,4,16,12,11,1,3,3,3,3,1,3,3,3,1,1
"7888",84159755,"Marvin Keller","7/3/2002 (20 years old)","GK","Young Boys","Swiss Promotion League","SUI","Yes","2/13/2023","6/30/2027","$60K - $600K","Right Only","Weak","Very Strong","6'2""","189 lbs","60","-",114,146,4,1,1,1,8,9,8,2,2,3,12,3,3,8,5,12,12,13,13,12,13,2,9,1,12,12,10,12,7,13,13,15,13,8,7,12,12,13,11,14,10,12,15,16,6,6,20,13,17,13,14,14,8,13,11,13,8,12,12,15
"7889",69004248,"Haris Seferovic","2/22/1992 (31 years old)","ST (C)","Vigo","Spanish First Division","SUI","Yes","6/14/2021","6/30/2025","$0","Left","Very Strong","Fairly Strong","6'2""","198 lbs","314","94",125,145,9,11,11,13,12,9,14,12,8,7,13,11,9,13,12,15,14,12,11,14,13,11,12,15,10,15,12,12,9,10,16,14,14,11,12,16,7,8,12,12,12,7,8,13,9,15,12,13,15,2,2,1,3,1,1,1,1,2,2,1
"7890",98033113,"Jonas Omlin","1/10/1994 (29 years old)","GK","Borussia M'gladbach","Bundesliga","SUI","Yes","1/19/2023","6/30/2027","$13M - $15.5M","Right Only","Weak","Very Strong","6'3""","176 lbs","259","-",140,145,3,2,1,1,10,5,7,1,2,1,12,3,1,11,12,13,15,12,14,13,16,6,15,1,16,12,11,12,9,15,12,16,13,11,11,13,11,14,13,17,14,11,10,12,7,6,15,14,15,12,15,16,12,14,12,12,6,12,15,14
"7891",98034373,"Djibril Sow","2/6/1997 (26 years old)","DM, M (C)","Eintracht Frankfurt","Bundesliga","SUI","Yes","6/14/2021","6/30/2025","$0","Right","Reasonable","Very Strong","6'0""","169 lbs","228","18",138,144,11,8,12,8,14,10,9,12,6,12,14,10,12,14,16,13,12,13,12,13,13,12,13,12,13,15,14,16,13,13,15,11,17,15,17,12,12,12,14,15,12,14,6,12,8,5,12,15,9,2,2,1,3,3,3,3,1,3,3,3
"7892",98029947,"Albian Ajeti","2/26/1997 (26 years old)","ST (C)","Celtic","cinch Premiership","SUI","Yes","8/13/2020","5/31/2024","$65K - $650K","Right","Fairly Strong","Very Strong","6'0""","171 lbs","207","76",115,144,7,6,13,11,12,7,11,9,4,8,8,12,8,13,12,14,15,11,12,14,15,7,8,14,8,14,9,12,11,11,14,10,12,14,14,15,8,8,9,13,11,8,5,11,7,12,7,15,7,4,2,1,1,1,1,1,2,1,2,2
"7893",98006385,"Josip Drmić","8/8/1992 (30 years old)","M/AM (L), ST (C)","Dinamo","Croatian First League","SUI","Yes","6/15/2022","6/30/2024","$550K - $1.7M","Right","Fairly Strong","Very Strong","6'0""","178 lbs","304","103",120,143,11,10,10,15,12,8,12,10,6,4,11,13,6,12,11,15,11,14,14,13,10,12,3,15,7,9,8,12,12,10,13,12,11,11,9,12,12,7,9,13,14,6,13,10,9,13,9,17,9,2,2,1,1,2,1,3,2,2,3,2
"7894",98046083,"Bećir Omeragić","1/20/2002 (21 years old)","D (C)","Zürich","Swiss Super League","SUI","Yes","6/13/2022","6/30/2026","$95K - $950K","Right","Reasonable","Very Strong","6'2""","167 lbs","104","-",117,143,4,6,10,5,11,7,11,7,9,13,13,8,14,12,11,13,12,13,12,13,11,7,12,9,13,13,12,10,11,10,12,14,11,11,14,13,15,10,12,13,11,7,12,12,11,12,12,13,11,1,3,3,1,3,3,2,1,1,1,1
"7895",79033391,"Kevin Pereira","1/15/2004 (19 years old)","AM (LC)","FC Juárez","Mexican First Division","PAR","No","1/19/2022","12/31/2026","$12K - $120K","Right","Reasonable","Very Strong","5'6""","127 lbs","15","3",93,136,10,11,13,8,12,6,7,7,4,5,7,9,4,14,6,7,11,9,8,8,12,15,5,10,9,8,6,11,14,14,7,4,13,13,9,5,7,20,6,12,13,10,13,8,5,8,12,9,16,3,4,1,3,1,4,1,3,3,1,3
"7896",84161856,"Ardon Jashari","7/30/2002 (20 years old)","DM, M (C)","Luzern","Swiss Super League","SUI","Yes","6/15/2022","6/30/2026","$6.6M - $10M","Left","Very Strong","Reasonable","5'11""","180 lbs","78","8",124,143,11,14,14,12,13,10,5,12,4,9,14,9,10,13,13,11,8,13,13,13,16,14,14,12,10,14,13,15,13,12,15,8,13,11,14,16,12,13,9,9,14,14,4,12,7,5,13,15,9,1,3,1,4,3,3,3,2,1,2,1
"7897",98033710,"Eray Cömert","2/4/1998 (25 years old)","D (C)","Valencia","Spanish First Division","SUI","Yes","1/25/2022","6/30/2026","$450K - $4.5M","Right","Fairly Strong","Very Strong","6'0""","176 lbs","170","7",127,143,5,7,11,6,13,12,13,13,7,14,13,11,16,13,14,14,14,13,11,12,12,8,12,8,12,14,11,12,11,12,13,12,13,12,15,13,13,12,10,14,13,12,9,13,12,7,11,13,13,3,1,1,2,2,2,1,2,1,1,3
"7898",84153469,"Darian Maleš","5/3/2001 (22 years old)","AM (RC), ST (C)","Inter","Italian Serie A","SUI","Yes","9/16/2020","6/30/2027","$2.1M - $4.4M","Left","Very Strong","Weak","6'2""","167 lbs","108","14",126,142,13,13,13,11,13,11,9,11,4,6,13,15,7,14,11,14,8,13,11,13,13,13,8,13,8,13,14,12,13,12,14,13,14,14,14,12,12,13,11,14,12,11,8,13,7,4,12,13,10,3,3,1,1,1,2,2,1,1,1,2
"7899",84153276,"Dan Ndoye","10/25/2000 (22 years old)","M (R), AM (RL), ST (C)","Basel","Swiss Super League","SUI","Yes","7/1/2022","6/30/2026","$9.6M - $14.5M","Right","Weak","Very Strong","6'0""","174 lbs","148","19",130,141,11,12,14,8,12,6,6,9,4,4,11,8,9,13,12,11,7,10,12,10,12,13,6,12,9,12,9,13,15,14,13,11,14,17,15,12,10,13,12,15,11,14,6,15,6,6,15,14,15,1,2,1,3,1,1,3,2,3,3,3
"7900",98041798,"Nicolas Vouilloz","5/11/2001 (22 years old)","D (C)","Servette","Swiss Super League","SUI","Yes","8/24/2021","6/30/2024","$120K - $8.4M","Right","Reasonable","Very Strong","6'0""","176 lbs","111","3",120,141,4,6,7,4,10,5,13,6,8,14,12,7,13,10,14,12,15,13,14,13,13,6,11,7,13,12,7,13,11,12,12,13,15,12,13,14,8,12,9,14,13,15,6,13,12,7,13,12,11,2,1,2,1,2,1,2,1,3,3,4
"7901",98035093,"Cédric Zesiger","6/24/1998 (24 years old)","D (C)","Young Boys","Swiss Super League","SUI","Yes","7/1/2019","6/30/2026","$5.4M - $10M","Left","Very Strong","Reasonable","6'4""","202 lbs","186","7",134,141,4,6,8,6,11,4,15,6,10,14,12,6,13,10,16,14,16,12,14,13,16,6,12,8,14,13,11,14,11,10,14,16,13,13,14,17,10,11,12,14,11,12,10,13,12,5,13,12,10,3,3,2,1,3,2,1,1,4,3,3
"7902",69004250,"Steven Zuber","8/17/1991 (31 years old)","AM (LC), ST (C)","AEK","Greek Super League 1","SUI","Yes","7/1/2022","6/30/2025","Not for Sale","Right","Fairly Strong","Very Strong","6'0""","178 lbs","381","68",130,140,14,13,14,13,13,13,9,13,7,8,13,12,8,14,12,13,11,13,11,10,11,15,12,13,8,13,13,13,13,13,14,10,12,12,12,13,15,12,12,13,13,11,9,14,5,6,11,13,12,1,1,3,1,1,3,4,3,2,3,3
"7903",84156412,"Bryan Okoh","5/16/2003 (20 years old)","D (C)","FC RB Salzburg","Austrian Premier Division","SUI","Yes","7/25/2021","5/31/2025","$200K - $8.2M","Left","Very Strong","Fairly Strong","6'2""","200 lbs","44","2",106,140,6,7,8,4,9,5,12,6,6,11,10,6,11,10,6,12,12,12,10,10,15,7,7,7,13,12,9,13,14,12,10,14,14,14,13,12,5,14,13,13,11,13,10,7,6,9,10,15,17,2,1,4,1,3,2,2,2,1,3,2
"7904",98010781,"Silvan Widmer","3/5/1993 (30 years old)","D (RC), WB (R)","Mainz 05","Bundesliga","SUI","Yes","5/5/2023","6/30/2026","$6.2M - $11M","Right","Reasonable","Very Strong","6'0""","174 lbs","335","25",132,140,6,12,11,8,12,6,13,8,17,12,11,7,13,12,13,12,14,12,12,12,16,11,15,13,12,16,11,17,13,12,13,12,12,15,16,12,13,12,12,18,16,15,13,15,12,7,13,13,16,2,4,3,2,1,1,1,2,1,3,2
"7905",98033057,"Nico Elvedi","9/30/1996 (26 years old)","D (RLC)","Borussia M'gladbach","Bundesliga","SUI","Yes","3/11/2021","6/30/2024","$10M - $12M","Right","Fairly Strong","Very Strong","6'2""","185 lbs","280","13",136,140,4,8,8,6,12,4,14,6,8,14,14,7,13,12,13,13,14,14,14,13,12,7,12,9,14,16,12,13,13,11,15,15,13,15,14,13,17,16,14,14,12,16,9,12,10,4,12,15,12,3,2,1,1,1,3,2,3,1,1,1
"7906",79013862,"Cecilio Domínguez","8/11/1994 (28 years old)","M (R), AM (RL), ST (C)","Santos Laguna","Mexican First Division","PAR","No","7/25/2022","6/30/2026","$350K - $3.5M","Right","Weak","Very Strong","5'10""","167 lbs","295","64",121,136,11,13,14,13,8,7,13,12,9,8,12,13,7,13,15,11,11,13,11,12,14,14,7,15,9,8,11,14,14,15,13,7,9,13,13,12,13,7,4,9,13,8,11,13,14,11,11,11,12,1,3,1,3,3,3,1,1,1,2,3
"7907",98029336,"Kevin Mbabu","4/19/1995 (28 years old)","D/WB (R)","Servette","Swiss Super League","SUI","Yes","7/26/2022","6/30/2025","$14M - $21M","Right","Reasonable","Very Strong","6'0""","187 lbs","173","7",126,140,7,12,13,7,11,6,12,7,17,11,11,6,14,12,16,11,13,11,10,11,12,11,8,12,11,12,11,13,15,13,13,12,13,15,14,13,9,9,10,8,10,10,10,11,12,16,10,14,12,1,1,3,1,3,3,1,2,3,1,2
"7908",98041215,"Rubén Vargas","8/5/1998 (24 years old)","M/AM (RL)","Augsburg","Bundesliga","SUI","Yes","7/25/2021","6/30/2025","$7.4M - $9.4M","Right","Fairly Strong","Very Strong","5'10""","154 lbs","190","42",132,140,12,12,15,11,13,11,8,9,16,8,12,10,10,14,15,10,13,11,9,9,14,15,5,13,8,12,12,13,15,16,9,8,12,16,12,8,14,10,10,12,8,11,11,13,10,9,11,14,12,2,1,2,3,1,3,1,3,1,3,1
"7909",48044024,"Anthony Racioppi","12/31/1998 (24 years old)","GK","Young Boys","Swiss Super League","SUI","Yes","1/9/2022","6/30/2025","$4.6M - $6.8M","Right","Reasonable","Very Strong","6'2""","185 lbs","49","-",130,139,3,2,2,1,12,2,7,1,1,1,12,2,1,12,7,12,13,12,12,13,14,2,11,4,13,10,10,10,11,13,11,13,14,11,11,11,1,14,13,14,13,15,8,14,6,5,15,14,14,12,12,15,8,14,13,14,8,12,13,14
"7910",84153580,"Amir Saipi","7/8/2000 (22 years old)","GK","Lugano","Swiss Super League","SUI","Yes","9/9/2021","6/30/2026","$400K - $7.6M","Right","Weak","Very Strong","6'4""","185 lbs","114","-",124,139,5,1,3,2,8,10,2,3,1,2,12,3,1,8,11,13,14,12,12,12,14,5,7,2,13,12,9,12,7,12,13,16,12,7,10,13,13,13,11,15,13,7,11,13,5,13,11,14,20,13,13,15,8,13,12,13,8,13,13,16
"7911",98041219,"Filip Ugrinić","1/5/1999 (24 years old)","M/AM (C)","Young Boys","Swiss Super League","SUI","Yes","7/1/2022","6/30/2026","$6M - $7.6M","Right","Fairly Strong","Very Strong","6'0""","194 lbs","188","19",131,139,11,12,11,11,13,13,8,13,5,8,13,11,7,14,11,13,11,12,13,14,11,13,12,13,8,13,14,14,11,12,15,11,14,12,15,15,14,15,14,14,12,13,7,11,8,7,14,11,10,2,4,2,3,2,1,3,2,3,2,4
"7912",84156301,"Marvin Hübel","3/1/2003 (20 years old)","GK","Aarau","Swiss Challenge League","SUI","Yes","4/7/2022","6/30/2025","$1.1M - $2.4M","Right","Fairly Strong","Very Strong","6'2""","176 lbs","59","-",94,139,4,3,1,1,6,7,1,3,2,2,10,2,1,7,6,11,14,8,9,11,13,1,12,2,12,10,9,9,14,12,10,12,13,14,6,8,11,10,11,14,12,10,9,5,7,4,11,16,10,9,6,11,7,12,9,10,5,9,12,11
"7913",2000039996,"Luuk Breedijk","2/20/2004 (19 years old)","M/AM (RL)","Luzern","Swiss Promotion League","SUI","Yes","7/1/2020","6/30/2026","$275K - $2.8M","Right","Reasonable","Very Strong","6'1""","158 lbs","39","14",86,138,7,12,9,12,14,7,5,8,6,7,14,7,5,12,5,9,4,8,6,10,13,15,4,14,7,8,6,12,14,12,8,10,13,12,8,6,10,14,10,11,10,10,7,19,7,7,8,10,9,3,3,2,3,1,3,1,3,3,1,1
"7914",2000210858,"Elohim Kamoko","2/14/2006 (17 years old)","D (C)","Zürich","Swiss Super League","SUI","Yes","7/1/2022","6/30/2025","$130K - $1.3M","Right Only","Weak","Very Strong","6'1""","176 lbs","-","-",78,138,7,6,4,7,10,3,11,2,6,9,10,7,14,9,5,7,10,7,9,11,3,5,9,9,9,9,3,10,11,10,13,13,13,12,10,13,9,12,13,9,11,12,5,15,10,5,10,11,15,1,3,1,1,3,3,2,2,2,1,2
"7915",2000260079,"Eman Kospo","5/17/2007 (16 years old)","D (C)","Grasshoppers","Swiss Super League","SUI","Yes","6/13/2022","6/30/2026","$0","Right","Reasonable","Very Strong","6'3""","171 lbs","-","-",90,138,3,5,10,6,10,3,12,6,6,11,12,6,12,10,10,11,12,10,9,10,14,8,10,8,12,11,11,11,11,10,12,13,14,11,10,11,10,14,12,14,12,10,6,12,12,6,12,14,12,3,3,1,1,2,2,3,3,2,3,2
"7916",69000798,"Marwin Hitz","9/18/1987 (35 years old)","GK","Basel","Swiss Super League","SUI","Yes","7/1/2022","6/30/2025","Not for Sale","Right","Weak","Very Strong","6'4""","200 lbs","319","1",117,138,3,3,2,1,9,7,7,3,3,2,10,3,1,9,8,16,11,17,16,13,12,2,12,3,13,14,8,8,6,9,12,16,12,5,13,14,13,10,8,14,15,15,6,16,12,6,15,10,14,12,13,15,14,15,10,11,6,15,13,13
"7917",79010845,"Juan Iturbe","6/4/1993 (30 years old)","AM (RL)","Aris","Greek Super League 1","PAR","No","8/7/2021","6/30/2024","$2.3M - $4.7M","Left Only","Very Strong","Weak","5'7""","136 lbs","301","32",115,150,12,13,14,10,12,12,7,12,7,8,12,12,7,13,16,10,13,12,10,8,13,12,8,12,6,9,10,16,15,15,8,7,10,14,11,11,8,9,10,10,7,7,9,15,13,8,8,11,14,2,3,1,1,1,4,1,2,3,1,2
"7918",79026928,"Saúl Salcedo","8/29/1997 (25 years old)","D (C)","Olimpia","Paraguay First Division Primera División","PAR","No","1/31/2021","12/31/2025","$150K - $1.5M","Right Only","Weak","Very Strong","6'0""","171 lbs","188","7",127,136,6,10,7,6,12,7,16,2,10,14,12,8,15,8,14,14,16,12,13,13,12,9,10,10,14,13,7,12,13,11,13,13,16,12,11,13,12,12,13,11,12,11,13,11,11,9,14,11,14,1,2,2,2,2,2,3,1,2,2,3
"7919",98037853,"Sandro Lauper","10/25/1996 (26 years old)","D (C), DM, M (C)","Young Boys","Swiss Super League","SUI","Yes","10/15/2021","6/30/2025","$6.2M - $11.5M","Right","Fairly Strong","Very Strong","6'1""","160 lbs","185","13",130,138,7,7,12,7,14,7,12,13,8,12,14,11,14,14,11,15,12,14,13,15,12,7,9,11,12,15,13,13,11,10,12,12,8,11,12,10,12,13,11,14,11,11,14,13,8,4,15,12,17,1,1,1,2,2,3,2,2,2,2,3
"7920",13174979,"Yves Bissouma","8/30/1996 (26 years old)","DM, M (C)","Tottenham","English Premier Division","MLI","No","6/17/2022","6/30/2026","$56M - $70M","Right","Weak","Very Strong","6'0""","171 lbs","181","6",160,165,8,11,16,9,16,13,12,13,7,14,14,13,17,15,13,15,14,17,14,16,14,14,11,12,14,15,10,16,16,14,13,12,14,14,16,15,14,14,13,14,10,12,7,13,9,4,15,14,16,3,1,1,2,2,1,3,1,2,2,2
"7921",85027988,"Abdoulaye Doucouré","1/1/1993 (30 years old)","DM, M/AM (C)","Everton","English Premier Division","MLI","Yes","9/8/2020","6/30/2024","$24M - $36M","Right","Weak","Very Strong","6'0""","154 lbs","303","38",136,160,5,11,12,14,14,7,12,13,5,12,13,8,12,13,15,12,14,13,12,13,16,12,10,13,12,16,13,17,14,13,14,12,16,13,16,15,10,12,15,15,14,13,9,14,11,5,12,15,14,2,4,1,3,2,2,2,2,2,3,2
"7922",13194021,"Cheick Doucouré","1/8/2000 (23 years old)","DM, M (C)","Crystal Palace","English Premier Division","MLI","No","7/11/2022","6/30/2027","$48M - $57M","Right","Reasonable","Very Strong","5'11""","160 lbs","149","6",141,158,8,9,12,9,14,8,12,12,10,13,15,10,14,14,13,15,14,12,13,13,15,10,10,12,14,14,15,14,13,13,12,12,14,13,14,14,11,13,12,14,16,10,8,12,12,4,15,12,12,3,2,1,2,3,2,1,3,1,2,2
"7923",12081007,"El Bilal Touré","10/3/2001 (21 years old)","ST (C)","Almería","Spanish First Division","MLI","No","9/1/2022","6/30/2027","$26M - $32M","Right","Reasonable","Very Strong","6'1""","158 lbs","85","16",137,153,8,8,12,13,14,9,14,11,11,7,12,13,7,14,8,13,10,13,11,12,12,12,8,13,9,12,11,12,16,14,13,13,11,15,14,14,6,12,12,12,13,7,8,10,7,12,12,14,13,3,2,3,2,3,1,2,2,1,2,3
"7924",13193983,"Mohamed Camara","1/6/2000 (23 years old)","DM, M (C)","AS Monaco","Ligue 1 Uber Eats","MLI","No","8/14/2022","6/30/2027","$27M - $34M","Right","Reasonable","Very Strong","5'9""","160 lbs","124","6",137,151,7,9,10,9,13,8,8,9,5,14,13,10,14,12,12,14,16,12,12,13,17,10,8,10,14,14,14,16,15,14,12,8,14,14,14,15,8,15,11,12,10,10,5,10,7,1,12,12,13,3,1,1,1,3,2,3,2,1,1,2
"7925",12088452,"Daouda Guindo","10/14/2002 (20 years old)","D (LC)","FC RB Salzburg","Austrian Premier Division","MLI","No","1/4/2021","5/31/2025","$9.8M - $15M","Left","Very Strong","Reasonable","6'0""","158 lbs","44","2",122,150,5,8,12,8,11,8,13,12,8,13,12,6,12,12,9,12,12,11,12,12,15,8,6,12,11,13,9,14,14,13,13,12,13,15,15,13,9,12,14,13,9,10,5,6,6,7,11,14,12,1,3,2,1,1,2,1,2,3,3,1
"7926",16199711,"Amadou Haïdara","1/31/1998 (25 years old)","DM, M (C)","RB Leipzig","Bundesliga","MLI","No","5/10/2021","6/30/2025","$8.2M - $10.5M","Right","Reasonable","Very Strong","5'9""","158 lbs","183","17",140,148,11,11,13,9,14,11,9,12,8,13,14,8,14,15,15,14,15,13,12,13,16,14,8,15,13,16,13,16,13,14,12,9,14,12,16,12,16,9,9,12,12,12,10,12,11,10,13,16,8,4,2,2,3,4,2,3,1,1,3,3
"7927",53173177,"Ismaïla Coulibaly","12/25/2000 (22 years old)","DM, M/AM (C)","Sheff Utd","English Premier Division","MLI","No","9/9/2020","6/30/2024","$14M - $16.5M","Right","Fairly Strong","Very Strong","5'9""","149 lbs","71","9",115,145,7,8,13,11,12,6,7,11,3,5,12,8,8,12,7,12,7,11,9,11,16,11,5,12,11,13,10,13,14,13,12,10,10,13,12,10,12,12,13,9,11,13,11,5,6,2,9,11,11,1,1,1,2,3,2,3,2,3,3,2
"7928",12078989,"Amadou Danté","10/7/2000 (22 years old)","D/WB/M (L)","SK Sturm Graz","Austrian Premier Division","MLI","No","12/19/2022","6/30/2026","$7.4M - $9M","Left","Very Strong","Reasonable","5'10""","154 lbs","96","3",127,145,6,8,11,8,11,6,8,8,7,11,10,6,11,12,8,12,12,11,12,10,15,7,7,13,15,13,11,13,16,13,12,10,13,16,14,12,6,10,14,13,12,9,5,7,5,2,11,15,13,4,3,2,3,2,1,1,1,1,2,1
"7929",79027217,"Omar Alderete","12/26/1996 (26 years old)","D (C)","Hertha","Bundesliga 2","PAR","No","10/5/2020","6/30/2026","$4.3M - $8.2M","Left","Very Strong","Weak","6'2""","202 lbs","149","7",136,149,3,8,10,6,11,6,16,4,12,15,10,11,15,10,17,13,18,13,14,13,14,6,8,10,15,13,7,13,11,10,15,15,15,13,14,15,11,13,14,14,10,11,10,12,14,5,13,11,12,2,3,4,4,1,2,1,2,3,3,2
"7930",13162806,"Aliou Dieng","10/16/1997 (25 years old)","DM, M (C)","Al-Ahly","Egyptian Premier League","MLI","No","7/4/2019","7/31/2026","$600K - $9.2M","Right","Reasonable","Very Strong","6'0""","171 lbs","119","4",133,145,6,6,12,6,12,5,8,11,6,13,13,9,14,13,14,12,12,11,13,13,14,11,9,12,14,13,12,17,13,11,12,11,15,15,18,16,10,12,11,13,14,10,6,15,9,4,15,10,14,1,1,4,1,4,2,3,2,1,3,2
"7931",49037484,"Sikou Niakaté","7/10/1999 (23 years old)","D (C)","BRG","Portuguese Premier League","MLI","Yes","6/7/2023","6/30/2028","$8.6M - $13M","Left","Very Strong","Reasonable","6'1""","182 lbs","135","5",134,144,5,10,12,8,11,7,14,6,10,14,12,9,11,13,14,15,14,13,14,12,13,12,12,8,14,14,12,13,14,13,16,14,12,13,14,14,10,12,11,10,10,10,7,11,13,7,12,13,7,2,2,2,3,2,3,4,3,1,3,3
"7932",55083819,"Moussa Maréga","4/14/1991 (32 years old)","AM (R), ST (C)","Al-Hilal (KSA)","Saudi Professional League","MLI","Yes","7/1/2021","6/30/2024","$9.8M - $12.5M","Right","Reasonable","Very Strong","6'0""","207 lbs","293","108",130,140,4,9,9,12,9,11,13,12,4,7,8,12,8,10,16,12,17,12,12,12,17,12,8,14,9,13,12,16,15,10,15,12,18,16,15,19,11,12,6,9,13,2,4,15,12,19,14,17,16,1,2,3,3,3,3,3,1,3,2,1
"7933",12095305,"Souleymane Sanogo","10/1/2006 (16 years old)","D/WB (R)","Yeelen Olympique","Bamako District League","MLI","No","1/1/2022","12/31/2025","$30K - $95K","Right Only","Weak","Very Strong","5'7""","125 lbs","-","-",75,140,6,13,8,3,13,2,7,8,7,7,10,7,10,10,15,6,10,7,11,10,14,5,10,4,10,9,7,9,15,15,9,8,10,15,8,4,9,19,11,9,10,9,8,12,7,6,8,10,13,3,1,3,2,2,3,2,3,1,1,2
"7934",12095182,"Cheickna Diakité","12/25/2004 (18 years old)","AM (RL), ST (C)","Réal Bamako","Malian Ligue 1","MLI","No","7/1/2022","12/31/2024","$26K - $250K","Right Only","Weak","Very Strong","5'9""","149 lbs","-","-",94,140,5,10,12,13,14,7,7,9,8,8,14,5,5,14,5,11,9,10,6,10,14,13,7,8,7,9,9,10,14,14,9,9,13,14,8,7,13,16,10,10,11,11,8,5,7,1,20,12,17,1,1,2,3,4,1,3,3,3,2,2
"7935",2000289434,"Nouhoum Kamissoko","12/27/2004 (18 years old)","DM, M (C)","OM","Ligue 1 Uber Eats","MLI","No","6/12/2023","6/30/2024","$275K - $2.7M","Right","Reasonable","Very Strong","5'9""","152 lbs","-","-",80,139,4,2,3,8,12,7,7,13,1,7,11,5,13,8,7,10,8,8,9,14,3,5,1,8,13,8,12,11,8,11,4,9,11,10,7,7,10,11,12,11,10,11,6,13,8,1,11,11,16,1,1,3,1,1,1,1,3,1,1,3
"7936",12088460,"Kamory Doumbia","2/18/2003 (20 years old)","M/AM (C), ST (C)","Reims","French National 3 - Group I","MLI","No","7/10/2021","6/30/2025","$250K - $2.6M","Right","Reasonable","Very Strong","6'1""","174 lbs","34","4",115,139,9,9,12,12,13,7,11,11,6,6,13,10,7,12,11,12,13,12,12,11,13,13,8,14,8,13,13,12,13,14,12,11,13,13,12,11,11,12,14,13,13,13,5,10,8,5,10,11,11,3,1,1,2,3,3,1,2,2,1,2
"7937",13157142,"Sékou Koïta","11/28/1999 (23 years old)","ST (C)","FC RB Salzburg","Austrian Premier Division","MLI","No","12/18/2019","6/30/2024","$475K - $4.7M","Left","Very Strong","Reasonable","5'8""","147 lbs","84","34",123,138,7,8,11,14,13,8,7,9,5,7,12,10,8,13,6,13,12,13,11,11,13,9,10,16,5,14,12,13,16,15,12,9,13,15,15,10,5,11,12,14,13,14,10,10,5,11,12,13,15,3,2,1,3,4,2,2,3,3,3,4
"7938",48036752,"Lassana Coulibaly","4/10/1996 (27 years old)","DM, M (C)","Salernitana","Italian Serie A","MLI","No","8/2/2021","6/30/2026","$5.4M - $8M","Right Only","Weak","Very Strong","6'0""","169 lbs","194","7",134,138,6,6,15,9,14,6,9,13,6,8,13,6,16,13,15,14,15,13,14,12,16,8,9,12,13,14,10,16,14,13,16,11,18,13,16,16,13,14,14,14,12,13,4,13,12,3,15,8,10,2,3,2,3,3,2,3,4,3,2,2
"7939",85137055,"Youssouf Koné","7/5/1995 (27 years old)","D/WB (L)","OL","Ligue 1 Uber Eats","MLI","No","7/3/2019","6/30/2024","$0","Left Only","Very Strong","Weak","5'9""","156 lbs","101","1",110,138,8,12,12,8,12,6,11,9,12,13,12,10,13,12,13,13,14,12,11,11,11,11,5,14,10,13,9,14,13,12,12,9,14,13,12,13,12,15,13,13,10,8,9,13,13,2,12,10,18,1,4,1,2,1,1,1,2,2,3,2
"7940",79011415,"Derlis Gonzalez","3/20/1994 (29 years old)","AM (RLC), ST (C)","Olimpia","Paraguay First Division Primera División","PAR","No","6/15/2020","12/31/2024","$90K - $900K","Right","Reasonable","Very Strong","5'8""","145 lbs","279","76",133,148,9,12,15,14,13,9,8,11,6,7,12,14,9,13,12,11,12,13,12,11,14,14,7,13,7,12,11,14,15,15,11,7,12,13,13,7,10,6,8,13,14,10,8,8,14,12,7,13,14,2,2,1,2,2,3,2,3,3,1,1
"7941",30035411,"Hamari Traoré","1/27/1992 (31 years old)","D/WB (R)","Rennes","Ligue 1 Uber Eats","MLI","No","9/7/2020","6/30/2023","$40K - $400K","Right","Reasonable","Very Strong","5'9""","156 lbs","317","10",136,138,10,13,11,7,12,8,12,7,15,13,12,5,12,12,15,13,13,11,12,13,12,12,9,13,13,14,11,16,15,13,12,10,16,15,17,12,13,16,13,14,13,10,5,12,13,8,15,10,14,1,1,3,2,4,2,3,1,3,1,2
"7942",12083693,"Boubacar Traoré","8/20/2001 (21 years old)","DM, M (C)","FC Metz","Ligue 1 Uber Eats","MLI","No","8/22/2019","6/30/2027","$11.5M - $13.5M","Right","Reasonable","Very Strong","6'0""","147 lbs","42","2",118,136,8,6,12,8,13,8,11,13,9,9,13,12,11,12,13,14,14,13,12,13,10,10,9,14,10,12,13,15,12,14,13,13,13,10,12,12,14,11,11,10,10,12,8,11,12,4,12,12,8,2,2,1,3,4,2,3,3,2,1,1
"7943",85022790,"Abdou Sissoko","3/20/1990 (33 years old)","DM, M (C)","Qadsia","Kuwaiti Premier League","MLI","Yes","1/22/2023","6/30/2023","$0 - $65K","Left","Very Strong","Fairly Strong","6'0""","160 lbs","295","9",110,136,6,9,10,10,12,8,14,13,7,13,12,7,14,12,14,13,12,12,12,11,14,8,12,10,13,15,10,15,10,11,14,12,16,10,12,11,15,11,11,11,12,13,7,12,10,10,14,16,9,2,4,3,3,3,3,3,1,3,2,3
"7944",13162801,"Falaye Sacko","5/1/1995 (28 years old)","D/WB (R)","VTSC","Portuguese Premier League","MLI","No","6/15/2020","6/30/2025","$1.4M - $3M","Right","Reasonable","Very Strong","5'10""","147 lbs","206","2",125,136,10,12,13,8,11,9,8,10,9,11,11,9,14,11,12,14,11,12,11,10,12,13,7,13,12,14,13,14,16,15,12,10,15,16,14,7,12,11,12,14,8,13,9,8,9,5,12,12,12,3,1,1,3,1,2,1,2,3,1,2
"7945",49044569,"Moussa Diarra","11/10/2000 (22 years old)","D (LC), DM","Toulouse FC","Ligue 1 Uber Eats","MLI","Yes","9/29/2021","6/30/2024","$2.6M - $5.4M","Left","Very Strong","Weak","6'0""","160 lbs","66","-",118,136,6,11,12,7,12,3,13,6,12,13,13,6,13,13,13,13,12,12,12,11,13,8,12,13,12,13,12,13,13,13,12,13,13,12,13,12,12,12,12,13,11,11,7,10,7,7,11,12,13,1,1,3,1,1,2,2,4,3,1,2
"7946",13186668,"Kiki Kouyaté","4/15/1997 (26 years old)","D (RC)","Montpellier","Ligue 1 Uber Eats","MLI","No","1/20/2023","6/30/2026","$8.4M - $12.5M","Right","Reasonable","Very Strong","6'4""","171 lbs","175","10",127,135,5,7,6,9,9,5,12,6,6,15,10,8,12,8,14,13,16,12,12,12,12,7,10,7,13,14,10,14,12,12,12,16,16,12,13,16,5,10,13,11,12,8,8,13,10,6,12,13,13,1,2,3,2,2,2,1,2,2,3,2
"7947",48031396,"Adama Traoré","6/28/1995 (27 years old)","AM (RLC)","Hull","Sky Bet Championship","MLI","No","7/1/2022","6/30/2024","$6.8M - $10.5M","Left","Very Strong","Reasonable","5'11""","158 lbs","142","11",127,135,12,11,14,9,15,12,9,14,4,10,15,12,11,14,10,12,11,14,10,13,11,14,9,10,10,13,15,12,13,14,12,10,13,13,11,10,14,14,15,13,14,13,16,15,5,6,13,14,12,2,4,1,3,2,3,2,3,4,1,3
"7948",13165848,"Adama Traoré","6/5/1995 (28 years old)","M/AM (L)","Ferencváros","Hungarian Division I","MLI","No","6/16/2022","6/30/2025","$220K - $7.8M","Left","Very Strong","Fairly Strong","5'10""","163 lbs","188","48",132,135,4,10,13,14,13,10,10,12,1,3,12,10,4,14,8,12,14,14,13,13,12,14,10,15,12,13,13,14,16,13,11,8,7,14,13,10,11,14,11,11,13,10,9,12,5,7,12,12,13,2,1,3,2,3,2,3,1,1,1,2
"7949",2000024313,"Ibrahima Kébé","8/1/2000 (22 years old)","DM, M (C)","Girona","Spanish First Division","MLI","No","6/15/2020","6/30/2024","$1.7M - $3.7M","Right","Weak","Very Strong","5'11""","169 lbs","51","1",112,135,8,7,8,6,10,8,10,11,8,10,12,10,13,11,13,12,14,11,13,12,5,7,8,8,14,13,10,13,14,11,11,9,13,14,15,14,17,10,7,11,10,11,11,10,9,5,14,14,12,2,2,1,1,3,3,3,4,3,3,2
"7950",12088462,"Dorgéles Néné","12/23/2002 (20 years old)","AM (RL), ST (C)","FC RB Salzburg","Austrian Premier Division","MLI","No","1/4/2021","5/31/2025","$230K - $7M","Right Only","Weak","Very Strong","5'9""","156 lbs","80","25",114,135,9,9,12,9,9,8,7,9,7,7,8,9,4,13,9,10,12,12,11,9,15,9,5,13,6,11,11,12,17,13,9,8,13,15,12,12,12,14,12,13,11,10,5,7,8,8,11,15,14,2,3,2,1,2,2,2,1,3,1,1
"7951",79035283,"Matías Galarza","2/11/2002 (21 years old)","M (C), AM (L)","VDG","Brazilian National First Division","PAR","No","1/19/2022","12/31/2025","$130K - $1.3M","Left","Very Strong","Reasonable","5'9""","147 lbs","36","1",115,147,11,10,11,11,12,11,10,11,8,14,12,6,12,12,12,12,12,11,11,11,14,12,12,12,13,14,12,13,13,12,11,9,12,13,13,9,13,11,11,12,10,8,5,11,11,7,10,8,9,3,3,2,2,3,3,3,3,2,1,3
"7952",2000032708,"Mamadou Sangaré","6/26/2002 (20 years old)","AM (C)","TSV Hartberg","Austrian Premier Division","MLI","No","9/3/2020","6/30/2025","$190K - $7.6M","Left","Very Strong","Weak","5'10""","158 lbs","62","9",110,135,9,10,12,15,15,9,8,11,6,9,15,9,10,15,6,9,7,10,10,15,17,13,8,12,11,11,15,12,15,12,11,9,12,10,8,9,13,12,12,14,12,11,12,14,6,2,12,8,15,3,1,2,2,2,1,3,2,2,1,2
"7953",12078238,"Ibrahima Koné","6/16/1999 (23 years old)","ST (C)","FC Lorient","Ligue 1 Uber Eats","MLI","No","1/31/2022","6/30/2026","$7.4M - $11M","Left","Very Strong","Fairly Strong","6'3""","185 lbs","134","31",125,135,5,7,10,14,12,7,13,10,6,7,10,12,6,12,10,12,13,12,10,10,13,12,8,13,7,14,11,16,14,11,13,15,13,14,14,16,7,9,10,13,7,8,8,10,5,8,12,13,12,2,1,3,4,2,3,1,1,1,2,3
"7954",8633054,"Modibo Maïga","9/3/1987 (35 years old)","AM (L), ST (C)","Al-Jeel","Saudi Second Division Group A","MLI","No","1/24/2023","6/30/2023","$0 - $22K","Left","Very Strong","Weak","6'2""","167 lbs","394","113",110,135,7,11,12,13,13,11,15,13,5,6,12,14,4,15,12,12,14,12,11,11,16,13,8,14,8,13,11,8,10,11,13,15,12,10,10,13,8,13,13,5,10,5,9,14,12,15,13,18,12,1,3,2,3,1,3,2,2,1,1,1
"7955",49039268,"Moussa Sissako","11/10/2000 (22 years old)","D (C)","Sochi","Russian Premier League","MLI","Yes","9/1/2022","6/30/2025","$160K - $1.6M","Right","Fairly Strong","Very Strong","6'2""","171 lbs","37","2",109,134,8,8,8,7,11,9,14,9,10,12,11,10,13,11,14,11,12,11,11,10,12,7,8,8,11,13,8,13,11,11,14,14,12,13,12,12,10,13,8,11,11,11,5,14,14,5,10,11,15,3,4,1,3,1,1,3,1,2,2,2
"7956",13162061,"Diadié Samassékou","1/11/1996 (27 years old)","DM, M (C)","TSG Hoffenheim","Bundesliga","MLI","No","9/16/2022","6/30/2025","$3.4M - $6.8M","Right","Reasonable","Very Strong","5'9""","149 lbs","207","5",128,134,10,8,11,7,12,8,11,9,6,12,13,10,15,12,16,15,16,12,11,12,12,8,12,8,13,16,11,17,13,14,12,9,13,12,16,12,7,13,10,13,8,9,9,11,10,9,12,12,7,3,3,2,1,3,2,1,1,3,4,4
"7957",12095249,"Ibrahim Diarra","12/12/2006 (16 years old)","AM (RLC)","Africa Foot","Bamako District League","MLI","No","1/1/2022","12/31/2025","$50K - $150K","Left Only","Very Strong","Weak","6'2""","152 lbs","-","-",80,134,8,12,13,10,13,6,6,8,6,6,10,2,7,11,5,4,6,9,4,11,4,11,5,13,5,7,8,8,13,13,7,15,15,13,5,5,11,19,10,12,10,14,12,7,5,8,20,10,9,2,3,3,1,1,3,4,1,3,2,2
"7958",2000279637,"Amadou Koné","8/5/2005 (17 years old)","DM","Reims","Ligue 1 Uber Eats","MLI","No","6/12/2023","6/30/2025","$800K - $1.7M","Left","Very Strong","Reasonable","5'11""","154 lbs","-","-",75,133,6,3,7,7,12,6,2,7,4,7,12,1,13,7,14,12,8,3,6,13,13,5,11,6,8,7,8,12,13,8,7,8,16,12,8,8,14,12,12,13,12,11,10,19,5,3,15,9,13,2,3,1,4,1,1,2,2,1,2,2
"7959",12078756,"Ousmane Diakité","7/25/2000 (22 years old)","DM, M (C)","TSV Hartberg","Austrian Premier Division","MLI","No","2/1/2023","6/30/2024","$600K - $6M","Right","Fairly Strong","Very Strong","6'2""","191 lbs","56","3",115,133,8,10,12,8,12,8,12,9,8,9,12,9,9,13,6,12,11,11,10,11,13,12,5,11,12,12,12,12,15,13,13,14,13,14,13,12,10,19,9,11,9,12,15,9,5,4,11,13,14,1,3,1,2,1,1,3,2,1,3,3
"7960",2000049935,"Habib Keïta","2/5/2002 (21 years old)","DM, M/AM (C)","OL","French National 3 - Group K","MLI","No","10/5/2020","6/30/2026","$210K - $2.1M","Left","Very Strong","Weak","6'0""","158 lbs","22","-",108,132,11,11,14,8,12,11,7,11,5,10,12,10,13,13,16,11,14,9,13,10,7,14,8,14,10,14,12,13,12,13,10,10,13,12,14,10,14,8,13,12,14,12,6,12,13,7,12,14,12,3,2,3,3,2,1,2,1,3,1,3
"7961",18112353,"Ibrahima Cissé","2/15/2001 (22 years old)","D (C)","Schalke 04","Bundesliga 2","MLI","Yes","7/1/2022","6/30/2026","$1.5M - $3.1M","Right","Weak","Very Strong","6'5""","189 lbs","18","5",108,132,3,6,9,6,10,3,14,6,8,13,11,6,13,10,13,10,14,10,9,9,12,7,6,8,13,11,10,12,11,9,15,17,11,13,11,16,5,8,9,10,9,10,8,10,7,10,10,11,7,1,3,2,1,1,3,3,1,2,1,4
"7962",2000091624,"Hugo Cuenca","1/8/2005 (18 years old)","AM (R)","AC Milan","Italian Serie A","PAR","Yes","8/8/2022","6/30/2024","$300K - $3M","Left","Very Strong","Reasonable","6'0""","160 lbs","-","-",87,146,5,8,12,9,12,6,10,11,6,5,12,8,5,13,7,10,12,8,6,8,13,14,8,12,5,9,12,7,12,13,10,11,12,13,9,8,10,13,14,14,12,11,9,7,6,6,9,14,13,1,2,1,3,3,2,2,3,1,2,3
"7963",2000091093,"Moïse Sahi Dion","12/20/2001 (21 years old)","ST (C)","Strasbourg","French National 3 - Group I","MLI","No","1/23/2021","6/30/2026","$2.3M - $4.8M","Left","Very Strong","Fairly Strong","5'9""","154 lbs","50","16",107,132,5,10,11,13,11,7,10,10,5,5,11,10,5,12,8,11,10,12,12,12,6,11,7,12,11,11,11,12,13,12,12,8,13,14,11,9,8,11,11,13,9,10,8,9,7,2,13,13,12,1,2,3,1,3,3,3,3,1,1,2
"7964",2000210608,"Soumaïla Traoré","7/29/2004 (18 years old)","DM","OM","Ligue 1 Uber Eats","MLI","No","7/1/2022","6/30/2027","$190K - $1.9M","Right","Weak","Very Strong","6'2""","171 lbs","-","-",82,132,7,3,3,8,13,6,7,7,1,9,13,3,14,14,6,11,8,7,6,14,13,5,8,6,13,8,9,12,12,9,8,12,10,9,8,7,12,14,13,12,11,11,5,10,8,1,13,11,9,1,3,4,1,3,3,2,3,4,1,2
"7965",48036393,"Charles Traoré","1/1/1992 (31 years old)","D (L)","FC Nantes","Ligue 1 Uber Eats","MLI","Yes","8/31/2018","6/30/2025","$350K - $1M","Left","Very Strong","Reasonable","5'11""","163 lbs","143","2",111,131,9,13,12,7,12,7,10,10,12,12,12,10,13,12,12,12,12,12,11,12,12,10,9,12,11,12,10,12,12,13,11,10,12,12,12,12,11,20,10,9,13,11,14,10,11,8,11,10,11,3,1,1,2,2,3,3,3,1,2,1
"7966",67297772,"Issa Fomba","5/24/2001 (22 years old)","M (L), AM (RL), ST (C)","Málaga","Spanish Federation First Division B","MLI","No","7/1/2019","6/30/2025","$70K - $700K","Right","Fairly Strong","Very Strong","5'9""","152 lbs","63","4",104,131,6,11,12,11,11,7,9,9,7,3,9,11,6,12,12,8,3,12,7,7,12,12,3,12,5,7,10,8,15,14,13,9,14,16,12,9,13,17,8,12,9,10,7,12,3,7,12,11,16,2,1,3,4,4,1,1,3,2,2,2
"7967",85122415,"Almamy Touré","4/28/1996 (27 years old)","D (RC), WB (R)","Eintracht Frankfurt","Bundesliga","MLI","Yes","6/15/2020","6/30/2027","$275K - $2.7M","Right","Weak","Very Strong","6'0""","178 lbs","114","7",126,131,6,13,12,6,12,6,13,8,13,13,12,7,15,13,11,13,15,13,12,12,13,11,8,12,12,12,11,13,13,12,15,13,9,16,12,13,16,17,17,15,12,14,14,14,7,6,11,11,10,2,2,2,3,3,3,3,4,2,2,1
"7968",12095308,"Mahamoud Barry","6/11/2006 (17 years old)","AM (RL)","Étoiles du Mandé","ACEFOOT League","MLI","No","1/1/2022","12/31/2024","$18K - $170K","Right","Fairly Strong","Very Strong","5'9""","138 lbs","-","-",85,131,8,12,13,10,13,6,6,7,6,1,12,2,7,10,5,8,8,7,2,13,18,11,2,6,6,7,8,8,13,13,6,4,13,13,6,3,8,18,11,9,12,8,13,14,9,4,8,9,14,1,3,1,1,1,1,3,2,1,3,4
"7969",12001328,"Cheick Diabaté","4/25/1988 (35 years old)","ST (C)","Persepolis","Persian Gulf Premier League","MLI","No","9/2/2022","6/30/2024","$35K - $375K","Right","Reasonable","Very Strong","6'4""","194 lbs","270","121",118,130,4,6,11,15,10,7,17,11,2,4,12,14,4,10,10,14,15,14,12,9,16,8,6,14,8,11,8,16,10,8,16,16,12,11,12,16,6,14,11,14,15,15,17,12,10,7,10,17,10,3,3,1,2,3,2,3,3,3,2,3
"7970",85083759,"Birama Touré","6/6/1992 (31 years old)","DM, M (C)","AJ Auxerre","Ligue 2 BKT","MLI","Yes","5/12/2020","6/30/2023","$7K - $70K","Right","Weak","Very Strong","6'0""","167 lbs","335","6",120,130,8,11,11,8,12,9,13,12,6,13,12,10,13,13,13,12,14,12,12,12,12,7,13,12,12,16,12,13,12,13,12,11,15,13,15,13,8,14,14,13,12,15,6,14,11,6,13,13,7,3,2,2,3,3,2,1,3,1,2,2
"7971",13111558,"Moussa Doumbia","8/15/1994 (28 years old)","AM (LC)","FCSM","French National","MLI","No","7/1/2022","6/30/2024","$400K - $3.9M","Right","Reasonable","Very Strong","5'8""","149 lbs","182","20",120,130,12,11,14,10,12,8,6,10,5,5,12,9,7,13,12,13,9,12,11,11,8,11,7,14,8,11,12,11,14,15,12,7,12,14,14,8,9,13,11,10,7,12,7,12,6,5,12,14,11,2,1,2,3,3,1,1,2,1,3,1
"7972",49049339,"Lassine Sinayoko","12/8/1999 (23 years old)","AM (R), ST (C)","AJ Auxerre","Ligue 2 BKT","MLI","Yes","12/17/2021","6/30/2025","$230K - $2.3M","Right","Weak","Very Strong","6'1""","178 lbs","66","4",120,130,8,12,13,11,12,10,11,10,5,6,12,11,6,13,10,10,13,11,12,11,13,11,8,12,6,11,12,13,14,13,12,11,14,15,13,14,8,16,12,13,14,12,6,10,7,5,11,13,12,1,1,4,3,2,3,1,1,2,3,3
"7973",67175052,"Thomas Partey","6/13/1993 (29 years old)","D (R), DM, M (C)","Arsenal","English Premier Division","GHA","No","10/5/2020","6/30/2025","$106M - $160M","Right","Reasonable","Very Strong","6'1""","176 lbs","314","30",159,162,8,11,14,10,15,9,13,15,10,12,15,8,14,16,13,16,14,16,14,16,14,13,12,15,15,16,14,15,13,13,14,14,11,13,14,15,16,15,12,14,14,13,11,13,10,9,15,14,14,1,1,3,2,3,1,2,2,3,3,1
"7974",49063222,"Alidu Seidu","6/4/2000 (23 years old)","D (RLC), WB (R)","Clermont","Ligue 1 Uber Eats","GHA","No","10/19/2022","6/30/2027","$4.5M - $6.8M","Right","Reasonable","Very Strong","5'8""","149 lbs","71","-",130,146,10,11,10,6,11,8,11,9,12,13,10,9,14,11,12,12,15,11,13,12,14,11,10,10,12,12,11,12,14,11,15,11,15,15,14,15,10,14,12,13,11,10,8,11,9,8,12,11,11,2,2,3,1,2,1,1,2,2,3,1
"7975",2000079739,"Emirhan İlkhan","6/1/2004 (19 years old)","M/AM (C)","Sampdoria","Italian Serie B","TUR","No","8/8/2022","6/30/2026","$120K - $1.2M","Right","Reasonable","Very Strong","5'9""","158 lbs","23","1",112,139,6,11,15,12,14,5,7,11,3,4,12,8,7,13,9,12,10,12,10,13,13,15,7,13,7,12,12,14,13,13,12,8,14,13,13,8,12,12,14,14,10,16,5,11,6,2,13,15,13,2,1,1,3,2,3,3,4,2,1,2
"7976",18083491,"Leon Bailey","8/9/1997 (25 years old)","M/AM (RL)","Aston Villa","English Premier Division","JAM","No","8/4/2021","6/30/2025","$37M - $47M","Left","Very Strong","Weak","5'10""","165 lbs","226","41",140,160,13,14,15,13,12,10,7,13,11,4,11,12,7,14,13,13,12,10,10,9,15,17,8,13,9,12,12,14,17,16,10,12,14,17,13,9,12,10,10,10,12,5,12,13,8,16,9,18,16,3,2,3,1,1,1,4,1,3,3,2
"7977",29233994,"Coniah Boyce-Clarke","3/1/2003 (20 years old)","GK","Reading","Sky Bet League One","JAM","No","7/2/2020","8/30/2023","$210K - $8.4M","Right","Weak","Very Strong","6'3""","185 lbs","15","-",98,154,4,1,2,3,10,9,3,2,1,2,9,3,3,7,12,8,8,9,10,8,4,3,8,3,14,11,10,10,10,16,12,13,14,11,8,11,14,16,13,9,15,12,5,6,10,3,14,8,10,11,8,14,6,11,14,11,9,8,9,13
"7978",28036815,"Michail Antonio","3/28/1990 (33 years old)","M/AM (R), ST (C)","West Ham","English Premier Division","JAM","No","1/7/2022","6/30/2024","$11.5M - $14.5M","Right","Reasonable","Very Strong","5'11""","180 lbs","439","104",136,148,8,11,13,11,12,6,15,9,15,9,11,10,8,13,13,13,13,13,11,12,14,14,9,13,9,14,11,14,15,14,15,12,13,15,13,15,14,16,16,15,13,12,11,13,5,6,14,14,14,2,3,3,3,1,3,1,3,3,2,2
"7979",29114887,"Demarai Gray","6/28/1996 (26 years old)","AM (RLC), ST (C)","Everton","English Premier Division","JAM","No","7/22/2021","6/30/2024","$7.4M - $9.2M","Right","Reasonable","Very Strong","6'0""","163 lbs","282","28",130,145,12,11,13,12,12,11,6,13,6,7,12,11,5,14,9,11,7,10,10,9,13,15,7,11,8,12,11,11,16,14,12,9,15,16,12,9,6,11,9,15,11,11,5,10,5,5,8,14,10,2,1,1,2,1,3,1,2,2,1,2
"7980",89040516,"Ethan Pinnock","5/29/1993 (30 years old)","D (C)","Brentford","English Premier Division","JAM","No","5/28/2023","6/30/2027","$35M - $52M","Left Only","Very Strong","Weak","6'4""","169 lbs","390","22",139,140,5,7,10,9,12,7,15,6,14,14,13,5,14,13,12,14,15,14,14,14,16,6,13,8,14,13,12,14,12,11,15,17,14,12,14,15,10,18,14,18,14,14,8,14,6,4,14,14,14,3,3,2,3,3,3,3,2,1,3,2
"7981",2000048959,"Brandon Cover","9/25/2003 (19 years old)","DM, M/AM (C)","Leicester","Sky Bet Championship","JAM","No","10/2/2022","6/30/2024","$95K - $950K","Right","Reasonable","Very Strong","6'2""","171 lbs","-","-",80,137,5,6,10,7,13,6,6,11,4,7,10,5,9,10,15,7,8,10,7,13,15,8,9,4,9,12,9,13,10,8,5,12,15,11,12,7,8,18,11,10,14,13,10,13,11,4,11,11,20,2,2,1,1,3,3,4,3,2,3,1
"7982",28049809,"Kemar Roofe","1/6/1993 (30 years old)","AM (RLC), ST (C)","Rangers","cinch Premiership","JAM","No","8/4/2020","5/31/2024","$5.2M - $9.8M","Right","Reasonable","Very Strong","5'10""","156 lbs","246","84",124,136,4,12,14,14,13,9,12,12,1,3,11,7,4,13,6,14,11,13,10,12,14,15,4,14,4,13,12,13,14,12,14,10,12,13,13,10,14,14,14,16,12,10,18,15,13,2,13,16,10,2,3,3,1,2,2,1,2,2,3,3
"7983",30002284,"Garath McCleary","5/15/1987 (36 years old)","M (R), AM (RLC)","Wycombe","Sky Bet League One","JAM","No","1/31/2021","6/30/2024","$20K - $210K","Right","Fairly Strong","Very Strong","5'10""","174 lbs","533","77",112,135,10,12,15,11,14,11,9,9,10,7,11,12,8,11,5,11,12,12,13,12,12,15,12,12,5,13,10,12,11,12,13,8,15,12,11,11,12,10,12,17,12,18,13,11,3,7,12,12,10,3,3,1,2,3,1,2,1,2,3,2
"7984",28060185,"Kevin Stewart","9/7/1993 (29 years old)","DM, M (C)","Blackpool","Sky Bet League One","JAM","No","1/23/2021","6/30/2024","$3.1M - $6.2M","Right","Fairly Strong","Very Strong","5'11""","160 lbs","126","6",117,135,4,8,11,6,12,7,12,6,4,14,12,8,14,12,14,14,13,14,13,13,14,7,11,7,14,16,11,14,11,11,13,10,15,12,13,12,13,15,12,16,12,16,20,12,12,7,14,11,12,3,1,3,2,1,1,2,3,1,2,3
"7985",43084308,"Alfred Duncan","3/10/1993 (30 years old)","DM, M (C)","Fiorentina","Italian Serie A","GHA","Yes","9/1/2020","6/30/2024","$4.9M - $7.4M","Left","Very Strong","Reasonable","5'10""","171 lbs","289","13",138,145,12,10,13,11,13,11,10,12,9,13,13,10,14,12,14,13,15,13,14,13,15,12,9,14,14,17,13,16,12,12,15,10,15,14,15,15,12,11,15,15,11,13,9,14,12,4,14,13,13,3,1,2,3,3,2,2,3,3,1,2
"7986",90050278,"Curtis Tilt","8/4/1991 (31 years old)","D (C)","Wigan","Sky Bet League One","JAM","No","7/1/2022","6/30/2024","$20K - $210K","Left","Very Strong","Weak","6'4""","165 lbs","299","16",105,135,2,6,8,5,10,2,15,3,7,12,10,6,13,9,16,13,16,10,11,11,14,9,12,8,12,12,8,12,10,7,13,15,15,12,12,15,8,7,12,10,12,8,6,12,12,10,15,8,11,2,1,1,1,2,3,1,1,2,2,2
"7987",28058544,"Bobby Decordova-Reid","2/2/1993 (30 years old)","WB (R), AM (RLC)","Fulham","English Premier Division","JAM","No","1/5/2023","6/30/2024","$23M - $35M","Right","Fairly Strong","Very Strong","5'7""","149 lbs","355","57",135,135,9,11,14,13,12,10,9,11,5,8,12,11,8,13,10,12,9,12,14,13,17,13,8,13,9,16,12,17,14,13,15,5,14,14,14,7,19,14,12,15,12,12,8,13,5,6,12,12,18,3,2,1,1,1,3,1,1,1,2,2
"7988",28112989,"Jonathan Russell","10/9/2000 (22 years old)","DM, M (C)","Barnsley","Sky Bet League One","JAM","No","1/31/2023","6/30/2026","$1.5M - $3.3M","Right","Fairly Strong","Very Strong","6'5""","187 lbs","61","4",106,135,7,8,12,10,12,8,11,10,6,9,13,8,10,11,8,10,9,13,9,11,12,11,8,14,14,11,11,11,10,10,14,13,12,11,14,14,11,11,9,12,12,12,8,10,6,4,10,11,11,2,2,3,1,1,4,1,2,1,1,4
"7989",81000113,"Rodolph Austin","6/1/1985 (38 years old)","D (C), DM, M (C)","Portmore Utd","Jamaican Premier League","JAM","No","1/1/2022","6/30/2024","$0","Right Only","Weak","Very Strong","6'0""","185 lbs","357","32",86,135,4,5,4,5,6,11,13,6,7,12,9,11,12,4,15,14,16,12,11,10,17,9,15,9,14,15,7,11,3,4,11,12,15,5,8,15,12,10,14,15,14,13,16,13,9,5,15,13,12,2,1,4,2,2,1,1,2,2,1,3
"7990",29038609,"Andre Gray","6/26/1991 (31 years old)","ST (C)","Aris","Greek Super League 1","JAM","No","7/3/2022","6/30/2026","$500K - $1.5M","Right","Reasonable","Very Strong","5'11""","160 lbs","472","169",110,135,7,11,12,13,10,7,13,12,5,5,10,13,5,12,12,14,12,11,10,12,12,10,7,14,6,11,10,10,12,13,12,10,12,12,12,15,6,10,10,9,10,9,7,15,8,13,11,15,12,4,4,3,3,1,3,3,3,3,3,2
"7991",5119893,"Adrian Mariappa","10/3/1986 (36 years old)","D (RC)","Salford","Sky Bet League Two","JAM","No","3/23/2023","6/30/2024","$6K - $18K","Right","Fairly Strong","Very Strong","5'10""","165 lbs","424","10",91,135,5,7,7,4,12,5,11,5,11,12,12,7,12,11,12,12,12,13,12,10,18,10,13,7,13,14,7,13,7,8,10,11,20,8,10,13,14,17,16,19,11,15,10,10,7,7,12,13,15,2,1,2,3,3,4,1,2,2,3,1
"7992",28108493,"Joel Latibeaudiere","1/6/2000 (23 years old)","D (RC), DM","Swansea","Sky Bet Championship","JAM","No","10/16/2020","6/30/2026","$600K - $1.4M","Right","Fairly Strong","Very Strong","5'11""","176 lbs","76","3",113,133,5,8,10,6,10,5,14,6,3,11,10,8,12,10,16,12,17,10,14,11,18,8,13,11,11,18,11,16,11,10,11,11,12,10,15,13,18,6,5,18,8,16,8,12,18,4,10,14,11,1,2,4,2,2,2,3,2,2,3,2
"7993",28058697,"Michael Hector","7/19/1992 (30 years old)","D (C)","Charlton","Sky Bet League One","JAM","No","1/31/2023","6/30/2026","$210K - $650K","Right","Reasonable","Very Strong","6'4""","180 lbs","335","16",110,132,6,6,10,6,10,9,14,9,9,12,11,12,13,11,12,10,14,8,10,8,15,6,13,8,12,14,9,11,12,12,15,15,14,12,13,15,9,12,16,14,9,13,8,14,12,9,10,12,10,1,3,3,2,2,1,4,3,3,3,3
"7994",29085571,"Jamal Lowe","7/21/1994 (28 years old)","AM (RL), ST (C)","Bournemouth","English Premier Division","JAM","No","8/31/2021","6/30/2024","$325K - $3.4M","Right","Reasonable","Very Strong","6'0""","165 lbs","390","97",119,131,8,11,14,12,12,7,8,12,5,7,11,14,6,12,10,12,8,12,9,11,12,15,6,11,6,11,10,12,13,12,14,11,17,14,14,11,12,9,9,14,15,12,2,13,3,2,12,12,11,3,4,1,3,1,1,1,2,1,3,3
"7995",81002616,"Andre Blake","11/21/1990 (32 years old)","GK","Philadelphia","Major League Soccer","JAM","No","7/15/2021","12/31/2024","Not for Sale","Right","Reasonable","Very Strong","6'2""","176 lbs","284","-",131,131,7,1,1,2,10,8,1,3,3,2,14,2,3,6,11,11,13,12,11,12,15,3,15,11,12,11,10,11,12,15,13,14,15,12,15,12,15,19,16,15,16,17,11,14,5,2,13,13,17,8,9,16,8,14,10,11,8,12,13,16
"7996",93034815,"Daniel Amartey","12/21/1994 (28 years old)","D (RC), DM","Leicester","Sky Bet Championship","GHA","No","6/14/2021","6/30/2025","$19M - $24M","Right","Reasonable","Very Strong","6'1""","174 lbs","184","5",134,145,6,12,11,6,12,8,15,10,8,15,12,9,15,12,15,13,15,11,13,12,17,5,8,11,12,15,10,16,12,12,13,13,13,12,15,14,15,13,14,15,13,15,8,14,10,5,11,15,11,4,2,1,2,3,2,1,1,3,1,3
"7997",81061731,"Trivante Stewart","3/22/2000 (23 years old)","ST (C)","Mount Pleasant FC","Jamaican Premier League","JAM","No","4/5/2022","6/30/2025","$0","Right","Weak","Very Strong","6'2""","176 lbs","64","30",96,130,6,6,10,12,10,7,12,10,6,5,10,11,7,10,13,9,13,9,9,8,15,8,7,10,5,12,8,15,14,11,13,13,16,14,13,13,7,16,10,13,11,11,5,4,8,8,12,12,19,2,1,1,3,1,1,4,4,1,3,3
"7998",81056050,"Venton Evans","6/19/1998 (24 years old)","DM, M (C)","Greenville","United States Soccer Leagues Division One","JAM","No","12/23/2021","11/30/2023","$120K - $1.2M","Right","Strong","Very Strong","5'11""","160 lbs","110","13",101,130,10,9,9,9,10,10,9,11,5,10,10,8,10,9,12,11,13,11,10,9,9,14,3,10,10,12,10,11,14,10,10,11,15,13,12,11,9,14,11,11,11,12,2,3,7,3,11,11,14,1,1,2,3,3,2,1,1,2,3,1
"7999",2000173141,"Christopher Pearson","1/21/2003 (20 years old)","M/AM (C)","Tulsa","USSL Championship Eastern Conference","JAM","No","12/27/2022","11/30/2024","$325K - $1M","Right","Reasonable","Very Strong","6'2""","174 lbs","13","1",89,130,12,8,11,11,10,12,9,12,3,10,11,12,10,10,6,8,9,13,9,8,11,15,6,11,11,10,11,11,12,8,10,14,14,12,9,12,11,19,12,13,12,10,12,5,11,6,8,8,20,2,1,2,2,4,2,2,2,2,2,1
"8000",28115829,"Di'Shon Bernard","10/14/2000 (22 years old)","D (RC), WB (R)","Man UFC","English Premier Division","JAM","No","6/15/2020","6/30/2028","$95K - $275K","Right","Reasonable","Very Strong","6'2""","167 lbs","66","2",107,130,4,8,10,4,11,4,11,6,9,11,12,5,13,11,13,10,12,11,9,11,13,4,9,6,12,12,10,14,14,12,12,14,16,14,13,13,12,13,15,14,9,11,3,11,6,5,10,12,13,1,2,1,3,1,1,3,2,3,3,2
"8001",29045054,"Liam Moore","1/31/1993 (30 years old)","D (C)","Reading","Sky Bet League One","JAM","No","6/14/2021","6/30/2025","$170K - $1.7M","Right","Reasonable","Very Strong","6'1""","189 lbs","319","9",111,129,7,9,9,6,12,6,13,6,18,14,12,7,14,10,13,11,18,12,11,9,14,5,17,10,13,12,10,12,9,9,9,12,14,11,11,16,14,14,15,12,12,12,12,11,12,12,11,13,8,3,3,4,2,2,2,3,2,3,1,1
"8002",28048721,"Daniel Johnson","10/8/1992 (30 years old)","M/AM (C)","Preston","Sky Bet Championship","JAM","No","6/14/2021","6/30/2025","$3.1M - $6.2M","Left Only","Very Strong","Very Weak","5'9""","147 lbs","334","56",117,128,9,11,12,11,16,13,6,12,6,7,16,18,10,14,10,13,8,15,10,11,11,13,14,13,9,11,15,10,13,14,13,7,13,12,13,9,9,8,11,12,11,12,10,13,7,7,10,13,12,3,2,1,1,1,1,2,2,1,4,3
"8003",81015053,"Alvas Powell","7/18/1994 (28 years old)","D (R)","Cincinnati","Major League Soccer","JAM","No","1/1/2022","12/31/2024","$1.3M - $2.9M","Right","Reasonable","Very Strong","6'0""","185 lbs","191","6",116,128,7,11,10,7,10,10,11,8,6,11,11,10,12,10,13,10,13,8,7,10,15,8,15,13,10,11,8,14,15,14,13,11,12,16,15,13,15,18,17,15,14,14,12,12,7,2,8,8,9,4,3,4,3,1,3,3,1,2,2,2
"8004",81061845,"Dwayne Atkinson","5/5/2002 (21 years old)","AM (LC), ST (C)","ÍBV","Icelandic Premier Division","JAM","No","4/27/2023","10/31/2023","$30K - $95K","Right","Reasonable","Very Strong","5'8""","141 lbs","78","25",92,128,8,10,13,14,13,5,8,11,5,8,11,5,5,12,9,10,5,6,4,5,15,18,4,14,9,9,7,13,13,11,14,3,14,13,10,9,17,15,11,12,13,11,2,17,7,6,13,10,18,1,3,1,2,1,3,1,4,4,3,2
"8005",81037383,"Shamar Nicholson","3/16/1997 (26 years old)","ST (C)","Spartak Moscow","Russian Premier League","JAM","No","12/21/2021","6/30/2026","$220K - $2.2M","Right","Reasonable","Very Strong","6'4""","174 lbs","232","84",123,127,9,9,9,11,12,11,15,11,7,6,11,10,6,10,12,12,13,14,13,13,15,14,7,13,9,12,12,12,14,13,10,16,14,14,13,14,12,15,13,13,14,13,3,12,7,3,11,15,8,2,1,2,2,2,2,1,3,2,1,1
"8006",28059557,"Jonson Clarke-Harris","7/20/1994 (28 years old)","ST (C)","Peterborough","Sky Bet League One","JAM","No","8/27/2020","6/30/2024","$1.8M - $3.8M","Left","Very Strong","Reasonable","6'0""","156 lbs","361","122",118,125,3,11,11,15,13,13,15,13,4,7,10,16,7,13,15,13,15,14,12,12,15,12,16,12,7,14,9,9,9,9,15,14,6,9,12,17,3,5,9,10,13,9,7,10,13,15,14,12,12,2,2,2,2,2,2,1,2,1,3,3
"8007",29194724,"Antoine Semenyo","1/7/2000 (23 years old)","AM (RL), ST (C)","Bournemouth","English Premier Division","GHA","No","1/27/2023","6/30/2027","$12.5M - $18.5M","Right","Weak","Very Strong","5'10""","138 lbs","158","23",128,145,7,11,14,12,11,7,9,11,4,5,11,9,7,12,14,10,12,14,8,9,12,17,8,14,7,9,13,11,16,15,13,9,14,16,11,14,14,6,7,11,12,14,11,19,14,11,11,13,11,1,3,2,1,4,1,1,1,3,3,2
"8008",5112486,"Darren Pratley","4/22/1985 (38 years old)","DM, M (C)","Leyton Orient","Sky Bet League One","JAM","No","5/16/2023","6/30/2024","$0 - $30K","Right","Weak","Very Strong","6'1""","154 lbs","585","51",96,125,5,5,5,5,12,7,11,8,9,12,12,9,12,10,14,15,16,14,15,14,14,8,16,8,14,16,6,14,7,8,14,12,19,8,13,16,12,14,14,18,14,14,6,12,8,8,15,14,12,3,2,3,1,2,1,2,3,1,1,3
"8009",72041405,"Damion Lowe","5/5/1993 (30 years old)","D (C)","Philadelphia","Major League Soccer","JAM","No","1/25/2023","12/31/2023","$1.2M - $2.5M","Right","Reasonable","Very Strong","6'3""","174 lbs","192","11",117,125,5,7,11,7,11,7,15,6,8,13,10,7,17,9,15,11,15,9,9,9,17,12,16,8,11,11,9,12,13,11,9,15,14,14,14,15,11,13,14,15,11,14,8,15,14,3,11,16,18,2,3,2,4,2,2,3,3,1,3,4
"8010",81001828,"Kemar Lawrence","9/17/1992 (30 years old)","D/WB (L)","Minnesota","Major League Soccer","JAM","No","3/17/2022","12/31/2024","$475K - $4.8M","Left Only","Very Strong","Weak","5'10""","160 lbs","280","10",121,125,9,13,10,9,10,8,8,9,11,12,11,9,12,10,14,9,14,12,14,11,15,13,8,13,11,10,10,12,15,14,13,9,15,15,16,9,10,14,14,10,13,14,3,12,9,2,10,15,15,1,1,1,1,1,9,1,1,1,1,1
"8011",28093277,"Wes Harding","10/20/1996 (26 years old)","D (RC), WB (R)","Rotherham","Sky Bet Championship","JAM","No","8/20/2020","6/30/2025","$250K - $750K","Right","Reasonable","Very Strong","5'11""","174 lbs","182","1",110,125,5,9,10,4,10,5,14,4,13,13,11,5,13,10,14,10,14,12,12,11,13,5,13,9,12,14,9,14,11,10,10,11,14,11,13,14,8,13,14,16,10,11,5,12,8,2,10,11,10,1,3,2,2,3,3,1,1,3,2,3
"8012",2000025509,"Dexter Lembikisa","11/4/2003 (19 years old)","D (R), WB (RL)","Wolves","English Premier Division","JAM","No","1/9/2023","6/30/2026","$700K - $1.5M","Right","Fairly Strong","Very Strong","5'11""","158 lbs","1","-",110,124,7,10,11,4,8,3,9,5,10,8,9,7,10,11,14,7,11,12,8,9,8,10,13,7,10,11,12,14,15,12,11,9,15,15,12,10,12,20,12,10,9,9,8,6,7,8,11,12,8,1,3,3,1,1,1,2,2,3,1,1
"8013",2000017295,"Luke Badley-Morgan","10/22/2003 (19 years old)","D (LC)","Stoke","Sky Bet Championship","JAM","No","8/28/2022","6/30/2024","$35K - $375K","Left","Very Strong","Fairly Strong","6'0""","156 lbs","-","-",71,124,8,7,5,4,8,9,7,9,6,8,7,7,6,13,8,9,7,8,10,8,5,5,9,9,8,12,12,11,15,8,10,12,15,12,11,7,15,10,10,12,12,13,7,4,13,6,9,10,9,1,1,1,2,3,2,2,2,2,3,2
"8014",81042506,"Kaheem Parris","1/6/2000 (23 years old)","AM (R)","Dynamo Kyiv","Ukrainian Premier League","JAM","No","9/2/2022","6/30/2026","$230K - $2.3M","Left","Very Strong","Fairly Strong","5'10""","152 lbs","114","36",112,124,9,10,13,12,13,10,7,9,2,6,12,10,9,13,9,11,12,13,9,11,13,18,8,12,7,11,12,11,13,11,11,11,14,14,12,10,6,14,14,13,14,3,5,12,3,12,11,14,7,3,3,1,1,2,4,1,1,1,2,1
"8015",81056047,"Lamar Walker","9/26/2000 (22 years old)","M (R), AM (RLC)","Portmore Utd","Jamaican Premier League","JAM","No","2/1/2023","6/30/2024","$0","Right Only","Weak","Very Strong","5'6""","134 lbs","84","13",91,123,10,8,14,9,12,8,9,12,8,5,12,7,7,12,11,10,10,12,8,9,15,16,8,10,5,10,12,10,14,12,11,9,15,13,9,7,16,20,14,10,12,13,3,14,2,7,13,15,7,3,2,3,2,1,3,1,1,1,2,1
"8016",5113025,"Clayton Donaldson","2/7/1984 (39 years old)","ST (C)","Farsley","Vanarama National League North","JAM","No","6/7/2023","6/30/2024","$0","Right","Weak","Very Strong","6'1""","176 lbs","691","227",58,122,5,8,8,9,12,5,10,8,14,6,11,14,9,10,6,9,12,8,9,9,11,11,12,12,8,9,11,9,8,8,10,13,10,8,6,12,9,14,15,10,10,11,11,11,4,13,11,14,11,1,2,3,3,3,3,2,1,2,2,4
"8017",2000127804,"Karoy Anderson","10/1/2004 (18 years old)","M/AM (C)","Charlton","Sky Bet League One","JAM","No","6/13/2022","6/30/2025","$90K - $900K","Right","Fairly Strong","Very Strong","6'0""","160 lbs","5","-",95,121,9,11,12,9,11,8,9,8,4,7,12,8,10,12,11,11,10,9,7,11,11,11,5,9,7,12,11,12,12,12,11,9,13,12,12,10,10,11,12,11,9,8,5,11,5,8,10,10,9,2,3,2,3,2,1,2,1,3,3,3
"8018",13211267,"Abdul Fatawu","3/8/2004 (19 years old)","M (R), AM (RLC)","Sporting CP","Portuguese Premier League","GHA","No","1/1/2022","6/30/2027","$220K - $2.2M","Left","Very Strong","Weak","5'10""","160 lbs","26","8",125,145,12,11,15,11,13,13,6,14,7,6,13,8,6,14,10,10,13,12,10,8,11,13,3,10,6,10,12,11,16,15,12,5,11,15,11,13,12,12,10,11,10,7,12,13,15,8,7,16,13,4,1,2,1,4,1,1,3,1,2,2
"8019",29106785,"Amari'i Bell","5/5/1994 (29 years old)","D (LC)","Luton","English Premier Division","JAM","No","7/1/2021","6/30/2026","$5.4M - $10M","Left Only","Very Strong","Weak","5'11""","145 lbs","336","13",119,120,10,10,12,6,9,6,11,6,9,12,11,8,12,10,7,10,7,8,11,11,13,11,8,10,12,13,9,15,17,14,12,13,15,16,15,13,7,13,13,14,9,12,2,10,5,5,10,11,8,3,2,2,3,1,4,3,3,1,2,2
"8020",81000130,"Steven Morrissey","7/25/1986 (36 years old)","ST (C)","VPS","Finnish Premier League","JAM","No","6/14/2021","11/15/2023","$0 - $12K","Right","Reasonable","Very Strong","5'9""","171 lbs","241","65",88,120,5,8,12,13,11,8,9,10,4,6,9,10,6,11,7,9,9,12,12,9,15,13,7,15,7,11,10,10,11,14,12,7,9,12,7,9,8,12,10,11,12,10,12,11,6,7,11,12,12,1,4,2,1,3,1,1,1,3,3,3
"8021",29116506,"Jevani Brown","10/16/1994 (28 years old)","AM (RC), ST (C)","Exeter","Sky Bet League One","JAM","No","6/29/2021","6/30/2025","$80K - $800K","Left","Very Strong","Weak","5'9""","143 lbs","283","64",110,120,13,12,13,12,14,11,8,12,2,3,13,12,6,14,11,12,8,12,10,12,9,13,2,13,6,12,13,12,12,11,13,7,11,12,13,10,12,9,11,5,13,8,2,9,6,14,12,10,9,2,1,2,3,1,1,1,1,3,3,3
"8022",5132368,"Theo Robinson","1/22/1989 (34 years old)","ST (C)","Brackley","Vanarama National League North","JAM","No","3/1/2023","6/30/2024","$0 - $4K","Right","Reasonable","Very Strong","5'11""","143 lbs","512","120",65,120,3,7,10,10,8,6,8,8,4,7,8,8,7,10,8,11,10,8,9,9,13,13,8,12,7,9,9,8,10,12,10,9,16,9,9,11,8,9,9,11,11,9,7,14,8,10,6,14,5,3,2,3,1,2,1,1,3,3,1,1
"8023",81000905,"Dever Orgill","3/8/1990 (33 years old)","ST (C)","Bodrum FK","Turkish 1. League","JAM","No","1/12/2023","6/30/2024","$130K - $375K","Right","Reasonable","Very Strong","6'0""","176 lbs","275","71",100,120,4,7,11,10,8,5,11,10,3,9,7,9,8,8,16,8,12,8,10,9,14,9,6,13,7,12,9,14,14,11,14,13,13,15,14,15,9,17,16,15,15,12,12,10,11,4,9,16,15,1,1,1,1,2,1,1,1,1,3,3
"8024",29115801,"Kasey Palmer","11/9/1996 (26 years old)","M (C), AM (RLC)","Coventry","Sky Bet Championship","JAM","No","6/21/2022","6/30/2025","$1.9M","Right","Fairly Strong","Very Strong","5'11""","174 lbs","167","17",115,120,12,10,13,10,14,16,10,11,8,8,13,12,8,13,13,12,12,11,10,11,13,18,7,11,9,12,14,12,12,13,11,10,14,11,11,13,11,8,13,14,7,8,12,11,9,4,9,15,12,1,1,3,3,3,1,1,3,1,3,3
"8025",81052663,"Jeadine White","7/7/2000 (22 years old)","GK","Cavalier","Jamaican Premier League","JAM","No","7/1/2022","6/30/2026","$0 - $1.5K","Right Only","Weak","Very Strong","6'1""","169 lbs","60","-",79,120,2,3,3,1,3,5,1,3,3,2,8,3,1,5,9,10,11,8,9,9,14,1,10,2,8,8,8,8,10,10,10,12,14,10,10,10,14,13,13,12,11,12,2,5,9,2,13,14,2,10,12,11,7,11,10,10,4,10,11,10
"8026",28109988,"Jordon Garrick","7/15/1998 (24 years old)","M (L), AM (RL)","Forest Green","Sky Bet League Two","JAM","No","1/5/2023","6/30/2024","$26K - $275K","Right","Reasonable","Very Strong","5'11""","169 lbs","107","13",95,120,3,9,10,9,9,5,8,7,5,6,8,9,7,10,14,8,9,8,7,7,12,11,6,10,5,10,8,10,14,13,13,11,14,15,13,14,10,18,16,15,14,15,16,8,5,2,9,11,7,3,2,3,4,3,2,2,3,3,4,2
"8027",28070419,"Greg Leigh","9/30/1994 (28 years old)","D/WB/M (L)","Ipswich","Sky Bet Championship","JAM","No","7/1/2022","6/30/2024","$18K - $190K","Left","Very Strong","Weak","5'11""","160 lbs","222","8",108,119,8,10,11,9,10,4,12,7,11,12,10,7,13,10,14,11,12,11,11,8,14,8,7,12,10,12,9,15,14,12,9,15,12,14,14,10,10,12,13,15,9,13,13,10,9,7,12,12,8,1,2,3,4,2,2,2,3,2,4,3
"8028",81001320,"Kavin Bryan","2/7/1984 (39 years old)","ST (C)","SC Scarborough","Canadian Soccer League","JAM","No","6/14/2021","12/31/2023","$0 - $5K","Right","Weak","Very Strong","5'11""","160 lbs","87","34",75,119,9,10,11,9,9,9,9,10,4,6,9,13,8,9,12,12,13,11,11,11,13,12,9,11,9,11,10,9,9,9,9,12,14,10,10,10,9,15,13,12,12,14,3,12,8,6,11,14,13,2,3,1,4,1,1,2,2,3,2,2
"8029",43062372,"Afriyie Acquah","1/5/1992 (31 years old)","DM, M (C)","Al-Quwa Al-Jawiya","Iraqi Premier League","GHA","No","2/1/2023","7/31/2023","$0 - $35K","Right","Reasonable","Very Strong","5'10""","154 lbs","262","12",110,143,5,8,12,8,11,6,10,12,5,13,12,8,13,12,17,10,16,12,9,10,18,9,10,12,13,15,12,13,12,12,16,9,16,13,14,11,9,15,11,15,14,12,3,9,11,9,13,14,12,3,3,2,1,2,3,3,3,2,1,1
"8030",2000124501,"Richard King","11/27/2001 (21 years old)","D (C)","ÍBV","Icelandic Premier Division","JAM","No","4/27/2023","10/31/2023","$35K - $100K","Right Only","Weak","Very Strong","6'3""","171 lbs","58","4",98,118,6,3,7,5,10,5,11,6,7,10,11,7,16,10,9,11,11,9,7,10,17,5,11,10,10,10,9,11,12,12,11,18,15,15,9,7,15,15,14,12,10,11,9,12,10,3,12,13,10,2,2,1,2,2,2,3,2,2,2,1
"8031",2000080496,"Garang Kuol","9/15/2004 (18 years old)","AM (R), ST (C)","Newcastle","English Premier Division","AUS","No","1/1/2023","6/30/2026","$190K - $1.9M","Right Only","Weak","Very Strong","5'9""","147 lbs","32","7",110,160,5,9,15,12,12,8,5,8,5,5,9,7,6,11,14,12,10,8,8,9,15,15,3,11,6,11,10,10,16,16,11,8,15,16,8,7,13,17,11,11,13,14,12,5,5,7,11,16,11,1,3,1,1,3,1,1,3,2,2,2
"8032",15016785,"Adam Taggart","6/2/1993 (30 years old)","ST (C)","Perth Glory","Isuzu UTE A-League","AUS","No","12/15/2022","6/30/2026","$1.2M - $2.5M","Right","Reasonable","Very Strong","6'0""","158 lbs","218","90",115,150,8,11,12,15,12,9,12,12,6,6,11,10,6,12,7,10,11,10,10,13,11,12,7,16,10,11,10,12,12,12,11,11,12,12,12,12,7,10,13,13,12,12,10,11,6,4,13,15,13,2,2,2,2,2,2,3,2,2,3,3
"8033",2000093091,"Nestory Irankunda","2/9/2006 (17 years old)","AM (RL), ST (C)","Adelaide United","Isuzu UTE A-League","AUS","No","6/13/2022","6/30/2024","$170K - $1.7M","Right Only","Weak","Very Strong","5'9""","163 lbs","62","12",103,148,12,9,8,12,6,12,12,13,9,7,7,9,5,13,14,8,10,9,8,9,11,16,5,11,8,7,6,10,16,17,14,7,14,15,8,5,12,6,10,9,16,10,12,6,5,13,14,18,17,3,2,2,2,3,3,4,1,1,4,3
"8034",2000088437,"Nectar Triantis","5/11/2003 (20 years old)","D (C)","CC Mariners","Isuzu UTE A-League","AUS","Yes","7/26/2022","6/30/2026","$325K - $950K","Right","Weak","Very Strong","6'3""","189 lbs","28","-",110,145,8,4,8,7,14,4,13,6,7,10,11,10,11,13,14,11,13,14,13,13,10,5,10,11,11,11,11,14,12,12,11,15,7,12,9,11,16,18,10,10,11,14,5,16,10,5,12,10,7,3,1,3,1,3,2,4,3,3,1,1
"8035",15016604,"Mathew Ryan","4/8/1992 (31 years old)","GK","AZ","Eredivisie","AUS","No","1/9/2023","6/30/2024","$6M - $9.2M","Right","Weak","Very Strong","6'0""","185 lbs","346","-",139,144,3,1,3,1,11,1,6,3,12,3,14,4,3,13,13,13,14,13,13,13,16,8,17,2,15,14,13,15,10,15,10,12,14,10,13,12,1,17,14,18,16,14,6,16,8,4,13,17,17,12,14,15,13,13,15,14,8,14,12,10
"8036",2000056027,"Patrick Yazbek","5/4/2002 (21 years old)","DM, M (C)","Viking","Norwegian Premier Division","AUS","No","2/2/2023","12/31/2026","$230K - $2.3M","Right Only","Weak","Very Strong","5'10""","163 lbs","39","1",114,140,10,13,13,9,12,8,10,10,7,12,13,9,13,12,12,11,13,10,14,13,15,12,9,12,13,14,12,15,12,12,11,9,11,12,15,10,10,13,15,15,11,13,12,12,9,1,12,11,14,3,1,1,2,1,3,3,2,1,3,3
"8037",28063437,"Massimo Luongo","9/25/1992 (30 years old)","DM, M (C)","Ipswich","Sky Bet Championship","AUS","Yes","1/5/2023","6/30/2025","$3.1M - $6.2M","Right","Fairly Strong","Very Strong","5'9""","165 lbs","321","29",118,140,8,11,12,12,13,9,10,10,7,11,12,9,14,13,14,13,15,12,13,10,14,11,12,13,11,12,11,15,11,12,14,10,12,11,14,13,11,14,12,12,10,14,12,13,12,4,15,12,10,3,2,3,3,1,3,2,4,3,2,3
"8038",15075581,"Riley McGree","11/2/1998 (24 years old)","M (C), AM (LC)","Middlesbrough","Sky Bet Championship","AUS","No","1/14/2022","6/30/2025","$7.2M - $8.8M","Left","Very Strong","Fairly Strong","5'10""","158 lbs","168","35",124,140,11,12,12,12,13,10,8,12,5,8,13,9,8,14,9,13,14,13,12,13,11,13,7,14,12,14,14,13,11,13,12,9,12,12,14,11,12,12,12,12,11,12,7,11,7,10,10,12,14,3,1,2,2,2,2,2,2,1,2,2
"8039",61069532,"Harry Souttar","10/22/1998 (24 years old)","D (C)","Leicester","Sky Bet Championship","AUS","No","1/31/2023","6/30/2028","$11.5M - $17.5M","Right","Reasonable","Very Strong","6'6""","207 lbs","133","6",125,140,4,3,7,2,9,5,14,4,9,14,9,8,14,10,13,12,11,11,14,13,16,4,11,4,13,13,8,15,7,9,13,20,12,11,15,15,4,13,13,18,17,11,4,13,4,4,17,16,12,2,1,1,3,1,1,2,1,1,3,2
"8040",2000253243,"Christopher Bonsu Baah","12/14/2004 (18 years old)","AM (RL)","Sarpsborg","Norwegian Premier Division","GHA","No","3/30/2023","12/31/2025","$850K - $5.6M","Left","Very Strong","Reasonable","5'7""","147 lbs","12","1",104,143,8,10,14,10,12,8,6,11,5,5,8,10,5,12,9,11,9,8,9,9,14,14,4,12,7,12,10,10,14,16,11,6,12,13,11,8,9,17,11,15,10,11,6,11,6,1,12,14,13,2,3,2,3,3,2,2,1,1,4,1
"8041",2000155676,"Paul Okon","1/24/2005 (18 years old)","DM","Benfica","Portuguese Premier League","AUS","Yes","6/5/2023","6/30/2027","$210K - $2.1M","Left","Very Strong","Weak","6'1""","165 lbs","-","-",94,139,4,7,10,7,12,6,10,6,7,11,12,6,12,12,13,11,12,12,12,11,14,10,8,10,12,13,11,13,12,11,11,10,14,12,10,11,10,15,16,15,12,10,5,12,9,8,14,14,12,2,1,2,3,3,3,1,2,2,3,3
"8042",28126240,"Alex Robertson","4/17/2003 (20 years old)","M/AM (C)","Man City","English Premier Division","AUS","No","10/21/2022","6/30/2025","$700K - $8.6M","Right","Strong","Very Strong","6'0""","171 lbs","3","-",118,138,9,9,12,11,11,11,9,12,4,12,12,4,11,13,13,11,9,12,10,13,6,12,11,11,12,11,12,12,13,10,12,11,12,11,11,11,12,12,11,12,10,12,12,2,7,8,12,13,10,2,2,4,3,1,2,3,2,3,1,3
"8043",2000093082,"Jonny Yull","3/5/2005 (18 years old)","M/AM (C)","Adelaide United","Isuzu UTE A-League","AUS","No","6/13/2022","6/30/2026","$230K - $2.3M","Right","Strong","Very Strong","5'9""","145 lbs","31","-",91,138,10,11,13,9,13,11,5,11,1,5,11,9,5,10,7,10,8,10,11,10,15,12,8,10,8,9,10,9,12,10,11,5,11,10,9,7,7,20,8,10,11,11,5,16,12,6,15,9,13,2,1,2,4,3,1,3,1,2,1,3
"8044",28051370,"Bailey Wright","7/28/1992 (30 years old)","D (RC)","Sunderland","Sky Bet Championship","AUS","No","8/2/2020","6/30/2025","$26K - $250K","Right","Reasonable","Very Strong","6'0""","178 lbs","348","13",109,135,4,8,7,6,10,4,15,5,6,13,10,7,14,8,13,13,15,10,13,13,14,7,15,9,14,14,7,13,7,11,13,12,12,7,12,13,11,10,13,15,12,13,10,7,9,4,11,12,14,2,1,2,1,3,3,3,3,1,1,4
"8045",15084942,"Joe Gauci","7/4/2000 (22 years old)","GK","Adelaide United","Isuzu UTE A-League","AUS","Yes","4/13/2023","6/30/2026","$230K - $2.3M","Right","Reasonable","Very Strong","6'4""","191 lbs","100","-",107,135,3,3,3,2,9,7,2,2,3,1,9,1,1,9,7,11,10,11,11,11,11,2,10,2,12,13,11,13,8,13,12,15,14,8,8,12,14,10,10,10,11,11,4,8,6,6,16,11,10,11,7,14,6,12,9,11,5,10,13,15
"8046",15004041,"Mitchell James Langerak","8/22/1988 (34 years old)","GK","Nagoya","J1 League","AUS","No","1/1/2022","1/31/2024","$650K - $1.5M","Right","Fairly Strong","Very Strong","6'4""","174 lbs","293","-",134,135,2,1,3,1,9,5,6,1,1,3,9,2,2,9,8,14,11,14,12,12,11,1,8,1,10,15,8,10,12,15,13,14,12,10,12,14,10,12,15,13,14,16,4,13,5,3,12,10,15,17,15,16,10,14,14,12,8,10,11,12
"8047",28058298,"Brad Smith","4/9/1994 (29 years old)","D/WB (L)","Houston","Major League Soccer","AUS","No","1/6/2023","12/31/2024","$450K - $4.6M","Left Only","Very Strong","Weak","5'10""","154 lbs","117","3",118,135,8,14,12,8,12,6,8,11,9,12,11,6,12,12,13,12,12,10,10,12,12,10,7,13,11,13,10,14,15,12,13,8,12,15,13,11,10,12,9,14,11,12,13,11,11,8,11,14,10,1,2,3,1,1,1,3,1,3,2,3
"8048",2000017415,"Alessandro Circati","10/10/2003 (19 years old)","D (C)","Parma","Italian Serie B","AUS","Yes","6/8/2023","6/30/2027","$240K - $2.4M","Right Only","Weak","Very Strong","6'3""","185 lbs","41","2",123,133,7,9,9,10,9,6,14,10,14,14,10,8,13,10,14,14,13,14,14,13,13,11,12,12,14,12,10,13,12,12,12,14,14,12,14,12,13,12,12,12,11,11,4,14,12,9,13,12,14,1,3,1,2,1,3,1,4,3,1,1
"8049",95078188,"Joshua Rawlins","4/23/2004 (19 years old)","D (RC), WB (R)","FC Utrecht","Keuken Kampioen Divisie","AUS","No","7/1/2022","6/30/2026","$170K - $7.4M","Right","Reasonable","Very Strong","5'11""","160 lbs","76","1",100,133,7,10,12,6,10,6,6,5,10,11,12,4,9,9,15,10,12,10,10,10,13,12,8,11,10,12,9,14,14,13,11,10,16,12,12,9,12,7,7,12,8,4,5,11,12,13,11,15,11,1,1,1,1,2,1,2,1,3,3,3
"8050",15085280,"Kai Trewin","5/18/2001 (22 years old)","D (RC), DM, M (C)","Brisbane Roar","Isuzu UTE A-League","AUS","No","7/1/2018","6/30/2024","$210K - $2.1M","Right","Reasonable","Very Strong","5'10""","160 lbs","146","6",96,132,5,8,9,8,9,8,10,7,6,14,11,4,11,8,11,11,11,10,6,10,16,5,13,7,9,14,9,15,11,14,9,9,14,10,14,10,18,11,12,11,11,9,13,7,9,1,11,13,17,2,1,2,3,2,2,3,1,2,1,1
"8051",72049212,"Latif Blessing","12/30/1996 (26 years old)","M (C), AM (RLC)","New England","Major League Soccer","GHA","No","1/3/2023","12/31/2024","$600K - $6.2M","Right","Weak","Very Strong","5'3""","141 lbs","190","18",120,142,5,10,13,10,11,10,8,9,2,10,12,11,10,9,9,11,13,11,10,10,12,15,8,13,7,12,10,15,17,15,9,4,14,16,14,4,19,8,12,12,9,10,6,12,6,10,11,12,7,2,3,2,2,1,1,2,3,1,2,2
"8052",29065287,"Mathew Leckie","2/4/1991 (32 years old)","M/AM (RL)","Melbourne City FC","Isuzu UTE A-League","AUS","No","6/5/2021","6/30/2024","$55K - $550K","Right","Reasonable","Very Strong","5'11""","180 lbs","355","77",121,132,9,10,13,11,11,8,15,11,6,6,10,14,8,11,14,9,13,8,10,9,10,12,8,11,7,12,9,15,13,11,14,14,16,17,15,13,15,12,13,15,11,11,7,11,5,3,11,13,14,1,3,3,3,2,2,3,3,2,1,1
"8053",2000015270,"Mohamed Touré","3/26/2004 (19 years old)","AM (L)","Reims","French National 3 - Group I","AUS","No","7/1/2022","6/30/2026","$55K - $550K","Right","Weak","Very Strong","6'1""","154 lbs","45","7",90,132,7,13,13,11,10,3,4,5,6,7,13,6,8,7,5,9,7,9,6,12,18,13,4,11,7,8,9,7,15,12,8,13,15,13,7,5,15,10,10,12,11,14,6,12,13,5,14,13,10,2,3,1,1,1,2,2,2,2,1,3
"8054",95078185,"Nicholas Bilokapic","9/8/2002 (20 years old)","GK","Huddersfield","Sky Bet Championship","AUS","Yes","2/26/2020","6/30/2026","$450K - $1.3M","Right Only","Weak","Very Strong","6'5""","180 lbs","8","-",100,132,3,3,7,1,9,6,6,3,3,2,9,3,2,9,8,12,11,13,12,11,13,3,8,3,12,9,9,8,9,11,10,13,10,10,10,9,13,15,11,12,11,9,9,7,7,1,17,10,11,12,9,13,8,12,11,12,2,12,11,13
"8055",15085649,"Joel King","10/30/2000 (22 years old)","D (L)","Sydney FC","Isuzu UTE A-League","AUS","No","1/29/2022","12/31/2024","$180K - $550K","Left Only","Very Strong","Weak","5'10""","171 lbs","149","1",100,131,10,10,9,8,10,8,12,6,7,12,8,4,13,11,7,10,13,11,12,10,14,4,9,13,11,14,8,12,13,12,13,10,13,13,13,12,6,8,9,12,12,14,4,1,6,5,9,12,18,3,2,2,1,3,2,3,2,2,2,1
"8056",43090927,"Chris Ikonomidis","5/4/1995 (28 years old)","M (L), AM (RLC)","Melbourne Victory","Isuzu UTE A-League","AUS","Yes","7/21/2021","7/31/2024","$80K - $800K","Right","Fairly Strong","Very Strong","5'11""","176 lbs","129","23",114,130,9,11,14,12,12,9,12,10,7,5,10,13,5,13,10,13,10,13,10,9,13,15,11,15,7,9,11,8,13,13,13,11,14,14,10,9,12,14,10,14,10,9,5,10,6,12,11,13,15,1,3,2,3,1,1,2,3,2,3,2
"8057",61039990,"Martin Boyle","4/25/1993 (30 years old)","WB/M/AM (R), ST (C)","Hibernian","cinch Premiership","AUS","No","8/7/2022","5/31/2026","$550K - $5.6M","Right","Reasonable","Very Strong","5'8""","154 lbs","359","96",119,130,10,13,12,12,11,7,6,11,9,3,9,10,6,11,10,10,7,11,8,9,14,12,5,13,10,14,9,16,15,12,13,5,13,16,13,12,7,13,9,12,10,13,8,11,4,7,11,11,15,1,1,1,1,1,1,1,1,1,1,1
"8058",15040452,"Awer Mabil","9/15/1995 (27 years old)","M/AM (RL)","Sparta Prague","Czech First Division","AUS","No","7/1/2022","6/30/2026","$0","Right","Reasonable","Very Strong","5'10""","143 lbs","254","34",119,130,9,11,14,10,12,8,6,10,4,4,12,8,4,14,9,11,8,9,8,6,13,15,7,11,6,7,10,13,18,15,13,8,10,17,11,7,10,6,8,11,8,14,5,10,6,5,8,16,10,1,2,4,4,3,1,1,3,1,3,2
"8059",15009268,"Aziz Behich","12/16/1990 (32 years old)","D/WB/M (L)","Dundee United","cinch Championship","AUS","Yes","7/28/2022","5/31/2024","$0","Left","Very Strong","Reasonable","5'7""","147 lbs","354","15",113,130,11,13,13,8,7,6,5,6,11,9,12,8,10,12,16,13,13,13,11,10,12,5,7,13,8,14,10,14,15,14,11,7,12,12,14,11,14,10,10,14,9,13,3,11,5,5,13,10,11,1,1,1,3,3,2,3,2,2,2,1
"8060",28058647,"Alex Grant","1/23/1994 (29 years old)","D (C)","Pohang","Hana 1Q K LEAGUE 1","AUS","No","2/1/2021","12/31/2024","$9K - $90K","Left Only","Very Strong","Weak","6'3""","180 lbs","188","11",104,130,3,3,4,4,7,3,14,4,3,13,10,4,13,7,12,8,18,11,12,14,17,4,12,9,13,15,10,13,11,9,11,13,11,9,10,15,3,11,14,15,12,11,6,14,12,5,14,11,17,3,4,3,4,3,2,3,1,3,3,1
"8061",31050472,"Jay Rich-Baghuelou","10/22/1999 (23 years old)","D (C)","Accrington","Sky Bet League Two","AUS","Yes","1/14/2022","6/30/2024","$75K - $750K","Right","Weak","Very Strong","6'5""","240 lbs","37","2",88,130,4,5,7,9,10,5,13,8,6,9,10,9,11,10,11,10,12,8,9,9,13,4,8,8,9,10,7,10,9,8,9,18,8,11,10,16,8,10,12,11,9,12,8,9,10,4,10,14,13,1,2,4,3,3,2,3,2,4,1,2
"8062",2000077867,"Amankwah Forson","12/31/2002 (20 years old)","M (R), AM (RL)","FC RB Salzburg","Austrian Premier Division","GHA","No","2/8/2021","5/31/2025","$650K - $5.2M","Left","Very Strong","Weak","5'8""","147 lbs","80","8",115,142,11,11,12,9,10,7,7,10,6,8,11,9,8,12,9,9,11,9,10,10,12,11,7,12,10,12,10,11,16,14,9,8,12,16,12,9,13,14,13,11,9,10,8,7,7,8,12,15,14,4,1,3,3,3,1,1,3,2,3,1
"8063",2000024170,"Calem Nieuwenhof","2/17/2001 (22 years old)","M (C)","Western Sydney Wanderers","Isuzu UTE A-League","AUS","Yes","7/1/2022","6/30/2026","$0","Right","Reasonable","Very Strong","5'11""","163 lbs","47","5",109,129,10,9,12,11,12,10,10,11,6,12,12,3,12,13,12,14,13,12,15,11,12,9,14,10,14,15,11,13,10,10,13,12,13,12,12,8,14,13,13,12,11,11,12,16,15,3,10,12,14,1,3,1,1,2,3,3,2,1,3,1
"8064",15085654,"Marco Tilio","8/23/2001 (21 years old)","AM (LC)","Melbourne City FC","Isuzu UTE A-League","AUS","Yes","10/20/2021","6/30/2024","$300K - $2.9M","Left","Very Strong","Reasonable","5'4""","134 lbs","95","23",111,129,9,13,13,10,15,10,6,11,5,7,10,7,6,14,5,14,12,13,12,10,15,15,3,14,6,9,10,11,14,13,12,6,15,13,11,7,17,13,12,13,9,11,5,2,5,3,12,11,12,3,1,3,1,2,2,4,3,4,2,1
"8065",78011437,"Bruno Fornaroli","9/7/1987 (35 years old)","ST (C)","Melbourne Victory","Isuzu UTE A-League","AUS","Yes","1/18/2023","6/30/2024","$110K - $325K","Right","Fairly Strong","Very Strong","5'9""","165 lbs","286","117",112,129,10,11,12,15,14,12,10,12,6,7,11,14,6,15,13,15,12,14,10,13,14,14,6,14,6,11,9,13,10,12,15,8,8,9,9,10,9,6,13,7,15,10,12,11,14,14,17,8,16,2,2,2,1,1,1,2,4,1,1,1
"8066",15075193,"Cameron Devlin","6/7/1998 (25 years old)","DM, M (C)","Hearts","cinch Premiership","AUS","No","8/31/2021","5/31/2025","$1.1M - $2.3M","Right","Weak","Very Strong","5'7""","154 lbs","153","8",112,129,5,6,9,6,11,6,8,8,3,12,10,6,15,10,18,15,18,10,12,10,16,9,13,10,13,16,11,18,11,11,13,8,14,11,15,11,2,8,15,12,12,10,3,15,13,4,15,15,17,2,1,1,3,2,1,1,3,1,1,1
"8067",61041668,"Jackson Irvine","3/7/1993 (30 years old)","DM, M/AM (C)","St. Pauli","Bundesliga 2","AUS","No","10/13/2022","6/30/2025","$400K - $4.1M","Right","Reasonable","Very Strong","6'2""","163 lbs","339","36",123,128,3,8,11,11,11,6,16,9,8,12,12,7,13,11,16,14,15,12,13,12,16,10,17,13,12,18,12,16,11,10,13,16,16,14,16,12,15,13,16,18,18,17,8,14,10,5,17,12,12,3,2,1,2,4,2,1,1,1,1,2
"8068",15069940,"Denis Genreau","5/21/1999 (24 years old)","M (C)","Toulouse FC","Ligue 1 Uber Eats","AUS","Yes","7/31/2021","6/30/2025","$325K - $3.3M","Right","Reasonable","Very Strong","5'9""","165 lbs","121","4",120,128,11,10,12,9,14,8,8,10,5,7,13,9,10,13,12,12,11,12,12,13,13,12,8,14,12,13,13,14,13,13,11,8,16,12,16,10,12,13,13,12,11,11,8,10,6,6,12,11,13,2,4,3,3,4,2,4,3,4,2,2
"8069",61064592,"Jason Cummings","8/1/1995 (27 years old)","ST (C)","CC Mariners","Isuzu UTE A-League","AUS","No","1/23/2022","6/30/2025","$110K - $1.1M","Left","Very Strong","Reasonable","5'10""","149 lbs","283","111",122,128,10,12,12,14,11,6,12,13,2,6,13,15,8,13,13,13,14,12,10,14,14,15,10,13,11,8,14,13,12,13,12,10,9,10,12,12,2,7,8,8,10,9,4,17,9,14,12,9,10,2,3,2,3,1,1,4,2,1,3,2
"8070",15023766,"Miloš Degenek","4/28/1994 (29 years old)","D (RLC)","Columbus","Major League Soccer","AUS","No","1/24/2022","12/31/2024","$0","Right","Weak","Very Strong","6'2""","178 lbs","211","5",121,128,4,8,5,5,11,5,14,5,10,14,10,9,14,9,15,14,15,11,13,11,13,12,13,7,13,13,8,15,12,12,14,14,11,11,13,14,14,13,13,13,13,10,12,15,12,6,15,12,14,1,1,1,2,2,2,2,1,1,3,3
"8071",15086586,"Lewis Miller","8/24/2000 (22 years old)","D/WB (RL)","Hibernian","cinch Premiership","AUS","No","7/1/2022","6/30/2025","$325K - $3.3M","Right","Reasonable","Very Strong","6'2""","187 lbs","100","1",108,128,5,10,8,10,9,2,11,6,15,10,10,6,13,10,11,12,11,11,9,15,3,9,6,11,11,11,9,12,11,11,6,14,12,10,12,14,16,15,9,13,11,11,14,11,5,7,11,10,19,2,2,2,1,3,1,1,2,2,2,2
"8072",15023593,"Mitchell Duke","1/18/1991 (32 years old)","ST (C)","FC Machida","J2 League","AUS","No","1/2/2023","1/31/2024","$170K - $500K","Right","Reasonable","Very Strong","6'1""","185 lbs","306","63",114,127,9,12,11,13,8,11,11,8,12,11,7,7,6,8,13,13,14,9,11,17,4,7,13,13,8,11,9,11,15,10,11,12,15,14,12,15,11,14,10,12,12,11,13,10,8,5,10,10,10,3,2,2,2,1,3,3,3,1,2,1
"8073",28088342,"Godsway Donyoh","10/14/1994 (28 years old)","AM (L), ST (C)","Apol. Limassol","Cypriot First Division","GHA","No","1/23/2023","5/31/2025","$120K - $1.2M","Left Only","Very Strong","Weak","5'11""","156 lbs","214","54",113,140,6,12,11,11,12,6,12,9,6,4,11,10,4,11,9,14,9,11,11,11,11,9,4,12,5,10,12,10,16,14,11,11,12,15,12,13,6,12,14,13,12,15,14,13,7,6,10,11,11,2,1,2,2,1,1,2,1,3,3,1
"8074",15069939,"Connor Metcalfe","11/5/1999 (23 years old)","DM, M (C), AM (RC)","St. Pauli","Bundesliga 2","AUS","No","7/1/2022","6/30/2025","$85K - $850K","Left","Very Strong","Reasonable","6'0""","154 lbs","108","16",113,127,12,9,12,9,13,10,7,10,13,11,13,8,11,13,13,11,12,12,11,11,12,12,7,11,11,16,12,12,12,12,11,9,15,14,13,11,16,12,12,15,13,14,4,12,7,5,12,13,15,3,2,2,4,1,1,3,3,3,3,2
"8075",15016774,"Josh Risdon","7/27/1992 (30 years old)","D (R)","Western United FC","Isuzu UTE A-League","AUS","No","12/6/2021","6/30/2024","$140K - $1.4M","Right Only","Weak","Very Strong","5'6""","154 lbs","239","5",105,126,11,9,8,7,9,12,9,5,10,12,11,7,13,10,5,13,13,13,12,14,10,5,13,11,12,11,8,14,12,12,8,4,12,11,14,10,15,18,12,15,11,12,11,13,9,1,15,13,7,3,3,2,1,3,2,3,1,2,2,1
"8076",15085775,"Ryan Teague","1/24/2002 (21 years old)","DM, M/AM (C)","Famalicão","Portuguese Premier League","AUS","No","1/29/2020","6/30/2024","$0","Left","Very Strong","Weak","6'0""","167 lbs","42","1",96,126,11,8,12,7,12,10,9,10,4,9,13,8,12,12,10,11,9,11,10,11,11,10,8,11,10,11,13,13,11,11,11,10,10,11,11,10,12,11,11,13,11,12,6,10,7,5,11,11,12,2,1,3,1,1,2,2,1,2,3,2
"8077",15086658,"Samuel Silvera","10/25/2000 (22 years old)","M/AM (RL)","Middlesbrough","Sky Bet Championship","AUS","No","6/22/2022","6/30/2026","$550K - $5.4M","Right","Reasonable","Very Strong","5'10""","149 lbs","112","15",110,126,6,9,13,10,12,7,6,11,4,4,12,11,6,12,8,9,7,9,9,10,8,14,4,11,5,6,9,11,14,16,10,7,12,13,13,8,19,13,9,8,10,12,13,4,8,5,11,13,20,4,1,1,3,4,1,3,1,2,1,3
"8078",29129579,"Alex Gersbach","5/8/1997 (26 years old)","D/WB (L)","Colorado","Major League Soccer","AUS","Yes","1/30/2023","12/31/2025","$120K - $1.2M","Left Only","Very Strong","Weak","6'0""","158 lbs","156","1",112,126,8,12,13,7,10,6,7,8,12,10,8,7,12,12,13,14,13,12,14,12,14,15,7,11,10,13,11,15,14,15,13,11,14,15,12,11,11,12,16,16,11,8,15,12,9,3,12,15,14,1,1,4,1,1,3,1,2,1,2,3
"8079",29151100,"Ashley Maynard-Brewer","6/25/1999 (23 years old)","GK","Charlton","Sky Bet League One","AUS","No","3/10/2023","6/30/2026","$70K - $700K","Left Only","Very Strong","Weak","6'2""","167 lbs","71","-",104,126,3,2,1,3,3,5,3,3,2,1,10,4,2,7,12,11,13,10,11,10,5,7,9,3,12,11,10,10,10,12,11,14,12,10,11,12,9,11,13,12,10,12,10,11,8,1,11,10,9,11,10,13,9,12,11,12,11,10,11,13
"8080",2000093083,"Ethan Alagich","7/22/2004 (18 years old)","M/AM (C)","Adelaide United","Isuzu UTE A-League","AUS","Yes","6/13/2022","6/30/2026","$95K - $950K","Left","Very Strong","Reasonable","5'10""","154 lbs","50","2",93,125,10,10,10,9,11,10,7,9,4,8,11,7,9,11,15,11,11,11,11,12,11,10,11,12,8,14,10,12,11,11,11,9,14,9,13,8,11,14,13,14,10,14,14,13,6,2,16,10,19,1,2,3,2,4,2,1,2,3,2,1
"8081",28000416,"Shane Lowry","6/12/1989 (34 years old)","D (LC)","Johor DT","Malaysian Super League","AUS","Yes","1/1/2023","11/30/2023","$0 - $18K","Left Only","Very Strong","Weak","6'1""","194 lbs","299","8",92,125,7,13,5,4,12,13,13,10,7,13,11,10,14,9,17,10,14,11,13,10,15,4,10,6,11,12,6,14,8,8,11,12,14,8,11,12,11,13,9,14,9,5,5,12,13,10,15,12,15,3,3,2,2,1,3,1,2,1,3,3
"8082",128776,"Wayne Srhoj","3/23/1982 (41 years old)","DM, M (C)","Mareeba Utd","FQ Premier League - Far North & Gulf","AUS","No","6/14/2021","-","$0","Right","Reasonable","Very Strong","6'0""","178 lbs","397","61",77,125,6,5,8,8,13,7,12,5,9,10,11,6,12,13,16,9,13,11,10,12,11,13,13,7,8,12,10,14,7,8,11,11,9,8,8,12,7,15,13,14,13,13,5,9,15,5,9,12,9,1,1,1,1,1,1,1,1,1,1,1
"8083",15084600,"Louis D'Arrigo","9/23/2001 (21 years old)","DM, M (C)","Adelaide United","Isuzu UTE A-League","AUS","Yes","12/6/2019","6/30/2023","$0 - $16K","Right","Reasonable","Very Strong","5'10""","156 lbs","98","3",93,125,8,8,4,7,10,7,8,12,8,14,13,3,14,13,15,12,9,10,10,14,9,5,10,12,12,9,9,13,9,10,7,8,13,9,12,6,13,10,13,11,12,10,11,14,6,3,11,12,13,2,4,2,2,2,2,1,2,1,2,1
"8084",13200568,"Mohammed Kudus","8/2/2000 (22 years old)","M (C), AM (RC), ST (C)","Ajax","Eredivisie","GHA","No","7/16/2020","6/30/2025","$35M - $53M","Left","Very Strong","Fairly Strong","5'10""","154 lbs","119","35",149,162,10,10,15,14,15,14,9,10,11,7,14,13,6,16,15,14,14,15,12,12,13,15,6,13,7,14,12,15,15,14,14,8,14,14,14,14,16,14,13,13,10,12,9,8,9,12,13,11,20,1,3,1,3,3,2,2,4,3,3,2
"8085",13220325,"Nathaniel Adjei","8/21/2002 (20 years old)","D (RC)","Hammarby IF","Swedish Premier Division","GHA","No","7/15/2022","12/31/2026","$1.5M - $3.2M","Right","Weak","Very Strong","6'1""","169 lbs","32","-",112,140,7,10,6,6,10,7,14,8,7,12,10,7,13,10,14,12,14,11,12,12,14,6,8,7,12,12,10,11,12,10,16,13,12,12,12,16,6,10,10,12,13,10,5,3,13,5,13,13,15,2,1,2,2,4,2,1,2,2,2,1
"8086",8454613,"Danny Vukovic","3/27/1985 (38 years old)","GK","CC Mariners","Isuzu UTE A-League","AUS","No","8/5/2022","6/30/2023","$3K - $9K","Right Only","Weak","Very Strong","6'2""","211 lbs","425","1",104,125,3,2,8,4,8,1,5,1,8,1,8,9,7,9,15,11,14,12,11,11,18,8,12,5,11,12,9,8,7,10,14,14,9,8,10,13,1,5,9,12,12,16,8,9,8,17,14,11,9,9,11,13,5,14,8,13,13,11,15,14
"8087",92074020,"Christian Pulisic","9/18/1998 (24 years old)","AM (RLC)","Chelsea","English Premier Division","USA","Yes","6/14/2021","6/30/2028","$13M - $20M","Right","Fairly Strong","Very Strong","5'10""","160 lbs","188","33",151,160,13,14,16,14,15,10,8,13,5,6,13,10,8,15,13,15,14,13,12,13,14,15,12,15,8,15,14,14,15,16,9,7,11,14,14,8,14,14,16,14,13,9,12,15,4,6,13,17,15,3,1,2,3,3,3,2,4,1,3,1
"8088",28129089,"Yunus Musah","11/29/2002 (20 years old)","M/AM (RC)","Valencia","Spanish First Division","USA","Yes","6/13/2022","6/30/2028","$21M - $26M","Right","Weak","Very Strong","5'10""","156 lbs","111","3",134,160,11,12,13,11,14,10,9,11,7,11,13,11,13,13,15,13,14,14,13,14,16,11,12,14,13,15,13,14,14,14,13,10,15,13,14,14,15,14,14,16,15,14,5,13,7,10,13,16,18,1,1,2,3,1,2,3,2,3,2,1
"8089",72051281,"Giovanni Reyna","11/13/2002 (20 years old)","M (C), AM (RLC)","Borussia Dortmund","Bundesliga","USA","Yes","11/20/2020","6/30/2025","$81M - $98M","Right","Reasonable","Very Strong","6'1""","174 lbs","79","13",136,160,13,12,15,12,16,14,7,13,6,8,14,13,8,16,11,14,10,15,11,12,11,14,6,13,8,12,14,11,14,15,12,10,12,14,12,10,15,12,10,10,10,13,12,16,7,14,12,15,13,1,3,3,3,2,2,3,4,2,2,2
"8090",2000082511,"Quinn Sullivan","3/27/2004 (19 years old)","M/AM (RC)","Philadelphia","Major League Soccer","USA","Yes","1/1/2021","12/31/2023","$5.8M - $7.4M","Right","Weak","Very Strong","5'11""","158 lbs","76","7",107,158,10,10,11,9,11,10,8,12,4,10,11,5,9,10,8,12,7,10,9,12,5,14,12,11,10,12,11,13,12,11,10,8,16,11,15,8,13,12,11,14,11,12,9,16,4,6,10,11,11,4,3,2,1,1,3,1,3,2,1,2
"8091",28116305,"Folarin Balogun","7/3/2001 (21 years old)","ST (C)","Arsenal","English Premier Division","USA","No","4/26/2021","6/30/2025","$37M - $44M","Right","Fairly Strong","Very Strong","5'10""","163 lbs","57","24",139,155,5,9,13,15,13,8,12,10,4,6,11,11,5,13,10,12,12,13,12,12,13,14,8,15,8,13,12,13,16,16,12,12,12,15,13,11,8,14,14,13,12,8,7,12,7,10,13,14,13,2,3,3,2,1,3,1,1,3,2,1
"8092",72048035,"Weston McKennie","8/28/1998 (24 years old)","WB (R), M (RC)","Leeds","Sky Bet Championship","USA","No","7/1/2021","6/30/2025","$11.5M - $14.5M","Right","Fairly Strong","Very Strong","6'1""","185 lbs","164","13",143,153,7,13,12,12,12,7,16,10,15,10,13,8,15,12,17,14,17,14,10,11,17,12,13,14,11,15,11,16,14,14,16,14,18,14,15,15,16,12,15,10,13,10,11,16,12,13,12,14,17,3,3,3,2,2,2,3,1,2,3,4
"8093",72044918,"Tyler Adams","2/14/1999 (24 years old)","D/WB (R), DM, M (C)","Leeds","Sky Bet Championship","USA","No","7/1/2022","6/30/2027","$23M - $35M","Right","Fairly Strong","Very Strong","5'9""","158 lbs","184","3",142,151,5,10,11,6,13,5,8,8,11,13,13,5,15,12,16,15,15,12,13,12,15,9,13,12,14,15,12,18,14,14,14,10,17,13,17,12,16,12,16,15,13,11,7,15,12,4,13,16,15,3,2,1,2,1,2,1,3,3,3,1
"8094",91187679,"Malik Tillman","5/28/2002 (21 years old)","M (C), AM (RLC), ST (C)","FC Bayern","Bundesliga","USA","Yes","6/13/2022","6/30/2027","$750K - $5.4M","Right","Reasonable","Very Strong","6'2""","156 lbs","57","19",131,150,10,10,15,12,14,10,13,12,6,7,14,12,9,15,11,14,9,13,10,11,11,14,4,13,6,13,14,10,14,14,13,13,12,15,12,10,16,18,12,14,11,14,9,10,4,2,13,16,12,1,2,2,3,1,1,1,1,2,1,3
"8095",48042432,"Timothy Weah","2/22/2000 (23 years old)","WB/M (R), AM (RL), ST (C)","LOSC","Ligue 1 Uber Eats","USA","Yes","7/1/2019","6/30/2027","$10M - $15.5M","Right","Weak","Very Strong","6'1""","145 lbs","101","11",134,150,8,11,13,12,12,8,12,11,11,8,12,12,9,12,10,12,10,11,11,12,10,13,7,13,10,11,12,13,16,14,13,12,14,14,12,10,15,13,12,12,11,10,7,13,7,7,11,13,19,1,3,2,2,2,3,1,3,4,1,1
"8096",27128916,"Abdul Mumin","6/6/1998 (25 years old)","D (C)","Vallecano","Spanish First Division","GHA","No","9/1/2022","6/30/2026","$80K - $8M","Right","Weak","Very Strong","6'2""","176 lbs","123","1",130,140,5,5,10,6,12,5,12,6,10,15,13,3,11,12,13,13,16,12,15,12,8,15,4,8,14,13,11,12,13,14,13,15,15,16,13,14,1,9,10,12,14,11,7,10,15,1,13,14,17,2,3,1,3,3,1,2,2,1,4,1
"8097",20048604,"Ricardo Pepi","1/9/2003 (20 years old)","ST (C)","Augsburg","Bundesliga","USA","No","1/2/2022","6/30/2027","$7.2M - $11M","Right","Fairly Strong","Very Strong","6'1""","171 lbs","113","38",121,150,6,9,11,14,11,8,15,10,8,6,10,13,6,10,11,13,12,12,12,12,12,12,7,13,6,10,10,12,12,12,13,15,13,14,14,11,10,14,10,11,10,12,3,12,7,8,12,13,7,4,3,2,2,2,3,1,3,3,3,2
"8098",72051563,"Chris Richards","3/28/2000 (23 years old)","D (RC)","Crystal Palace","English Premier Division","USA","No","7/27/2022","6/30/2027","$23M - $29M","Right","Fairly Strong","Very Strong","6'2""","171 lbs","82","5",133,150,4,10,11,6,12,4,15,6,6,13,12,6,14,12,11,12,15,11,13,12,15,11,6,12,13,14,11,14,14,12,13,16,13,15,14,13,14,12,13,15,14,10,12,13,6,2,12,14,19,2,2,2,4,1,2,1,3,2,4,3
"8099",980486,"Michael Bradley","7/31/1987 (35 years old)","D (C), DM, M (C)","Toronto FC","Major League Soccer","USA","No","12/12/2019","12/31/2023","$60K - $600K","Right Only","Weak","Very Strong","6'2""","176 lbs","498","44",122,149,6,9,12,11,13,12,10,12,13,16,15,11,15,12,17,15,18,11,14,12,17,8,16,12,16,16,15,10,9,9,13,12,16,10,12,14,13,7,9,19,12,14,13,17,14,4,14,18,15,1,1,1,1,1,1,1,1,1,1,1
"8100",28100767,"Cameron Carter-Vickers","12/31/1997 (25 years old)","D (C)","Celtic","cinch Premiership","USA","No","6/10/2022","5/31/2026","$17.5M - $22M","Right","Reasonable","Very Strong","6'1""","202 lbs","175","6",138,149,3,6,12,4,12,5,16,6,10,14,14,7,14,13,14,12,17,14,13,12,15,5,7,9,15,12,10,15,14,12,12,12,12,14,14,18,8,13,14,14,9,10,10,16,7,4,18,14,13,1,1,3,2,3,2,2,1,2,1,3
"8101",20046423,"Brenden Aaronson","10/22/2000 (22 years old)","M (C), AM (RLC)","Leeds","Sky Bet Championship","USA","No","7/1/2022","6/30/2027","$7.4M - $9.2M","Right","Reasonable","Very Strong","5'10""","149 lbs","157","18",129,149,12,10,14,10,13,10,8,11,6,8,12,12,10,13,12,12,15,11,11,10,11,13,7,13,8,16,12,17,15,15,9,9,16,15,16,8,11,12,10,12,8,5,5,8,5,5,12,12,10,3,2,1,2,2,2,2,4,2,3,2
"8102",2000021340,"Taylor Booth","5/31/2001 (22 years old)","M/AM (RC)","FC Utrecht","Eredivisie","USA","Yes","7/1/2022","6/30/2025","$28M - $43M","Right","Reasonable","Very Strong","5'9""","145 lbs","70","8",130,148,13,14,13,10,12,13,6,11,9,6,12,12,6,14,14,12,11,13,10,10,14,15,6,14,8,12,13,15,14,14,13,8,11,14,13,10,16,11,12,15,13,9,11,11,10,4,14,16,15,3,1,1,1,4,3,4,3,2,4,1
"8103",2000181201,"Cruz Medina","9/24/2006 (16 years old)","M/AM (C), ST (C)","San Jose","Major League Soccer","USA","No","6/3/2022","12/31/2026","$10.5M - $12.5M","Right","Fairly Strong","Very Strong","5'7""","134 lbs","33","1",88,148,9,11,13,9,10,9,5,11,8,10,11,4,8,9,10,8,8,9,6,10,6,11,7,13,9,11,9,8,13,13,12,5,12,12,9,6,8,19,11,11,11,11,6,6,8,7,9,8,16,3,3,3,2,3,4,3,3,1,1,2
"8104",2000015818,"Tanner Tessmann","9/24/2001 (21 years old)","DM, M (C)","Venezia","Italian Serie B","USA","No","7/15/2021","6/30/2025","$650K - $6.6M","Right","Fairly Strong","Very Strong","6'4""","189 lbs","92","4",120,148,5,8,10,9,11,11,11,12,8,13,13,9,12,13,14,13,14,12,12,12,13,10,10,12,12,12,11,11,12,12,14,12,12,12,15,15,12,12,12,12,12,11,10,10,13,12,11,12,12,4,1,1,1,1,1,3,1,3,2,3
"8105",37065767,"Sergiño Dest","11/3/2000 (22 years old)","D/WB (RL)","Barcelona","Spanish First Division","USA","Yes","9/30/2020","6/30/2025","$425K - $4.2M","Right","Fairly Strong","Very Strong","5'7""","136 lbs","100","3",133,147,8,13,14,7,13,8,7,9,10,12,13,9,11,14,10,12,12,10,11,10,13,17,9,14,11,13,11,12,16,16,11,7,13,14,13,7,14,10,13,11,12,10,11,11,11,8,12,14,12,2,3,1,3,1,3,2,3,2,3,3
"8106",92025938,"John Brooks","1/28/1993 (30 years old)","D (C)","TSG Hoffenheim","Bundesliga","USA","Yes","1/26/2023","6/30/2024","$600K - $10.5M","Left","Very Strong","Reasonable","6'4""","207 lbs","299","15",131,147,4,7,10,6,12,4,15,6,8,14,12,8,14,12,14,12,15,12,12,12,13,9,12,7,14,12,12,12,12,10,15,17,12,12,12,16,5,8,14,12,12,11,12,10,11,13,11,10,12,1,3,2,2,2,1,1,2,1,2,3
"8107",34010721,"Jordan Ayew","9/11/1991 (31 years old)","AM (RL), ST (C)","Crystal Palace","English Premier Division","GHA","Yes","3/31/2023","6/30/2024","$12M - $14.5M","Right","Weak","Very Strong","6'0""","171 lbs","418","66",133,140,5,11,14,11,14,9,12,10,5,11,11,12,13,12,14,13,14,10,12,11,17,11,6,14,12,14,11,18,13,13,13,11,15,13,16,13,14,15,7,14,11,10,7,13,8,8,14,14,15,3,1,3,2,1,1,2,2,2,1,1
"8108",92092175,"Josh Sargent","2/20/2000 (23 years old)","AM (RLC), ST (C)","Norwich","Sky Bet Championship","USA","No","8/9/2021","6/30/2025","$14.5M - $18M","Right","Reasonable","Very Strong","6'1""","176 lbs","150","35",128,146,5,7,10,14,13,8,14,9,3,6,10,16,6,10,15,12,14,11,10,11,16,10,12,15,7,15,10,17,14,12,13,14,15,13,15,13,12,16,14,15,13,10,5,13,5,6,12,16,14,1,1,1,3,3,2,1,1,3,3,1
"8109",980785,"Brad Guzan","9/9/1984 (38 years old)","GK","Atlanta United","Major League Soccer","USA","No","6/14/2021","12/31/2023","$75K - $220K","Left","Very Strong","Reasonable","6'4""","207 lbs","388","-",115,146,4,2,1,2,7,5,7,2,3,3,8,5,2,9,13,12,13,13,13,11,15,5,14,12,13,11,10,12,8,9,12,13,12,8,11,13,12,13,16,17,11,14,11,14,5,4,13,6,16,12,13,13,12,14,12,15,8,14,13,12
"8110",72051619,"Joe Scally","12/31/2002 (20 years old)","D/WB (RL)","Borussia M'gladbach","Bundesliga","USA","No","4/20/2023","6/30/2027","$5.2M - $6.6M","Right","Reasonable","Very Strong","6'0""","176 lbs","77","2",125,146,6,12,12,7,11,6,10,7,13,11,12,6,12,12,13,11,14,10,12,11,16,11,5,12,11,16,10,16,14,12,12,11,17,15,15,11,16,11,11,16,10,12,4,11,8,7,12,12,16,2,1,2,3,2,2,3,2,3,1,1
"8111",91156033,"Zack Steffen","4/2/1995 (28 years old)","GK","Man City","English Premier Division","USA","No","11/4/2021","6/30/2025","$2.4M - $4.9M","Right","Reasonable","Very Strong","6'3""","189 lbs","160","-",130,146,3,3,3,1,9,7,2,1,3,1,10,3,3,10,8,12,12,12,13,10,12,3,10,1,13,12,11,8,13,13,14,15,12,12,13,14,12,13,14,16,10,9,10,12,7,5,12,11,14,14,12,16,13,16,13,10,7,12,13,14
"8112",2000228176,"Diego Kochen","3/19/2006 (17 years old)","GK","Barcelona","Spanish First Division","USA","No","3/2/2022","6/30/2025","$700K - $7M","Right","Weak","Very Strong","6'2""","169 lbs","-","-",90,146,2,1,3,3,11,6,7,2,2,1,11,6,2,7,9,10,11,9,9,10,14,9,10,2,11,9,10,8,11,12,10,13,14,9,8,9,2,16,12,14,14,12,6,14,8,8,14,14,16,9,14,13,12,11,10,13,6,10,10,11
"8113",72053451,"Cade Cowell","10/14/2003 (19 years old)","AM (RL), ST (C)","San Jose","Major League Soccer","USA","No","2/11/2022","12/31/2026","$8.2M - $10.5M","Right","Reasonable","Very Strong","5'11""","174 lbs","102","11",113,146,9,9,13,10,11,9,7,10,11,6,9,10,6,10,12,9,8,10,9,8,12,13,4,10,6,10,10,13,15,12,10,10,9,17,13,13,12,16,9,12,12,11,12,11,5,3,11,13,8,2,3,1,3,3,1,3,3,1,1,2
"8114",2000165742,"Christian McFarlane","1/25/2007 (16 years old)","D/WB (L)","NYCFC","Major League Soccer","USA","No","12/23/2022","12/31/2026","$5M - $7.6M","Left","Very Strong","Reasonable","6'0""","141 lbs","12","-",86,145,8,9,8,5,9,6,11,4,6,10,10,7,11,10,10,11,9,11,10,12,5,12,8,10,11,10,11,12,11,10,10,14,10,11,10,12,7,19,11,11,10,11,5,10,10,3,10,11,9,2,2,2,2,1,1,2,1,4,1,2
"8115",2000177762,"Nathan Ordaz","1/12/2004 (19 years old)","AM (RL), ST (C)","LAFC","Major League Soccer","USA","No","4/25/2022","12/31/2025","$650K - $8.6M","Left Only","Very Strong","Weak","5'9""","145 lbs","39","1",103,145,10,9,11,12,12,10,10,11,10,6,10,9,6,13,14,8,12,6,10,8,13,11,4,12,12,10,9,13,12,12,13,12,11,14,12,10,11,5,11,12,12,8,7,15,7,7,10,10,9,1,2,3,4,1,1,1,3,3,2,3
"8116",72046884,"Matt Turner","6/24/1994 (28 years old)","GK","Arsenal","English Premier Division","USA","Yes","6/27/2022","6/30/2025","$6.8M - $10.5M","Right","Reasonable","Very Strong","6'3""","196 lbs","129","-",140,145,1,1,8,2,9,4,2,1,2,3,9,1,3,7,6,12,14,12,14,13,15,6,8,3,15,11,9,10,11,15,6,12,6,10,12,14,15,13,13,14,12,12,6,14,6,6,13,12,14,10,7,16,6,14,12,15,10,13,15,14
"8117",67276121,"Konrad De la Fuente","7/16/2001 (21 years old)","M/AM (RL)","OM","French National 3 - Group A","USA","No","7/3/2021","6/30/2025","$900K - $1.9M","Right","Reasonable","Very Strong","5'7""","138 lbs","44","7",120,145,10,11,15,11,13,10,5,11,6,4,11,10,5,14,6,11,8,10,7,10,9,14,6,13,6,9,12,8,16,16,13,6,12,15,10,7,15,13,10,10,9,13,7,12,6,8,11,12,9,2,3,2,3,1,2,1,1,2,2,3
"8118",91184447,"Patric Pfeiffer","8/20/1999 (23 years old)","D (C)","Darmstadt 98","Bundesliga","GHA","Yes","7/1/2019","6/30/2027","$400K - $4M","Right","Fairly Strong","Very Strong","6'5""","200 lbs","103","9",128,140,2,6,11,6,11,2,16,6,8,13,12,5,13,11,16,13,15,12,12,11,17,11,6,8,13,12,11,12,12,11,14,17,13,17,12,13,8,9,9,13,14,11,8,12,11,7,16,14,13,2,4,2,3,3,1,2,1,3,2,3
"8119",29141175,"Luca De La Torre","5/23/1998 (25 years old)","M (LC), AM (RLC)","Vigo","Spanish First Division","USA","Yes","6/30/2022","6/30/2026","$8.8M - $11M","Left","Very Strong","Strong","5'10""","149 lbs","99","2",134,145,5,12,13,8,12,11,7,9,4,7,14,11,10,15,9,15,12,11,15,13,11,13,8,16,8,14,13,16,12,14,13,7,15,13,14,10,12,8,13,12,11,9,5,12,9,8,10,12,14,3,2,2,1,2,1,3,3,1,3,3
"8120",67224237,"Shaq Moore","11/2/1996 (26 years old)","D/WB/M (R)","Nashville","Major League Soccer","USA","No","7/19/2022","12/31/2025","$5.6M - $10.5M","Right","Weak","Very Strong","5'11""","163 lbs","210","7",126,145,11,15,11,7,10,7,8,9,12,11,9,8,13,11,13,13,14,11,12,11,14,9,8,13,11,15,10,15,14,14,10,10,15,15,15,12,14,14,15,16,13,12,7,11,9,7,13,14,16,1,1,3,2,3,3,2,3,1,3,2
"8121",72049787,"Gianluca Busio","5/28/2002 (21 years old)","DM, M/AM (C)","Venezia","Italian Serie B","USA","Yes","8/5/2021","6/30/2025","$190K - $1.9M","Right","Fairly Strong","Very Strong","5'8""","143 lbs","124","9",117,145,10,10,12,10,13,12,6,9,6,8,14,10,14,14,12,12,12,11,10,10,10,13,9,13,14,12,13,11,12,13,12,6,11,13,12,10,12,12,12,12,10,12,10,9,9,6,11,14,10,1,2,1,1,2,1,3,3,1,3,1
"8122",83103190,"Keaton Parks","8/6/1997 (25 years old)","DM, M (C)","NYCFC","Major League Soccer","USA","No","1/8/2020","12/31/2023","$600K - $5.8M","Right","Fairly Strong","Very Strong","6'4""","187 lbs","177","21",127,145,9,8,12,11,14,8,13,11,6,8,14,13,12,14,10,14,8,13,13,14,12,12,12,12,14,15,14,13,10,12,14,15,12,11,13,12,10,15,14,14,13,5,10,14,7,10,14,16,14,4,1,3,3,2,2,3,2,2,1,1
"8123",72056265,"John Tolkin","7/31/2002 (20 years old)","D/WB (L)","New York","Major League Soccer","USA","No","10/6/2022","12/31/2027","$11M - $13.5M","Left","Very Strong","Weak","5'7""","145 lbs","102","2",115,145,7,12,12,9,11,10,12,8,7,13,13,7,13,11,12,12,13,10,12,13,15,8,8,11,13,13,11,13,13,13,12,11,12,13,14,7,9,17,10,10,11,11,10,8,7,10,13,14,16,3,3,2,1,3,1,2,1,3,3,3
"8124",72056133,"Daryl Dike","6/3/2000 (23 years old)","ST (C)","West Brom","Sky Bet Championship","USA","No","1/1/2022","6/30/2026","$9.4M - $11.5M","Right","Fairly Strong","Very Strong","6'2""","220 lbs","84","27",126,145,5,7,10,15,11,8,14,12,7,7,11,12,7,11,14,11,13,12,9,11,15,11,8,13,7,12,9,12,14,11,12,13,13,14,13,18,7,16,14,16,14,8,9,12,10,3,10,14,16,2,1,2,1,1,2,2,1,2,3,3
"8125",2000237833,"Benjamin Cremaschi","3/2/2005 (18 years old)","M (RC)","Inter Miami","Major League Soccer","USA","No","11/28/2022","12/31/2025","$5.6M - $10.5M","Right","Reasonable","Very Strong","6'0""","165 lbs","29","6",105,144,10,10,11,9,12,10,7,9,7,9,13,6,9,12,12,10,11,11,10,11,17,10,9,13,10,15,12,15,11,10,11,10,13,12,14,6,10,9,10,15,11,8,8,4,5,11,14,16,7,3,2,3,4,2,1,1,2,4,1,3
"8126",29125265,"Antonee Robinson","8/8/1997 (25 years old)","D/WB (L)","Fulham","English Premier Division","USA","No","8/20/2020","6/30/2024","$43M - $51M","Left","Very Strong","Weak","6'0""","154 lbs","193","3",139,143,3,10,13,7,12,7,10,7,4,12,11,8,13,13,13,12,14,11,11,11,12,11,9,12,12,14,12,17,17,13,13,12,14,17,16,14,11,15,15,12,12,12,11,13,2,4,14,12,14,3,4,1,1,1,2,2,1,1,2,2
"8127",72053584,"Gabriel Słonina","5/15/2004 (19 years old)","GK","Chelsea","English Premier Division","USA","Yes","8/2/2022","6/30/2028","$50K - $6.2M","Right","Reasonable","Very Strong","6'4""","196 lbs","43","-",114,143,4,1,3,3,9,8,3,2,2,2,8,5,3,9,9,13,13,13,13,9,18,1,2,1,13,14,10,11,12,12,12,17,14,11,13,13,10,17,17,18,19,18,8,4,11,2,14,18,17,11,7,14,8,12,10,10,6,13,12,13
"8128",2000111594,"Caleb Wiley","12/22/2004 (18 years old)","D/WB/M/AM (L)","Atlanta United","Major League Soccer","USA","No","1/18/2022","12/31/2025","$1M - $11.5M","Left Only","Very Strong","Weak","5'11""","163 lbs","79","1",100,143,10,12,11,7,11,7,7,6,8,11,11,7,9,10,9,11,11,12,11,8,12,11,11,12,10,11,9,13,14,11,11,11,12,13,12,8,14,12,11,11,12,10,7,15,4,3,12,11,16,3,4,1,2,2,1,1,4,1,1,3
"8129",13117442,"Baba Rahman","7/2/1994 (28 years old)","D/WB (L)","Chelsea","English Premier Division","GHA","No","6/15/2020","6/30/2025","$0","Left","Very Strong","Reasonable","5'11""","154 lbs","204","4",115,140,7,12,12,7,12,6,10,8,14,12,10,9,14,13,13,12,12,11,10,9,13,12,9,13,10,14,9,16,13,14,13,12,13,14,14,9,10,11,12,12,12,9,13,14,11,8,10,9,15,3,2,2,2,3,3,3,4,3,3,1
"8130",2000037579,"Paxten Aaronson","8/26/2003 (19 years old)","M (C), AM (RLC)","Eintracht Frankfurt","Bundesliga","USA","No","1/1/2023","6/30/2027","$6.4M - $8M","Right","Fairly Strong","Very Strong","5'9""","138 lbs","69","10",116,142,11,10,14,10,13,11,6,10,6,8,12,12,8,13,9,10,11,11,9,10,13,13,6,12,8,12,12,13,15,15,9,7,15,14,12,7,16,12,12,14,13,12,5,11,3,4,12,14,16,2,1,3,2,3,3,1,3,3,2,1
"8131",92022817,"Bobby Wood","11/15/1992 (30 years old)","ST (C)","New England","Major League Soccer","USA","No","12/5/2022","12/31/2023","$1.6M - $3.4M","Right","Reasonable","Very Strong","5'11""","174 lbs","277","52",118,142,7,9,13,14,14,9,11,13,7,6,10,12,8,12,15,10,8,10,9,13,6,12,4,11,7,14,10,8,14,13,16,11,15,16,12,12,14,17,14,13,7,7,11,10,6,6,7,9,14,1,3,1,3,2,3,3,2,3,1,3
"8132",27139789,"Kristoffer Lund","5/14/2002 (21 years old)","D (RL)","BK Häcken","Swedish Premier Division","USA","Yes","8/11/2021","12/31/2024","$2.9M - $5.8M","Left","Very Strong","Reasonable","6'0""","160 lbs","64","-",117,142,9,13,11,5,12,7,8,6,8,12,12,8,12,12,14,12,12,12,12,12,14,8,9,13,13,13,12,15,13,12,12,13,13,13,14,11,8,12,14,13,13,13,5,12,7,5,14,13,14,2,2,3,3,2,3,2,4,1,2,2
"8133",72056224,"Aidan Morris","11/16/2001 (21 years old)","DM, M (C)","Columbus","Major League Soccer","USA","No","4/12/2023","12/31/2026","$4.6M - $7M","Right","Reasonable","Very Strong","5'10""","158 lbs","81","2",118,141,5,8,12,7,12,7,9,12,9,14,14,9,13,13,13,11,14,11,12,12,14,8,11,12,12,13,11,15,12,12,13,12,14,12,15,14,11,20,10,13,13,8,7,11,7,8,12,12,12,4,3,1,1,2,3,1,1,2,1,2
"8134",72044871,"Alejandro Zendejas","2/7/1998 (25 years old)","M (LC), AM (RL)","América","Mexican First Division","USA","No","1/17/2022","12/31/2026","$3.5K - $35K","Left","Very Strong","Weak","5'5""","141 lbs","152","31",133,140,11,14,15,13,14,11,7,12,11,5,15,10,7,14,10,12,12,13,12,15,11,12,9,15,11,13,15,13,14,14,11,6,14,13,13,7,14,13,8,12,12,6,8,11,4,13,11,14,13,2,3,1,2,3,1,2,1,3,1,3
"8135",28084759,"Emerson Hyndman","4/9/1996 (27 years old)","M/AM (C)","Memphis","USSL Championship Eastern Conference","USA","Yes","6/9/2023","11/30/2024","$75K - $750K","Right","Reasonable","Very Strong","5'7""","136 lbs","109","10",115,140,11,9,12,9,14,11,5,8,5,8,13,7,9,14,11,10,10,12,11,11,13,11,6,13,14,14,14,13,13,13,14,6,16,13,14,9,10,17,15,16,12,10,11,12,6,5,15,16,15,1,4,2,3,2,1,1,3,1,1,1
"8136",72021508,"Tim Ream","10/5/1987 (35 years old)","D (LC)","Fulham","English Premier Division","USA","No","12/26/2022","6/30/2024","$275K - $8M","Left Only","Very Strong","Weak","6'1""","160 lbs","454","5",136,140,3,9,11,6,13,6,14,7,7,13,13,3,15,13,12,14,16,14,14,14,15,10,18,12,15,18,14,16,11,12,14,13,17,12,15,13,13,14,15,17,15,14,9,12,7,5,15,12,14,2,2,2,1,3,2,3,1,3,1,1
"8137",2000095120,"Reed Baker-Whiting","3/31/2005 (18 years old)","D (RL), DM, M (C)","Seattle","Major League Soccer","USA","No","5/12/2021","12/31/2024","$4.4M - $6.8M","Right","Fairly Strong","Very Strong","5'11""","160 lbs","60","1",96,140,10,12,11,9,10,10,8,13,7,9,10,8,10,9,15,8,10,10,8,10,9,8,3,7,9,15,11,12,12,11,9,10,12,12,11,10,14,15,10,10,11,10,12,5,14,4,20,11,20,3,3,3,1,2,2,4,2,3,1,4
"8138",72014252,"Omar González","10/11/1988 (34 years old)","D (C)","New England","Major League Soccer","USA","No","12/21/2021","12/31/2023","$55K","Right","Weak","Very Strong","6'5""","205 lbs","373","20",111,139,4,1,9,8,9,8,15,5,6,13,10,8,14,10,10,13,14,13,9,12,14,3,12,9,10,13,7,11,8,9,12,16,14,9,12,17,5,10,14,14,12,15,11,14,5,9,11,14,9,4,3,3,4,3,3,1,1,4,1,3
"8139",2000112376,"Noel Buck","4/5/2005 (18 years old)","M/AM (RC)","New England","Major League Soccer","USA","No","1/18/2022","12/31/2025","$7M - $10.5M","Right","Reasonable","Very Strong","5'11""","160 lbs","61","7",96,139,8,11,10,10,10,10,10,16,10,11,13,8,10,12,5,11,8,10,9,14,16,6,4,11,12,12,11,15,13,7,8,9,13,10,10,11,11,11,10,7,10,8,14,10,4,13,11,15,12,3,1,1,4,3,2,3,1,1,1,1
"8140",91205184,"Ransford-Yeboah Königsdörffer","9/13/2001 (21 years old)","M (R), AM (RL)","HSV","Bundesliga 2","GHA","Yes","7/1/2022","6/30/2026","$550K - $5.6M","Right","Reasonable","Very Strong","5'11""","171 lbs","100","20",117,140,5,9,13,12,12,11,9,9,13,8,11,10,8,12,14,12,9,11,9,9,12,13,4,13,8,12,11,12,15,12,9,11,14,16,12,9,17,10,10,11,10,12,7,10,8,8,11,14,12,1,1,1,2,3,2,2,2,1,3,2
"8141",2000037531,"Caden Clark","5/27/2003 (20 years old)","AM (RLC)","RB Leipzig","Bundesliga","USA","No","6/24/2021","6/30/2025","$0","Right","Reasonable","Very Strong","5'11""","156 lbs","62","11",100,139,8,12,10,10,10,10,10,11,8,9,12,4,11,12,13,12,12,8,10,10,8,12,3,11,11,10,12,14,12,12,11,11,10,12,9,9,16,12,13,13,12,10,10,14,7,5,20,13,8,3,2,4,2,1,3,1,1,1,2,3
"8142",45111891,"Kaoru Mitoma","5/20/1997 (26 years old)","M/AM (L)","Brighton","English Premier Division","JPN","No","8/10/2021","6/30/2025","$59M - $74M","Right","Weak","Very Strong","5'10""","158 lbs","177","57",149,160,9,11,18,13,15,8,8,14,7,8,13,7,8,14,13,12,13,14,15,14,13,16,6,15,7,15,14,13,17,14,14,10,14,16,14,7,15,15,12,15,15,9,10,15,1,6,14,14,18,3,2,3,2,1,2,2,2,1,2,3
"8143",45095490,"Takehiro Tomiyasu","11/5/1998 (24 years old)","D (RLC), WB (RL)","Arsenal","English Premier Division","JPN","No","8/31/2021","6/30/2025","$63M - $95M","Right","Strong","Very Strong","6'2""","171 lbs","186","5",150,160,7,11,13,8,12,6,12,9,11,13,12,7,15,13,13,15,15,14,14,13,15,13,7,12,14,16,12,16,13,14,13,14,16,13,15,13,16,14,17,17,14,15,8,12,10,4,15,14,18,2,1,1,1,1,1,1,3,2,1,1
"8144",45001639,"Shinji Kagawa","3/17/1989 (34 years old)","AM (C)","C-Osaka","J1 League","JPN","No","1/29/2023","1/31/2024","$55K - $550K","Right","Strong","Very Strong","5'9""","149 lbs","398","112",125,160,12,14,16,12,16,13,9,5,11,5,15,13,8,17,9,12,6,15,11,15,9,17,8,15,10,15,16,11,10,14,8,9,9,11,9,7,8,16,15,14,11,12,13,10,6,6,10,13,10,3,2,1,2,1,3,1,2,1,2,2
"8145",45104608,"Takefusa Kubo","6/4/2001 (22 years old)","M (R), AM (RC), ST (C)","Real San Sebastián","Spanish First Division","JPN","No","7/19/2022","6/30/2027","$50M - $75M","Left","Very Strong","Reasonable","5'8""","141 lbs","187","25",149,159,14,12,15,14,16,12,7,11,8,6,15,10,6,16,8,15,12,14,14,16,10,15,7,14,7,15,16,14,14,14,15,7,10,12,13,12,11,13,9,12,11,10,10,14,6,6,15,10,11,3,1,2,2,3,3,3,2,1,2,2
"8146",3900562,"Shinji Ono","9/27/1979 (43 years old)","M/AM (C)","Sapporo","J1 League","JPN","No","1/1/2022","1/31/2024","$8K","Right","Strong","Very Strong","5'9""","165 lbs","484","67",80,155,14,12,10,8,9,16,8,3,10,4,12,9,8,14,11,15,7,15,11,14,8,13,13,12,8,14,11,6,6,9,12,10,7,6,5,10,12,13,14,14,12,10,14,12,4,3,10,4,18,2,3,1,1,3,1,2,3,3,2,2
"8147",3900305,"Yasuhito Endo","1/28/1980 (43 years old)","DM, M/AM (C)","Iwata","J2 League","JPN","No","12/27/2021","1/31/2024","Not for Sale","Right","Fairly Strong","Very Strong","5'10""","165 lbs","774","113",99,155,14,7,6,8,8,13,7,4,13,7,14,17,10,10,11,14,9,15,12,14,13,12,14,11,14,18,13,9,10,11,12,7,16,9,7,7,13,14,8,16,14,15,6,14,8,5,14,11,7,1,2,2,3,2,3,3,1,3,4,3
"8148",45109174,"Hidemasa Morita","5/10/1995 (28 years old)","DM, M (C)","Sporting CP","Portuguese Premier League","JPN","No","7/1/2022","6/30/2026","$24M - $36M","Right","Reasonable","Very Strong","5'10""","163 lbs","227","17",146,152,13,13,13,12,15,8,11,11,8,11,15,12,14,15,16,13,12,16,15,14,16,10,13,14,15,16,15,14,12,13,15,8,14,13,14,12,16,14,16,17,16,13,4,14,10,6,16,16,18,2,1,1,1,3,2,1,1,2,1,2
"8149",45092714,"Daichi Kamada","8/5/1996 (26 years old)","M/AM (C)","Eintracht Frankfurt","Bundesliga","JPN","No","6/14/2021","6/30/2025","$26M - $40M","Right","Fairly Strong","Very Strong","6'0""","167 lbs","228","48",144,152,13,12,14,13,15,14,7,13,4,10,14,14,12,16,13,12,11,15,12,13,12,14,6,16,11,14,15,14,12,14,14,10,14,14,15,10,14,18,16,17,12,11,6,12,5,3,13,17,12,2,3,1,2,2,2,3,2,3,3,2
"8150",45108807,"Keito Nakamura","7/28/2000 (22 years old)","AM (RLC), ST (C)","LASK","Austrian Premier Division","JPN","No","8/11/2021","6/30/2025","$10M - $13M","Right","Reasonable","Very Strong","5'11""","165 lbs","134","36",135,150,7,12,13,12,13,7,8,12,8,6,13,7,8,15,8,13,13,12,12,11,14,11,8,15,6,13,14,13,14,13,12,11,12,15,14,11,11,20,11,12,10,10,10,11,6,6,11,11,14,2,1,1,2,2,4,2,2,2,1,2
"8151",67233494,"Iddrisu Baba","1/22/1996 (27 years old)","DM, M (C)","Mallorca","Spanish First Division","GHA","Yes","6/15/2020","6/30/2024","$350K - $3.6M","Right","Reasonable","Very Strong","6'0""","160 lbs","230","3",125,140,5,8,9,5,11,6,11,9,7,13,10,8,15,10,14,15,15,11,14,12,6,9,10,6,15,15,9,16,12,13,12,11,14,14,16,14,14,14,10,11,12,12,10,12,9,7,13,11,20,1,3,1,1,3,2,3,3,1,3,4
"8152",45109024,"Hiroki Ito","5/12/1999 (24 years old)","D (LC), WB (L)","VfB Stuttgart","Bundesliga","JPN","No","7/1/2022","6/30/2025","$11M - $16.5M","Left","Very Strong","Weak","6'2""","185 lbs","119","6",140,150,12,12,11,7,12,12,12,8,15,13,13,7,14,12,13,14,13,15,14,14,16,11,11,11,15,16,12,14,13,13,14,12,15,15,14,13,15,16,16,16,15,14,7,13,6,4,16,15,18,1,3,3,2,2,2,2,3,1,1,2
"8153",45111893,"Reo Hatate","11/21/1997 (25 years old)","M/AM (C)","Celtic","cinch Premiership","JPN","No","12/31/2021","5/31/2026","$21M - $25M","Right","Reasonable","Very Strong","5'7""","154 lbs","188","60",136,150,8,12,12,11,14,9,7,12,5,7,14,10,12,15,15,14,9,13,12,12,16,11,10,15,12,15,16,17,14,13,14,6,13,13,13,12,15,16,15,11,11,10,10,18,10,8,13,10,14,2,2,3,3,1,1,2,3,1,2,3
"8154",45064891,"Takumi Minamino","1/16/1995 (28 years old)","AM (LC)","AS Monaco","Ligue 1 Uber Eats","JPN","No","7/1/2022","6/30/2026","$16M - $20M","Right","Fairly Strong","Very Strong","5'9""","149 lbs","256","56",140,150,10,12,14,13,14,10,7,12,5,8,14,10,7,15,12,14,14,12,14,11,15,15,7,14,8,14,14,16,15,16,15,8,14,13,14,8,11,15,14,15,10,10,7,11,6,4,12,14,7,1,3,1,1,1,3,4,1,2,2,2
"8155",45005331,"Yuto Nagatomo","9/12/1986 (36 years old)","D/WB/M (RL)","FC-Tokyo","J1 League","JPN","No","1/1/2022","1/31/2024","$26K - $250K","Either","Very Strong","Very Strong","5'7""","149 lbs","413","19",122,150,4,7,7,7,11,4,8,10,8,12,9,5,13,9,14,13,14,14,11,12,16,8,13,7,15,16,6,12,12,14,9,6,15,11,10,7,18,18,15,18,16,16,9,13,6,2,12,13,16,3,2,3,2,1,2,2,2,2,3,2
"8156",2000053170,"Takuhiro Nakai","10/24/2003 (19 years old)","M/AM (C)","R. Madrid B","Spanish Federation First Division B","JPN","No","7/1/2020","6/30/2025","$85K - $850K","Right","Fairly Strong","Very Strong","5'10""","143 lbs","2","-",104,150,8,8,16,10,15,8,8,10,4,9,15,6,8,16,8,10,9,8,7,12,9,16,11,7,10,11,13,13,13,10,9,9,18,12,11,8,15,11,14,8,11,12,7,13,5,7,11,10,15,3,3,3,3,4,1,2,3,2,1,2
"8157",45111317,"Yukinari Sugawara","6/28/2000 (22 years old)","D/WB/M/AM (R)","AZ","Eredivisie","JPN","No","1/1/2020","6/30/2025","$17.5M - $21M","Right","Reasonable","Very Strong","5'11""","160 lbs","129","9",139,148,12,15,12,10,13,12,8,13,12,10,15,12,11,14,12,13,14,13,9,11,14,13,5,13,11,15,13,16,14,14,11,11,13,14,16,8,10,10,10,12,10,13,3,10,10,7,10,12,10,2,1,1,2,2,1,1,3,3,2,2
"8158",45105555,"Kyogo Furuhashi","1/20/1995 (28 years old)","AM (RL), ST (C)","Celtic","cinch Premiership","JPN","No","7/19/2021","5/31/2025","$17.5M - $22M","Right","Strong","Very Strong","5'7""","138 lbs","287","116",136,148,7,10,10,13,13,7,7,13,5,5,11,12,10,14,15,16,10,12,14,11,18,13,8,18,8,16,13,17,16,15,12,6,14,15,15,7,10,16,14,16,18,13,4,13,4,1,13,15,17,3,2,3,3,2,4,3,1,2,3,2
"8159",45065338,"Shoya Nakajima","8/23/1994 (28 years old)","AM (RLC)","Antalyaspor","Turkish Super League","JPN","No","9/8/2022","6/30/2025","$0","Right","Fairly Strong","Very Strong","5'5""","141 lbs","226","31",130,145,12,13,15,12,15,13,4,13,4,5,14,12,7,16,11,11,9,11,9,12,8,17,5,14,7,11,14,10,15,14,7,4,14,11,11,6,13,12,10,5,8,12,3,15,4,10,12,8,1,2,2,2,1,1,1,1,1,3,1,1
"8160",45095577,"Ritsu Doan","6/16/1998 (24 years old)","M (R), AM (RLC)","SC Freiburg","Bundesliga","JPN","No","7/1/2022","6/30/2026","$14M - $17M","Left","Very Strong","Reasonable","5'8""","154 lbs","207","48",137,145,12,10,15,12,15,13,7,12,6,8,13,12,12,16,13,12,13,12,11,12,13,15,7,14,9,13,13,15,13,16,12,6,13,15,13,10,12,12,12,18,13,8,7,14,7,9,12,12,17,3,2,1,1,1,2,1,2,2,1,2
"8161",45030953,"Wataru Endo","2/9/1993 (30 years old)","DM, M (C)","VfB Stuttgart","Bundesliga","JPN","No","11/26/2020","6/30/2024","$20M - $24M","Right","Reasonable","Very Strong","5'10""","169 lbs","380","43",142,145,6,8,12,10,13,6,15,11,8,13,13,11,15,13,14,13,16,14,16,13,18,10,16,13,15,19,13,16,12,12,15,12,17,12,17,12,15,16,14,20,20,15,7,18,8,1,17,17,18,2,3,1,2,2,3,1,3,4,2,3
"8162",8442448,"André Ayew","12/17/1989 (33 years old)","AM (RL), ST (C)","Nottm Forest","English Premier Division","GHA","Yes","2/2/2023","6/30/2025","$400K - $4M","Left Only","Very Strong","Weak","5'9""","158 lbs","455","126",124,140,9,10,16,13,15,11,15,12,5,6,9,14,7,14,13,15,17,15,14,10,15,15,18,12,7,11,8,14,11,14,16,10,15,11,14,13,15,5,4,15,15,8,7,15,13,12,13,16,17,1,3,1,2,1,2,1,3,3,1,1
"8163",2000067601,"Masaya Shibayama","7/2/2002 (20 years old)","AM (RL)","Omiya","J2 League","JPN","No","6/13/2022","12/31/2025","$550K - $1.6M","Left","Very Strong","Strong","5'3""","130 lbs","87","6",107,144,5,11,13,10,10,8,7,3,9,8,12,7,9,15,12,10,5,9,9,6,12,13,2,14,6,9,9,9,15,16,9,9,9,15,11,7,13,15,13,10,12,11,13,7,5,8,11,12,18,1,3,2,3,3,2,1,3,1,3,3
"8164",45021707,"Yuya Osako","5/18/1990 (33 years old)","M (L), AM (LC), ST (C)","Kobe","J1 League","JPN","No","1/1/2022","1/31/2024","$55K - $550K","Right","Strong","Very Strong","6'0""","165 lbs","395","89",118,144,6,8,11,15,14,7,14,3,10,6,11,11,7,14,16,10,14,9,11,13,12,13,7,12,6,14,12,9,12,14,13,12,15,10,13,8,12,18,16,16,8,10,8,11,5,5,11,15,11,2,2,2,2,2,2,1,3,3,2,2
"8165",45092815,"Junya Ito","3/9/1993 (30 years old)","M/AM (R)","Reims","Ligue 1 Uber Eats","JPN","No","7/1/2022","6/30/2026","$16M - $20M","Right","Reasonable","Very Strong","5'9""","145 lbs","286","56",140,144,10,14,15,13,13,10,6,11,8,8,13,12,7,14,14,10,14,13,14,13,15,14,5,15,6,14,12,14,17,12,11,7,14,16,13,9,10,12,14,16,7,15,5,13,10,8,13,12,8,3,1,4,2,1,1,2,2,3,2,1
"8166",45035657,"Ryota Oshima","1/23/1993 (30 years old)","M/AM (RLC)","Kawasaki-F","J1 League","JPN","No","1/1/2022","1/31/2024","$110K - $325K","Right","Reasonable","Very Strong","5'6""","145 lbs","250","15",93,143,8,11,12,9,13,11,5,4,12,12,14,13,9,13,9,13,11,13,9,12,12,12,11,7,8,11,12,8,12,10,12,11,7,10,7,8,13,15,11,11,13,9,16,8,6,5,13,10,11,2,3,3,2,3,3,1,3,1,2,1
"8167",788545,"Shinji Okazaki","4/16/1986 (37 years old)","ST (C)","STVV","Jupiler Pro League","JPN","No","8/19/2022","6/30/2024","$350K - $1.1M","Right","Strong","Very Strong","5'9""","154 lbs","487","109",121,143,5,8,12,12,13,9,15,10,8,8,13,13,9,13,16,12,16,11,15,10,14,12,12,14,10,14,10,18,11,12,11,11,16,11,11,9,12,9,12,18,14,13,5,15,9,4,12,15,12,3,4,3,3,3,3,3,1,3,2,1
"8168",45006041,"Hiroshi Kiyotake","11/12/1989 (33 years old)","M (L), AM (RLC)","C-Osaka","J1 League","JPN","No","1/1/2022","1/31/2024","$160K - $475K","Right","Strong","Very Strong","5'8""","145 lbs","391","58",109,143,15,12,10,8,11,14,10,5,14,6,12,10,6,14,8,14,7,15,10,13,7,15,5,12,9,12,14,8,12,14,8,6,12,12,9,7,13,18,13,13,11,8,15,9,4,8,7,15,10,3,3,3,2,3,2,2,3,4,3,2
"8169",45005560,"Takashi Inui","6/2/1988 (35 years old)","M (L), AM (LC)","Shimizu","J2 League","JPN","No","7/22/2022","1/31/2024","$0 - $50K","Right","Weak","Very Strong","5'7""","138 lbs","431","71",105,143,13,9,13,9,13,12,7,5,11,5,10,8,7,16,14,12,6,12,11,12,9,13,4,12,6,11,10,11,13,14,7,6,13,13,9,5,14,18,15,17,8,10,3,8,4,2,12,12,10,1,1,1,4,3,3,1,3,2,1,1
"8170",45065336,"Shinnosuke Hatanaka","8/25/1995 (27 years old)","D (C)","Yokohama F･M","J1 League","JPN","No","1/1/2022","1/31/2024","$90K - $900K","Right","Strong","Very Strong","6'1""","182 lbs","212","6",107,143,6,6,6,4,9,4,11,7,4,13,11,5,12,10,11,11,12,10,12,11,9,10,9,5,9,9,12,13,10,12,11,16,15,11,13,13,8,20,11,9,10,10,6,13,5,5,13,12,13,2,2,1,1,2,2,1,2,3,4,1
"8171",45109737,"Kanya Fujimoto","7/1/1999 (23 years old)","M (C), AM (RC)","Gil Vicente","Portuguese Premier League","JPN","No","7/1/2022","6/30/2025","$2.5M - $5.2M","Left","Very Strong","Weak","5'9""","147 lbs","142","8",125,142,14,15,14,10,15,12,6,13,5,4,15,10,6,16,8,10,10,15,12,14,13,14,12,8,12,14,15,14,12,14,14,7,12,13,12,8,10,14,11,15,15,12,6,12,5,2,14,11,12,1,1,2,3,2,1,1,2,2,1,2
"8172",45005892,"Maya Yoshida","8/24/1988 (34 years old)","D (C)","Schalke 04","Bundesliga 2","JPN","No","7/5/2022","6/30/2024","$50K - $475K","Right","Reasonable","Very Strong","6'2""","171 lbs","380","19",120,142,4,8,8,6,12,6,12,6,6,12,12,8,10,10,12,14,13,14,14,14,15,8,17,8,17,17,12,14,9,10,13,12,15,10,11,11,14,14,14,16,14,9,6,17,7,3,10,15,17,2,1,2,1,2,2,2,3,2,3,2
"8173",13158416,"Joseph Aidoo","9/29/1995 (27 years old)","D (C)","Vigo","Spanish First Division","GHA","No","2/7/2022","6/30/2026","$10.5M - $15.5M","Right Only","Weak","Very Strong","6'0""","176 lbs","226","9",134,140,7,7,8,4,11,8,14,7,9,14,10,6,15,11,15,12,17,11,12,12,14,7,11,8,13,12,9,14,14,14,15,13,18,15,15,18,6,14,14,13,13,10,5,12,8,4,11,13,14,3,3,2,1,3,3,4,3,1,2,2
"8174",45015318,"Gotoku Sakai","3/14/1991 (32 years old)","D/WB (RL), DM","Kobe","J1 League","JPN","Yes","1/1/2022","1/31/2024","$75K - $750K","Either","Very Strong","Very Strong","5'9""","163 lbs","412","6",111,142,11,11,7,6,6,9,7,13,7,11,8,6,10,11,13,11,13,9,9,11,15,13,13,8,11,13,9,11,11,12,10,8,16,11,12,8,14,13,11,18,8,15,4,11,10,4,11,14,12,3,1,1,1,4,2,1,2,2,3,2
"8175",45092658,"Ko Itakura","1/27/1997 (26 years old)","D (C), DM, M (C)","Borussia M'gladbach","Bundesliga","JPN","No","7/2/2022","6/30/2026","$12.5M - $19M","Right","Reasonable","Very Strong","6'2""","163 lbs","147","8",138,142,3,7,11,7,12,3,13,7,6,15,14,8,14,12,14,16,15,15,14,13,16,12,12,9,15,16,12,16,13,12,14,13,15,13,14,13,14,14,13,18,16,10,6,14,8,4,16,15,18,2,3,1,3,2,3,1,3,2,3,2
"8176",45015208,"Hiroki Sakai","4/12/1990 (33 years old)","D (RL), WB (R)","Urawa","J1 League","JPN","No","1/1/2022","1/31/2024","$130K - $1.3M","Right","Reasonable","Very Strong","6'1""","171 lbs","344","7",117,141,5,11,11,7,11,7,9,14,9,10,11,4,13,10,14,12,14,10,13,11,16,10,8,11,12,14,8,11,13,11,11,12,15,12,12,11,15,15,13,18,12,15,6,14,10,4,16,15,12,4,4,2,2,3,1,3,4,2,2,3
"8177",45015407,"Takashi Usami","5/6/1992 (31 years old)","M (L), AM (LC), ST (C)","G-Osaka","J1 League","JPN","No","1/1/2022","1/31/2024","$12K - $120K","Right","Strong","Very Strong","5'10""","152 lbs","341","102",98,140,9,11,14,12,13,9,6,4,11,3,13,9,2,14,9,9,6,11,8,10,9,14,3,13,5,7,11,10,13,14,7,8,14,12,11,6,13,18,16,12,8,14,5,10,4,5,11,12,3,1,2,1,2,1,3,1,1,3,1,3
"8178",45109986,"Koki Saito","8/10/2001 (21 years old)","AM (LC)","Lommel SK","Belgian Challenger Pro League","JPN","No","1/3/2021","6/30/2025","$500K - $8.6M","Right Only","Weak","Very Strong","5'7""","134 lbs","118","21",120,140,11,13,14,9,13,8,8,8,6,6,13,7,5,13,5,11,11,12,12,11,15,12,5,13,7,15,12,15,15,13,8,9,12,15,14,8,15,20,15,16,6,14,12,8,7,4,10,14,10,2,1,2,1,2,3,3,2,2,3,2
"8179",45097393,"Tomoki Iwata","4/7/1997 (26 years old)","D (C), DM","Yokohama F･M","J1 League","JPN","No","1/2/2021","12/31/2026","$0","Right","Strong","Very Strong","5'10""","169 lbs","213","10",123,140,9,5,9,9,11,11,12,12,5,16,11,8,13,6,12,15,12,12,10,11,18,5,11,12,14,12,10,13,11,12,13,11,12,11,13,12,12,20,11,12,11,10,12,16,5,3,12,12,9,1,3,2,2,2,2,1,2,2,2,2
"8180",788636,"Yosuke Kashiwagi","12/15/1987 (35 years old)","DM, M (C), AM (LC)","FC Gifu","J3 League","JPN","No","1/1/2022","1/31/2024","$0 - $20K","Left Only","Very Strong","Weak","5'9""","160 lbs","473","61",79,140,11,7,8,8,9,11,6,3,9,7,13,11,7,11,8,13,10,13,12,14,11,13,8,9,10,12,12,7,12,10,11,9,12,9,7,7,7,7,15,6,16,8,6,12,12,16,8,11,9,3,2,2,1,1,3,2,3,2,3,3
"8181",45092622,"Yuma Suzuki","4/26/1996 (27 years old)","ST (C)","Kashima","J1 League","JPN","No","1/9/2022","12/31/2024","$425K - $4.3M","Right","Reasonable","Very Strong","6'0""","165 lbs","226","73",121,139,10,10,12,13,11,11,14,8,11,8,12,9,7,13,17,10,17,12,11,11,12,14,12,8,8,15,13,14,14,12,7,11,15,15,13,8,11,17,13,11,9,12,8,9,7,3,11,9,16,3,2,1,3,1,3,3,2,1,3,3
"8182",783418,"Masato Morishige","5/21/1987 (36 years old)","D (C), DM","FC-Tokyo","J1 League","JPN","No","1/1/2022","1/31/2024","$30K - $300K","Right","Reasonable","Very Strong","6'0""","176 lbs","494","40",117,139,12,13,13,11,13,12,12,5,11,10,13,11,12,13,9,14,14,13,13,13,4,8,12,14,11,14,13,11,13,13,12,13,13,14,13,12,13,16,9,11,9,12,4,12,14,1,12,9,17,2,2,1,3,1,3,1,4,1,3,2
"8183",45101691,"Daizen Maeda","10/20/1997 (25 years old)","AM (L), ST (C)","Celtic","cinch Premiership","JPN","No","5/23/2022","5/31/2026","$11.5M - $14.5M","Right","Weak","Very Strong","5'8""","147 lbs","225","65",130,139,8,7,12,11,9,8,7,9,5,7,10,11,8,6,16,11,12,10,11,12,16,11,8,14,12,17,8,19,19,13,8,7,18,19,17,8,10,15,11,16,12,11,3,10,2,5,9,14,8,1,1,3,1,3,1,3,1,2,2,3
"8184",2000096580,"Felix Afena-Gyan","1/19/2003 (20 years old)","AM (RL), ST (C)","Cremonese","Italian Serie B","GHA","No","8/29/2022","6/30/2026","$275K - $7M","Right","Weak","Very Strong","5'9""","165 lbs","40","2",115,139,5,10,10,11,9,6,10,10,6,5,8,10,8,9,12,11,12,10,9,8,11,10,5,10,5,10,7,10,16,16,14,9,14,16,13,11,11,10,5,12,12,11,5,9,15,7,8,14,15,1,2,3,3,3,2,2,3,3,2,1
"8185",45035554,"Gen Shoji","12/11/1992 (30 years old)","D (C)","Kashima","J1 League","JPN","No","1/2/2023","1/31/2025","$275K - $2.8M","Right Only","Weak","Very Strong","6'0""","167 lbs","248","8",110,139,5,7,11,4,13,3,13,5,7,13,11,1,13,14,8,13,12,11,11,12,10,5,14,8,12,10,12,8,11,13,11,13,10,12,11,13,13,14,12,9,14,10,8,6,8,11,10,9,6,3,3,2,1,2,1,3,4,3,3,2
"8186",45077916,"Kosuke Nakamura","2/27/1995 (28 years old)","GK","PTM","Portuguese Premier League","JPN","No","9/27/2022","6/30/2025","$450K - $4.5M","Right Only","Weak","Very Strong","6'1""","180 lbs","185","-",126,138,2,2,2,1,8,7,7,1,3,6,11,3,12,8,7,10,13,11,11,10,12,3,7,8,14,12,6,12,10,16,8,11,14,12,14,13,14,11,14,19,12,17,11,11,3,6,12,13,18,11,13,17,15,10,13,14,4,14,14,12
"8187",788533,"Shinzo Koroki","7/31/1986 (36 years old)","ST (C)","Urawa","J1 League","JPN","No","1/4/2023","1/31/2024","$28K","Right","Weak","Very Strong","5'9""","158 lbs","495","163",102,138,6,5,11,13,14,6,14,6,12,5,10,10,5,11,13,13,14,10,15,11,14,12,8,13,11,12,11,5,13,14,13,10,11,12,9,9,8,14,14,14,10,13,5,16,5,5,12,9,10,2,1,2,1,3,3,1,3,2,3,3
"8188",45111315,"Yuki Soma","2/25/1997 (26 years old)","M (R), AM (RL)","Casa Pia","Portuguese Premier League","JPN","No","6/15/2020","12/31/2025","$65K - $650K","Right","Reasonable","Very Strong","5'5""","149 lbs","217","28",122,138,14,13,14,11,14,13,7,13,9,4,13,10,6,14,11,8,9,14,11,12,13,12,8,11,8,12,12,13,13,13,14,5,13,14,13,7,14,20,14,16,14,10,5,13,13,1,13,9,13,1,1,3,2,3,3,3,2,1,3,2
"8189",45104573,"Ayumu Seko","6/7/2000 (23 years old)","D (C)","Grasshoppers","Swiss Super League","JPN","No","1/18/2022","6/30/2025","$1.8M - $3.8M","Right","Reasonable","Very Strong","6'1""","158 lbs","146","3",119,138,5,5,8,6,9,6,14,6,7,13,13,7,14,9,12,14,12,13,12,13,13,7,9,6,13,13,9,12,12,12,12,13,14,12,13,13,6,16,16,16,9,12,8,11,6,5,12,13,11,3,2,2,1,3,2,2,4,2,3,2
"8190",45025168,"Hotaru Yamaguchi","10/6/1990 (32 years old)","DM, M (C)","Kobe","J1 League","JPN","No","1/1/2022","1/31/2027","Not for Sale","Right","Reasonable","Very Strong","5'8""","158 lbs","386","32",122,138,10,9,8,5,12,11,7,5,11,14,12,7,13,10,8,13,13,15,11,11,13,8,8,11,13,12,11,16,13,15,12,13,16,13,13,14,12,14,14,16,12,16,6,13,7,5,13,12,6,2,3,2,1,2,1,1,4,1,4,3
"8191",45112276,"Zion Suzuki","8/21/2002 (20 years old)","GK","Urawa","J1 League","JPN","No","6/13/2022","12/31/2025","$150K - $1.5M","Right Only","Weak","Very Strong","6'3""","200 lbs","28","-",101,137,3,2,1,3,2,4,1,2,2,3,8,2,3,2,11,10,12,7,8,13,14,1,13,1,6,9,8,12,10,8,18,17,12,8,7,19,11,10,14,12,11,9,6,13,8,8,14,10,9,11,13,14,5,15,14,13,13,13,12,14
"8192",2000142990,"Shio Fukuda","4/8/2004 (19 years old)","ST (C)","Borussia M'gladbach","Bundesliga","JPN","No","1/15/2023","6/30/2025","$300K - $3.1M","Right","Reasonable","Very Strong","5'10""","143 lbs","-","-",92,137,7,8,11,12,11,7,13,9,4,6,11,12,7,12,10,9,12,11,9,8,13,12,4,12,6,12,10,12,12,12,11,11,14,12,11,10,10,15,15,15,13,12,4,11,5,2,12,13,15,4,1,2,1,3,3,2,2,1,1,2
"8193",783414,"Shusaku Nishikawa","6/18/1986 (36 years old)","GK","Urawa","J1 League","JPN","No","1/1/2022","1/31/2024","$0 - $30K","Left","Very Strong","Reasonable","6'0""","178 lbs","557","-",88,136,3,3,2,3,1,8,1,3,1,1,6,6,2,5,11,14,15,13,8,11,10,13,12,1,11,12,10,10,11,9,11,13,9,11,7,9,11,11,12,10,10,11,13,14,10,4,7,13,20,11,11,10,8,9,10,15,5,9,9,12
"8194",775004,"Daisuke Matsui","5/11/1981 (42 years old)","M/AM (RLC)","YSCC Yokohama","J3 League","JPN","No","1/21/2022","1/31/2024","$0 - $8K","Right","Fairly Strong","Very Strong","5'9""","145 lbs","509","54",67,136,9,12,5,6,12,7,8,6,9,7,13,7,10,14,12,14,3,10,5,12,12,12,11,15,8,8,13,9,5,5,6,11,12,5,5,6,13,16,16,16,9,14,10,9,6,6,12,15,14,2,3,2,1,1,2,3,3,3,1,1
"8195",67184349,"Iñaki Williams","6/15/1994 (28 years old)","M (RL), AM (RLC), ST (C)","A. Bilbao","Spanish First Division","GHA","Yes","6/14/2021","6/30/2028","$145M - $174M","Right","Reasonable","Very Strong","6'1""","176 lbs","340","79",155,159,7,12,14,13,14,9,13,10,7,7,10,9,7,14,10,12,15,11,12,12,12,11,7,14,11,12,12,15,16,13,11,12,18,18,14,13,13,8,10,13,10,14,1,14,11,11,11,14,15,2,1,1,2,4,1,2,3,2,3,1
"8196",13169837,"Nicholas Opoku","11/8/1997 (25 years old)","D (C)","Amiens SC","Ligue 2 BKT","GHA","No","7/1/2021","6/30/2024","$1.4M - $3M","Right Only","Weak","Very Strong","6'3""","178 lbs","152","2",120,138,8,8,8,8,6,6,15,6,14,13,11,6,13,13,13,13,14,11,12,12,14,8,10,11,13,13,8,13,12,10,14,14,12,13,14,15,8,20,11,16,10,6,10,10,13,6,12,14,10,3,1,1,3,4,1,3,2,3,3,3
"8197",45060093,"Sho Sasaki","10/2/1989 (33 years old)","D (LC)","Hiroshima","J1 League","JPN","No","1/1/2022","1/31/2024","$160K - $475K","Right","Fairly Strong","Very Strong","5'10""","154 lbs","391","33",117,136,8,13,12,7,12,8,12,13,5,14,12,7,14,12,13,9,14,12,13,14,16,8,8,10,9,11,8,14,13,14,14,15,15,14,13,11,12,17,13,14,14,12,8,14,10,13,13,10,13,1,3,1,1,3,2,3,2,2,2,1
"8198",36023421,"Kostas Manolas","6/14/1991 (31 years old)","D (C)","Sharjah","UAE Professional League","GRE","Yes","9/24/2022","5/31/2024","$2.9M - $5.8M","Right","Weak","Very Strong","6'2""","182 lbs","353","16",130,160,4,5,6,8,10,5,15,5,8,15,11,7,14,9,18,13,17,10,12,12,16,5,14,8,14,14,9,12,13,12,14,15,10,14,13,15,4,7,6,13,12,12,13,13,16,15,11,11,11,3,2,2,3,2,1,2,3,1,3,1
"8199",36096824,"Kostas Tsimikas","5/12/1996 (27 years old)","D/WB (L)","Liverpool","English Premier Division","GRE","Yes","8/10/2020","6/30/2025","$49M - $74M","Left Only","Very Strong","Weak","5'9""","147 lbs","147","10",149,159,13,16,15,6,15,13,8,8,11,13,15,12,15,15,14,14,14,15,13,14,15,13,9,14,14,15,14,16,15,14,14,10,14,15,15,12,10,15,8,16,14,14,8,13,10,6,13,15,15,2,2,3,1,2,1,2,1,2,3,3
"8200",1804808,"Sokratis Papastathopoulos","6/9/1988 (35 years old)","D (C)","Olympiacos","Greek Super League 1","GRE","Yes","1/25/2021","6/30/2024","$22K - $220K","Right","Weak","Very Strong","6'1""","187 lbs","404","19",115,155,5,7,8,4,10,4,13,5,12,13,10,6,13,9,17,13,18,12,12,13,16,5,15,8,14,16,8,13,10,9,13,12,13,12,10,15,10,9,8,16,13,10,10,14,15,13,12,15,15,1,3,3,3,3,1,1,2,1,3,3
"8201",2000227373,"Stefanos Tzimas","1/6/2006 (17 years old)","ST (C)","PAOK","Greek Super League 1","GRE","Yes","12/23/2022","12/31/2025","$2.7M - $5.6M","Right","Reasonable","Very Strong","6'0""","169 lbs","13","7",80,155,6,8,9,12,8,8,14,9,6,9,9,7,9,12,10,13,12,10,8,8,14,12,10,10,9,11,8,12,10,9,12,12,12,11,10,11,6,13,12,11,15,11,3,4,9,1,9,15,11,3,1,1,3,2,3,2,2,2,4,2
"8202",36160679,"Georgios Koutsias","2/8/2004 (19 years old)","AM (RL), ST (C)","Chicago","Major League Soccer","GRE","Yes","2/28/2023","12/31/2026","$600K - $5.2M","Right","Weak","Very Strong","5'11""","165 lbs","53","13",100,149,7,7,10,14,9,6,9,8,5,6,9,13,6,12,8,13,11,10,8,9,12,11,9,13,6,7,9,10,14,13,12,10,12,15,10,10,8,17,7,12,11,12,3,11,10,8,10,16,8,2,2,2,3,2,2,3,2,2,2,3
"8203",36116501,"Konstantinos Mavropanos","12/11/1997 (25 years old)","D (RC)","VfB Stuttgart","Bundesliga","GRE","Yes","7/1/2022","6/30/2025","$21M - $25M","Right","Reasonable","Very Strong","6'4""","196 lbs","114","9",140,148,2,8,12,7,11,2,15,11,16,13,13,6,16,12,16,14,18,12,12,12,18,12,12,10,13,12,12,17,13,11,15,16,13,16,12,16,6,13,12,16,15,12,11,13,13,6,14,17,15,1,3,2,2,3,3,2,2,2,1,1
"8204",91151156,"Vangelis Pavlidis","11/21/1998 (24 years old)","AM (L), ST (C)","AZ","Eredivisie","GRE","Yes","7/10/2021","6/30/2025","$18.5M - $28M","Right","Fairly Strong","Very Strong","6'1""","180 lbs","167","62",140,146,7,8,12,15,13,8,14,11,3,6,12,12,7,13,11,14,14,14,13,13,14,13,12,15,5,14,13,15,12,13,15,15,11,13,14,14,11,11,11,13,10,11,7,12,7,10,14,12,11,4,4,3,3,1,2,3,3,2,1,1
"8205",36017098,"Andreas Samaris","6/13/1989 (33 years old)","D (C), DM, M (C)","Rio Ave","Portuguese Premier League","GRE","Yes","8/29/2022","6/30/2024","$45K - $425K","Right","Reasonable","Very Strong","6'2""","176 lbs","310","17",115,145,11,11,11,7,12,12,12,12,6,10,13,12,11,13,14,13,13,13,12,11,16,11,16,10,13,16,13,12,10,12,14,14,12,11,10,13,15,6,10,19,12,19,13,16,16,13,15,16,15,2,3,3,4,3,1,1,3,1,1,1
"8206",55027830,"Zeca","8/31/1988 (34 years old)","DM, M (C)","FC København","3F Superliga","GRE","Yes","6/14/2021","6/30/2024","$28K - $275K","Right Only","Weak","Very Strong","6'0""","147 lbs","376","18",120,145,7,10,9,7,12,7,8,10,7,15,12,8,17,12,16,15,16,13,13,13,20,7,16,8,14,17,10,17,12,13,13,10,18,12,13,10,14,12,17,18,15,18,17,15,10,3,14,15,19,1,2,2,1,3,2,1,2,1,1,3
"8207",2000171710,"Emmanuel Yeboah","2/25/2003 (20 years old)","AM (R), ST (C)","CFR Cluj","Romanian First League","GHA","No","3/1/2022","6/30/2025","$450K - $4.5M","Right","Weak","Very Strong","6'2""","169 lbs","57","17",110,138,8,10,12,13,12,9,12,9,5,6,10,9,8,11,8,12,11,11,10,11,12,12,6,13,7,11,10,12,14,12,10,13,12,14,11,12,12,14,12,12,11,10,5,10,5,2,10,13,14,1,3,2,3,3,4,2,3,2,3,1
"8208",36105265,"Dimitris Nikolaou","8/13/1998 (24 years old)","D (C)","Spezia","Italian Serie B","GRE","Yes","8/10/2021","6/30/2026","$2.3M - $4.8M","Left Only","Very Strong","Weak","6'2""","180 lbs","135","1",126,143,6,7,7,7,10,6,13,8,9,13,11,9,15,11,15,14,15,12,15,14,14,7,13,7,13,13,6,13,12,12,14,15,13,12,15,14,12,11,12,14,15,11,4,12,11,9,13,15,15,1,1,1,1,1,2,1,3,2,2,2
"8209",92017506,"Odysseas Vlachodimos","4/26/1994 (29 years old)","GK","Benfica","Portuguese Premier League","GRE","Yes","2/8/2023","6/30/2027","$5.2M - $7.8M","Right","Reasonable","Very Strong","6'2""","167 lbs","269","-",138,142,4,3,3,1,8,7,8,1,2,2,9,2,3,8,11,11,10,11,13,13,13,4,10,3,14,13,10,13,13,16,12,14,14,12,13,12,13,9,8,13,8,14,5,13,4,14,13,14,13,14,7,18,13,14,12,16,4,10,8,14
"8210",43393590,"Ilias Koutsoupias","5/10/2001 (22 years old)","DM, M (C)","Entella","Italian Serie C/B","GRE","Yes","6/15/2020","6/30/2026","$150K - $1.5M","Right","Reasonable","Very Strong","5'11""","167 lbs","64","5",112,141,8,8,11,11,12,6,8,11,6,9,12,8,12,12,12,13,12,12,12,13,15,10,11,12,12,11,11,13,13,12,14,8,13,12,14,13,10,12,12,14,11,12,7,12,10,3,12,12,12,3,4,2,1,3,3,1,3,3,1,1
"8211",36137769,"Christos Mandas","9/17/2001 (21 years old)","GK","OFI","Greek Super League 1","GRE","Yes","1/31/2022","6/30/2026","$1.5M - $3.2M","Right","Weak","Very Strong","6'1""","178 lbs","55","-",112,140,2,3,1,1,12,6,2,3,3,2,10,2,2,7,15,13,13,12,10,12,12,3,12,1,13,13,13,13,10,13,12,13,7,10,11,10,13,13,11,12,11,16,6,12,5,1,13,15,8,12,7,13,10,12,12,13,6,10,11,12
"8212",36137588,"Tasos Douvikas","8/2/1999 (23 years old)","ST (C)","FC Utrecht","Eredivisie","GRE","Yes","7/1/2021","6/30/2025","$9.8M - $15M","Right","Reasonable","Very Strong","6'0""","167 lbs","136","41",131,140,8,11,11,15,13,11,12,10,4,7,11,14,6,13,13,15,16,12,14,11,14,14,8,14,7,13,10,17,13,12,14,13,15,13,16,14,7,15,7,17,14,13,5,11,6,5,12,14,15,3,1,2,3,3,2,4,2,3,3,3
"8213",36042095,"Kostas Fortounis","10/16/1992 (30 years old)","AM (RLC)","Olympiacos","Greek Super League 1","GRE","Yes","8/27/2022","6/30/2024","$7.4M - $9.2M","Right","Reasonable","Very Strong","6'0""","154 lbs","311","73",135,140,15,15,16,12,16,15,8,13,3,6,16,14,6,17,7,15,8,14,12,13,10,16,12,14,6,14,16,10,13,14,14,10,13,12,12,8,8,14,8,12,13,16,11,13,9,8,12,12,9,3,3,1,3,3,1,1,3,4,2,3
"8214",36159445,"Kostas Koulierakis","11/28/2003 (19 years old)","D (C)","PAOK","Greek Super League 2 North","GRE","Yes","12/23/2022","12/31/2026","$6.8M - $8.2M","Left","Very Strong","Weak","6'1""","171 lbs","47","2",110,140,7,8,8,8,10,8,14,10,8,11,12,8,12,11,12,12,13,11,10,10,15,4,11,9,11,12,10,13,13,12,12,14,15,13,13,13,6,13,10,12,16,12,4,12,7,8,13,11,20,2,2,1,1,2,2,2,2,2,3,1
"8215",36152916,"Christos Tzolis","1/30/2002 (21 years old)","M/AM (L), ST (C)","Norwich","Sky Bet Championship","GRE","Yes","8/12/2021","6/30/2026","$140K - $8.4M","Right","Reasonable","Very Strong","5'10""","160 lbs","79","9",118,140,8,10,13,13,13,8,7,12,6,6,11,13,7,14,10,13,10,12,9,11,13,15,6,13,6,11,11,13,15,15,12,8,11,13,12,8,10,16,12,15,10,12,10,12,4,2,12,13,8,2,1,1,2,2,1,1,2,1,2,1
"8216",36138739,"Fotis Ioannidis","1/10/2000 (23 years old)","ST (C)","Panathinaikos","Greek Super League 1","GRE","Yes","5/10/2023","6/30/2027","$6M - $7.6M","Right","Reasonable","Very Strong","6'1""","176 lbs","149","24",125,140,6,9,13,12,12,6,12,10,6,10,13,15,7,14,13,12,16,13,10,12,15,13,10,13,9,13,13,15,13,12,15,14,13,13,12,15,6,15,12,15,15,13,7,15,6,6,13,15,9,2,3,2,1,1,2,2,3,3,1,1
"8217",36078574,"Dimitris Giannoulis","10/17/1995 (27 years old)","D/WB/M (L)","Norwich","Sky Bet Championship","GRE","Yes","7/1/2021","6/30/2024","$350K - $9.2M","Left Only","Very Strong","Very Weak","5'10""","156 lbs","245","3",123,140,9,13,13,7,13,10,6,8,11,11,11,8,11,14,14,11,10,13,11,11,14,9,6,12,11,12,11,15,16,14,13,9,16,16,15,8,15,10,11,16,14,13,4,10,13,6,12,16,12,2,2,2,1,3,3,1,2,1,2,3
"8218",29045055,"Jeffrey Schlupp","12/23/1992 (30 years old)","M (LC), AM (L)","Crystal Palace","English Premier Division","GHA","Yes","3/31/2023","6/30/2024","$12.5M - $15.5M","Left","Very Strong","Weak","5'10""","163 lbs","314","32",133,137,9,11,13,13,12,9,10,9,10,11,11,10,11,13,10,12,14,12,11,11,13,12,8,13,12,15,10,15,15,15,13,11,13,15,15,13,18,12,11,13,14,10,13,10,9,9,11,11,16,2,3,1,3,3,3,1,3,2,1,2
"8219",36039032,"Tasos Bakasetas","6/28/1993 (29 years old)","M/AM (C)","Trabzonspor","Turkish Super League","GRE","Yes","1/30/2021","6/30/2024","$10.5M - $16M","Left","Very Strong","Fairly Strong","5'11""","165 lbs","310","72",135,140,13,10,12,13,11,14,11,18,8,7,15,17,8,16,18,12,16,13,14,12,17,14,14,14,8,12,16,13,11,12,14,12,15,11,14,14,10,13,12,16,13,16,9,14,10,4,16,14,18,4,1,2,2,3,2,1,2,1,4,2
"8220",36141840,"Sotiris Alexandropoulos","11/26/2001 (21 years old)","DM, M (C)","Sporting CP","Portuguese Premier League","GRE","Yes","8/29/2022","6/30/2027","$150K - $1.5M","Right","Reasonable","Very Strong","6'1""","156 lbs","76","1",115,140,7,8,12,7,11,8,10,11,7,11,12,7,13,12,14,11,15,11,9,9,15,12,10,11,10,12,10,14,16,15,14,12,12,16,14,10,10,16,15,14,11,16,7,11,10,3,12,15,6,1,3,1,3,1,2,3,3,2,4,4
"8221",36159280,"Giannis Konstantelias","3/5/2003 (20 years old)","AM (RLC)","PAOK","Greek Super League 1","GRE","Yes","2/15/2023","6/30/2027","$750K - $8.8M","Right Only","Weak","Very Strong","5'10""","145 lbs","41","2",115,139,10,10,16,8,16,9,8,7,7,7,13,10,6,17,8,12,7,12,10,12,12,17,7,12,7,10,14,13,12,16,9,8,11,12,11,7,8,16,9,15,15,15,6,13,4,3,13,13,10,1,3,3,1,3,3,3,2,2,2,3
"8222",36078367,"Vasilis Barkas","5/30/1994 (29 years old)","GK","Celtic","cinch Premiership","GRE","Yes","7/31/2020","5/31/2025","$0","Left Only","Very Strong","Weak","6'5""","200 lbs","139","-",129,137,2,1,7,1,7,7,5,3,2,3,11,4,2,8,9,12,13,14,14,13,14,2,10,3,12,12,11,11,9,14,13,18,12,9,10,12,14,11,14,16,9,15,5,10,7,7,12,18,5,13,14,15,11,14,14,12,4,12,11,16
"8223",29063519,"George Baldock","3/9/1993 (30 years old)","D/WB (R)","Sheff Utd","English Premier Division","GRE","Yes","12/12/2020","6/30/2024","$10.5M - $13.5M","Right Only","Weak","Very Strong","5'10""","147 lbs","370","13",127,137,6,11,12,8,13,6,12,8,8,12,12,8,13,13,14,13,15,13,12,13,15,13,11,13,13,14,12,16,14,13,13,12,15,14,15,13,13,11,9,16,11,12,5,10,9,8,13,14,12,3,2,1,3,2,1,3,3,2,1,3
"8224",36105386,"Panos Retsos","8/9/1998 (24 years old)","D (RC)","Hellas Verona","Italian Serie A","GRE","Yes","1/25/2022","6/30/2026","$210K - $2.1M","Right","Reasonable","Very Strong","6'1""","174 lbs","69","1",120,135,3,9,10,6,12,6,13,7,11,13,12,7,13,13,13,12,14,12,10,12,12,8,10,7,13,14,10,12,13,13,13,14,11,14,14,12,15,13,10,14,13,12,15,12,10,5,13,16,13,3,2,2,3,2,2,3,1,2,3,2
"8225",36077389,"Giorgos Giakoumakis","12/9/1994 (28 years old)","ST (C)","Atlanta United","Major League Soccer","GRE","Yes","2/8/2023","12/31/2026","$7.6M - $9.2M","Right","Weak","Very Strong","6'1""","185 lbs","229","85",130,135,6,6,10,16,11,7,13,9,6,5,9,16,8,11,13,17,14,15,13,14,15,13,8,16,7,14,9,14,11,12,16,14,13,13,14,16,5,12,10,15,15,13,9,13,12,4,14,14,13,1,1,3,1,2,1,4,3,2,1,2
"8226",36002122,"Dimitris Siovas","9/16/1988 (34 years old)","D (C)","Fortuna Sittard","Eredivisie","GRE","Yes","6/24/2022","6/30/2024","$80K - $800K","Left","Very Strong","Weak","6'4""","182 lbs","319","11",123,135,6,13,10,7,14,7,15,12,10,14,12,12,14,14,12,13,14,14,13,14,13,12,14,11,14,12,12,13,8,8,14,15,13,9,11,14,13,15,13,10,12,11,9,10,8,9,13,12,13,3,2,1,4,1,2,2,3,3,2,1
"8227",36125561,"Dimitris Stavropoulos","5/1/1997 (26 years old)","D (C)","Warta Poznań","PKO Bank Polski Ekstraklasa","GRE","Yes","7/5/2022","6/30/2024","$450K - $1.3M","Right","Reasonable","Very Strong","6'3""","191 lbs","128","5",111,135,3,4,4,6,7,4,15,6,6,14,6,7,13,7,13,12,13,11,11,9,14,4,12,6,15,11,6,12,11,10,13,16,11,11,12,14,6,15,12,15,10,16,5,12,6,3,13,13,15,2,1,2,1,3,1,2,3,1,3,2
"8228",36090959,"Giorgos Kyriakopoulos","2/5/1996 (27 years old)","D/WB/M/AM (L)","Bologna","Italian Serie A","GRE","Yes","2/18/2022","6/30/2025","$325K - $3.2M","Left","Very Strong","Weak","6'0""","163 lbs","183","6",130,135,12,12,13,10,13,11,8,10,12,11,13,8,13,13,14,12,15,10,10,12,15,12,10,14,12,13,12,14,14,13,14,11,13,14,14,12,12,13,15,15,13,13,4,13,11,8,13,15,16,2,2,2,2,2,2,2,1,1,4,2
"8229",91206169,"Joselpho Barnes","12/12/2001 (21 years old)","AM (R)","Riga","Optibet Virsliga","GHA","Yes","1/1/2022","11/30/2024","$0","Right Only","Weak","Very Strong","6'1""","156 lbs","41","7",114,137,10,14,15,14,10,6,9,10,10,6,14,10,5,12,13,13,10,12,11,8,7,12,6,15,5,11,10,12,15,12,14,10,12,15,13,11,16,19,12,10,12,11,5,10,8,6,8,11,15,1,2,3,1,3,4,4,1,1,1,3
"8230",1806230,"Sotiris Ninis","4/3/1990 (33 years old)","M/AM (C)","PAS Giannina","Greek Super League 1","GRE","Yes","1/1/2023","6/30/2024","$55K - $550K","Right","Fairly Strong","Very Strong","5'8""","152 lbs","234","19",100,135,13,12,12,9,13,14,8,11,6,5,15,12,4,14,8,12,10,13,10,13,8,14,11,10,8,13,15,10,9,12,9,6,9,9,9,8,8,14,15,9,12,11,14,12,12,13,11,8,7,2,3,2,1,3,1,2,3,3,2,1
"8231",36017184,"Kyriakos Papadopoulos","2/23/1992 (31 years old)","D (C)","Lamia","Greek Super League 1","GRE","Yes","5/31/2023","6/30/2024","$150K - $1.5M","Right","Weak","Very Strong","6'1""","191 lbs","209","10",105,135,4,6,7,5,8,4,15,6,12,16,9,4,15,8,17,12,18,8,7,8,16,4,12,7,13,12,6,14,10,7,14,14,10,11,10,16,3,4,7,10,13,12,15,16,14,14,11,13,12,3,1,2,3,2,1,3,1,1,3,3
"8232",36151881,"Vasilis Zagaritis","5/4/2001 (22 years old)","D/WB (L)","Parma","Italian Serie B","GRE","Yes","1/22/2021","6/30/2024","$1.7M - $3.6M","Left Only","Very Strong","Weak","5'10""","149 lbs","39","-",120,134,10,13,13,8,12,9,10,8,12,10,11,10,13,12,13,14,12,12,12,12,15,9,7,13,10,14,11,15,14,13,14,10,14,14,14,11,14,15,14,15,11,9,7,12,8,6,12,16,12,4,1,2,3,2,3,2,2,2,3,3
"8233",2000091483,"Dimitris Kaloskamis","3/1/2005 (18 years old)","AM (C)","Panathinaikos","Greek Super League 1","GRE","Yes","7/1/2021","6/30/2024","$70K - $700K","Right","Strong","Very Strong","5'10""","149 lbs","-","-",80,134,7,7,14,10,11,7,9,8,6,7,11,2,9,11,7,6,8,6,8,7,13,8,7,11,9,8,8,8,13,13,4,8,12,14,9,6,11,11,11,12,10,10,11,12,11,8,10,11,9,3,1,3,2,2,1,3,2,3,2,3
"8234",36160107,"Apostolis Konstantopoulos","8/2/2002 (20 years old)","D (C)","Beerschot","Belgian Challenger Pro League","GRE","Yes","7/1/2021","6/30/2025","$60K - $600K","Right Only","Weak","Very Strong","6'2""","174 lbs","58","2",97,133,4,5,7,5,12,5,14,4,9,14,11,6,14,6,12,13,14,10,12,11,12,6,9,9,12,10,8,13,9,8,11,14,13,9,12,10,15,8,9,12,9,13,10,11,6,8,11,15,11,1,3,2,3,2,1,1,1,3,2,3
"8235",36045542,"Charalampos Lykogiannis","10/22/1993 (29 years old)","D (LC), WB (L)","Bologna","Italian Serie A","GRE","Yes","7/1/2022","6/30/2024","$650K","Left Only","Very Strong","Weak","6'3""","180 lbs","242","14",122,133,13,16,11,8,11,14,14,15,14,12,10,10,12,12,12,13,12,13,11,12,12,10,9,13,12,13,10,12,12,12,14,13,14,14,13,14,12,9,10,14,14,13,8,12,14,6,13,12,12,1,2,1,1,1,1,2,1,3,1,1
"8236",37053040,"Pantelis Hatzidiakos","1/18/1997 (26 years old)","D (RC)","AZ","Eredivisie","GRE","Yes","6/21/2020","6/30/2024","$275K - $2.8M","Right","Fairly Strong","Very Strong","6'0""","163 lbs","175","3",127,133,5,6,10,6,13,5,12,5,6,12,11,7,13,12,14,13,13,13,14,10,16,10,14,11,15,16,12,15,13,13,14,14,15,13,15,13,12,12,15,16,8,17,5,7,6,6,13,13,14,3,3,1,3,3,1,2,1,2,2,1
"8237",36146763,"Nikos Michelis","3/23/2001 (22 years old)","D (C), DM","Mirandés","Spanish Second Division","GRE","Yes","8/7/2022","6/30/2025","$22K - $230K","Left","Very Strong","Weak","6'4""","156 lbs","30","-",105,133,7,7,8,7,10,7,13,8,8,13,11,8,12,12,13,13,13,10,11,10,13,7,10,7,13,13,11,12,11,8,13,15,14,12,12,12,14,14,14,15,12,11,7,5,12,4,13,16,14,1,1,2,1,3,3,3,3,1,2,1
"8238",91014707,"Thanos Petsos","6/5/1991 (32 years old)","DM, M (C)","Riga","Optibet Virsliga","GRE","Yes","1/26/2022","11/30/2023","$7K - $65K","Right","Weak","Very Strong","6'0""","176 lbs","248","11",102,132,8,8,9,8,11,13,12,13,12,12,12,8,13,12,11,11,15,12,12,11,13,9,12,8,12,14,11,12,9,9,14,12,12,11,12,13,12,10,12,10,10,12,6,14,10,12,13,8,7,2,1,1,1,3,2,2,2,3,4,2
"8239",36045569,"Manolis Siopis","5/14/1994 (29 years old)","DM, M (C)","Trabzonspor","Turkish Super League","GRE","Yes","8/18/2021","6/30/2024","$0","Right","Weak","Very Strong","5'7""","152 lbs","261","1",125,131,7,9,12,4,12,10,7,6,7,16,13,6,13,11,18,15,16,12,14,13,16,6,13,10,13,15,11,18,14,15,10,6,16,12,15,11,12,13,12,16,12,12,5,13,9,6,13,13,18,2,2,1,1,1,3,3,1,2,1,2
"8240",13200569,"Ibrahim Sadiq","5/7/2000 (23 years old)","AM (RL), ST (C)","BK Häcken","Swedish Premier Division","GHA","No","2/18/2022","12/31/2025","$4.3M - $8.2M","Right","Weak","Very Strong","5'6""","143 lbs","88","18",122,137,8,11,13,12,13,9,4,11,7,4,11,11,7,13,13,12,12,12,12,12,12,13,6,13,7,13,10,13,16,12,8,6,11,15,12,8,10,7,8,10,7,11,14,11,12,12,12,12,13,2,1,3,2,1,2,2,1,3,1,1
"8241",36045448,"Kostas Stafylidis","12/2/1993 (29 years old)","D (RL), WB (L), DM","VfL Bochum","Bundesliga","GRE","Yes","7/1/2022","6/30/2025","$350K - $3.4M","Left","Very Strong","Reasonable","5'10""","163 lbs","186","8",120,130,12,12,11,7,12,13,9,10,14,12,12,8,15,12,16,13,15,12,13,12,16,8,12,11,13,15,11,14,12,11,15,9,8,12,12,12,17,8,9,12,14,12,15,12,13,8,12,12,13,3,1,3,2,1,2,4,2,2,4,1
"8242",36141838,"Giorgos Vagiannidis","9/12/2001 (21 years old)","D/WB/M (R)","Panathinaikos","Greek Super League 1","GRE","Yes","9/3/2021","6/30/2025","$180K - $9M","Right","Reasonable","Very Strong","6'0""","149 lbs","35","1",115,130,8,11,12,7,11,7,10,7,10,11,10,7,10,11,11,10,11,10,9,9,13,9,8,13,9,10,9,14,15,15,10,10,15,16,13,7,12,14,13,13,10,10,8,12,6,9,14,16,9,2,3,3,3,1,1,2,1,1,2,2
"8243",694238,"Lazaros Christodoulopoulos","12/19/1986 (36 years old)","AM (RLC)","Aris","Greek Super League 1","GRE","Yes","2/7/2023","6/30/2024","$55K - $550K","Right","Weak","Very Strong","6'0""","169 lbs","355","57",115,130,13,14,14,12,14,15,12,14,5,6,14,15,7,15,10,14,12,12,11,12,14,14,12,13,7,10,14,9,11,12,14,10,15,12,10,11,10,9,8,15,13,6,12,16,12,15,11,15,16,3,3,1,3,3,1,3,3,2,2,1
"8244",36055197,"Taxiarchis Fountas","9/4/1995 (27 years old)","AM (RLC), ST (C)","D.C. United","Major League Soccer","GRE","Yes","3/21/2022","12/31/2024","$3.7M - $7.4M","Right","Reasonable","Very Strong","5'7""","143 lbs","267","70",125,130,7,8,12,13,10,9,6,10,6,8,11,11,7,13,11,12,11,10,9,11,12,13,8,14,5,12,9,12,17,16,9,6,13,14,12,7,13,6,8,13,10,10,9,12,10,13,11,15,12,3,2,2,2,1,2,4,4,2,3,2
"8245",36004439,"Giorgos Tzavellas","11/26/1987 (35 years old)","D (C)","AEK","Greek Super League 1","GRE","Yes","7/1/2021","6/30/2024","$7K - $75K","Left Only","Very Strong","Weak","6'0""","178 lbs","360","20",115,130,9,12,11,8,12,12,13,11,13,12,13,11,12,12,15,14,15,12,12,12,15,10,14,9,14,14,14,14,10,10,13,12,18,10,11,14,13,6,7,15,15,12,4,15,14,14,13,15,15,2,2,1,3,2,2,3,1,3,1,3
"8246",1800872,"Stefanos Athanasiadis","12/24/1988 (34 years old)","ST (C)","Anagennisi Karditsas","Greek Super League 2 North","GRE","Yes","8/18/2021","6/30/2024","$0 - $45K","Right","Reasonable","Very Strong","6'1""","163 lbs","304","83",95,130,4,6,9,13,12,7,14,6,6,9,10,13,8,11,9,12,11,12,9,10,6,12,12,14,10,13,9,6,11,10,12,13,10,11,9,10,9,10,12,9,14,15,6,13,12,14,11,9,8,3,4,1,3,3,1,3,3,4,2,3
"8247",91155708,"Christos Albanis","11/5/1994 (28 years old)","AM (RL)","F.C. Andorra","Spanish Second Division","GRE","Yes","9/1/2022","6/30/2025","$150K - $1.5M","Right","Reasonable","Very Strong","6'0""","176 lbs","222","40",118,130,9,12,15,10,15,8,9,11,3,7,12,10,8,15,8,11,10,10,9,10,12,13,8,12,8,11,13,12,13,13,13,12,11,14,12,12,13,15,15,14,10,13,12,11,4,3,9,11,10,2,1,3,2,3,2,2,2,3,3,1
"8248",36035173,"Petros Mantalos","8/31/1991 (31 years old)","M (C), AM (LC)","AEK","Greek Super League 1","GRE","Yes","6/14/2021","6/30/2024","$4.5M - $8.6M","Right","Reasonable","Very Strong","5'9""","160 lbs","306","48",125,130,14,14,13,10,14,13,10,11,5,9,15,13,8,15,10,13,11,12,11,12,14,13,14,12,9,14,16,13,12,13,12,7,12,12,13,8,10,11,12,16,10,16,8,11,12,6,12,12,11,2,1,2,2,3,3,3,2,1,1,2
"8249",36037081,"Giannis Fetfatzidis","12/21/1990 (32 years old)","AM (RLC)","SPAL","Italian Serie C/B","GRE","Yes","1/23/2023","6/30/2024","$230K - $650K","Left Only","Very Strong","Weak","5'5""","127 lbs","267","43",110,130,12,10,14,8,15,12,7,8,5,6,13,13,5,16,8,12,8,9,9,9,11,15,8,14,6,11,13,12,14,15,12,6,9,13,11,7,8,15,12,14,7,14,7,9,6,6,10,14,12,3,3,3,2,4,2,3,3,3,3,2
"8250",92102720,"Stelios Kokovas","7/6/2001 (21 years old)","D (L)","Karviná","Czech Third Division MSFL","GRE","Yes","1/11/2021","12/31/2023","$130K - $1.3M","Left","Very Strong","Fairly Strong","6'1""","171 lbs","48","3",90,130,10,11,10,8,10,9,11,9,9,11,11,8,11,10,11,11,10,8,11,7,11,11,9,11,12,12,13,12,10,12,11,12,11,11,12,11,11,11,12,12,11,12,7,11,7,11,11,13,11,2,3,4,3,3,4,1,1,2,1,1
"8251",43068478,"Caleb Ekuban","3/23/1994 (29 years old)","AM (RC), ST (C)","Genoa","Italian Serie A","GHA","Yes","8/8/2021","6/30/2024","$350K - $3.4M","Right","Reasonable","Very Strong","6'0""","176 lbs","266","52",120,137,5,10,13,11,11,5,12,8,3,4,13,12,5,13,14,10,13,11,12,11,11,10,10,12,7,14,12,13,15,13,13,13,15,15,13,14,14,7,15,15,6,8,9,12,6,3,12,12,11,1,1,3,2,3,1,2,3,2,1,1
"8252",2000054441,"Panagiotis Anastasopoulos","10/24/2003 (19 years old)","D (LC)","Panetolikos","Greek Super League 1","GRE","Yes","8/30/2022","6/30/2025","$190K - $550K","Left","Very Strong","Reasonable","6'0""","158 lbs","1","-",75,130,5,6,7,6,9,5,8,6,7,10,9,6,10,8,13,8,14,11,9,7,11,11,8,11,8,9,11,12,10,12,11,12,11,8,11,12,8,7,13,11,10,12,8,11,7,8,10,12,10,2,2,3,3,2,3,1,4,3,1,1
"8253",51012751,"Jesús Corona","1/6/1993 (30 years old)","WB/M (R), AM (RL)","Sevilla","Spanish First Division","MEX","Yes","1/13/2022","6/30/2025","$375K - $3.7M","Right","Strong","Very Strong","5'8""","145 lbs","302","41",141,160,13,13,18,10,16,10,5,8,9,6,15,10,11,17,13,12,11,11,10,12,14,18,10,12,8,8,16,13,13,14,10,4,13,14,12,6,12,8,10,12,14,11,10,15,12,10,11,13,11,1,3,3,3,1,4,3,1,1,3,3
"8254",51000001,"Carlos Vela","3/1/1989 (34 years old)","AM (RLC), ST (C)","LAFC","Major League Soccer","MEX","No","6/28/2022","12/31/2023","$700K - $1.5M","Left Only","Very Strong","Weak","5'10""","163 lbs","463","158",130,160,13,14,16,15,16,14,8,13,1,4,15,14,5,17,10,14,12,13,10,11,11,17,13,16,8,9,15,7,13,16,12,7,7,13,9,7,13,13,14,9,13,7,13,14,6,7,8,8,11,3,4,1,1,1,1,2,3,3,3,3
"8255",51078596,"Jesús Hernández","1/9/2004 (19 years old)","ST (C)","Tijuana","Mexican First Division","MEX","No","7/1/2022","6/30/2025","$350K - $3.4M","Right","Reasonable","Very Strong","6'0""","156 lbs","6","-",88,159,8,8,9,12,11,9,11,8,8,8,10,10,8,11,9,10,9,9,11,12,15,9,8,12,10,9,8,10,10,10,10,11,8,9,9,10,9,9,12,12,10,12,8,9,7,7,10,12,13,2,1,2,2,3,1,1,4,1,2,3
"8256",51072223,"Jordan Carrillo","11/30/2001 (21 years old)","M (C), AM (LC)","S. Gijón","Spanish Second Division","MEX","No","2/20/2021","6/30/2025","$350K - $3.4M","Right","Reasonable","Very Strong","5'6""","138 lbs","53","3",109,157,8,9,14,8,12,8,7,10,7,7,12,8,7,14,12,11,8,10,9,10,15,14,8,11,12,12,13,11,14,14,12,5,10,14,11,9,11,9,12,12,11,11,10,10,9,8,11,14,12,1,1,3,2,1,4,2,1,4,1,1
"8257",51001380,"Chicharito","6/1/1988 (35 years old)","ST (C)","LA Galaxy","Major League Soccer","MEX","No","11/14/2022","12/31/2023","$80K - $800K","Right","Fairly Strong","Very Strong","5'9""","160 lbs","383","152",128,156,7,9,10,16,12,8,13,11,5,5,9,15,6,11,12,17,14,16,15,9,16,9,11,17,7,9,8,9,13,15,11,8,14,12,13,10,5,12,12,18,16,12,13,14,6,5,13,14,14,3,2,1,1,1,1,1,3,1,2,4
"8258",51067947,"Santiago Giménez","4/18/2001 (22 years old)","ST (C)","Feyenoord","Eredivisie","MEX","No","7/29/2022","6/30/2027","$50M - $63M","Left","Very Strong","Fairly Strong","6'0""","152 lbs","111","33",140,155,8,8,12,16,14,8,14,11,9,6,13,14,5,13,10,14,14,15,14,14,15,14,12,15,6,13,13,16,13,13,15,12,13,13,14,11,8,12,13,14,13,13,7,15,11,8,12,16,14,3,3,1,1,3,4,3,1,3,1,2
"8259",51013463,"Raúl Jiménez","5/5/1991 (32 years old)","ST (C)","Wolves","English Premier Division","MEX","No","6/14/2021","6/30/2025","$5.2M - $6.4M","Right","Fairly Strong","Very Strong","6'3""","167 lbs","385","119",135,155,6,11,13,13,12,8,13,13,6,8,13,20,9,14,17,13,13,14,14,12,16,9,8,14,10,15,11,16,13,12,14,15,14,13,12,13,12,15,14,17,13,14,11,11,8,6,13,10,10,1,3,3,2,2,1,1,1,4,2,1
"8260",51054011,"Edson Álvarez","10/24/1997 (25 years old)","D (C), DM, M (C)","Ajax","Eredivisie","MEX","No","6/14/2021","6/30/2027","$31M - $39M","Right","Reasonable","Very Strong","6'1""","160 lbs","195","16",150,155,5,7,8,11,14,6,14,8,9,15,14,11,15,13,19,16,16,14,15,14,13,12,14,13,14,16,14,16,12,13,15,15,15,12,16,12,14,11,10,14,12,12,4,13,14,10,15,13,13,2,3,2,3,3,2,1,2,1,2,2
"8261",51031039,"Rodolfo Pizarro","2/15/1994 (29 years old)","AM (LC)","Inter Miami","Major League Soccer","MEX","No","2/17/2020","12/31/2024","$275K - $2.7M","Right","Reasonable","Very Strong","5'8""","160 lbs","387","58",125,155,12,12,15,10,14,11,8,12,6,9,13,12,8,16,10,13,10,12,11,12,8,15,12,14,13,11,15,10,13,14,14,7,10,12,11,11,15,12,9,9,9,8,7,15,6,10,9,8,8,1,1,1,3,1,1,2,2,2,2,2
"8262",13129289,"Lawrence Zigi","11/29/1996 (26 years old)","GK","St. Gallen","Swiss Super League","GHA","No","9/14/2022","6/30/2025","$5.4M - $10M","Right","Strong","Very Strong","6'2""","191 lbs","178","-",132,137,6,2,2,3,8,7,10,2,2,1,12,3,3,8,8,13,16,12,12,12,13,8,9,2,13,10,6,10,9,11,14,16,13,8,10,14,13,14,13,12,9,13,7,14,10,8,13,9,13,13,18,16,7,14,14,13,8,13,13,14
"8263",2000131736,"Heriberto Jurado","1/3/2005 (18 years old)","AM (L)","Necaxa","Mexican First Division","MEX","No","7/1/2020","6/30/2024","$130K - $8.2M","Left","Very Strong","Reasonable","5'8""","138 lbs","40","1",92,155,9,10,15,9,11,5,7,8,6,4,11,2,5,12,8,8,10,11,10,9,12,12,9,11,10,10,12,10,12,14,11,7,13,11,11,8,11,14,9,13,11,9,12,7,7,8,9,14,20,3,1,2,1,3,3,1,2,1,2,3
"8264",5664830,"Héctor Herrera","4/19/1990 (33 years old)","DM, M (C)","Houston","Major League Soccer","MEX","Yes","7/1/2022","12/31/2024","Not for Sale","Right","Fairly Strong","Very Strong","5'10""","158 lbs","414","55",150,153,14,12,13,10,13,14,12,13,10,11,16,12,14,14,14,15,16,15,14,15,14,11,16,14,14,15,14,15,12,13,15,13,16,12,14,14,14,12,12,15,16,12,8,15,11,6,16,14,14,1,2,3,2,1,3,2,1,1,1,2
"8265",51042313,"Hirving Lozano","7/30/1995 (27 years old)","AM (RL), ST (C)","Parthenope","Italian Serie A","MEX","No","6/14/2021","6/30/2024","$16M - $19.5M","Right","Reasonable","Very Strong","5'9""","154 lbs","302","90",146,153,9,13,14,14,15,12,12,12,7,4,14,14,8,15,12,14,9,15,10,13,12,16,7,16,6,11,13,12,16,15,11,9,13,16,12,7,14,14,12,16,11,12,11,13,10,6,12,14,10,1,2,1,2,1,2,2,3,2,1,2
"8266",51080920,"Bryan González","4/10/2003 (20 years old)","M/AM (L)","Pachuca","Mexican First Division","MEX","No","7/1/2021","6/30/2025","$325K - $3.2M","Left","Very Strong","Reasonable","5'10""","156 lbs","36","2",95,152,8,11,12,11,10,7,8,9,9,8,10,10,8,13,9,10,10,9,9,11,13,9,8,10,9,9,10,10,12,13,10,10,9,12,10,10,10,8,10,10,9,10,8,10,7,8,12,12,10,1,3,3,2,1,4,1,3,1,1,1
"8267",51063650,"Erick Sánchez","9/27/1999 (23 years old)","M (C)","Pachuca","Mexican First Division","MEX","No","6/15/2020","12/31/2023","$750K - $10M","Right","Reasonable","Very Strong","5'6""","136 lbs","152","13",137,150,10,12,11,12,14,7,7,8,13,12,14,11,13,14,13,13,13,12,12,13,12,10,13,12,11,11,13,13,15,14,9,8,11,12,15,12,13,14,10,11,10,10,6,14,14,2,14,13,12,1,3,4,2,4,3,2,3,2,3,2
"8268",51078642,"Víctor Guzmán","3/7/2002 (21 years old)","D (C)","Monterrey","Mexican First Division","MEX","No","1/2/2023","6/30/2025","$800K - $9M","Right","Fairly Strong","Very Strong","5'11""","165 lbs","88","2",127,150,9,12,8,8,12,10,13,10,12,15,15,11,15,14,12,15,13,15,14,13,11,9,13,14,14,15,14,11,9,11,13,12,9,12,13,12,8,11,12,13,14,11,5,11,11,9,14,14,15,3,2,1,1,2,3,1,1,1,3,1
"8269",51000344,"Miguel Layún","6/25/1988 (34 years old)","D/WB (RL), M (R)","América","Mexican First Division","MEX","Yes","7/1/2021","12/31/2023","$16K - $160K","Right","Fairly Strong","Very Strong","5'11""","167 lbs","423","28",122,149,16,12,11,10,11,12,6,13,11,9,13,15,10,13,12,11,14,13,11,10,12,10,14,12,10,13,11,12,14,13,11,8,10,13,11,9,18,4,8,17,15,13,4,11,9,16,11,13,16,2,1,3,3,3,2,3,1,2,3,1
"8270",51072114,"Eduardo García","7/11/2002 (20 years old)","GK","Tapatío","Mexican Expansion League","MEX","No","6/12/2023","6/30/2026","$45K - $7.4M","Right Only","Weak","Very Strong","5'8""","147 lbs","37","-",103,148,4,3,3,2,6,5,1,2,3,2,11,2,2,8,5,12,15,8,11,13,18,3,10,3,12,10,9,8,12,10,9,13,10,14,7,17,10,19,11,11,13,10,9,12,13,1,14,12,15,11,9,12,10,11,10,13,10,9,10,9
"8271",51042458,"Luis Romo","6/5/1995 (28 years old)","D (C), DM, M (C)","Monterrey","Mexican First Division","MEX","No","1/2/2022","12/31/2025","$800K - $11.5M","Right","Reasonable","Very Strong","6'0""","180 lbs","199","26",136,148,6,12,8,11,13,6,11,12,11,12,13,10,12,13,9,13,13,15,13,14,14,12,13,13,12,14,14,16,12,10,15,11,14,14,17,12,16,18,13,15,14,13,4,13,12,6,16,12,13,4,3,1,3,4,1,3,1,3,1,2
"8272",5666492,"Guillermo Ochoa","7/13/1985 (37 years old)","GK","Salernitana","Italian Serie A","MEX","Yes","1/2/2023","6/30/2024","$180K - $1.8M","Right","Weak","Very Strong","6'0""","171 lbs","615","-",137,148,4,4,3,3,10,7,7,7,14,6,10,8,13,9,7,12,12,13,15,12,16,6,16,5,16,11,7,11,10,16,8,15,17,10,14,12,1,14,18,19,15,12,7,16,7,10,14,13,15,10,7,17,13,16,13,14,15,14,10,11
"8273",13107111,"Frank Acheampong","10/16/1993 (29 years old)","D/WB/M/AM (L), ST (C)","Shenzhen","Chinese Super League","GHA","No","1/1/2021","12/31/2024","$550K - $4.9M","Left Only","Very Strong","Weak","5'6""","147 lbs","315","79",133,136,8,9,14,12,12,9,7,12,5,8,12,14,9,13,8,10,15,13,11,12,12,11,5,14,6,11,7,12,18,11,11,6,13,17,10,10,9,10,14,8,10,11,4,12,5,4,12,11,8,2,3,1,2,1,2,2,1,2,1,1
"8274",51067299,"Jonathan González","4/13/1999 (24 years old)","DM, M (C)","Monterrey","Mexican First Division","MEX","No","1/2/2023","6/30/2024","$45K - $450K","Right","Fairly Strong","Very Strong","5'6""","136 lbs","110","2",108,148,7,6,9,7,11,4,10,4,6,16,10,7,13,12,7,13,15,12,13,10,15,12,10,10,12,14,9,17,13,15,12,7,15,14,16,8,13,15,12,11,11,10,12,17,5,2,13,15,14,3,3,1,2,4,2,3,2,1,2,3
"8275",51055610,"César Montes","2/24/1997 (26 years old)","D (C)","Espanyol","Spanish Second Division","MEX","No","1/1/2023","6/30/2028","$8.8M - $13.5M","Right Only","Weak","Very Strong","6'3""","154 lbs","254","16",141,148,8,12,7,6,11,7,15,9,14,16,11,11,14,14,9,16,13,15,15,15,15,8,8,7,15,13,13,14,12,13,14,15,14,14,13,9,8,13,12,15,12,15,13,14,8,8,16,12,13,1,3,3,3,2,1,2,3,3,1,2
"8276",51060128,"Sebastián Córdova","6/12/1997 (26 years old)","AM (RLC)","Tigres","Mexican First Division","MEX","No","12/21/2021","6/30/2025","$4.8M - $7.2M","Either","Very Strong","Very Strong","5'8""","136 lbs","158","31",137,148,14,13,13,11,13,12,8,13,12,6,14,13,9,15,10,11,8,13,12,14,10,15,10,15,8,12,16,13,13,13,11,7,9,12,11,6,14,12,12,10,11,13,9,13,5,8,11,8,10,4,2,3,4,1,3,2,4,2,2,1
"8277",51049626,"Carlos Acevedo","4/19/1996 (27 years old)","GK","Santos Laguna","Mexican First Division","MEX","No","3/18/2021","6/30/2027","$900K - $10M","Right Only","Weak","Very Strong","6'0""","163 lbs","125","1",134,148,3,3,4,3,11,7,1,12,1,5,10,3,1,11,5,13,15,11,10,13,5,3,9,1,12,13,10,12,14,17,14,14,14,13,8,12,11,9,18,17,12,10,14,11,5,2,12,10,19,14,11,17,14,13,8,12,4,12,12,14
"8278",51000042,"Héctor Moreno","1/17/1988 (35 years old)","D (C)","Monterrey","Mexican First Division","MEX","Yes","1/31/2021","12/31/2023","$85K - $850K","Left","Very Strong","Reasonable","6'0""","176 lbs","434","30",130,148,8,7,9,5,13,10,15,9,11,15,13,6,14,13,15,13,14,14,14,14,13,14,13,7,15,16,13,15,12,10,14,11,14,12,15,13,12,11,8,15,12,15,10,16,12,7,18,14,14,2,2,3,3,2,3,2,3,2,2,3
"8279",51054788,"Alexis Vega","11/25/1997 (25 years old)","AM (RLC), ST (C)","Chivas","Mexican First Division","MEX","No","6/15/2020","12/31/2025","$6.8M - $10.5M","Right","Reasonable","Very Strong","5'8""","158 lbs","189","38",137,148,10,11,15,14,13,13,13,14,7,5,12,11,7,15,13,14,13,12,13,11,11,12,14,13,9,11,10,12,14,13,13,13,10,13,12,14,12,16,11,9,10,14,15,13,10,7,12,10,12,2,2,1,3,2,2,2,2,1,4,1
"8280",67038643,"Jonathan dos Santos","4/26/1990 (33 years old)","DM, M (C)","América","Mexican First Division","MEX","Yes","12/23/2021","12/31/2023","$40K - $375K","Right","Reasonable","Very Strong","5'8""","149 lbs","323","17",119,148,16,15,11,8,14,10,9,14,8,12,16,12,11,14,14,13,13,12,12,13,11,9,12,10,11,13,14,12,13,12,13,7,9,11,11,12,12,9,10,10,12,12,16,10,13,13,11,11,10,2,2,2,1,2,2,3,3,2,3,3
"8281",5667723,"Andrés Guardado","9/28/1986 (36 years old)","DM, M/AM (LC)","Real Hispalis","Spanish First Division","MEX","Yes","3/24/2022","6/30/2024","$140K - $1.4M","Left","Very Strong","Weak","5'7""","132 lbs","497","38",139,148,12,12,11,10,14,12,6,13,10,9,16,17,12,14,13,11,17,13,14,13,17,12,15,15,12,15,15,16,12,13,14,8,13,12,12,11,13,15,12,18,18,15,14,12,8,8,13,14,11,1,2,1,3,3,1,1,1,2,2,4
"8282",51011883,"Néstor Araujo","8/29/1991 (31 years old)","D (C)","América","Mexican First Division","MEX","No","7/1/2022","6/30/2025","Not for Sale","Right","Reasonable","Very Strong","6'2""","191 lbs","348","7",128,148,6,7,8,5,13,7,10,9,12,14,13,11,13,13,8,11,13,13,13,13,13,9,13,9,15,13,12,12,13,12,12,14,12,12,14,14,9,12,13,14,12,13,7,13,6,5,11,12,13,3,2,2,1,1,2,4,2,1,3,1
"8283",2000131671,"Rodrigo Huescas","9/18/2003 (19 years old)","ST (C)","Cruz Azul","Mexican First Division","MEX","No","7/1/2020","6/30/2024","$400K - $4.1M","Right","Reasonable","Very Strong","5'9""","152 lbs","40","4",104,148,9,10,12,11,12,11,11,11,11,8,12,11,7,13,10,12,7,12,11,12,6,9,12,12,11,12,10,13,13,13,12,10,10,9,10,8,11,12,11,10,11,10,14,17,8,4,8,12,15,1,1,2,3,1,3,3,4,1,2,2
"8284",83209641,"Aziz Yakubu","5/10/1998 (25 years old)","ST (C)","WH Three Towns","Chinese Super League","GHA","No","7/1/2022","6/30/2025","$2.9M - $6M","Right","Weak","Very Strong","6'2""","176 lbs","136","51",127,136,5,7,12,15,11,6,12,12,6,5,10,11,5,11,13,13,14,12,11,10,13,11,8,11,7,9,12,12,16,14,15,14,16,16,13,14,9,12,11,11,8,10,10,13,4,5,12,11,10,2,2,2,1,3,3,3,1,3,4,1
"8285",2000129885,"Joshua Mancha","10/5/2004 (18 years old)","M (RL), AM (RLC), ST (C)","Santos Laguna","Mexican First Division","MEX","No","6/13/2022","6/30/2026","$10K - $30K","Right","Reasonable","Very Strong","5'8""","149 lbs","2","-",92,147,10,10,9,10,7,7,8,10,6,8,11,11,6,9,10,8,9,12,9,11,13,12,10,14,9,9,11,10,12,9,10,6,14,11,12,7,10,12,12,12,13,10,5,10,8,8,10,11,13,2,1,4,2,2,2,2,3,3,1,2
"8286",51078456,"Fidel Ambríz","3/21/2003 (20 years old)","DM, M (C)","León","Mexican First Division","MEX","No","1/1/2022","6/30/2024","$7.6M - $11.5M","Right","Reasonable","Very Strong","5'11""","145 lbs","65","4",124,147,10,11,13,11,14,11,9,10,12,12,14,10,12,16,8,13,9,12,12,14,10,5,13,14,12,12,12,15,14,12,12,10,10,14,12,12,10,9,8,9,9,9,5,12,5,5,12,12,9,1,1,3,3,2,2,3,3,1,1,2
"8287",51078457,"Saúl Zamora","3/26/2003 (20 years old)","M (C)","León","Mexican First Division","MEX","No","7/1/2019","6/30/2028","$0","Left","Very Strong","Reasonable","5'8""","149 lbs","2","-",83,147,9,9,8,8,11,8,8,11,12,10,12,9,10,10,6,9,8,14,10,9,2,5,12,11,8,9,10,12,8,11,10,8,12,8,9,9,7,14,13,10,13,9,7,4,6,2,20,13,10,1,2,3,1,2,1,3,3,1,2,2
"8288",51063318,"Diego Lainez","6/9/2000 (23 years old)","AM (RL)","Tigres","Mexican First Division","MEX","Yes","1/31/2023","6/30/2027","$11M - $16.5M","Left","Very Strong","Reasonable","5'6""","132 lbs","119","6",124,147,10,11,16,9,11,8,5,7,9,4,12,10,5,15,10,11,15,11,11,9,15,15,7,11,4,10,13,14,16,15,13,5,13,14,15,6,14,13,12,13,14,11,9,13,6,5,11,14,13,3,3,1,3,3,1,1,1,2,3,3
"8289",51063413,"César Huerta","12/3/2000 (22 years old)","AM (RL)","Pumas","Mexican First Division","MEX","No","7/1/2022","6/30/2025","$6.4M - $7.8M","Right","Reasonable","Very Strong","5'8""","154 lbs","116","12",130,147,5,10,15,14,11,7,7,15,6,3,13,11,4,14,15,10,9,12,9,12,12,16,9,13,6,11,13,13,15,14,10,7,13,14,14,8,15,10,13,13,8,11,9,11,5,7,13,13,14,2,2,2,2,3,2,2,3,3,2,1
"8290",2000030216,"Omar Campos","7/20/2002 (20 years old)","D/WB/M (L)","Santos Laguna","Mexican First Division","MEX","No","9/14/2021","6/30/2025","$8.4M - $13M","Left","Very Strong","Reasonable","5'9""","143 lbs","88","3",127,147,7,12,15,8,8,5,7,8,5,12,11,8,11,13,12,15,14,11,12,13,8,13,8,13,8,13,12,13,17,16,12,12,11,13,13,8,14,8,13,11,14,11,10,11,8,7,14,16,14,3,1,3,2,3,1,3,1,1,2,3
"8291",51072604,"Marcel Ruiz","10/26/2000 (22 years old)","DM, M (C)","Toluca","Mexican First Division","MEX","No","7/1/2022","6/30/2025","$4.5M - $6.8M","Right","Weak","Very Strong","5'11""","149 lbs","138","13",129,146,14,15,14,14,14,13,11,9,10,9,14,8,8,15,11,13,10,13,14,14,12,15,7,14,11,12,14,13,15,15,11,11,16,14,14,9,12,10,12,12,9,9,9,10,12,9,13,11,10,2,2,3,1,1,2,3,1,1,4,1
"8292",2000130682,"Jorge Ruvalcaba","7/23/2001 (21 years old)","M/AM (L)","Pumas","Mexican First Division","MEX","No","7/1/2020","12/31/2027","$60K - $600K","Right","Reasonable","Very Strong","5'11""","138 lbs","35","5",106,145,12,13,13,13,11,10,11,13,12,8,12,10,7,14,12,11,14,12,12,12,9,12,8,12,12,12,9,10,14,15,11,9,16,7,13,8,11,12,10,13,9,12,11,14,8,3,11,10,18,3,2,3,1,3,1,2,3,2,2,2
"8293",51063399,"José Juan Macías","9/22/1999 (23 years old)","AM (L), ST (C)","Chivas","Mexican First Division","MEX","No","7/1/2020","6/30/2024","$300K - $3M","Right","Fairly Strong","Very Strong","5'10""","160 lbs","156","63",123,145,8,8,12,15,14,9,10,14,4,6,11,11,6,15,5,14,8,13,13,13,16,13,6,14,8,10,13,10,14,13,12,10,13,12,14,9,7,18,12,12,13,12,11,13,7,16,13,18,12,2,3,3,2,2,1,2,4,2,3,1
"8294",51073017,"Erik Lira","5/8/2000 (23 years old)","M/AM (C)","Cruz Azul","Mexican First Division","MEX","No","7/1/2021","1/1/2026","$4.5M - $8.8M","Right","Reasonable","Very Strong","5'7""","136 lbs","92","-",132,145,13,12,10,10,15,10,9,13,12,14,14,10,12,14,13,14,14,16,15,15,10,14,15,15,15,14,15,14,11,12,12,8,9,11,11,7,12,17,12,13,10,12,15,9,13,5,13,13,11,1,4,1,3,3,2,4,2,1,2,2
"8295",91179959,"Daniel-Kofi Kyereh","3/8/1996 (27 years old)","M (C), AM (RLC), ST (C)","SC Freiburg","Bundesliga","GHA","Yes","7/1/2022","6/30/2025","$800K - $5.6M","Right","Reasonable","Very Strong","5'10""","163 lbs","199","60",132,136,13,11,15,12,14,15,11,12,6,8,13,10,8,16,13,12,9,13,11,12,12,17,7,12,8,12,13,12,14,15,12,9,10,14,13,9,13,12,12,12,12,10,14,11,9,7,13,15,8,2,2,1,2,2,3,2,2,3,1,1
"8296",51070655,"Kevin Álvarez","1/15/1999 (24 years old)","D (R)","Pachuca","Mexican First Division","MEX","No","6/15/2020","6/30/2028","$8.2M - $10.5M","Right","Reasonable","Very Strong","5'9""","138 lbs","154","6",133,145,10,13,14,8,11,9,11,8,13,12,14,8,14,15,13,13,13,11,12,14,12,7,13,14,13,10,12,12,14,14,12,10,18,14,15,11,12,11,10,11,10,12,11,14,10,5,13,13,11,2,1,3,1,4,2,1,2,3,1,1
"8297",72053642,"Julián Araujo","8/13/2001 (21 years old)","D/WB/M (R)","Barcelona B","Spanish Federation First Division A","MEX","No","2/17/2023","6/30/2026","$130K - $6.4M","Right","Fairly Strong","Very Strong","5'10""","154 lbs","100","1",125,145,8,12,12,6,12,8,10,6,10,12,12,6,13,12,14,11,15,11,13,11,14,6,5,11,12,14,10,15,14,13,14,9,14,14,15,10,14,12,10,14,12,8,7,3,11,6,13,16,14,2,2,1,1,1,3,3,1,1,1,3
"8298",2000064674,"Alonso Aceves","3/28/2001 (22 years old)","D (L)","Chicago","Major League Soccer","MEX","No","7/1/2022","6/30/2025","$500K - $5.2M","Left","Very Strong","Weak","5'11""","147 lbs","57","1",112,145,9,13,10,9,13,9,9,11,11,14,12,8,11,15,8,10,8,12,13,12,15,11,8,10,12,14,12,15,13,13,11,10,14,12,14,10,10,12,12,14,13,15,7,12,8,7,12,13,12,1,2,1,3,1,1,3,2,2,2,1
"8299",5662695,"José de Jesús Corona","7/26/1981 (41 years old)","GK","Cruz Azul","Mexican First Division","MEX","No","6/14/2021","6/30/2024","$0","Left","Very Strong","Fairly Strong","6'0""","185 lbs","669","-",126,145,3,3,2,1,8,6,4,6,5,5,4,6,11,5,9,12,11,12,11,11,15,1,12,2,14,11,9,9,12,15,14,12,13,10,13,13,2,11,15,13,11,14,10,11,8,7,12,13,12,12,12,12,6,11,10,14,5,12,14,13
"8300",51045753,"Roberto Alvarado","9/7/1998 (24 years old)","M (L), AM (RL)","Chivas","Mexican First Division","MEX","No","1/2/2022","6/30/2026","$5.6M - $10.5M","Left","Very Strong","Reasonable","5'8""","154 lbs","283","37",135,145,12,15,16,13,15,10,11,11,12,7,13,8,7,13,12,13,13,13,13,13,11,12,11,13,8,12,14,10,15,14,12,9,10,13,13,9,11,18,12,11,10,6,9,12,5,10,14,14,11,2,1,2,2,3,2,4,2,1,1,3
"8301",51052239,"Orbelín Pineda","3/24/1996 (27 years old)","M (C), AM (LC)","Vigo","Spanish First Division","MEX","No","1/7/2022","6/30/2026","$7.4M - $9.2M","Right","Reasonable","Very Strong","5'6""","132 lbs","284","34",140,145,9,13,14,12,13,11,9,14,8,11,14,12,10,16,12,12,12,12,12,13,13,14,8,13,12,13,14,14,15,16,12,4,16,14,15,8,16,13,13,15,13,15,6,12,7,8,13,13,15,1,2,3,2,3,3,1,3,1,1,2
"8302",51049312,"Jesús Gallardo","8/15/1994 (28 years old)","D/WB/M/AM (L)","Monterrey","Mexican First Division","MEX","No","6/15/2020","6/30/2024","$325K - $8.8M","Left Only","Very Strong","Weak","5'10""","149 lbs","342","54",135,145,8,13,12,10,11,10,11,9,13,11,13,8,13,12,8,13,15,11,11,12,11,13,7,14,13,14,12,16,14,15,11,12,14,14,15,7,17,19,12,12,9,12,4,12,7,2,15,11,13,1,2,1,1,3,1,3,2,3,1,1
"8303",51072965,"Santiago Naveda","4/16/2001 (22 years old)","DM, M (C)","América","Mexican First Division","MEX","No","8/9/2022","6/30/2024","$1.6M - $3.5M","Right","Reasonable","Very Strong","5'9""","163 lbs","44","2",111,145,7,6,9,7,13,6,9,9,10,13,13,8,13,12,13,12,14,11,13,11,14,7,9,12,14,15,9,13,13,13,10,9,13,13,15,8,10,8,12,14,12,12,13,11,9,6,14,13,10,1,2,1,3,1,1,3,1,1,3,3
"8304",2000045321,"Isaías Violante","10/20/2003 (19 years old)","M (L), AM (RL)","Toluca","Mexican First Division","MEX","No","7/1/2022","6/30/2025","$1.6M - $3.4M","Left","Very Strong","Reasonable","5'8""","154 lbs","24","1",97,145,8,12,14,10,10,5,5,6,7,6,9,7,6,11,9,10,6,10,9,9,12,12,8,12,7,9,7,10,14,12,9,9,11,14,10,5,12,12,11,10,11,12,13,10,3,1,11,11,9,1,3,2,3,3,2,2,3,2,2,3
"8305",51055617,"Carlos Rodríguez","1/3/1997 (26 years old)","M/AM (C)","Cruz Azul","Mexican First Division","MEX","No","1/2/2022","6/30/2025","$7M - $8.6M","Right","Reasonable","Very Strong","5'9""","145 lbs","187","16",133,144,11,12,13,12,15,11,8,11,13,10,14,13,11,15,8,13,12,15,14,15,14,13,10,14,11,14,15,14,12,15,16,9,13,12,14,7,12,13,12,15,14,13,5,15,7,7,13,15,16,1,2,1,3,3,2,3,2,3,1,2
"8306",67270690,"Mohammed Salisu","4/17/1999 (24 years old)","D (C)","Southampton","Sky Bet Championship","GHA","No","8/12/2020","6/30/2027","$17M - $26M","Left Only","Very Strong","Weak","6'3""","180 lbs","138","2",137,156,7,9,10,6,11,6,16,8,14,14,10,6,16,11,12,15,14,12,13,11,14,9,10,9,14,15,12,15,14,12,11,15,13,14,15,16,11,11,11,12,11,11,8,13,9,5,13,12,10,1,2,2,2,3,1,1,2,1,3,2
"8307",48036760,"Alexander Djiku","8/9/1994 (28 years old)","D (C), DM","Strasbourg","Ligue 1 Uber Eats","GHA","Yes","7/5/2019","6/30/2026","$6.6M - $10M","Right","Weak","Very Strong","6'0""","163 lbs","220","4",133,136,6,11,10,5,12,6,15,5,11,15,12,8,14,12,15,13,17,13,15,13,14,10,10,10,14,13,8,15,13,13,15,12,15,13,15,14,14,12,12,13,12,13,6,11,12,7,14,14,8,2,3,2,2,1,2,3,2,2,3,1
"8308",2000018468,"Ozziel Herrera","5/23/2001 (22 years old)","AM (R), ST (C)","Atlas","Mexican First Division","MEX","No","6/15/2020","6/30/2027","$5.4M - $8M","Left","Very Strong","Fairly Strong","5'10""","138 lbs","89","9",122,144,11,12,12,11,9,8,11,11,7,5,10,10,9,10,11,11,9,12,8,9,18,7,2,13,10,11,10,13,15,15,12,11,11,15,14,10,12,12,10,9,13,11,8,9,8,5,11,11,18,1,3,4,3,2,3,3,2,2,2,2
"8309",28121369,"Armando Broja","9/10/2001 (21 years old)","AM (RL), ST (C)","Chelsea","English Premier Division","ALB","No","9/2/2022","6/30/2028","$56M - $67M","Right","Reasonable","Very Strong","6'3""","191 lbs","75","17",135,160,7,8,15,14,12,7,12,8,7,5,7,12,8,13,14,13,11,14,8,12,12,13,11,14,6,11,9,13,16,12,15,14,14,16,13,14,11,12,12,12,12,10,6,10,7,6,10,10,13,1,1,2,2,3,1,3,2,3,1,3
"8310",43424567,"Kristjan Asllani","3/9/2002 (21 years old)","DM, M/AM (C)","Empoli","Italian Serie A","ALB","Yes","6/13/2022","6/30/2028","$8.6M - $10.5M","Right","Reasonable","Very Strong","5'9""","149 lbs","43","1",133,156,12,11,11,10,15,13,7,13,5,9,15,13,10,13,10,14,12,14,12,12,12,10,10,14,14,14,13,12,13,13,13,9,13,12,16,10,11,12,12,15,11,12,6,11,8,8,12,14,12,3,3,2,3,2,4,3,2,1,2,3
"8311",43296495,"Marash Kumbulla","2/8/2000 (23 years old)","D (C)","AS Roma","Italian Serie A","ALB","Yes","7/1/2021","6/30/2025","$5.6M - $7M","Right","Reasonable","Very Strong","6'3""","180 lbs","71","2",129,150,5,7,8,9,10,5,17,5,13,16,12,6,15,11,8,14,13,11,11,11,11,7,6,5,14,14,9,15,10,9,12,16,15,12,13,15,4,12,13,16,8,12,8,11,13,7,12,15,14,2,2,2,2,2,3,2,2,2,2,2
"8312",11035674,"Ernest Muçi","3/19/2001 (22 years old)","AM (C), ST (C)","Legia","PKO Bank Polski Ekstraklasa","ALB","No","2/23/2021","6/30/2025","$650K - $6.6M","Right","Fairly Strong","Very Strong","5'11""","165 lbs","121","25",116,148,9,13,14,13,13,8,12,14,5,5,12,14,7,15,7,10,7,13,11,12,14,16,4,12,6,12,12,8,14,13,10,11,12,14,10,7,12,10,12,17,11,10,3,11,3,2,9,16,7,2,1,1,1,4,3,3,3,3,3,1
"8313",43616542,"Stiven Shpendi","5/19/2003 (20 years old)","AM (RLC), ST (C)","Cesena","Italian Serie C/B","ALB","Yes","4/3/2023","6/30/2026","$450K - $4.6M","Right","Fairly Strong","Very Strong","5'11""","147 lbs","31","12",117,148,5,7,10,12,13,9,9,11,5,5,12,8,5,13,11,12,12,12,12,12,18,15,14,13,8,12,12,11,13,14,11,13,13,13,11,9,13,9,12,15,13,14,5,17,8,9,17,15,14,3,3,1,3,1,3,1,3,4,4,3
"8314",43115047,"Thomas Strakosha","3/19/1995 (28 years old)","GK","Brentford","English Premier Division","ALB","Yes","7/14/2022","6/30/2025","$13M - $16.5M","Right","Weak","Very Strong","6'4""","171 lbs","175","-",133,146,1,1,3,3,5,3,4,1,3,3,8,2,3,6,8,14,15,12,11,12,15,10,10,8,15,15,11,15,13,14,13,17,15,13,15,13,1,16,16,15,12,18,8,15,9,5,12,15,16,11,13,15,13,14,12,14,11,11,11,14
"8315",98038311,"Nedim Bajrami","2/28/1999 (24 years old)","M/AM (C)","Sassuolo","Italian Serie A","ALB","Yes","9/1/2020","6/30/2028","$5.2M - $6.4M","Right","Reasonable","Very Strong","5'10""","149 lbs","219","28",132,145,13,13,13,13,14,13,8,14,4,7,14,14,7,15,13,12,12,13,12,12,13,14,9,14,9,14,14,13,13,13,13,8,12,14,13,11,14,9,11,14,13,12,5,10,9,8,11,14,14,1,2,2,3,2,2,1,2,1,2,4
"8316",43083951,"Elseid Hysaj","2/2/1994 (29 years old)","D/WB (RL)","Lazio","Italian Serie A","ALB","No","7/1/2021","6/30/2025","$9.4M - $12M","Right","Reasonable","Very Strong","6'0""","154 lbs","339","4",139,145,8,12,12,9,13,8,12,8,9,14,12,8,14,12,13,17,16,11,11,10,13,8,12,16,14,15,12,14,14,14,14,11,16,15,15,13,15,13,13,14,12,13,6,13,6,7,12,13,15,2,2,3,3,3,1,4,2,3,2,2
"8317",98015432,"Berat Djimsiti","2/19/1993 (30 years old)","D (C)","Atalanta","Italian Serie A","ALB","Yes","3/21/2022","6/30/2026","$10.5M - $16M","Right","Reasonable","Very Strong","6'3""","182 lbs","355","15",142,145,5,7,8,5,10,4,15,5,5,16,11,4,15,11,13,15,17,13,14,13,15,6,11,7,14,15,10,14,11,12,13,16,14,12,14,17,12,15,12,15,7,14,6,12,12,5,14,14,13,1,1,2,2,1,2,2,3,3,2,1
"8318",2000184837,"Mario Dorgeles","8/7/2004 (18 years old)","DM, M (C)","FC Nordsjælland","3F Superliga","GHA","No","7/1/2022","6/30/2026","$1.5M - $3.1M","Left","Very Strong","Reasonable","5'10""","147 lbs","15","-",105,136,8,8,11,6,12,8,10,8,8,12,12,9,12,12,11,12,12,12,12,8,10,5,2,12,13,14,11,14,13,13,12,11,14,13,12,13,15,12,13,14,8,10,9,6,10,4,10,13,16,3,1,1,2,1,4,1,1,2,3,4
"8319",43499985,"Brayan Boci","7/24/2003 (19 years old)","D/WB (L)","Genoa","Italian Serie A","ALB","Yes","6/13/2022","6/30/2027","$425K - $1.2M","Left","Very Strong","Weak","6'0""","163 lbs","2","-",110,145,6,12,9,8,11,5,13,7,9,12,11,7,13,11,10,11,12,12,13,12,11,5,10,11,13,14,9,14,13,12,13,11,12,13,11,11,13,15,12,12,13,11,5,10,6,1,13,11,18,1,2,3,3,2,1,2,1,1,1,2
"8320",11027837,"Ylber Ramadani","4/12/1996 (27 years old)","DM, M (C)","Aberdeen","cinch Premiership","ALB","Yes","6/8/2022","5/31/2025","$1.9M - $4M","Right Only","Weak","Very Strong","6'1""","176 lbs","301","14",125,142,3,7,12,8,13,4,11,11,6,13,11,6,14,8,14,15,15,11,15,13,14,7,18,9,15,15,11,16,11,12,11,12,13,11,17,15,9,11,12,14,15,13,3,13,8,5,17,15,11,3,1,2,3,3,2,3,1,1,2,3
"8321",29193606,"Anis Mehmeti","1/9/2001 (22 years old)","AM (LC)","Bristol City","Sky Bet Championship","ALB","No","1/31/2023","6/30/2026","$700K - $9.2M","Right","Reasonable","Very Strong","5'11""","165 lbs","117","22",116,139,13,12,16,11,13,11,5,13,3,5,12,7,9,16,8,11,9,13,10,8,11,16,6,12,10,11,12,13,13,15,12,8,12,12,12,9,13,11,10,12,10,10,5,12,6,3,10,14,9,2,1,3,1,2,3,2,2,1,2,2
"8322",68015622,"Etrit Berisha","3/10/1989 (34 years old)","GK","Torino","Italian Serie A","ALB","Yes","7/3/2021","6/30/2024","$0","Left","Very Strong","Reasonable","6'4""","180 lbs","279","4",125,138,3,1,2,2,10,7,11,2,3,3,9,12,2,10,14,12,13,10,12,11,15,3,11,2,14,12,11,14,12,11,13,15,12,10,14,13,10,13,15,17,9,12,8,13,4,11,15,15,14,14,15,14,15,14,11,13,15,12,13,15
"8323",67228750,"Keidi Bare","8/28/1997 (25 years old)","DM, M (C)","Espanyol","Spanish Second Division","ALB","No","9/22/2020","6/30/2024","$300K - $3M","Right","Reasonable","Very Strong","5'9""","145 lbs","191","6",124,137,8,13,13,11,13,8,11,11,7,13,13,9,12,13,13,13,14,12,10,12,13,10,8,12,12,13,12,15,14,14,13,8,13,13,13,11,10,10,7,13,11,13,12,13,15,12,13,14,18,2,1,3,1,2,1,1,3,2,2,2
"8324",11024744,"Myrto Uzuni","5/31/1995 (28 years old)","AM (RLC), ST (C)","Granada","Spanish First Division","ALB","No","10/23/2022","6/30/2026","$750K - $9.2M","Right","Fairly Strong","Very Strong","5'10""","158 lbs","285","96",131,137,12,11,13,14,12,12,13,10,3,4,11,14,5,12,16,10,13,12,11,10,15,13,10,13,6,11,11,15,14,14,12,10,5,14,13,11,15,8,8,15,15,12,8,14,8,9,12,15,15,4,1,2,2,1,2,2,1,2,3,1
"8325",67053461,"Iván Balliu","1/1/1992 (31 years old)","D/WB (R)","Vallecano","Spanish First Division","ALB","Yes","7/7/2022","6/30/2025","Not for Sale","Right","Fairly Strong","Very Strong","5'8""","138 lbs","349","3",133,136,8,14,12,7,13,8,9,12,14,11,13,7,14,13,12,13,14,13,13,12,12,6,7,13,13,15,12,15,14,14,10,6,14,14,15,10,15,13,15,14,12,10,5,12,6,4,14,14,15,1,3,2,1,4,4,3,2,2,1,2
"8326",24052869,"Ardian Ismajli","9/30/1996 (26 years old)","D (C)","Empoli","Italian Serie A","ALB","No","8/10/2021","6/30/2025","$3M - $6M","Right","Weak","Very Strong","6'1""","176 lbs","162","3",127,135,5,8,8,8,10,7,14,8,14,14,12,6,14,9,14,13,15,12,12,12,13,7,12,9,13,14,11,14,12,12,14,14,12,13,14,15,11,12,8,14,11,12,9,11,11,14,13,12,11,2,3,3,4,1,2,3,2,3,2,4
"8327",43317791,"Sergio Kalaj","1/28/2000 (23 years old)","D (C)","Frosinone","Italian Serie A","ALB","Yes","1/13/2022","6/30/2026","$100K - $1M","Right","Weak","Very Strong","6'4""","171 lbs","51","1",110,135,5,7,9,5,10,5,15,5,11,12,10,5,12,10,13,13,12,12,14,11,16,11,9,10,12,11,8,12,12,13,13,13,12,11,12,13,10,16,9,11,11,14,5,12,10,8,10,9,16,3,1,4,4,3,1,3,1,1,3,1
"8328",11026078,"Gentian Selmani","3/9/1998 (25 years old)","GK","KF Laçi","Albanian Superleague","ALB","No","1/9/2023","6/30/2024","$55K - $550K","Right","Reasonable","Very Strong","6'1""","171 lbs","245","1",107,135,4,3,1,1,10,8,8,1,3,1,9,1,2,10,6,10,12,10,12,10,13,6,7,1,11,11,8,10,11,13,10,13,13,12,8,9,12,18,11,10,11,11,7,10,4,6,15,13,15,12,10,16,10,15,13,12,5,10,11,11
"8329",2000165828,"Mohammed Fuseini","5/16/2002 (21 years old)","AM (RL)","SK Sturm Graz","Austrian Premier Division","GHA","No","11/29/2022","6/30/2026","$600K - $6M","Right","Reasonable","Very Strong","5'7""","141 lbs","41","13",112,135,4,8,10,9,10,9,6,12,10,5,9,8,6,9,7,9,12,10,9,8,16,10,6,15,4,11,10,13,16,13,9,8,12,17,13,9,11,17,13,12,12,13,6,6,10,5,8,14,13,1,2,1,3,1,1,3,3,1,1,3
"8330",83273689,"Adrian Bajrami","4/5/2002 (21 years old)","D (C)","Benfica","Portuguese Premier League","ALB","Yes","3/11/2021","6/30/2025","$850K - $1.9M","Left Only","Very Strong","Weak","6'2""","167 lbs","25","2",105,134,4,8,7,7,11,5,13,11,8,13,13,8,13,10,13,12,12,11,11,11,13,10,10,10,12,12,11,11,11,10,13,14,15,11,11,13,10,14,14,14,12,10,6,12,5,8,12,13,12,2,1,2,1,2,3,1,3,2,1,3
"8331",43616541,"Cristian Shpendi","5/19/2003 (20 years old)","ST (C)","Cesena","Italian Serie C/B","ALB","Yes","4/3/2023","6/30/2026","$375K - $1.1M","Right","Fairly Strong","Very Strong","5'11""","158 lbs","21","1",110,131,6,8,11,13,12,7,9,10,6,6,11,12,6,11,12,12,13,14,10,12,16,10,7,15,7,12,11,11,12,14,13,13,15,12,11,9,12,12,8,14,8,9,4,16,8,12,16,14,13,3,1,2,1,3,2,2,3,4,3,3
"8332",2000080117,"Andreas Ndoj","2/2/2003 (20 years old)","D (C), DM, M (C)","Olympiacos","Greek Super League 2 South","ALB","Yes","12/17/2021","6/30/2025","$2.7M - $5.6M","Right","Weak","Very Strong","6'3""","191 lbs","47","1",105,131,6,7,9,8,11,6,13,8,8,12,11,3,12,12,15,12,15,12,8,10,13,8,10,8,12,14,10,13,10,9,13,15,13,11,12,14,16,12,10,14,13,13,6,11,10,7,12,13,10,1,2,3,3,2,1,2,4,2,2,1
"8333",36047453,"Ergys Kace","7/8/1993 (29 years old)","DM, M (C)","Volos","Greek Super League 1","ALB","No","1/31/2023","6/30/2024","$210K - $650K","Right","Weak","Very Strong","5'7""","136 lbs","225","14",100,130,11,11,10,6,11,12,8,12,9,11,11,8,10,12,15,12,13,12,9,12,13,9,10,11,12,14,11,15,12,14,10,7,14,11,12,7,8,6,7,12,15,12,6,13,15,13,14,12,12,3,4,1,2,2,3,3,1,2,2,4
"8334",43072400,"Kastriot Dermaku","1/15/1992 (31 years old)","D (C)","Salento","Italian Serie A","ALB","Yes","8/30/2021","6/30/2024","$160K - $1.6M","Right Only","Weak","Very Strong","6'4""","198 lbs","259","13",120,130,7,7,7,8,9,5,15,8,5,13,11,7,13,8,12,13,13,13,13,13,13,5,10,4,13,10,8,12,10,10,13,17,14,11,15,15,5,13,9,13,10,9,5,10,8,7,12,13,11,3,3,1,1,2,1,3,1,1,1,1
"8335",11008334,"Armando Sadiku","5/27/1991 (32 years old)","ST (C)","Cartagena","Spanish Second Division","ALB","Yes","6/30/2022","6/30/2024","$75K - $750K","Right","Fairly Strong","Very Strong","6'0""","176 lbs","365","134",115,130,8,7,11,13,9,7,13,11,8,6,10,12,7,11,13,13,15,14,12,13,13,10,7,13,6,13,9,14,13,11,5,13,12,12,14,14,9,10,13,12,12,11,9,13,11,9,10,13,11,1,1,1,1,3,3,2,2,2,3,2
"8336",33062261,"Albion Ademi","2/19/1999 (24 years old)","AM (RL)","IFK Värnamo","Swedish Premier Division","ALB","Yes","1/22/2021","12/31/2024","$210K - $600K","Right","Fairly Strong","Very Strong","5'8""","154 lbs","129","38",105,130,11,10,13,10,12,10,6,6,4,4,10,11,4,13,12,11,7,11,10,10,11,14,5,12,7,9,9,10,14,14,12,9,10,13,11,7,9,14,14,13,10,9,13,2,6,7,10,12,9,2,2,1,2,2,1,1,3,3,1,2
"8337",28047503,"Frederic Veseli","11/20/1992 (30 years old)","D (RC)","Benevento","Italian Serie C/C","ALB","Yes","8/28/2022","6/30/2024","$0","Right","Reasonable","Very Strong","6'0""","171 lbs","244","2",108,130,6,6,7,6,10,7,14,6,8,12,10,7,12,9,13,11,13,12,10,11,12,10,12,7,13,15,7,15,11,11,15,14,14,11,13,13,13,13,13,13,12,12,2,10,11,6,10,12,10,2,3,2,3,1,3,3,2,3,4,3
"8338",98003823,"Taulant Xhaka","3/28/1991 (32 years old)","DM, M (C)","Basel","Swiss Super League","ALB","Yes","2/23/2023","6/30/2027","$35K - $325K","Right","Reasonable","Very Strong","5'8""","158 lbs","336","11",113,129,10,10,11,6,12,11,8,12,8,13,12,9,16,13,20,13,18,13,13,13,18,7,13,8,13,16,8,16,8,13,11,6,10,9,13,8,17,5,6,15,11,20,10,13,14,12,12,8,11,3,2,3,3,2,1,3,3,1,3,2
"8339",2000293631,"Matteo Dashi","1/22/2007 (16 years old)","M/AM (C)","Crystal Palace","English Premier Division","ALB","No","6/12/2023","6/30/2025","$1K - $9K","Left","Very Strong","Reasonable","5'6""","110 lbs","-","-",60,129,6,7,11,8,14,6,6,8,1,4,10,4,3,10,6,6,7,7,7,12,18,9,7,11,6,13,14,8,8,11,7,1,12,10,8,3,7,15,13,11,11,11,12,7,5,3,10,10,15,2,2,3,3,3,1,2,3,3,1,1
"8340",18102706,"Mo Dauda","2/20/1998 (25 years old)","AM (RLC), ST (C)","Tenerife","Spanish Second Division","GHA","No","7/21/2022","6/30/2025","$240K - $2.4M","Right","Fairly Strong","Very Strong","5'9""","152 lbs","131","25",119,135,11,12,14,12,12,8,10,13,6,5,9,7,7,14,13,10,13,7,9,9,14,14,7,13,6,9,9,12,15,14,9,10,10,14,12,9,11,7,12,10,12,9,12,13,7,9,7,14,9,2,2,1,3,2,3,3,2,2,1,4
"8341",27116046,"Arbnor Mucolli","9/15/1999 (23 years old)","M (RL), AM (RLC)","Vejle","3F Superliga","ALB","Yes","6/15/2020","6/30/2025","$240K - $2.4M","Left","Very Strong","Fairly Strong","5'7""","143 lbs","149","24",117,129,9,12,15,11,13,12,6,11,4,6,14,14,6,14,11,14,12,13,12,12,12,15,6,13,8,11,14,11,13,14,8,5,12,12,11,7,13,10,14,14,12,13,11,12,5,6,12,13,10,2,1,3,2,1,3,3,2,1,1,2
"8342",2000068410,"Tim Civeja","1/4/2002 (21 years old)","M/AM (C)","Augsburg","Bundesliga","ALB","Yes","6/13/2022","6/30/2024","$0","Right","Fairly Strong","Very Strong","5'11""","163 lbs","37","5",96,128,11,9,12,8,12,11,8,8,6,10,12,11,12,12,13,9,12,11,11,10,13,12,7,12,10,12,12,13,12,12,11,10,13,12,12,10,13,10,11,11,10,12,6,14,8,7,12,13,12,1,1,3,3,3,1,4,2,2,1,3
"8343",8707992,"Jürgen Gjasula","12/5/1985 (37 years old)","DM, M/AM (C)","Berliner AK","German Regional Division Northeast","ALB","Yes","7/9/2022","6/30/2023","$0","Right","Reasonable","Very Strong","6'2""","191 lbs","470","66",91,128,15,13,9,10,12,14,9,13,6,5,12,15,5,13,7,11,9,13,8,11,9,16,9,9,5,11,14,7,8,10,12,11,11,9,9,12,11,7,7,10,14,8,8,11,10,16,11,12,10,3,3,2,3,2,2,1,2,1,2,2
"8344",2000187865,"Flavio Sulejmani","3/20/2006 (17 years old)","ST (C)","Perugia","Italian Serie C/B","ALB","Yes","7/1/2022","6/30/2024","$0","Right Only","Weak","Very Strong","6'0""","171 lbs","-","-",67,126,3,7,9,11,9,7,10,8,4,4,9,10,4,9,11,10,9,9,8,9,11,7,8,8,4,11,8,10,11,10,12,10,10,12,12,13,9,12,13,12,11,11,8,16,7,5,10,13,10,3,2,1,1,2,1,3,1,1,3,3
"8345",69004693,"Amir Abrashi","3/27/1990 (33 years old)","DM, M (C)","Grasshoppers","Swiss Super League","ALB","Yes","1/23/2023","6/30/2024","$130K - $400K","Right","Reasonable","Very Strong","5'8""","163 lbs","347","16",103,126,7,7,9,5,10,10,5,10,8,13,11,9,14,10,17,14,16,9,13,10,17,8,16,9,13,16,9,15,10,13,12,9,15,9,14,8,13,6,7,15,14,18,11,11,15,7,13,9,10,4,3,1,3,1,2,3,3,2,2,4
"8346",43212533,"Elhan Kastrati","2/2/1997 (26 years old)","GK","Cittadella","Italian Serie B","ALB","No","7/4/2022","6/30/2026","$950K - $2.1M","Right Only","Weak","Very Strong","6'2""","189 lbs","137","-",118,126,5,5,5,5,9,5,9,8,10,5,10,5,5,8,8,12,12,12,12,12,11,10,10,9,12,12,12,12,12,13,12,14,10,12,15,12,5,10,12,12,11,11,10,11,8,7,11,14,12,13,10,13,13,13,12,12,10,12,12,12
"8347",43124843,"Emanuele Ndoj","11/20/1996 (26 years old)","DM, M (C)","Brescia","Italian Serie B","ALB","Yes","6/15/2020","6/30/2025","$45K - $425K","Right","Reasonable","Very Strong","6'2""","180 lbs","142","11",112,125,9,11,11,10,11,10,11,11,3,9,12,5,12,12,12,13,12,13,12,12,15,14,10,10,12,12,13,14,12,12,14,13,11,12,13,12,10,12,13,15,12,14,4,12,4,6,12,11,10,2,1,3,2,3,3,2,2,1,3,3
"8348",24065180,"Enis Çokaj","2/23/1999 (24 years old)","DM, M (C)","Panathinaikos","Greek Super League 1","ALB","No","9/15/2022","6/30/2026","$250K - $2.6M","Right","Reasonable","Very Strong","5'9""","152 lbs","128","3",115,125,11,11,9,8,10,10,10,13,8,13,13,11,14,11,16,10,15,9,13,10,15,8,13,9,13,13,10,17,11,12,13,9,15,11,16,12,10,10,9,12,13,13,6,10,13,8,12,12,12,1,1,3,2,4,4,1,2,1,1,2
"8349",62144317,"Eros Grezda","4/15/1995 (28 years old)","M/AM (RL)","ZTE","Hungarian Division I","ALB","No","2/22/2023","6/30/2025","$400K - $1.2M","Right","Weak","Very Strong","6'0""","169 lbs","184","32",105,125,5,11,14,10,10,5,9,10,6,7,10,7,8,11,16,9,14,11,9,7,2,13,6,13,7,9,10,12,14,13,10,11,15,14,14,10,13,5,5,3,5,3,16,10,11,14,9,3,4,4,3,3,1,1,3,2,2,2,4,1
"8350",43214539,"Kristal Abazaj","7/6/1996 (26 years old)","M/AM (RL)","KF Tirana","Albanian Superleague","ALB","No","12/22/2022","6/30/2024","$10K - $110K","Right","Fairly Strong","Very Strong","6'0""","165 lbs","182","42",95,125,4,10,12,9,11,10,4,6,2,3,11,6,3,11,5,7,10,6,7,5,10,10,5,10,4,7,9,9,14,13,12,9,17,15,9,8,11,13,8,12,11,12,13,2,5,1,12,12,13,3,2,1,2,3,3,2,3,1,2,3
"8351",13115176,"Ebenezer Ofori","7/1/1995 (27 years old)","DM, M (C)","Vejle","3F Superliga","GHA","No","6/15/2022","6/30/2024","$200K - $2M","Left Only","Very Strong","Weak","5'8""","154 lbs","227","11",109,135,11,14,12,9,13,11,8,12,10,11,14,10,13,13,15,12,10,12,12,12,11,10,9,12,11,12,12,13,12,13,12,9,15,12,11,8,12,11,10,11,12,10,12,12,12,8,12,11,13,1,3,3,1,3,1,3,2,2,3,2
"8352",43295817,"Erdis Kraja","7/7/2000 (22 years old)","DM, M (C)","Atalanta","Italian Serie C/A","ALB","Yes","8/8/2022","6/30/2025","$40K - $130K","Right Only","Weak","Very Strong","6'0""","171 lbs","115","7",103,125,5,7,8,8,12,6,12,12,8,12,13,7,13,9,12,14,12,10,13,12,12,6,8,9,13,13,11,11,11,12,11,11,13,11,13,11,15,14,11,10,14,10,6,12,8,2,14,11,11,1,2,1,1,2,1,3,4,2,1,4
"8353",35005587,"Valdet Rama","11/20/1987 (35 years old)","M (L), AM (RL), ST (C)","Wuppertal","German Regional Division West","ALB","Yes","1/3/2022","6/30/2024","$500 - $6K","Right","Reasonable","Very Strong","6'0""","169 lbs","368","42",92,125,12,10,15,9,12,13,8,11,6,6,12,9,7,13,12,10,13,10,10,9,10,13,6,12,8,9,11,11,11,12,11,9,11,11,12,9,13,8,10,9,8,12,14,12,4,7,11,13,14,4,3,1,3,1,4,4,2,3,2,2
"8354",11026890,"Eduart Rroca","7/28/1993 (29 years old)","M (C), AM (LC)","İstanbulspor","Turkish Super League","ALB","No","9/18/2020","6/30/2025","$200K - $2M","Right","Fairly Strong","Very Strong","6'0""","174 lbs","265","46",110,125,10,10,14,8,14,9,8,12,5,6,13,9,7,16,5,11,10,12,10,13,12,10,9,11,8,10,13,10,11,13,13,9,10,10,10,14,13,7,7,11,9,11,5,12,6,7,15,11,15,3,2,1,2,1,3,1,1,2,2,1
"8355",18097140,"Lindon Selahi","2/26/1999 (24 years old)","DM, M (C)","Rijeka","Croatian First League","ALB","Yes","7/24/2021","6/30/2025","$180K - $1.8M","Right","Reasonable","Very Strong","5'11""","145 lbs","113","6",117,124,8,8,13,9,13,9,6,13,6,10,15,9,12,14,15,13,10,11,10,10,15,13,10,12,10,11,13,13,14,15,10,10,12,13,12,8,2,7,8,13,11,12,9,12,10,9,11,13,8,2,4,1,1,1,3,1,3,3,3,1
"8356",43611960,"Kevin Haveri","9/18/2001 (21 years old)","D/WB (L)","Rimini","Italian Serie C/B","ALB","No","1/1/2022","6/30/2025","$80K - $800K","Left","Very Strong","Weak","6'3""","189 lbs","80","-",97,124,5,12,9,5,9,6,12,10,11,11,10,9,12,9,11,10,13,10,9,9,12,6,6,11,12,10,8,12,12,11,13,13,12,12,14,14,12,8,7,8,9,8,5,10,9,9,11,15,7,3,3,1,4,3,1,1,3,2,3,2
"8357",43474398,"Kleis Bozhanaj","3/1/2001 (22 years old)","AM (C), ST (C)","Modena","Italian Serie B","ALB","No","1/5/2023","6/30/2024","$140K - $1.4M","Right","Reasonable","Very Strong","5'11""","156 lbs","35","5",104,123,5,9,13,12,12,9,9,10,9,5,11,8,5,12,11,12,11,12,10,10,10,12,10,11,9,11,12,11,14,13,11,9,12,14,11,9,12,12,10,12,14,11,5,12,8,5,12,12,8,2,4,1,1,2,1,1,2,1,2,3
"8358",43204294,"Giacomo Vrioni","10/15/1998 (24 years old)","ST (C)","New England","Major League Soccer","ALB","Yes","7/5/2022","12/31/2025","$650K - $6.8M","Left","Very Strong","Reasonable","6'2""","178 lbs","121","34",113,122,4,7,12,13,13,5,14,13,10,5,11,13,6,12,9,12,12,10,8,12,13,8,9,14,8,13,9,14,12,10,13,15,12,13,12,14,9,8,9,9,10,9,7,9,7,6,10,14,9,2,2,3,4,3,1,3,1,2,3,1
"8359",24062833,"Bernard Karrica","1/7/2001 (22 years old)","AM (RL)","Rijeka","Croatian First League","ALB","No","7/2/2021","6/30/2024","$0","Right","Fairly Strong","Very Strong","6'1""","176 lbs","87","16",107,122,11,10,13,12,12,13,9,13,6,7,11,12,6,13,12,10,11,10,9,8,13,14,9,12,6,11,11,13,14,13,11,10,10,12,11,11,13,8,8,12,13,10,9,4,10,7,11,13,14,1,3,1,3,1,1,3,1,3,2,3
"8360",2000045800,"Jorgo Pëllumbi","6/15/2000 (22 years old)","D (LC), DM","Varaždin","Croatian First League","ALB","No","10/17/2022","5/31/2024","$80K - $800K","Left Only","Very Strong","Weak","6'1""","171 lbs","129","-",107,121,3,8,10,5,8,3,12,6,14,13,11,7,14,9,17,14,17,11,12,10,14,7,8,8,9,14,8,15,14,10,11,13,16,14,15,14,12,9,8,10,13,11,6,9,9,6,10,13,14,1,1,1,1,3,1,2,1,2,3,3
"8361",11007620,"Odise Roshi","5/22/1991 (32 years old)","M/AM (R)","Sakaryaspor","Turkish 1. League","ALB","No","8/5/2022","6/30/2024","$55K - $550K","Right","Reasonable","Very Strong","6'2""","171 lbs","351","31",105,121,8,10,12,8,11,9,9,11,8,4,9,8,11,11,9,7,7,9,8,7,10,13,7,8,5,8,10,9,16,15,12,10,12,15,11,13,13,10,11,9,10,12,12,8,10,13,11,10,8,2,3,2,1,1,1,3,1,2,1,3
"8362",2000272418,"Jalal Abdulai","1/5/2005 (18 years old)","ST (C)","Inter Allies","Ghanaian Lower Division","GHA","No","7/1/2022","6/30/2024","$0","Right","Weak","Very Strong","6'2""","176 lbs","-","-",92,135,4,6,11,10,10,7,10,10,5,4,5,7,10,10,17,8,15,9,9,9,13,11,5,12,6,11,5,11,14,11,14,15,12,13,12,14,6,7,8,10,10,9,5,8,17,5,10,12,12,3,1,3,3,3,2,1,3,3,3,2
"8363",2000029431,"Mario Mitaj","8/6/2003 (19 years old)","D (LC), WB (L)","Lokomotiv Moscow","Russian Premier League","ALB","Yes","8/27/2022","6/30/2027","$275K - $2.8M","Left Only","Very Strong","Weak","5'11""","160 lbs","45","-",100,121,9,9,10,6,10,7,12,8,10,11,9,8,12,11,11,11,13,11,12,11,12,8,8,10,11,13,9,13,13,14,10,10,13,13,12,9,12,15,14,13,12,12,6,11,7,6,10,15,13,3,3,3,3,1,2,3,3,1,2,1
"8364",86080119,"Telasco Segovia","4/2/2003 (20 years old)","DM, M (C)","Deportivo Lara","-","VEN","No","1/1/2019","12/31/2024","$40K - $400K","Right","Reasonable","Very Strong","5'10""","160 lbs","59","6",113,158,13,9,11,8,12,12,8,10,5,11,13,5,10,13,12,13,10,12,12,13,7,12,8,11,12,13,12,13,13,13,13,8,14,12,13,10,12,17,12,14,12,12,5,4,6,3,12,10,13,3,1,2,3,1,3,2,1,2,3,3
"8365",2000143321,"David Martínez","2/7/2006 (17 years old)","AM (RLC)","Monagas S.C.","Venezuelan Premier Division","VEN","No","1/1/2022","12/31/2024","$425K - $1.3M","Left","Very Strong","Reasonable","5'10""","156 lbs","26","4",104,157,13,10,13,10,12,13,11,12,6,10,11,14,11,13,8,12,8,11,8,10,3,15,13,11,10,8,13,8,13,13,12,8,16,12,10,6,10,13,12,10,13,12,14,3,6,5,11,13,8,2,1,2,2,2,3,1,2,1,1,1
"8366",86047272,"Yangel Herrera","1/7/1998 (25 years old)","DM, M (C)","Man City","English Premier Division","VEN","No","6/14/2021","6/30/2026","$750K - $10.5M","Right","Fairly Strong","Very Strong","6'0""","169 lbs","186","12",139,155,8,10,11,9,13,9,12,14,8,11,14,11,12,14,16,14,14,13,14,15,14,9,13,13,9,14,13,15,14,13,13,12,13,13,15,13,13,8,10,11,12,10,13,12,13,12,13,15,13,1,2,1,2,1,3,3,3,1,1,3
"8367",86076845,"Yerson Chacón","6/4/2003 (20 years old)","M/AM (RL)","Deportivo Táchira","Venezuelan Premier Division","VEN","No","2/23/2022","12/31/2024","$800K - $1.7M","Right","Reasonable","Very Strong","5'5""","125 lbs","75","14",110,149,9,12,14,10,12,8,4,12,4,6,11,8,5,13,13,13,8,11,12,10,3,14,5,12,5,15,13,13,13,15,15,2,14,12,13,7,12,17,10,10,13,11,4,16,12,6,11,10,20,2,2,3,3,3,3,2,3,1,3,2
"8368",86080622,"Andrés Romero","3/7/2003 (20 years old)","M (RC)","Monagas S.C.","Venezuelan Premier Division","VEN","No","3/20/2023","12/31/2025","$80K - $800K","Right","Fairly Strong","Very Strong","6'0""","156 lbs","87","7",111,148,12,12,12,8,12,11,12,8,8,9,12,8,10,13,8,13,11,12,12,13,3,10,5,10,10,12,12,13,12,11,11,12,13,12,13,10,16,10,10,13,9,11,6,8,8,7,20,11,10,2,1,1,3,2,2,1,1,2,3,3
"8369",86040729,"Yeferson Soteldo","6/30/1997 (25 years old)","AM (L), ST (C)","Tigres","Mexican First Division","VEN","No","2/1/2022","6/30/2028","$6.8M - $8.2M","Right","Strong","Very Strong","5'3""","138 lbs","245","45",135,146,8,12,16,11,15,12,5,10,1,3,14,13,3,15,12,13,10,12,10,13,11,16,5,13,8,13,13,14,16,15,12,2,10,14,14,9,11,11,11,12,11,10,7,10,6,13,8,11,7,1,2,2,2,3,2,1,2,4,1,4
"8370",86046565,"Wuilker Fariñez","2/15/1998 (25 years old)","GK","RC Lens","Ligue 1 Uber Eats","VEN","No","7/1/2021","6/30/2024","$800K - $1.7M","Right","Weak","Very Strong","5'11""","169 lbs","165","-",120,146,3,3,2,2,10,5,6,3,3,3,8,1,1,10,12,12,14,13,14,14,13,10,12,2,11,12,11,12,12,14,12,12,15,11,13,14,13,11,11,12,12,13,14,10,6,5,13,12,12,13,9,15,11,13,9,10,14,11,10,10
"8371",2000091060,"Kervin Andrade","4/13/2005 (18 years old)","M (C), AM (RLC)","Deportivo La Guaira","Venezuelan Premier Division","VEN","No","2/1/2021","12/31/2024","$30K - $300K","Right","Weak","Very Strong","5'4""","136 lbs","55","6",94,144,14,13,12,8,10,15,5,14,3,5,10,6,7,11,15,10,12,10,11,15,15,15,3,11,7,12,11,13,13,13,12,4,14,11,10,6,13,18,11,12,10,11,7,4,11,3,10,11,15,1,1,1,2,3,3,3,3,1,1,3
"8372",14023276,"Josef Martínez","5/19/1993 (30 years old)","AM (L), ST (C)","Inter Miami","Major League Soccer","VEN","No","1/18/2023","12/31/2024","$140K - $8.4M","Right","Fairly Strong","Very Strong","5'8""","163 lbs","315","148",130,142,4,9,13,15,14,5,14,8,3,3,13,15,6,14,14,11,16,12,12,11,16,14,12,13,5,14,13,13,14,16,13,14,11,14,11,13,9,8,11,9,11,10,12,12,11,11,11,13,10,2,2,3,3,3,1,3,1,4,1,1
"8373",13193935,"Kwadwo Opoku","7/13/2001 (21 years old)","AM (R), ST (C)","LAFC","Major League Soccer","GHA","No","10/6/2020","12/31/2025","$180K - $1.8M","Right","Reasonable","Very Strong","5'7""","154 lbs","67","10",113,135,8,11,13,13,12,7,8,11,3,8,10,7,5,12,5,11,7,9,10,9,12,11,3,12,6,8,10,12,15,13,13,6,12,14,11,10,10,11,8,10,8,9,3,11,3,2,10,12,10,1,2,2,3,3,1,1,3,2,3,1
"8374",86072358,"Andrés Ferro","8/2/2001 (21 years old)","D (C)","Metropolitanos","Venezuelan Premier Division","VEN","Yes","1/9/2022","12/31/2024","$80K - $800K","Right","Weak","Very Strong","6'1""","158 lbs","96","3",106,142,4,5,10,4,12,6,12,5,6,12,11,5,14,12,17,13,12,10,9,11,15,6,14,6,12,13,11,13,13,12,12,12,13,12,12,13,8,10,10,10,10,10,5,15,14,10,9,15,8,2,3,1,1,1,2,1,2,2,2,1
"8375",86000589,"Tomás Rincón","1/13/1988 (35 years old)","DM, M (C)","Sampdoria","Italian Serie B","VEN","No","7/5/2022","6/30/2024","$350K - $1M","Right","Reasonable","Very Strong","5'10""","165 lbs","440","11",130,141,4,6,10,10,12,4,13,9,4,15,12,6,15,13,19,15,18,11,13,13,19,5,13,12,16,15,9,16,11,11,17,10,16,11,15,15,11,15,10,17,12,15,6,15,12,6,15,13,18,3,1,2,4,3,1,1,1,1,3,3
"8376",67142869,"Juanpi","1/24/1994 (29 years old)","AM (RC)","Panetolikos","Greek Super League 1","VEN","Yes","1/31/2023","6/30/2024","$850K - $1.8M","Left","Very Strong","Weak","5'9""","147 lbs","219","31",110,140,13,13,13,9,14,14,10,13,8,5,13,12,6,14,8,13,7,13,11,12,12,12,9,12,7,10,12,11,12,13,12,7,10,12,12,8,10,12,15,10,8,15,13,11,7,3,12,10,13,2,2,2,3,2,2,3,1,2,2,1
"8377",2000145359,"Rafael Uzcátegui","10/4/2004 (18 years old)","D (C)","Mineros de Guayana","Venezuelan Premier Division","VEN","No","1/1/2021","12/31/2024","$26K - $250K","Right","Reasonable","Very Strong","6'0""","169 lbs","16","1",95,140,8,3,2,4,10,6,12,8,8,11,8,6,12,11,10,12,13,12,12,12,8,8,9,7,12,10,8,11,11,10,12,11,12,12,12,12,15,18,9,10,11,11,6,5,8,2,12,8,8,3,3,1,3,1,3,2,3,2,1,1
"8378",1502910,"Miku","8/19/1985 (37 years old)","ST (C)","Intercity","Spanish Federation First Division B","VEN","Yes","2/3/2023","6/30/2024","$0 - $120K","Right","Strong","Very Strong","6'1""","174 lbs","418","127",114,140,10,12,14,14,16,11,11,9,7,6,13,13,7,15,13,11,10,10,11,10,10,12,10,12,6,12,10,11,11,10,13,9,15,11,10,12,14,12,11,14,8,8,6,10,10,14,11,16,6,3,3,2,2,1,2,1,3,1,3,2
"8379",67063933,"Salomón Rondón","9/16/1989 (33 years old)","ST (C)","River","Argentine Premier Division","VEN","No","1/30/2023","12/31/2025","$800K - $1.7M","Right","Reasonable","Very Strong","6'1""","187 lbs","476","151",121,140,5,9,10,14,11,11,15,10,5,6,10,11,6,13,14,13,15,11,13,12,12,11,11,13,7,14,10,11,10,12,16,13,11,11,15,18,11,10,12,14,11,10,5,12,11,9,9,16,12,1,1,2,3,1,2,1,2,2,1,3
"8380",1510572,"Jeffren","1/20/1988 (35 years old)","AM (RLC)","Lamphun","Thai League","VEN","Yes","7/1/2021","6/30/2024","$0","Left","Very Strong","Fairly Strong","5'9""","154 lbs","350","55",102,140,13,12,13,11,14,12,7,10,7,5,14,16,7,14,7,13,8,12,10,12,12,14,7,13,6,12,13,7,11,11,10,5,8,12,8,7,12,9,7,10,7,12,14,8,6,12,8,15,4,1,3,1,3,3,1,3,2,3,4,1
"8381",86043122,"Ronaldo Lucena","2/27/1997 (26 years old)","M/AM (C)","Portuguesa F.C. (VEN)","Venezuelan Premier Division","VEN","No","11/16/2022","12/31/2023","$26K - $250K","Right","Weak","Very Strong","5'7""","138 lbs","113","3",102,138,14,12,11,8,12,14,8,12,7,8,12,8,8,13,10,13,10,13,12,12,13,14,8,10,10,14,13,12,12,13,12,4,9,12,10,10,11,15,12,10,11,11,14,14,10,1,7,13,10,3,2,2,2,4,3,1,1,1,2,2
"8382",86079978,"Saúl Guarirapa","10/18/2002 (20 years old)","AM (RL), ST (C)","Caracas","Venezuelan Premier Division","VEN","No","7/2/2019","12/31/2025","$190K - $1.9M","Right","Reasonable","Very Strong","6'2""","171 lbs","31","6",102,138,6,7,10,12,11,6,12,8,6,4,9,7,5,11,13,12,12,10,11,10,15,8,7,11,6,13,10,12,13,12,12,14,12,13,13,12,9,19,11,13,8,12,6,10,6,3,10,15,9,2,1,2,3,1,2,1,1,1,2,2
"8383",86055607,"Jesús Bueno","4/15/1999 (24 years old)","DM, M (C)","Philadelphia","Major League Soccer","VEN","No","7/29/2021","12/31/2023","$95K - $950K","Right","Reasonable","Very Strong","5'10""","160 lbs","112","15",114,137,7,12,11,7,12,14,8,12,5,9,12,13,11,12,14,12,12,11,12,12,14,9,14,10,10,14,12,13,13,12,12,9,14,12,15,10,10,20,13,9,14,14,6,13,7,7,13,8,10,1,4,4,3,1,1,2,1,3,2,3
"8384",28028952,"Andy Yiadom","12/9/1991 (31 years old)","D (RLC), WB (RL)","Reading","Sky Bet League One","GHA","No","6/17/2022","6/30/2025","$325K - $3.3M","Right","Reasonable","Very Strong","5'11""","165 lbs","465","26",115,135,8,10,10,9,12,7,12,7,9,13,10,5,14,9,15,12,17,12,12,9,15,10,16,11,10,14,9,15,14,10,11,10,15,12,13,13,15,16,16,17,15,15,10,12,6,3,14,13,14,4,1,3,1,3,1,3,2,1,2,1
"8385",86071986,"Jovanny Bolívar","12/16/2001 (21 years old)","ST (C)","Albacete","Spanish Second Division","VEN","No","1/11/2023","6/30/2028","$130K - $1.3M","Right","Weak","Very Strong","5'11""","158 lbs","82","28",112,137,6,9,12,14,12,14,13,12,5,4,10,10,5,13,13,13,12,12,11,11,17,14,14,13,7,13,11,14,13,13,12,12,14,12,13,10,8,16,12,10,7,12,7,15,11,2,13,14,7,2,2,3,1,1,3,2,1,1,1,3
"8386",14185468,"Nahuel Ferraresi","11/19/1998 (24 years old)","D (RC)","M.C. Torque","Uruguayan First Division","VEN","No","6/15/2020","6/30/2026","$325K - $3.2M","Right Only","Weak","Very Strong","6'2""","165 lbs","123","6",123,137,9,8,12,10,10,6,15,7,8,13,13,9,14,13,13,14,13,13,10,12,14,10,11,8,13,12,12,13,13,12,8,15,14,12,12,13,12,12,14,13,14,13,4,13,8,5,13,13,8,1,2,3,3,3,2,1,2,2,3,3
"8387",2000207034,"Sebastián Castillo","5/6/2005 (18 years old)","AM (L), ST (C)","Deportivo La Guaira","Venezuelan Premier Division","VEN","No","1/1/2023","12/31/2023","$110K - $1.1M","Right","Reasonable","Very Strong","5'7""","123 lbs","1","-",88,137,7,8,10,9,10,9,11,12,9,9,12,7,7,10,5,8,9,10,5,14,17,12,11,11,7,10,11,11,13,12,11,7,7,12,12,5,10,15,13,13,11,11,5,19,12,2,10,12,12,2,2,2,3,2,1,2,1,2,2,1
"8388",86039716,"Jefferson Savarino","11/11/1996 (26 years old)","M (R), AM (RC)","Real Salt Lake","Major League Soccer","VEN","No","5/3/2022","12/31/2025","$5.8M - $8.6M","Right","Fairly Strong","Very Strong","5'6""","149 lbs","311","75",132,137,12,13,15,13,13,11,5,12,3,2,12,10,3,15,12,14,11,12,12,12,11,15,5,12,7,13,13,12,16,15,12,4,13,15,11,7,8,11,11,13,11,12,8,9,7,7,12,12,12,3,2,1,2,2,3,2,1,2,3,3
"8389",2000037038,"Javier Márquez","2/14/2004 (19 years old)","D (RC)","Estudiantes de Mérida","Venezuelan Premier Division","VEN","No","1/1/2020","12/31/2024","$75K - $750K","Right","Reasonable","Very Strong","6'3""","180 lbs","6","-",80,137,9,11,9,4,11,7,11,9,5,9,10,6,15,9,11,9,10,11,8,8,1,5,13,8,11,9,8,10,6,11,10,15,17,7,6,9,9,19,8,11,10,12,12,17,9,1,16,13,13,2,2,2,2,3,1,2,1,3,3,2
"8390",86055764,"Cristian Cásseres","1/20/2000 (23 years old)","DM, M/AM (C)","New York","Major League Soccer","VEN","No","6/15/2020","12/31/2026","$200K - $2M","Right","Fairly Strong","Very Strong","5'9""","152 lbs","160","18",122,136,11,9,12,8,12,10,9,9,8,12,13,10,13,12,14,12,12,12,11,12,13,12,10,11,11,13,13,14,14,13,13,8,12,13,13,12,14,10,12,11,9,10,5,13,10,8,14,12,11,3,2,3,3,1,1,2,3,3,2,1
"8391",86017618,"Darwin Machís","2/7/1993 (30 years old)","M/AM (RL), ST (C)","Valladolid","Spanish Second Division","VEN","Yes","1/19/2023","6/30/2026","$650K - $6.2M","Right","Reasonable","Very Strong","5'7""","158 lbs","339","75",131,136,11,10,14,13,10,11,10,13,4,4,10,12,4,11,8,11,11,11,10,11,18,13,8,13,7,9,11,12,16,14,13,7,14,16,13,10,5,10,15,18,14,14,5,12,7,10,12,16,12,3,3,2,2,1,4,2,3,1,1,1
"8392",5300205,"César González","10/1/1982 (40 years old)","M (RL), AM (RLC)","Dénia","Spanish Lliga Comunitat Valenciana 2","VEN","No","2/16/2023","6/30/2024","$12K - $35K","Right","Weak","Very Strong","5'11""","163 lbs","353","72",94,136,13,14,12,9,13,14,9,14,9,6,12,14,7,13,9,11,10,14,8,13,13,13,13,12,8,14,14,10,8,9,13,9,14,9,12,10,14,11,10,14,13,9,5,7,5,6,9,15,11,4,2,2,3,1,1,2,3,2,1,3
"8393",86080170,"Jon Aramburu","7/23/2002 (20 years old)","D (RLC), WB (RL)","Real Irún","Spanish Federation First Division A","VEN","Yes","8/2/2022","6/30/2025","$0","Right Only","Weak","Very Strong","5'9""","156 lbs","90","4",109,136,6,9,9,5,11,7,12,6,8,13,9,5,13,11,14,13,13,12,13,12,20,8,13,8,13,13,9,13,13,12,12,8,14,12,13,11,18,15,11,12,10,13,5,4,7,3,18,13,11,1,1,2,3,1,4,2,1,1,1,1
"8394",86062514,"Edson Rivas","10/23/2001 (21 years old)","AM (R), ST (C)","Caracas","Venezuelan Premier Division","VEN","No","1/1/2023","12/31/2024","$170K - $1.7M","Right","Fairly Strong","Very Strong","6'7""","176 lbs","101","12",110,136,8,11,12,12,11,8,14,10,5,4,11,8,4,12,10,13,12,11,12,10,16,13,6,12,8,13,11,12,12,10,12,15,15,12,12,12,11,11,12,13,9,12,10,16,13,11,10,11,10,1,2,1,2,1,4,3,2,3,3,1
"8395",16199712,"Gideon Mensah","7/18/1998 (24 years old)","D/WB (L)","AJ Auxerre","Ligue 2 BKT","GHA","No","8/13/2022","6/30/2025","$650K - $6.6M","Left","Very Strong","Weak","5'10""","141 lbs","158","-",123,135,9,9,13,4,12,9,11,8,7,12,12,8,14,12,13,12,13,12,12,11,12,13,8,10,9,13,12,14,16,15,8,11,12,16,13,12,3,13,12,13,11,10,7,10,7,6,12,11,12,3,2,3,2,1,2,2,4,1,2,1
"8396",86031523,"Alejandro Fuenmayor","8/29/1996 (26 years old)","D (C)","Phoenix","USSL Championship Western Conference","VEN","No","12/23/2022","11/30/2024","$85K - $850K","Right","Reasonable","Very Strong","6'1""","171 lbs","144","6",105,135,6,6,7,7,11,4,13,10,7,11,8,3,12,11,15,11,14,11,12,11,11,8,11,5,12,13,8,10,11,10,12,13,11,12,11,13,14,9,11,10,10,12,5,20,12,1,8,10,8,2,2,2,1,2,3,2,3,3,1,3
"8397",86055565,"Jorge Echeverría","2/13/2000 (23 years old)","AM (LC)","Nueva Santa Cruz","Bolivian Regional Leagues","VEN","No","3/1/2023","12/31/2023","$110K - $350K","Right","Strong","Very Strong","5'9""","147 lbs","88","11",106,135,12,12,12,10,12,13,6,10,4,4,12,17,5,13,13,12,8,12,9,9,8,15,12,11,7,11,12,10,13,12,12,7,11,12,12,7,11,13,13,10,6,11,12,8,5,10,8,10,10,2,3,3,1,4,1,3,2,2,1,1
"8398",86056118,"Christian Larotonda","5/26/1999 (24 years old)","DM, M (C)","Metropolitanos","Venezuelan Premier Division","VEN","Yes","1/9/2022","12/31/2023","$75K - $750K","Right","Weak","Very Strong","5'9""","160 lbs","130","3",112,135,13,13,12,7,12,14,12,9,8,9,12,10,12,13,13,13,12,12,12,13,15,10,14,10,10,14,12,13,13,12,12,8,14,12,14,11,12,11,12,13,12,11,7,13,8,5,13,14,13,2,1,2,2,2,3,1,2,3,1,3
"8399",86061304,"Freddy Vargas","4/1/1999 (24 years old)","M (RL), AM (RLC)","Metropolitanos","Venezuelan Premier Division","VEN","No","6/3/2022","12/31/2024","$150K - $1.5M","Right","Weak","Very Strong","5'10""","158 lbs","165","16",116,135,12,12,15,8,12,13,9,12,6,5,13,11,7,13,14,12,10,11,12,13,15,14,10,12,8,13,12,12,13,14,13,9,15,12,13,10,13,14,13,14,15,12,5,13,4,5,14,15,13,3,2,3,2,1,3,2,2,2,2,2
"8400",86006513,"Rómulo Otero","11/9/1992 (30 years old)","M (RC), AM (RLC)","Aucas","Ecuadorian Serie A","VEN","No","3/24/2023","12/31/2024","$1.5M - $3.2M","Right","Strong","Very Strong","5'5""","145 lbs","286","55",125,135,16,15,13,13,12,18,3,16,2,11,12,9,11,14,13,12,14,12,8,8,15,15,11,14,7,8,12,10,15,15,10,3,16,14,11,4,13,10,10,8,16,12,14,11,13,13,10,13,13,2,2,1,3,3,3,2,3,1,1,2
"8401",86047757,"Sergio Córdova","8/9/1997 (25 years old)","M/AM (R), ST (C)","Vancouver","Major League Soccer","VEN","No","2/20/2023","12/31/2025","$2.8M - $5.6M","Right","Reasonable","Very Strong","6'2""","191 lbs","221","42",121,134,7,9,13,11,14,7,14,9,8,6,10,11,6,13,12,12,16,12,9,8,15,14,8,11,5,12,10,15,14,13,15,15,12,16,11,14,10,8,10,9,13,9,10,13,10,12,10,14,7,1,2,3,4,3,1,3,1,3,2,3
"8402",86071542,"Óscar Conde","6/6/2002 (21 years old)","D (LC)","Academia Puerto Cabello","Venezuelan Premier Division","VEN","No","1/20/2021","12/31/2024","$90K - $900K","Left","Very Strong","Weak","5'11""","156 lbs","22","1",101,134,9,7,8,1,10,7,12,7,10,11,7,6,12,10,15,12,12,11,12,10,6,5,12,5,11,11,8,12,13,12,11,11,11,12,13,12,8,11,12,9,12,12,12,10,6,5,18,11,8,1,2,1,2,1,1,2,2,1,2,3
"8403",2000165249,"Yair Ramos","10/13/2005 (17 years old)","DM, M (C)","Caracas","Venezuelan Premier Division","VEN","No","1/1/2022","12/31/2024","$230K - $700K","Right","Reasonable","Very Strong","5'11""","156 lbs","6","-",75,132,7,7,7,8,10,7,5,13,2,7,14,6,12,11,11,8,8,7,9,7,17,5,4,7,10,8,11,13,12,10,11,10,15,13,9,11,11,12,13,13,9,10,13,14,5,3,10,10,20,3,4,3,3,2,1,3,3,3,3,3
"8404",86006511,"Fernando Aristeguieta","4/9/1992 (31 years old)","ST (C)","Puebla","Mexican First Division","VEN","Yes","7/1/2021","6/30/2024","$55K - $550K","Right","Reasonable","Very Strong","6'2""","180 lbs","320","108",115,132,8,7,10,14,10,7,15,11,5,6,10,15,4,10,14,12,15,11,11,11,12,9,12,14,10,13,12,13,11,10,13,15,12,11,14,15,11,12,16,14,15,11,13,14,7,8,12,16,13,1,3,4,2,1,3,1,1,1,3,2
"8405",86037945,"Eduard Bello","8/20/1995 (27 years old)","M (R), AM (RL)","Mazatlán","Mexican First Division","VEN","No","12/26/2021","12/31/2023","$400K - $1.2M","Right","Fairly Strong","Very Strong","5'9""","158 lbs","254","61",118,131,13,10,13,10,11,10,9,11,3,5,11,5,6,12,14,13,11,11,12,13,12,13,4,13,7,13,11,13,14,13,11,8,12,15,11,9,12,8,12,13,9,10,5,12,11,4,9,11,11,1,3,4,1,2,3,2,2,2,1,3
"8406",13183090,"Kamal Sowah","1/9/2000 (23 years old)","M (R), AM (RLC)","Club Brugge","Jupiler Pro League","GHA","No","8/27/2021","6/30/2025","$275K - $2.7M","Left Only","Very Strong","Weak","5'10""","145 lbs","110","11",124,135,10,11,12,12,12,9,7,10,5,5,10,12,12,11,11,14,13,13,12,9,14,15,5,15,8,14,12,14,16,13,12,13,13,14,14,11,13,14,11,12,14,12,5,12,5,4,5,18,16,1,2,1,4,1,3,3,1,1,2,1
"8407",86056334,"Esli García","7/14/2000 (22 years old)","M/AM (RL)","Deportivo Táchira","Venezuelan Premier Division","VEN","No","6/25/2018","12/31/2023","$170K - $1.7M","Right","Fairly Strong","Very Strong","5'4""","127 lbs","146","26",108,131,11,11,13,10,12,10,4,11,4,5,11,6,6,13,14,12,8,10,9,9,8,16,8,11,5,8,12,8,15,15,14,2,11,12,11,7,12,15,10,10,11,12,9,7,8,5,8,10,18,2,2,1,2,4,3,1,2,3,1,3
"8408",86072493,"Ángelo Lucena","1/26/2003 (20 years old)","M (L), AM (LC)","Metropolitanos","Venezuelan Premier Division","VEN","No","1/14/2023","12/31/2025","$300K - $900K","Right","Reasonable","Very Strong","5'9""","143 lbs","81","5",93,131,8,11,12,7,11,13,4,14,5,4,12,10,4,12,12,10,9,9,9,10,10,15,6,10,5,12,12,10,13,13,12,7,12,12,11,5,8,16,11,11,9,11,11,11,10,6,8,9,17,3,1,3,2,2,2,2,1,1,2,4
"8409",86059371,"Keyner De Vasconcelos","2/24/2000 (23 years old)","DM, M (C)","Znojmo","Czech Third Division MSFL","VEN","Yes","2/25/2023","6/30/2024","$16K - $150K","Right","Reasonable","Very Strong","5'7""","138 lbs","86","-",99,131,10,6,9,5,12,10,10,9,6,9,11,8,11,12,13,12,11,12,12,11,17,10,10,8,11,13,11,12,12,11,12,5,12,12,13,11,8,16,12,11,14,9,13,14,6,4,13,7,7,3,2,1,1,2,2,3,3,3,1,3
"8410",2000144460,"Fernando Basante","7/26/2003 (19 years old)","ST (C)","Monagas S.C.","Venezuelan Premier Division","VEN","No","3/20/2023","12/31/2025","$100K - $1M","Right","Reasonable","Very Strong","6'0""","174 lbs","26","3",98,130,10,8,10,12,11,10,12,9,7,6,8,4,6,11,13,11,12,11,10,10,8,13,8,11,7,10,9,10,13,12,11,12,11,13,12,10,9,13,10,12,10,12,15,7,5,3,9,15,20,2,1,1,1,3,3,1,2,2,2,2
"8411",86056406,"Junior Moreno","3/3/2000 (23 years old)","D (C), DM, M (C)","Hermanos Colmenárez","Venezuelan Premier Division","VEN","No","6/13/2022","12/31/2025","$65K - $650K","Right","Weak","Very Strong","6'2""","171 lbs","110","1",99,130,6,9,8,5,10,7,12,7,8,11,8,6,12,10,8,12,12,11,12,11,5,5,12,5,11,12,8,11,11,11,11,14,14,13,12,10,15,10,11,12,10,12,10,12,6,7,12,12,12,3,3,2,2,1,1,2,1,3,1,1
"8412",86076178,"Héctor Acosta","7/17/2000 (22 years old)","D (C)","Charlotte Independence","United States Soccer Leagues Division One","VEN","Yes","2/15/2022","11/30/2023","$190K - $1.9M","Right","Reasonable","Very Strong","5'11""","152 lbs","69","6",95,130,5,6,10,5,10,6,12,6,8,10,11,5,12,12,18,12,13,11,10,10,7,10,8,8,11,13,12,12,13,11,11,10,11,12,13,12,6,19,9,10,12,13,13,18,5,3,10,9,13,2,1,1,3,2,1,2,4,2,3,1
"8413",2000086472,"Kevin Kelsy","7/27/2004 (18 years old)","ST (C)","Shakhtar","Ukrainian Premier League","VEN","No","1/31/2023","12/31/2028","$600K - $6.2M","Left","Very Strong","Weak","6'4""","176 lbs","47","10",105,130,8,9,10,11,10,8,13,9,1,8,8,6,6,10,12,10,12,14,9,13,19,13,9,14,8,12,9,12,13,10,10,19,15,13,12,12,13,14,11,11,13,10,15,16,13,8,9,12,15,1,2,2,2,1,1,2,4,3,3,1
"8414",86046422,"Joel Graterol","5/15/1997 (26 years old)","GK","Panetolikos","Greek Super League 1","VEN","No","2/6/2023","6/30/2024","$100K - $1M","Right","Weak","Very Strong","6'0""","160 lbs","140","-",105,130,3,3,1,3,9,6,6,1,1,3,9,3,1,9,8,11,12,11,10,11,11,3,9,9,10,10,9,11,12,12,12,11,13,11,12,12,11,11,10,12,11,12,5,8,10,7,11,12,11,11,10,14,10,12,11,12,5,12,11,12
"8415",86014874,"Yohandry Orozco","3/19/1991 (32 years old)","M (RL), AM (RLC)","Selangor","Malaysian Super League","VEN","No","2/15/2023","11/30/2024","Not for Sale","Left","Very Strong","Weak","5'5""","136 lbs","324","59",123,130,12,12,13,12,13,11,10,11,5,11,13,9,11,15,10,11,11,11,12,12,12,16,7,12,11,12,13,12,14,17,12,5,10,13,10,10,8,19,13,12,12,14,10,10,5,4,20,12,5,1,1,3,2,3,2,3,3,2,1,3
"8416",86055612,"Ignacio Anzola","7/28/1999 (23 years old)","D (RC)","Deportivo La Guaira","Venezuelan Premier Division","VEN","No","1/25/2023","12/31/2023","$90K - $900K","Right","Weak","Very Strong","6'1""","160 lbs","64","2",105,130,6,8,10,5,11,1,13,5,8,11,10,8,12,12,11,12,13,11,12,12,9,5,8,8,12,12,10,11,12,11,11,12,12,12,12,11,10,11,11,12,11,10,12,8,6,5,11,11,11,3,2,2,3,2,2,2,2,2,1,1
"8417",28112993,"Tariq Lamptey","9/30/2000 (22 years old)","D/WB (RL), M (R)","Brighton","English Premier Division","GHA","No","1/17/2021","6/30/2025","$86M - $103M","Right","Weak","Very Strong","5'5""","136 lbs","70","1",137,155,6,11,14,8,12,6,7,7,6,7,12,9,11,12,10,12,14,13,12,11,14,11,8,11,9,12,10,14,19,16,15,2,8,16,14,6,16,14,12,14,15,14,12,15,6,5,16,9,10,2,3,2,2,2,2,2,2,3,2,2
"8418",12006112,"Mubarak Wakaso","7/25/1990 (32 years old)","M (RLC), AM (RL)","Shenzhen","Chinese Super League","GHA","No","1/1/2021","12/31/2024","Not for Sale","Left","Very Strong","Reasonable","5'7""","171 lbs","271","11",108,135,11,14,13,9,9,11,9,13,14,12,11,9,12,10,19,10,16,7,7,8,11,12,4,14,10,9,13,17,13,14,12,7,17,13,12,11,11,5,7,7,7,10,8,11,16,15,11,12,12,3,1,3,1,2,2,1,1,1,1,4
"8419",86043118,"Yordan Osorio","5/10/1994 (29 years old)","D (C)","Parma","Italian Serie B","VEN","No","10/5/2020","6/30/2024","$375K - $3.8M","Right","Reasonable","Very Strong","6'1""","176 lbs","210","10",124,130,2,7,10,5,14,6,13,4,10,14,12,4,12,13,14,13,12,12,12,13,13,8,12,7,14,15,8,15,12,12,13,13,14,12,15,14,9,13,12,13,14,10,10,14,7,6,11,12,12,1,2,2,3,3,2,3,1,1,3,2
"8420",70093800,"Çağlar Söyüncü","5/23/1996 (27 years old)","D (C)","Leicester","Sky Bet Championship","TUR","No","6/14/2021","6/30/2025","$15.5M - $24M","Right","Fairly Strong","Very Strong","6'1""","180 lbs","182","7",136,162,4,7,11,7,12,5,14,8,8,15,10,8,16,10,12,14,16,11,11,10,16,9,10,7,14,13,12,14,14,12,15,16,13,12,13,15,7,6,11,12,14,9,9,15,13,5,10,16,12,2,2,1,4,1,3,3,2,3,3,3
"8421",2000077193,"Arda Güler","2/25/2005 (18 years old)","AM (RC)","Fenerbahçe","Turkish Super League","TUR","No","6/13/2022","6/30/2026","$28M - $33M","Left","Very Strong","Weak","5'9""","149 lbs","32","7",125,161,15,15,14,11,16,14,11,16,8,7,16,14,7,18,14,14,10,13,10,10,16,17,12,11,6,16,16,13,13,14,12,6,14,10,11,6,11,17,15,16,16,8,8,14,10,5,13,20,10,2,2,3,3,2,1,2,3,3,3,2
"8422",92026209,"Hakan Çalhanoğlu","2/8/1994 (29 years old)","DM, M/AM (C)","Inter","Italian Serie A","TUR","Yes","7/1/2021","6/30/2027","$108M - $130M","Right","Fairly Strong","Very Strong","5'10""","152 lbs","363","77",157,160,18,17,11,13,17,16,7,17,4,10,18,16,12,16,11,14,10,16,12,15,12,17,10,14,12,16,17,10,12,14,12,7,16,12,12,9,16,14,16,14,14,7,5,11,8,6,14,16,12,3,3,3,1,3,1,2,3,1,3,2
"8423",37061602,"Orkun Kökçü","12/29/2000 (22 years old)","M/AM (C)","Benfica","Portuguese Premier League","TUR","Yes","6/10/2023","6/30/2028","$36M - $54M","Right","Fairly Strong","Very Strong","5'9""","158 lbs","119","23",142,160,14,14,13,12,14,15,7,16,6,6,16,15,6,15,9,11,12,16,14,14,14,13,14,13,7,14,16,11,12,13,14,9,15,13,14,12,12,11,13,13,12,12,7,12,12,3,13,16,11,1,1,3,2,2,3,1,2,2,3,3
"8424",70118933,"Cenk Özkacar","10/6/2000 (22 years old)","D (C)","Valencia","Spanish First Division","TUR","No","8/18/2020","6/30/2027","$5.4M - $10M","Left","Very Strong","Weak","6'3""","198 lbs","82","3",130,154,5,6,9,7,12,5,13,5,6,14,11,8,15,11,16,13,16,13,13,13,15,7,12,7,13,14,10,16,13,10,12,16,12,13,14,15,10,9,11,15,13,10,7,16,13,10,14,14,14,1,1,3,2,3,3,1,2,1,1,3
"8425",2000204344,"Emre Gökay","2/18/2006 (17 years old)","M/AM (RL)","Sivasspor","Turkish Super League","TUR","No","6/1/2022","6/30/2025","$325K - $3.2M","Left","Very Strong","Fairly Strong","5'11""","156 lbs","3","1",80,153,13,7,12,8,9,13,6,11,4,4,10,13,4,11,5,8,7,9,8,7,12,16,5,11,4,7,9,8,14,12,10,7,16,12,9,10,9,19,13,10,10,13,4,13,10,6,13,10,17,3,1,1,1,1,1,2,3,3,3,1
"8426",37060600,"Ferdi Kadıoğlu","10/7/1999 (23 years old)","D/WB (RL)","Fenerbahçe","Turkish Super League","TUR","Yes","6/1/2022","6/30/2026","$14M - $21M","Right","Reasonable","Very Strong","5'9""","149 lbs","170","21",140,153,10,13,15,10,12,10,7,12,10,10,14,10,12,14,14,10,12,12,11,12,15,14,10,12,10,14,14,13,15,13,13,7,16,14,14,12,20,11,12,16,16,14,3,10,8,10,15,15,15,1,2,1,3,2,1,3,3,2,2,4
"8427",2000038244,"Ahmetcan Kaplan","1/16/2003 (20 years old)","D (C)","Ajax","Keuken Kampioen Divisie","TUR","No","8/19/2022","6/30/2027","$180K - $1.8M","Left","Very Strong","Reasonable","6'2""","158 lbs","13","-",110,152,4,6,9,6,9,5,15,4,8,13,9,7,13,9,5,9,16,16,13,12,16,6,5,5,13,12,9,13,12,9,14,14,11,11,12,13,9,18,16,14,12,18,14,11,5,5,16,15,14,2,2,3,1,1,3,1,1,2,1,1
"8428",27102375,"Emre Mor","7/24/1997 (25 years old)","AM (RLC)","Fenerbahçe","Turkish Super League","TUR","Yes","7/2/2022","6/30/2025","$6M - $7.6M","Left","Very Strong","Weak","5'7""","141 lbs","133","11",125,150,13,7,17,12,14,10,5,12,8,4,12,11,9,14,16,12,11,10,8,8,13,17,4,13,6,12,13,14,17,17,12,4,13,15,11,6,14,8,4,6,15,10,8,10,13,12,12,10,7,1,1,1,1,1,2,3,1,4,3,2
"8429",2000156783,"Ernest Nuamah","11/1/2003 (19 years old)","AM (RL)","FC Nordsjælland","3F Superliga","GHA","No","1/1/2022","6/30/2026","$25M - $31M","Left","Very Strong","Weak","5'10""","156 lbs","39","13",134,153,10,10,16,12,15,10,9,10,4,4,13,10,3,16,10,14,10,12,12,10,9,14,5,14,5,12,11,12,17,16,13,10,15,16,10,12,12,12,12,13,9,13,13,13,7,6,12,12,10,1,3,3,3,1,3,3,2,2,1,3
"8430",2000241614,"Efe Akman","3/20/2006 (17 years old)","DM, M (C)","Galatasaray","Turkish Super League","TUR","No","8/5/2022","6/30/2023","$240K - $2.4M","Right","Reasonable","Very Strong","5'7""","130 lbs","-","-",85,150,8,8,10,7,15,7,8,8,4,6,13,7,7,14,11,11,11,12,9,10,15,12,11,7,8,14,13,10,11,13,10,5,6,8,8,6,8,10,11,12,12,10,13,8,5,6,16,12,16,3,1,2,2,3,1,3,2,2,1,3
"8431",70087488,"Enes Ünal","5/10/1997 (26 years old)","ST (C)","Getafe","Spanish First Division","TUR","No","8/12/2020","6/30/2025","$5.4M - $8.2M","Right","Strong","Very Strong","6'1""","165 lbs","287","84",140,150,6,9,13,15,14,15,13,13,6,6,10,14,6,15,11,12,13,14,11,13,15,14,9,14,7,12,11,13,13,15,13,13,12,12,14,14,11,10,11,15,12,12,13,8,7,5,13,15,8,2,2,3,2,1,3,2,1,3,1,3
"8432",70097314,"Uğurcan Çakır","4/5/1996 (27 years old)","GK","Trabzonspor","Turkish Super League","TUR","No","9/8/2022","6/30/2027","$13M - $19.5M","Right","Weak","Very Strong","6'3""","171 lbs","172","-",135,150,2,2,3,2,10,2,8,1,3,3,10,5,2,10,10,14,13,13,13,12,17,5,14,2,14,13,9,13,8,16,13,14,14,9,14,13,1,13,13,15,15,17,1,18,1,7,17,13,16,12,6,17,10,16,12,11,5,13,13,13
"8433",83176849,"Merih Demiral","3/5/1998 (25 years old)","D (C)","Atalanta","Italian Serie A","TUR","No","7/1/2022","6/30/2026","$17.5M - $21M","Right Only","Weak","Very Strong","6'4""","187 lbs","148","6",145,149,4,6,7,7,10,4,15,6,6,16,11,5,18,11,19,15,19,10,11,12,18,6,14,6,14,15,9,16,13,12,14,15,15,16,15,17,5,11,10,13,15,8,12,13,16,13,13,17,9,1,3,2,1,2,3,3,1,1,1,2
"8434",70110530,"Ozan Kabak","3/25/2000 (23 years old)","D (C)","TSG Hoffenheim","Bundesliga","TUR","No","7/23/2022","6/30/2026","$19.5M - $30M","Right","Reasonable","Very Strong","6'2""","189 lbs","118","8",133,149,3,6,12,6,12,3,16,6,6,14,12,6,15,12,16,13,16,12,12,12,15,11,11,8,14,12,11,13,13,11,14,16,12,13,12,15,6,7,7,12,11,8,11,13,14,14,12,13,11,3,3,3,1,3,3,2,3,2,3,3
"8435",2000103330,"Can Uzun","11/11/2005 (17 years old)","M/AM (C), ST (C)","Nürnberg","Bundesliga 2","TUR","Yes","2/25/2022","6/30/2026","$550K - $9.6M","Right","Reasonable","Very Strong","6'1""","147 lbs","7","1",104,147,8,8,15,12,13,10,10,9,5,7,13,15,7,14,13,10,8,10,9,9,15,17,5,12,7,10,13,10,12,13,11,10,12,12,11,8,12,9,10,8,16,11,7,12,8,12,13,16,13,3,3,3,3,1,1,3,1,3,3,3
"8436",2000138835,"Kenan Yıldız","5/4/2005 (18 years old)","AM (RLC), ST (C)","Juventus","Italian Serie A","TUR","Yes","7/12/2022","6/30/2025","$550K - $5M","Right","Fairly Strong","Very Strong","6'1""","171 lbs","7","-",110,147,11,11,13,12,13,13,7,13,6,5,13,12,5,14,7,12,10,11,9,8,16,17,5,12,5,11,12,9,12,12,11,11,12,12,11,11,15,15,15,13,10,12,8,11,2,14,12,18,16,1,3,3,3,1,3,1,1,1,2,1
"8437",70099785,"Kerem Aktürkoğlu","10/21/1998 (24 years old)","AM (RLC)","Galatasaray","Turkish Super League","TUR","No","12/8/2021","6/30/2026","$20M - $24M","Right","Reasonable","Very Strong","5'8""","145 lbs","185","49",140,147,13,10,14,13,13,14,6,13,4,3,12,12,3,15,13,15,14,12,12,13,18,15,13,16,4,14,16,13,17,18,12,7,14,12,14,8,12,7,8,16,16,10,4,14,10,5,18,16,8,2,1,3,2,2,1,1,3,3,2,3
"8438",70052844,"Okay Yokuşlu","3/9/1994 (29 years old)","DM, M (C)","West Brom","Sky Bet Championship","TUR","No","7/18/2022","6/30/2025","$14.5M - $22M","Right","Reasonable","Very Strong","6'3""","174 lbs","362","23",136,146,8,10,11,12,15,12,15,12,5,13,15,13,15,15,12,15,13,14,11,12,12,13,12,13,14,15,13,14,10,10,15,15,13,12,14,15,10,12,14,15,12,15,12,12,13,5,13,15,11,3,1,1,1,3,4,1,1,2,2,1
"8439",70110533,"Yunus Akgün","7/7/2000 (22 years old)","M (C), AM (RC)","Galatasaray","Turkish Super League","TUR","No","12/7/2022","6/30/2026","$4.5M - $8.6M","Left","Very Strong","Reasonable","5'8""","143 lbs","103","15",128,145,12,12,15,11,13,10,9,12,5,4,13,10,4,15,12,10,12,12,10,10,12,16,8,12,6,13,13,11,15,18,12,6,14,14,12,8,10,16,14,14,8,12,5,13,10,8,12,12,10,3,2,1,2,2,3,2,1,3,1,3
"8440",29244869,"Kamaldeen Sulemana","2/15/2002 (21 years old)","AM (RL)","Southampton","Sky Bet Championship","GHA","No","1/31/2023","6/30/2027","$20M - $24M","Right","Fairly Strong","Very Strong","5'9""","152 lbs","94","21",132,149,8,11,15,14,12,6,5,12,2,3,11,10,3,16,9,12,11,12,9,12,13,17,3,14,5,9,12,12,18,15,8,8,12,18,8,7,9,13,13,14,10,10,12,10,13,10,11,13,12,1,1,2,3,3,2,3,4,3,2,4
"8441",91139869,"Salih Özcan","1/11/1998 (25 years old)","DM, M (C)","Borussia Dortmund","Bundesliga","TUR","Yes","7/1/2022","6/30/2026","$9.2M - $11M","Right","Reasonable","Very Strong","6'0""","163 lbs","186","12",138,145,13,11,12,8,13,12,13,11,8,13,15,12,14,13,16,14,16,13,13,13,16,12,12,10,13,15,13,16,12,12,15,12,14,14,15,13,17,14,17,13,13,12,8,15,10,7,13,16,8,1,3,3,1,3,1,3,2,2,3,3
"8442",70096289,"Cengiz Ünder","7/14/1997 (25 years old)","M (R), AM (RLC)","OM","Ligue 1 Uber Eats","TUR","No","6/30/2022","6/30/2025","$15.5M - $19M","Left","Very Strong","Reasonable","5'8""","145 lbs","236","46",138,144,13,14,15,12,14,14,7,14,3,3,12,9,4,15,7,11,11,13,12,11,12,15,5,13,4,12,12,12,17,16,13,7,12,16,11,10,13,12,11,13,12,13,12,14,10,5,13,14,12,3,2,2,1,3,1,1,3,3,4,4
"8443",70099201,"Altay Bayındır","4/14/1998 (25 years old)","GK","Fenerbahçe","Turkish Super League","TUR","No","6/14/2021","6/30/2026","$6.4M - $7.8M","Right","Reasonable","Very Strong","6'6""","194 lbs","143","-",130,144,5,3,3,1,11,7,8,3,3,1,12,1,3,10,16,15,16,8,7,8,12,4,15,3,12,10,10,14,10,15,14,19,7,10,11,16,15,13,15,12,10,15,6,12,5,5,12,15,18,10,14,14,13,16,15,17,12,10,13,15
"8444",91001078,"Cenk Tosun","6/7/1991 (32 years old)","AM (RL), ST (C)","Beşiktaş","Turkish Super League","TUR","Yes","7/4/2022","6/30/2024","$6M - $9M","Right","Strong","Very Strong","6'0""","171 lbs","313","120",130,143,1,5,12,16,12,8,14,10,1,2,12,17,2,12,12,14,14,15,14,14,17,12,16,14,2,14,12,14,12,12,12,13,14,10,12,13,14,15,15,15,10,15,13,15,10,5,14,14,12,2,4,3,4,3,1,1,3,2,3,2
"8445",70123237,"Bertuğ Yıldırım","7/12/2002 (20 years old)","ST (C)","Hatayspor","Turkish Super League","TUR","No","6/24/2021","6/30/2024","$5.4M - $10M","Right","Reasonable","Very Strong","6'1""","178 lbs","75","13",118,143,6,9,12,14,13,4,15,11,3,6,11,10,7,13,15,11,14,12,11,10,14,13,6,13,7,13,11,13,13,10,13,13,15,14,13,13,8,18,5,12,13,11,10,10,12,6,13,13,9,1,4,1,2,2,3,2,3,3,1,3
"8446",2000154217,"Semih Kılıçsoy","8/15/2005 (17 years old)","AM (RL), ST (C)","Beşiktaş","Turkish Super League","TUR","No","11/25/2021","6/30/2024","$3.9M - $7.6M","Right","Strong","Very Strong","5'9""","147 lbs","4","-",100,143,4,7,12,13,12,6,9,12,4,3,10,11,5,12,14,11,12,12,10,9,15,15,7,11,6,12,9,12,13,10,12,9,15,11,10,10,10,10,12,14,10,14,4,10,8,8,14,14,7,1,1,1,1,1,2,3,2,1,1,3
"8447",91000354,"Ömer Toprak","7/21/1989 (33 years old)","D (C)","Antalyaspor","Turkish Super League","TUR","Yes","7/1/2022","6/30/2024","$130K - $1.3M","Right","Reasonable","Very Strong","6'1""","182 lbs","362","13",115,143,4,6,7,5,11,5,11,5,9,12,11,7,12,11,8,15,12,13,12,14,11,8,14,7,17,14,10,10,7,10,13,12,11,9,10,14,8,12,16,16,11,14,18,11,9,5,12,15,8,3,1,2,3,1,2,4,1,3,1,3
"8448",2000038265,"Serdar Saatçı","2/14/2003 (20 years old)","D (C)","BRG","Portuguese Premier League","TUR","No","9/1/2022","6/30/2027","$6.2M - $11.5M","Right","Reasonable","Very Strong","6'3""","198 lbs","19","1",126,142,3,7,12,8,13,5,12,6,11,13,13,4,16,14,15,13,15,12,9,12,13,6,8,8,12,14,12,13,13,11,14,13,15,14,13,15,16,17,16,14,13,9,5,10,12,2,11,11,11,1,1,1,1,1,3,1,2,3,2,1
"8449",70117167,"Doğan Alemdar","10/29/2002 (20 years old)","GK","Rennes","French National 3 - Group E","TUR","No","8/18/2021","6/30/2026","$45K - $475K","Right Only","Weak","Very Strong","6'4""","182 lbs","47","-",105,142,1,1,1,1,8,1,2,2,1,1,9,1,2,9,8,9,13,12,13,9,5,7,8,8,10,14,6,15,10,11,13,12,12,11,14,14,1,10,13,8,13,13,5,12,6,7,12,10,9,12,11,13,12,13,12,12,7,12,12,13
"8450",2000241608,"Adnan Karahisar","1/1/2006 (17 years old)","ST (C)","Beşiktaş","Turkish Super League","TUR","No","9/26/2022","6/30/2023","$55K - $550K","Right","Strong","Very Strong","6'1""","156 lbs","-","-",65,140,2,4,8,11,9,2,8,7,2,3,7,9,2,12,12,9,12,11,8,8,15,14,10,9,4,11,7,13,10,10,8,9,14,9,8,8,10,10,12,14,12,16,4,10,7,8,10,10,11,3,2,2,3,2,2,3,1,3,3,2
"8451",49060803,"Salis Abdul Samed","3/26/2000 (23 years old)","DM, M (C)","RC Lens","Ligue 1 Uber Eats","GHA","No","6/8/2023","6/30/2028","$12M - $15M","Right","Weak","Very Strong","5'10""","152 lbs","76","2",136,148,8,11,12,6,13,10,12,9,9,14,14,8,15,13,16,14,15,13,14,13,14,11,10,12,14,15,14,16,13,13,13,13,16,13,14,14,8,12,11,12,10,10,10,11,11,10,15,11,11,3,1,1,3,1,1,1,2,1,3,1
"8452",70131673,"Emrecan Uzunhan","2/26/2001 (22 years old)","D (C)","Beşiktaş","Turkish Super League","TUR","No","7/20/2022","6/30/2027","$2M - $4.1M","Left","Very Strong","Reasonable","6'2""","176 lbs","34","-",105,140,3,6,10,6,11,5,12,5,7,12,12,4,13,10,11,12,13,11,12,12,14,9,9,7,11,13,10,12,12,12,12,12,14,12,12,13,11,14,11,11,10,8,8,10,10,2,12,13,20,1,3,3,1,3,4,1,3,2,2,3
"8453",91017783,"Yunus Mallı","2/24/1992 (31 years old)","M/AM (C)","Kasımpaşa","Turkish Super League","TUR","Yes","1/1/2023","6/30/2025","Not for Sale","Right","Fairly Strong","Very Strong","5'10""","158 lbs","273","44",105,140,13,12,14,9,13,12,7,11,4,6,11,13,8,15,10,13,7,12,9,11,5,14,5,11,10,12,14,13,13,15,12,7,11,7,10,7,13,18,14,11,8,12,9,10,4,9,11,5,7,1,2,2,2,3,1,1,1,3,2,3
"8454",2000050181,"Alptekin Çaylı","10/22/2004 (18 years old)","M (C), AM (RC)","Kastamonuspor","Turkish 2. League Red Group","TUR","No","6/1/2023","6/30/2025","$130K - $375K","Left Only","Very Strong","Weak","5'10""","141 lbs","38","-",90,140,12,11,15,6,14,13,5,8,2,5,14,11,6,15,8,11,5,10,8,7,14,16,5,12,5,11,13,11,14,14,8,8,10,12,9,6,12,9,11,14,6,11,7,11,5,8,12,11,15,1,2,2,2,2,3,3,3,1,3,2
"8455",70103149,"Yusuf Yazıcı","1/29/1997 (26 years old)","M (C), AM (RC)","LOSC","Ligue 1 Uber Eats","TUR","No","8/6/2019","6/30/2024","$7.6M - $9.2M","Left Only","Very Strong","Weak","6'0""","163 lbs","176","40",131,140,15,15,16,14,18,14,9,14,7,7,15,18,8,16,15,13,11,15,12,13,15,18,16,13,8,15,16,14,11,13,9,13,13,11,11,12,16,13,11,15,14,16,10,14,14,2,9,15,13,1,3,1,4,2,3,2,2,2,2,1
"8456",91203875,"Cem Türkmen","3/29/2002 (21 years old)","DM, M/AM (C)","Clermont","French National 3 - Group K","TUR","Yes","7/9/2021","6/30/2026","$10K - $110K","Right Only","Weak","Very Strong","5'9""","143 lbs","57","1",108,140,5,9,12,10,13,9,6,10,5,10,14,10,12,12,12,12,10,14,12,15,10,10,8,11,11,12,12,11,12,12,9,8,14,12,12,9,13,16,10,9,11,11,7,10,8,8,10,9,11,1,3,4,2,3,2,1,1,2,2,2
"8457",70076282,"Ozan Tufan","3/23/1995 (28 years old)","M/AM (C), ST (C)","Hull","Sky Bet Championship","TUR","No","7/1/2022","6/30/2025","$5.6M - $8.6M","Right","Reasonable","Very Strong","5'10""","176 lbs","240","29",126,140,6,7,14,15,13,4,12,15,8,12,15,14,13,13,16,11,16,13,10,11,12,11,11,11,11,15,13,13,12,10,14,11,14,12,11,16,16,10,15,8,10,14,7,11,10,10,12,10,12,2,1,3,1,1,2,3,4,1,2,1
"8458",70121604,"Rıdvan Yılmaz","5/21/2001 (22 years old)","D/WB/M (L)","Rangers","cinch Premiership","TUR","No","7/25/2022","5/31/2027","$17.5M - $26M","Left Only","Very Strong","Weak","5'9""","143 lbs","61","4",126,140,6,13,14,9,14,7,10,9,11,11,14,8,12,15,12,12,14,13,14,12,13,14,7,14,12,14,13,15,15,14,13,10,15,15,13,8,8,18,12,14,11,14,8,12,10,6,15,9,11,2,2,1,1,2,2,1,2,3,2,1
"8459",70097248,"Zeki Çelik","2/17/1997 (26 years old)","D (RL), WB (R)","AS Roma","Italian Serie A","TUR","No","7/5/2022","6/30/2026","$3.3M","Right","Fairly Strong","Very Strong","5'11""","171 lbs","240","10",133,140,9,12,11,6,12,5,11,8,13,12,14,5,14,12,8,13,15,13,14,13,14,10,7,14,12,14,8,16,14,12,12,11,14,15,14,13,17,10,10,14,11,12,5,12,4,8,13,15,14,1,2,3,1,1,2,3,2,3,2,3
"8460",37079279,"Naci Ünüvar","6/13/2003 (19 years old)","AM (LC), ST (C)","Ajax","Keuken Kampioen Divisie","TUR","Yes","7/4/2022","6/30/2026","$425K - $4.2M","Right","Fairly Strong","Very Strong","5'6""","132 lbs","81","25",121,140,10,8,15,11,15,13,4,11,5,7,13,12,6,17,12,13,10,11,9,12,15,16,6,12,7,10,13,13,12,14,12,6,13,13,10,8,8,12,9,13,12,13,8,13,8,6,11,14,10,3,2,1,4,2,2,1,2,1,1,2
"8461",28020561,"Oğuzhan Özyakup","9/23/1992 (30 years old)","M/AM (C)","Fortuna Sittard","Eredivisie","TUR","Yes","9/1/2022","6/30/2024","$2.6M - $5.4M","Right","Fairly Strong","Very Strong","5'11""","165 lbs","250","33",120,140,13,13,13,8,15,12,6,9,4,5,15,11,5,16,10,14,10,12,12,15,9,14,6,13,8,14,16,10,12,13,10,10,10,10,12,9,8,10,10,10,16,13,8,10,7,9,10,8,12,2,2,3,2,2,2,1,4,4,2,1
"8462",2000205565,"Ibrahim Sulemana","5/22/2003 (20 years old)","DM, M (C)","Hellas Verona","Italian Serie A","GHA","No","8/26/2021","6/30/2027","$5.2M - $9.8M","Right","Reasonable","Very Strong","5'11""","171 lbs","16","-",124,147,8,9,9,7,11,8,11,10,8,12,12,8,15,11,13,14,15,9,12,12,14,10,8,11,14,14,11,14,13,13,14,12,11,13,14,14,10,10,11,14,8,11,8,10,16,9,9,14,12,4,2,3,1,2,3,3,3,2,1,3
"8463",8157608,"Sinan Bolat","9/3/1988 (34 years old)","GK","Westerlo","Jupiler Pro League","TUR","Yes","7/1/2022","6/30/2026","Not for Sale","Right Only","Weak","Very Strong","6'2""","169 lbs","333","-",123,140,2,2,1,2,12,6,13,3,1,6,12,1,12,12,5,12,15,12,12,11,15,16,11,1,8,8,8,12,13,15,11,16,12,14,11,11,13,7,12,13,12,14,14,15,14,6,15,18,16,13,15,16,7,13,14,11,11,11,11,12
"8464",8485477,"Volkan Babacan","8/11/1988 (34 years old)","GK","Başakşehir FK","Turkish Super League","TUR","No","6/18/2021","6/30/2024","$400K - $1.2M","Right","Reasonable","Very Strong","6'4""","189 lbs","298","-",110,140,4,2,2,2,8,5,10,2,2,3,9,3,3,7,9,13,13,11,12,13,10,6,14,4,12,12,8,11,7,10,12,15,14,7,10,12,14,17,15,15,12,18,5,12,3,5,18,7,7,13,8,10,13,11,15,13,5,14,12,13
"8465",70112874,"Barış Alper Yılmaz","5/23/2000 (23 years old)","AM (RL), ST (C)","Galatasaray","Turkish Super League","TUR","No","5/8/2023","6/30/2027","$7.4M - $11.5M","Right","Weak","Very Strong","6'1""","165 lbs","114","13",125,140,7,9,13,12,11,6,12,12,6,5,9,11,6,12,16,11,15,12,13,8,16,13,6,13,5,13,8,16,14,14,15,13,15,17,14,15,12,11,14,16,10,11,9,12,7,2,14,14,8,2,3,1,3,2,3,1,3,2,2,3
"8466",70099762,"Abdülkadir Ömür","6/25/1999 (23 years old)","M (R), AM (RC)","Trabzonspor","Turkish Super League","TUR","No","1/17/2023","6/30/2027","$9M - $13.5M","Left Only","Very Strong","Weak","5'6""","143 lbs","159","22",125,140,12,12,14,12,14,11,7,13,2,7,15,11,6,17,12,13,15,13,13,12,16,16,10,17,7,14,12,14,15,16,11,8,13,12,13,8,15,12,18,13,13,18,12,14,5,11,12,15,10,1,2,2,1,1,2,4,1,1,1,2
"8467",70002610,"Batuhan Karadeniz","4/24/1991 (32 years old)","ST (C)","Van Spor FK","Turkish 2. League White Group","TUR","No","1/1/2023","6/30/2024","$18K - $170K","Right","Fairly Strong","Very Strong","6'5""","216 lbs","298","115",100,140,5,8,11,15,14,9,13,11,3,6,12,14,2,14,10,13,10,13,5,11,5,13,7,13,5,6,11,4,8,9,12,16,10,11,7,14,1,12,5,3,20,5,5,14,16,20,8,10,8,2,2,2,4,1,2,3,1,3,2,2
"8468",37071106,"Halil Dervişoğlu","12/8/1999 (23 years old)","AM (RLC), ST (C)","Brentford","English Premier Division","TUR","Yes","1/1/2020","6/30/2026","$600K - $6M","Right","Strong","Very Strong","6'0""","165 lbs","139","45",115,140,8,8,14,11,14,8,10,10,5,5,10,11,5,15,9,12,7,13,9,11,10,17,7,12,6,11,13,7,12,13,13,10,13,12,11,11,12,13,12,8,12,7,5,12,8,8,12,9,9,1,1,3,1,2,1,1,3,3,1,3
"8469",70118983,"İsmail Yüksek","1/26/1999 (24 years old)","DM, M (C)","Fenerbahçe","Turkish Super League","TUR","No","1/20/2023","6/30/2027","$8M - $10M","Right","Strong","Very Strong","6'0""","169 lbs","116","13",130,140,8,9,13,10,12,10,10,12,8,13,13,9,13,13,16,12,16,13,12,10,17,12,8,10,10,15,14,17,13,13,14,12,14,11,15,13,12,15,11,12,9,18,4,10,16,3,13,10,20,1,1,2,2,4,2,3,3,2,3,3
"8470",16184687,"Mert Müldür","4/3/1999 (24 years old)","D/WB (R)","Sassuolo","Italian Serie A","TUR","Yes","8/20/2019","6/30/2027","$300K - $3M","Right","Fairly Strong","Very Strong","6'2""","163 lbs","174","8",124,140,4,10,12,6,13,4,12,6,10,11,12,4,13,13,14,12,12,11,9,12,16,10,8,12,12,13,11,13,14,13,14,12,13,15,14,13,14,12,12,15,11,12,11,12,9,8,11,14,14,2,2,2,3,4,3,1,3,2,1,3
"8471",2000241577,"Yusuf İnci","2/1/2005 (18 years old)","M/AM (C)","Kasımpaşa","Turkish Super League","TUR","No","12/5/2022","6/30/2025","$3.4M - $6.8M","Right","Reasonable","Very Strong","5'10""","167 lbs","-","-",95,139,10,10,13,9,12,10,10,10,7,8,12,5,11,13,13,11,13,9,8,16,15,14,12,11,9,12,12,14,12,13,10,7,10,8,7,10,13,10,12,14,11,11,5,10,14,2,20,12,18,3,1,1,3,2,1,4,3,2,3,3
"8472",2000038460,"Jankat Yılmaz","8/16/2004 (18 years old)","GK","Galatasaray","Turkish Super League","TUR","No","6/1/2023","6/30/2025","$200K - $2M","Left Only","Very Strong","Weak","6'2""","163 lbs","-","-",85,139,6,2,1,3,1,8,1,3,1,2,7,5,1,2,12,8,15,11,8,8,8,2,10,3,11,7,6,6,13,14,7,11,7,11,5,7,9,14,13,11,12,13,6,7,9,1,9,13,7,9,16,13,14,9,10,13,5,6,7,10
"8473",58156289,"Artem Sokolov","4/1/2003 (20 years old)","M/AM (LC)","Krylja Sovetov","Russian Premier League","RUS","No","2/5/2022","6/30/2026","$350K - $1.1M","Right","Reasonable","Very Strong","5'8""","143 lbs","57","3",102,157,13,11,12,10,12,12,4,7,5,8,13,13,8,12,5,12,11,12,11,12,11,15,13,11,5,9,13,9,13,15,11,6,8,11,11,6,17,16,12,11,9,11,5,15,8,8,9,11,15,1,1,3,2,3,1,1,2,1,1,3
"8474",2000105989,"Victor Melekhin","12/16/2003 (19 years old)","D (C)","Rostov","Russian Premier League","RUS","No","4/15/2022","5/31/2027","$6M - $11M","Right","Reasonable","Very Strong","5'11""","154 lbs","41","-",113,148,7,7,9,6,11,6,14,11,6,14,11,6,12,10,13,12,12,13,14,11,7,5,7,7,13,13,10,15,12,13,14,10,5,12,13,9,13,10,8,8,10,12,13,9,5,2,13,9,12,2,3,1,1,3,1,1,2,1,3,1
"8475",2000269292,"Kasra Taheri","8/6/2006 (16 years old)","ST (C)","Sepahan","Persian Gulf Premier League","IRN","No","8/6/2021","6/30/2026","$170K - $1.7M","Right","Reasonable","Very Strong","5'8""","141 lbs","-","-",85,123,6,2,13,13,13,6,12,7,4,6,7,5,4,8,13,13,8,4,6,13,6,8,7,13,6,6,7,8,13,13,7,7,5,13,12,9,8,14,9,10,12,10,9,17,9,3,16,10,11,2,1,2,3,3,3,2,3,3,1,3
"8476",13196616,"Edmond Tapsoba","2/2/1999 (24 years old)","D (C)","Bayer 04","Bundesliga","BFA","No","12/17/2020","6/30/2026","$37M - $56M","Right","Reasonable","Very Strong","6'4""","187 lbs","146","14",147,156,3,7,12,7,12,8,13,8,8,15,14,15,15,13,14,14,13,16,14,14,15,10,12,8,16,14,13,12,13,12,16,15,13,14,13,15,11,15,14,15,12,10,6,12,6,6,14,13,16,3,2,1,2,3,3,4,2,2,2,1
"8477",2000026207,"Adamo Nagalo","9/22/2002 (20 years old)","D (RC)","FC Nordsjælland","3F Superliga","BFA","No","8/1/2020","6/30/2025","$475K - $4.8M","Right","Fairly Strong","Very Strong","6'1""","165 lbs","61","2",125,150,8,7,9,5,12,7,13,6,9,13,12,8,13,12,16,14,14,13,13,10,14,7,13,8,13,14,11,14,13,13,13,13,14,13,13,13,14,10,14,14,9,11,8,9,11,8,12,13,11,2,3,3,3,4,1,2,2,2,3,3
"8478",12091814,"Dango Ouattara","2/11/2002 (21 years old)","AM (R), ST (C)","Bournemouth","English Premier Division","BFA","No","1/19/2023","6/30/2028","$52M - $78M","Left","Very Strong","Weak","5'10""","149 lbs","73","13",129,148,8,12,14,12,12,12,8,10,5,10,13,4,10,14,8,11,8,11,10,12,13,12,7,12,8,14,13,14,15,14,12,9,15,15,13,9,11,13,12,15,10,12,7,13,7,6,13,14,12,1,1,1,3,1,3,3,3,3,1,3
"8479",13112706,"Bertrand Traoré","9/6/1995 (27 years old)","AM (RL), ST (C)","Aston Villa","English Premier Division","BFA","No","9/19/2020","6/30/2024","$9.6M - $14.5M","Left Only","Very Strong","Weak","5'11""","160 lbs","229","59",128,145,13,12,14,14,15,12,12,13,4,6,12,8,5,14,8,12,9,11,10,11,13,16,7,13,10,9,11,11,14,16,10,10,12,15,13,12,13,14,14,12,13,12,13,12,10,9,7,14,13,1,2,1,2,3,2,2,1,1,3,2
"8480",13196665,"Issa Kaboré","5/12/2001 (22 years old)","D/WB (R)","Man City","English Premier Division","BFA","No","7/29/2020","6/30/2025","$1M - $2.2M","Right","Reasonable","Very Strong","5'11""","154 lbs","85","1",118,143,10,11,12,10,12,7,8,8,8,11,12,10,11,12,14,12,12,12,12,12,14,13,8,14,11,10,9,10,16,13,8,8,12,16,12,12,1,17,10,12,9,12,5,11,5,3,11,18,14,2,2,2,1,4,3,2,1,4,3,2
"8481",13196622,"Lassina Traoré","1/12/2001 (22 years old)","ST (C)","Shakhtar","Ukrainian Premier League","BFA","No","6/18/2021","6/30/2026","$6M - $9.2M","Right","Fairly Strong","Very Strong","6'0""","198 lbs","92","44",127,140,5,5,11,14,14,13,13,11,5,5,13,12,4,12,12,12,14,13,9,12,15,11,5,12,5,13,8,10,13,14,15,12,14,14,13,16,7,14,12,12,12,11,11,11,5,5,11,14,15,3,3,3,2,2,1,2,3,3,1,3
"8482",34013978,"Charles Kaboré","2/9/1988 (35 years old)","DM, M (C)","Niort","French National","BFA","Yes","7/1/2022","6/30/2024","$35K - $375K","Right Only","Weak","Very Strong","5'11""","165 lbs","380","5",115,139,10,11,9,8,12,11,11,8,10,14,14,10,11,13,11,14,15,13,16,15,16,8,14,11,15,14,14,13,8,12,13,11,16,8,10,11,14,16,14,16,12,15,1,14,14,7,12,15,15,1,2,4,4,3,1,2,1,2,2,1
"8483",48048137,"Gustavo Sangaré","11/8/1996 (26 years old)","M/AM (C)","QRM","Ligue 2 BKT","BFA","Yes","7/8/2021","6/30/2024","$950K - $2.1M","Left","Very Strong","Weak","5'11""","145 lbs","110","7",114,139,11,10,11,9,12,11,10,12,11,11,13,6,11,12,12,13,15,12,12,13,12,8,8,12,11,12,11,13,12,13,12,10,14,12,14,10,13,11,13,15,12,13,8,12,14,5,12,12,12,1,1,3,2,3,3,2,3,3,2,3
"8484",18107149,"Abou Ouattara","12/26/1999 (23 years old)","AM (RL), ST (C)","Sheriff Tiraspol","Moldovan Divizia Naţională","BFA","No","6/20/2022","12/31/2026","$600K - $1.7M","Right Only","Weak","Very Strong","5'10""","169 lbs","42","1",106,134,11,8,13,10,13,9,5,7,8,5,10,10,5,14,12,8,14,10,8,9,11,12,10,10,4,7,11,11,15,15,8,7,11,15,10,11,12,12,12,13,10,13,10,12,12,5,10,11,14,1,2,2,2,3,2,3,2,2,3,2
"8485",58152092,"Stanislav Agkatsev","1/9/2002 (21 years old)","GK","Krasnodar","Russian Premier League","RUS","No","1/1/2022","6/30/2026","$700K - $10.5M","Right","Reasonable","Very Strong","6'2""","180 lbs","61","-",116,148,4,2,2,2,7,6,2,3,2,2,15,2,2,2,6,11,16,13,12,15,9,1,12,2,11,12,10,11,8,11,11,14,9,9,9,11,15,17,12,8,12,9,10,5,7,2,15,10,15,10,10,13,10,13,9,10,10,11,9,12
"8486",37082875,"Kilian Nikiéma","6/22/2003 (19 years old)","GK","ADO Den Haag","Keuken Kampioen Divisie","BFA","Yes","4/28/2022","6/30/2025","$160K - $1.6M","Left","Very Strong","Weak","6'1""","174 lbs","1","-",99,133,3,1,1,3,5,6,1,3,3,3,11,1,2,3,13,9,14,7,14,14,10,2,11,3,10,9,8,7,12,11,9,10,6,11,2,7,9,19,8,8,13,13,5,9,8,7,13,11,13,8,5,8,5,12,12,13,6,10,12,12
"8487",85059761,"Bryan Dabo","2/18/1992 (31 years old)","DM, M (C)","Aris","Greek Super League 1","BFA","Yes","7/5/2022","6/30/2024","$1.1M - $2.3M","Right","Reasonable","Very Strong","6'1""","174 lbs","226","13",115,130,6,9,11,9,12,9,12,10,5,11,13,9,12,13,12,13,14,13,12,13,13,10,14,12,12,14,12,13,11,10,14,13,12,11,12,15,14,9,12,13,10,10,10,13,13,12,12,13,10,3,2,2,2,3,1,3,2,2,3,4
"8488",67193003,"Blati Touré","8/4/1994 (28 years old)","DM, M (RC)","Pyramids","Egyptian Premier League","BFA","No","1/29/2022","7/31/2023","$55K - $550K","Right","Weak","Very Strong","5'7""","136 lbs","162","3",123,130,9,10,16,8,15,9,9,9,5,11,15,11,14,14,11,14,11,14,13,14,15,10,8,11,11,15,14,15,14,15,12,7,10,13,11,12,9,10,11,9,8,7,7,8,8,4,15,14,15,2,1,1,3,2,3,2,2,2,3,1
"8489",12092915,"Joffrey Bazié","10/27/2003 (19 years old)","M (C), AM (RLC)","LOSC","French National 3 - Group G","BFA","No","1/14/2022","6/30/2026","$120K - $1.2M","Left Only","Very Strong","Weak","5'10""","160 lbs","23","3",90,129,8,10,14,14,14,8,6,9,1,7,13,7,10,12,11,10,4,9,9,14,15,11,10,14,9,9,12,13,14,9,9,4,5,12,13,6,12,19,10,9,8,14,9,8,10,8,19,12,15,2,1,4,3,2,2,3,2,3,2,3
"8490",13197750,"Bassirou Compaoré","4/23/1998 (25 years old)","ST (C)","Don Benito","Spanish Federation Third Group 14","BFA","No","1/1/2023","6/30/2024","$50K - $500K","Right","Weak","Very Strong","6'0""","165 lbs","112","18",105,129,8,7,11,11,12,8,12,9,9,5,12,9,6,12,12,11,9,10,9,11,4,9,8,12,8,13,9,12,13,10,8,11,12,13,14,14,13,20,11,11,11,12,5,12,10,3,12,14,14,2,3,1,2,2,2,3,2,3,2,3
"8491",12092149,"Moumouni Kaboré","2/28/2005 (18 years old)","ST (C)","RC Kadiogo","Burkinabé D1","BFA","No","7/1/2022","6/30/2025","$0","Right","Reasonable","Very Strong","6'1""","163 lbs","47","3",87,127,4,8,13,14,14,7,14,6,2,5,8,6,1,11,5,6,8,7,3,12,6,12,4,14,8,7,4,8,14,13,5,13,10,14,10,5,8,16,12,12,11,11,15,7,12,3,10,11,19,1,3,2,1,2,3,2,3,2,1,1
"8492",12094016,"Abdel Rachid Zagré","3/9/2004 (19 years old)","ST (C)","Sion","Swiss First League Classic Group 1","BFA","No","7/1/2022","6/30/2026","$150K - $1.5M","Right Only","Weak","Very Strong","6'2""","174 lbs","74","23",88,127,8,8,10,9,14,9,11,7,3,8,9,8,3,10,7,15,7,9,9,9,7,15,13,12,10,10,8,9,14,9,8,13,8,13,11,13,10,12,13,12,10,13,11,7,7,1,11,12,20,1,2,3,1,3,3,1,1,1,1,1
"8493",12094986,"Aboubacar Camara","9/30/2006 (16 years old)","AM (RL)","CF Rahimo","Burkinabé D1","BFA","No","7/1/2022","6/30/2026","$18K - $190K","Left Only","Very Strong","Weak","5'6""","116 lbs","8","2",81,127,6,11,12,11,12,7,7,8,3,7,14,6,7,11,10,4,4,9,8,14,7,10,11,11,4,7,9,9,14,14,8,3,15,14,8,1,11,18,10,9,11,10,6,11,8,3,15,12,19,2,1,2,1,1,2,2,2,1,1,2
"8494",12095236,"Arouna Ouattara","12/27/2006 (16 years old)","M (C)","Vitesse (BFA)","Burkinabé D1","BFA","No","7/1/2022","6/30/2026","$0 - $140K","Right Only","Weak","Very Strong","6'2""","163 lbs","7","-",74,126,9,6,3,3,14,13,5,10,5,6,10,5,5,12,7,10,8,8,6,13,11,7,11,9,7,8,14,11,12,12,8,15,12,12,7,7,8,17,12,12,12,11,12,10,10,6,8,10,19,1,1,1,3,2,3,3,2,1,1,4
"8495",85100394,"Steeve Yago","12/16/1992 (30 years old)","D (RC), WB (R)","Aris Limassol","Cypriot First Division","BFA","Yes","7/1/2021","6/30/2025","$190K - $1.9M","Right Only","Weak","Very Strong","5'11""","169 lbs","223","1",115,125,6,11,11,6,13,7,8,5,8,13,10,9,12,9,15,13,15,10,12,13,14,7,8,7,10,13,7,13,14,13,13,10,14,13,15,14,8,14,12,13,15,15,7,12,12,3,10,13,12,2,1,2,2,1,2,3,1,2,1,1
"8496",2000242071,"Danila Kozlov","1/19/2005 (18 years old)","M/AM (C)","Zenit","Russian Premier League","RUS","No","1/13/2023","6/30/2026","$150K - $1.5M","Right","Reasonable","Very Strong","6'0""","160 lbs","2","-",76,147,8,8,8,8,9,6,6,8,6,8,11,8,10,8,14,10,7,8,7,12,17,15,8,11,10,9,10,8,12,13,8,10,14,11,11,9,12,13,10,10,11,10,11,1,11,1,12,12,17,2,1,3,1,1,2,2,1,1,1,3
"8497",34001338,"Alain Traoré","1/1/1988 (35 years old)","M (C), AM (LC)","AS Arta","Djiboutian Premier Division","BFA","Yes","9/1/2021","-","$0","Left","Very Strong","Weak","5'9""","160 lbs","184","30",100,125,12,12,13,10,12,12,8,13,6,4,12,12,5,12,7,12,9,10,10,11,14,15,7,12,9,10,12,10,12,13,12,8,11,12,12,9,8,16,16,10,12,13,10,14,7,7,8,17,11,3,2,2,1,2,1,4,3,3,1,3
"8498",49052374,"Mamady Bangré","6/15/2001 (21 years old)","AM (RL)","Toulouse FC","French National 2 - A","BFA","Yes","6/15/2022","6/30/2025","$325K - $3.4M","Left","Very Strong","Weak","5'8""","143 lbs","44","10",109,125,12,10,14,11,12,11,7,9,11,7,12,8,8,13,8,11,7,11,7,11,14,14,5,13,10,13,11,12,13,15,14,7,10,13,12,7,9,12,10,13,11,11,8,9,8,4,12,8,13,1,3,1,2,3,2,3,2,1,2,1
"8499",18107081,"Hassane Bandé","10/30/1998 (24 years old)","AM (RL), ST (C)","Amiens SC","Ligue 2 BKT","BFA","No","8/25/2022","6/30/2025","$0","Right","Weak","Very Strong","5'10""","154 lbs","108","20",110,125,8,10,14,12,12,9,10,9,5,5,10,8,5,13,11,9,13,12,9,8,12,14,5,10,5,11,11,13,15,14,9,8,7,15,10,8,9,13,13,11,7,11,17,8,7,1,12,14,7,3,1,1,3,3,2,2,2,2,3,1
"8500",13175645,"Hervé Koffi","10/16/1996 (26 years old)","GK","Charleroi","Jupiler Pro League","BFA","No","7/6/2021","6/30/2024","$1.2M - $2.5M","Right Only","Weak","Very Strong","6'1""","178 lbs","118","-",124,125,5,1,1,2,10,7,7,3,1,1,10,5,2,9,12,13,14,12,11,12,11,3,11,2,12,12,10,13,12,14,13,12,14,12,12,13,13,14,14,13,14,10,10,12,14,6,13,11,15,11,9,16,11,12,10,12,11,11,12,14
"8501",12095080,"Ismaël Seoné","4/26/2005 (18 years old)","ST (C)","Vitesse (BFA)","Burkinabé D1","BFA","No","7/1/2022","6/30/2024","$0","Right","Fairly Strong","Very Strong","6'0""","163 lbs","29","13",88,125,4,5,14,14,14,7,14,8,5,7,6,5,3,12,14,12,6,12,8,6,8,11,1,14,3,7,7,8,14,11,3,9,13,13,5,5,8,16,10,13,12,10,14,8,6,7,8,11,14,1,2,1,3,3,2,3,1,2,3,3
"8502",13201742,"Djibril Ouattara","9/19/1999 (23 years old)","AM (RL), ST (C)","RS Berkane","Botola Pro 1","BFA","No","12/27/2018","6/30/2026","$120K - $1.2M","Right","Fairly Strong","Very Strong","5'10""","158 lbs","34","25",97,125,8,13,13,14,11,8,13,9,5,7,14,6,6,14,6,11,9,10,9,11,8,13,11,14,7,7,10,10,14,11,9,5,9,11,10,7,12,20,11,10,10,10,5,16,15,7,14,9,17,3,2,3,2,2,3,1,1,2,1,2
"8503",48036494,"Dylan Ouédraogo","7/22/1998 (24 years old)","D (LC)","OH Leuven","Jupiler Pro League","BFA","Yes","8/28/2019","6/30/2025","$190K - $1.9M","Left","Very Strong","Reasonable","6'1""","165 lbs","54","-",108,124,9,13,8,7,9,10,13,6,8,16,8,5,13,10,12,12,12,11,12,12,13,8,11,13,11,12,11,11,12,8,11,12,13,14,13,10,11,19,9,15,11,10,7,7,10,7,11,12,17,3,3,2,2,3,3,1,3,3,3,2
"8504",49050737,"Nassim Innocenti","2/19/2002 (21 years old)","D (C)","VAFC","French National 3 - Group G","BFA","Yes","7/16/2022","6/30/2024","$400K - $1.2M","Left","Very Strong","Weak","6'2""","165 lbs","9","-",88,124,5,6,2,6,3,2,10,1,3,13,5,3,13,6,15,7,9,7,8,13,9,5,10,6,13,6,3,7,12,13,7,12,15,13,11,7,10,14,12,11,11,12,6,13,8,2,11,12,18,1,2,1,3,3,1,3,1,1,4,1
"8505",12095235,"Chabane Camara","1/1/2006 (17 years old)","AM (C)","Vitesse (BFA)","Burkinabé D1","BFA","No","7/1/2022","6/30/2024","$5K - $50K","Right Only","Weak","Very Strong","6'1""","165 lbs","17","1",81,123,4,6,9,12,14,6,7,8,5,5,14,3,7,12,7,8,8,5,7,14,5,11,5,9,8,8,14,9,14,13,8,12,11,14,7,8,11,11,13,10,12,10,8,9,8,8,10,11,18,1,3,2,2,1,1,4,3,3,3,2
"8506",12095271,"Nouhoun Bamba","6/2/2006 (17 years old)","D/WB (R)","SFC Koubri","Burkinabé D2 - Pool A","BFA","No","7/1/2022","6/30/2024","$2.5K - $24K","Right Only","Weak","Very Strong","5'8""","138 lbs","-","-",70,123,6,7,8,2,12,2,9,6,8,8,9,2,14,10,9,7,9,7,7,8,6,5,10,7,9,9,8,6,15,15,9,5,12,15,11,6,14,16,10,10,11,12,5,2,15,2,15,10,7,2,1,3,1,2,2,2,1,3,1,1
"8507",58152085,"Sergey Volkov","9/9/2002 (20 years old)","D (R)","Krasnodar","Russian Premier League","RUS","No","7/1/2020","6/30/2026","$5.8M - $10.5M","Right","Fairly Strong","Very Strong","6'0""","167 lbs","67","3",114,146,10,10,12,9,8,8,14,8,11,11,12,10,12,11,11,11,13,9,13,11,12,5,8,10,12,13,9,14,13,12,12,10,13,15,13,10,15,14,9,18,11,14,9,11,8,7,14,10,18,2,2,2,2,2,2,1,2,3,3,1
"8508",12080759,"Abdoul Tapsoba","8/23/2001 (21 years old)","AM (L), ST (C)","Sheriff Tiraspol","Moldovan Divizia Naţională","BFA","No","6/30/2020","6/30/2025","$70K - $700K","Right","Weak","Very Strong","5'10""","152 lbs","87","17",105,123,10,10,13,10,13,9,8,11,6,5,10,8,6,12,11,8,13,8,8,8,12,14,8,7,5,12,8,13,15,12,11,8,14,15,12,10,11,19,12,12,11,10,7,9,11,4,10,10,10,3,1,1,1,3,1,1,1,2,2,1
"8509",12095206,"Abdel Youssouf Kaboré","2/9/2005 (18 years old)","AM (RL)","US Forces Armées","Burkinabé D1","BFA","No","7/1/2022","6/30/2025","$0","Right Only","Weak","Very Strong","5'7""","145 lbs","29","2",85,122,6,12,14,11,11,4,6,8,6,5,9,6,8,12,8,10,8,8,8,7,16,11,8,9,4,8,9,13,14,14,8,2,9,13,10,1,14,19,11,9,13,9,5,7,9,4,6,10,13,2,2,1,3,3,3,4,2,1,4,2
"8510",13139364,"Cyrille Bayala","5/24/1996 (27 years old)","M/AM (RL)","AC Ajaccio","Ligue 2 BKT","BFA","No","6/30/2022","6/30/2024","$325K - $3.1M","Right","Weak","Very Strong","5'11""","149 lbs","225","27",118,122,8,11,12,10,13,8,8,12,5,6,11,10,5,13,6,11,11,11,12,10,9,12,7,13,6,12,11,13,14,14,11,10,14,15,14,11,10,13,10,10,10,13,7,11,5,3,12,13,12,2,2,1,1,2,2,1,3,2,3,2
"8511",12094698,"Mohamed Bélem","8/14/2005 (17 years old)","M (C)","Salitas FC","Burkinabé D1","BFA","No","7/1/2021","6/30/2024","$35K - $350K","Right","Weak","Very Strong","5'8""","145 lbs","24","-",86,122,7,6,7,8,14,7,4,11,4,6,14,1,12,14,12,6,5,9,5,12,16,9,11,5,6,8,14,13,14,14,6,4,7,12,10,7,12,10,11,9,13,10,10,7,12,5,6,12,11,2,2,1,1,2,1,3,2,2,1,3
"8512",12091871,"Sékou Diabaté","4/30/2002 (21 years old)","D (C), DM","RC Bobo","Burkinabé D1","BFA","No","7/1/2019","6/30/2025","$10K - $95K","Right","Fairly Strong","Very Strong","6'0""","163 lbs","73","5",88,122,7,7,2,8,12,7,9,7,7,10,12,2,14,8,5,7,8,8,10,14,13,5,3,7,14,8,12,12,12,12,4,10,11,11,7,5,13,13,11,12,10,11,6,4,8,6,11,13,16,2,1,1,1,2,1,1,3,3,1,1
"8513",2000155737,"Ousséni Bouda","4/28/2000 (23 years old)","AM (RL), ST (C)","San Jose","Major League Soccer","BFA","No","1/11/2022","12/31/2024","$1.6M - $3.4M","Right","Reasonable","Very Strong","5'10""","174 lbs","71","14",100,121,12,10,13,11,11,12,7,13,9,5,10,5,6,11,10,9,4,8,8,8,8,14,5,16,6,11,11,13,14,11,13,10,17,13,8,11,9,20,9,11,10,12,5,10,9,1,13,14,10,3,3,2,2,1,3,3,2,3,3,1
"8514",12095233,"Aly Sokondou","11/10/2006 (16 years old)","D (C)","Réal du Faso","Burkinabé D2 - Pool A","BFA","No","6/13/2022","6/30/2026","$26K - $75K","Right Only","Weak","Very Strong","6'0""","149 lbs","-","-",70,121,1,5,1,3,5,1,14,6,5,14,8,2,14,7,9,5,9,8,5,14,12,7,4,6,12,7,5,8,12,10,8,11,12,8,7,5,10,17,9,11,10,12,5,16,7,5,10,13,7,1,2,2,2,4,1,1,2,3,1,1
"8515",12095081,"Tidiane Bagaya","2/15/2004 (19 years old)","M (C)","Vitesse (BFA)","Burkinabé D1","BFA","No","7/1/2021","6/30/2024","$75K - $230K","Left","Very Strong","Reasonable","5'10""","149 lbs","42","3",90,121,5,4,5,7,13,7,5,9,1,11,13,6,7,12,6,8,7,12,6,13,8,10,12,8,9,8,13,12,13,8,7,8,13,12,10,5,14,11,11,13,11,13,11,3,5,2,11,12,10,3,2,3,2,2,3,2,1,1,2,1
"8516",13221086,"Moubarack Compaoré","9/24/2002 (20 years old)","AM (RL)","Sarpsborg","Norwegian Third Division Group 6","BFA","No","3/10/2021","12/31/2025","$0","Left","Very Strong","Weak","5'10""","154 lbs","31","7",85,120,10,14,12,11,12,9,6,10,8,7,10,9,4,12,15,10,5,11,10,10,11,11,6,9,6,10,10,7,12,12,7,5,10,12,12,5,17,16,12,11,12,10,7,6,13,2,17,11,12,1,2,1,1,3,3,3,2,3,3,3
"8517",12007157,"Adama Guira","4/24/1988 (35 years old)","DM, M (C)","Racing Rioja","Spanish Federation Third Group 16","BFA","No","1/2/2023","6/30/2024","$12K - $40K","Right Only","Weak","Very Strong","6'1""","171 lbs","329","10",101,120,11,11,6,7,11,7,13,9,10,13,10,7,15,10,16,13,15,12,12,10,13,11,11,12,12,13,7,14,12,12,14,13,15,11,12,13,11,10,14,8,12,11,2,13,13,11,11,12,11,3,1,2,3,1,2,2,2,2,2,3
"8518",2000082337,"Artem Karpukas","6/19/2002 (20 years old)","DM, M (C)","Lokomotiv Moscow","Russian Premier League","RUS","No","7/1/2020","5/31/2025","$6.6M - $8M","Right","Reasonable","Very Strong","6'0""","171 lbs","41","2",119,146,9,9,10,9,10,8,9,9,9,14,11,8,16,10,12,13,14,12,13,12,15,9,8,11,13,14,11,15,11,12,13,11,13,12,15,11,7,15,12,15,11,10,12,10,10,7,14,13,9,1,1,3,1,3,1,3,4,1,2,3
"8519",13139359,"Issoufou Dayo","8/6/1991 (31 years old)","D (C)","RS Berkane","Botola Pro 1","BFA","No","6/14/2021","6/30/2025","Not for Sale","Right Only","Weak","Very Strong","6'3""","187 lbs","171","18",116,120,5,8,8,9,12,6,14,6,9,14,11,7,13,9,15,14,14,9,13,14,15,7,12,9,14,11,11,12,11,8,14,14,15,12,13,15,16,10,14,15,10,11,13,13,13,4,14,9,10,1,2,3,2,3,1,1,3,3,3,2
"8520",13196630,"Dramane Salou","5/22/1998 (25 years old)","DM, M (C)","Urartu Ye.","Armenian High League","BFA","No","2/11/2023","6/30/2024","$0 - $50K","Right","Reasonable","Very Strong","5'9""","171 lbs","103","6",98,120,6,6,7,7,7,9,8,12,9,10,10,8,10,12,12,12,15,12,7,7,5,8,10,10,10,14,12,14,14,14,12,8,12,13,16,12,8,11,13,13,12,11,10,8,8,1,8,14,12,1,2,1,4,3,3,2,3,1,2,1
"8521",93121853,"Adama Fofana","10/11/1999 (23 years old)","D/WB/M (L)","Dijon FCO","French National","BFA","No","8/31/2021","6/30/2024","$400K - $1.2M","Left Only","Very Strong","Weak","5'8""","143 lbs","121","4",105,120,8,10,13,8,12,8,7,9,8,9,11,8,11,12,13,11,9,12,9,11,13,14,5,14,10,12,11,12,14,15,9,7,13,13,13,8,11,9,9,10,12,10,8,10,6,10,11,13,14,2,4,1,3,1,3,4,3,2,1,2
"8522",12094012,"Éric Chardey","8/6/2003 (19 years old)","D (RL)","Majestic SC","Burkinabé D1","BFA","No","7/1/2020","6/30/2025","$24K - $230K","Left","Very Strong","Fairly Strong","5'9""","152 lbs","49","3",88,120,6,13,4,3,8,3,9,6,8,11,8,5,15,9,9,11,9,9,8,15,7,8,2,6,10,9,9,9,14,15,9,5,18,12,8,8,13,18,12,11,11,12,15,2,8,7,9,11,7,2,3,3,1,1,2,2,4,1,3,1
"8523",2000306802,"Abdoul Latif Naon","3/24/2000 (23 years old)","AM (C), ST (C)","Al-Karamah","Syrian Premier League","BFA","No","6/12/2023","6/30/2024","$70K - $700K","Right","Reasonable","Very Strong","5'11""","154 lbs","-","-",89,120,8,9,10,15,10,6,15,10,5,8,10,10,6,12,5,13,1,12,8,15,12,10,12,12,8,8,3,10,14,10,9,8,15,10,7,5,12,17,12,13,11,12,6,14,7,7,11,14,15,2,3,1,2,3,3,2,3,2,3,3
"8524",13221078,"Jean Botué","8/7/2002 (20 years old)","ST (C)","AC Ajaccio","French National 3 - Group H","BFA","No","2/16/2021","6/30/2023","$0 - $35K","Left","Very Strong","Weak","6'0""","178 lbs","44","6",94,119,8,11,14,14,14,8,12,9,1,7,6,11,2,14,9,12,4,14,8,14,7,14,3,10,7,8,6,10,11,13,6,12,9,11,10,12,8,18,11,11,10,11,12,4,5,8,14,10,20,4,2,2,1,3,1,1,2,1,2,2
"8525",12094097,"Philippe Maré","11/14/2003 (19 years old)","GK","Étoile Filante","Burkinabé D1","BFA","No","7/1/2021","6/30/2025","$65K - $200K","Right","Reasonable","Very Strong","6'2""","167 lbs","33","-",89,119,5,3,1,3,4,8,1,1,3,1,11,2,1,6,8,10,9,5,12,13,13,3,10,1,9,6,6,6,12,14,7,12,14,12,3,4,10,13,9,9,10,12,10,12,13,2,14,13,10,10,6,10,12,6,8,13,5,7,12,13
"8526",12095106,"Mohamed Lamine Traoré","12/7/2004 (18 years old)","M (C)","Salitas FC","Burkinabé D1","BFA","No","7/1/2022","6/30/2024","$28K - $275K","Right Only","Weak","Very Strong","6'3""","187 lbs","30","1",89,119,8,8,9,8,15,8,8,12,5,10,15,1,9,15,5,6,9,9,4,11,19,5,5,10,8,9,14,14,9,11,9,13,11,11,10,7,11,19,9,11,9,12,9,13,11,4,8,11,13,1,1,2,3,1,1,2,2,2,1,2
"8527",12095238,"Jack Diarra","6/16/2006 (16 years old)","AM (R)","Salitas FC","Burkinabé D1","BFA","No","7/1/2022","6/30/2026","$24K - $240K","Right Only","Weak","Very Strong","5'7""","121 lbs","-","-",72,119,8,11,11,8,13,4,7,7,4,6,10,5,4,8,5,5,8,11,8,8,7,8,11,9,4,7,8,8,13,13,8,6,7,13,6,1,9,13,11,10,10,12,15,16,5,4,10,9,17,3,2,1,3,3,4,1,2,3,3,1
"8528",12095063,"Isidore Traoré","8/20/2006 (16 years old)","GK","Vitesse (BFA)","Burkinabé D1","BFA","No","7/1/2022","6/30/2026","$4K - $40K","Left Only","Very Strong","Weak","6'3""","165 lbs","1","-",79,119,3,3,1,1,1,8,1,3,3,2,11,1,3,5,8,6,11,2,10,13,17,1,6,2,10,7,6,6,13,6,2,12,9,10,3,6,8,12,11,10,12,12,9,4,12,4,8,11,16,8,6,13,6,10,12,13,5,9,7,13
"8529",58008957,"Fedor Smolov","2/9/1990 (33 years old)","ST (C)","Dinamo Moscow","Russian Premier League","RUS","No","5/31/2023","6/30/2024","$1.7M - $3.6M","Right","Fairly Strong","Very Strong","6'1""","182 lbs","326","109",127,145,10,9,11,14,14,12,8,13,10,7,12,12,6,14,12,13,12,14,12,13,15,14,11,14,9,11,13,9,14,13,11,14,14,13,12,13,12,10,10,12,9,15,6,8,13,12,12,18,15,2,3,2,4,3,4,1,2,3,3,2
"8530",16199914,"Zakaria Sanogo","12/11/1996 (26 years old)","M (R), AM (RL)","CF Rahimo","Burkinabé D1","BFA","No","2/2/2023","6/30/2024","$40K - $375K","Right","Fairly Strong","Very Strong","5'7""","132 lbs","164","17",102,119,8,9,13,8,11,6,6,7,8,8,11,8,8,11,12,7,8,6,10,10,11,8,6,11,15,13,9,12,15,14,8,4,12,15,13,7,13,13,11,12,8,10,7,7,7,6,9,11,10,1,2,1,3,2,1,3,2,3,1,2
"8531",62012567,"Stefan Savić","1/8/1991 (32 years old)","D (C)","A. Madrid","Spanish First Division","MNE","No","8/10/2021","6/30/2024","$21M - $26M","Right","Reasonable","Very Strong","6'2""","176 lbs","338","9",151,155,7,9,9,9,11,6,14,8,10,16,12,9,14,11,14,17,14,15,15,15,15,8,13,8,15,15,11,15,13,13,10,13,10,14,15,15,13,11,12,14,15,14,13,13,11,7,14,14,14,1,3,4,3,3,1,3,3,1,1,2
"8532",5789007,"Stevan Jovetić","11/2/1989 (33 years old)","ST (C)","Hertha","Bundesliga 2","MNE","No","7/27/2021","6/30/2024","$85K - $850K","Right","Reasonable","Very Strong","6'0""","174 lbs","345","96",125,155,12,10,13,13,15,14,13,13,4,5,15,15,6,16,11,14,12,15,12,13,11,17,12,13,6,11,15,11,11,12,13,11,9,12,11,11,13,15,15,13,10,9,17,15,7,7,12,13,15,1,1,1,3,2,3,3,1,2,2,2
"8533",62095383,"Adam Marušić","10/17/1992 (30 years old)","D (RL), WB (R)","Lazio","Italian Serie A","MNE","No","6/14/2021","6/30/2025","$17M - $21M","Right","Strong","Very Strong","6'1""","187 lbs","340","31",145,150,4,12,10,11,12,4,8,13,4,15,12,11,12,12,15,12,16,13,12,13,16,13,8,14,15,16,11,16,14,12,14,13,15,15,15,15,16,7,10,17,13,15,9,14,13,7,14,16,15,3,3,2,1,2,2,1,1,2,1,1
"8534",62195758,"Nikola Krstović","4/5/2000 (23 years old)","ST (C)","Dun. Streda","Slovak First Division","MNE","No","3/14/2023","6/30/2027","$400K - $10M","Right","Fairly Strong","Very Strong","6'1""","176 lbs","172","68",128,150,7,8,13,14,13,9,14,12,4,8,11,12,9,13,13,12,12,10,12,13,5,11,9,12,12,10,13,11,13,14,13,13,12,13,13,13,11,13,12,12,11,12,8,13,9,8,14,13,15,3,4,1,1,1,3,3,1,3,1,4
"8535",93065007,"Sead Hakšabanović","5/4/1999 (24 years old)","M (L), AM (LC)","Celtic","cinch Premiership","MNE","Yes","8/25/2022","5/31/2027","$9.8M - $12.5M","Right","Fairly Strong","Very Strong","5'9""","163 lbs","172","33",128,148,12,13,14,11,15,12,7,14,6,7,14,11,7,15,11,11,11,13,12,12,14,15,5,12,8,10,13,10,14,14,9,8,12,13,13,13,14,10,10,11,12,7,4,10,8,14,8,14,12,4,3,2,2,3,2,1,3,2,3,1
"8536",62060537,"Uroš Đurđević","3/2/1994 (29 years old)","ST (C)","S. Gijón","Spanish Second Division","MNE","No","8/11/2022","6/30/2027","$1.3M - $2.7M","Right Only","Weak","Very Strong","6'0""","176 lbs","314","103",121,141,7,11,10,14,13,11,11,14,7,12,11,16,12,12,16,11,17,10,13,11,11,15,12,12,11,10,11,16,13,14,11,10,17,13,15,18,8,7,12,13,12,13,8,12,11,11,10,15,12,3,1,2,1,3,4,4,2,1,3,3
"8537",2000241044,"Vasilije Adžić","5/12/2006 (17 years old)","M/AM (C)","Budućnost","Montenegrin First League","MNE","No","5/22/2023","12/31/2025","$100K - $1M","Right","Weak","Very Strong","6'2""","178 lbs","23","3",97,139,11,11,15,11,11,9,9,12,2,7,11,8,5,11,11,12,10,10,10,12,12,13,12,11,8,10,12,12,12,12,10,12,7,12,11,11,19,12,11,12,9,13,10,17,10,4,11,11,16,2,4,3,2,3,1,3,2,3,2,1
"8538",2000031831,"Lazar Mijović","3/12/2003 (20 years old)","AM (RL), ST (C)","Lommel SK","Belgian Challenger Pro League","MNE","No","9/2/2022","6/30/2026","$190K - $1.9M","Left","Very Strong","Weak","6'0""","163 lbs","67","16",107,138,9,11,11,12,12,10,11,13,10,8,11,7,7,12,7,11,6,13,6,11,8,14,13,11,10,11,11,12,12,11,11,12,15,12,11,13,11,12,11,12,13,11,10,7,5,8,12,12,11,2,1,3,4,3,2,1,1,1,3,3
"8539",62221063,"Milutin Osmajić","7/25/1999 (23 years old)","AM (L), ST (C)","Cádiz","Spanish First Division","MNE","No","7/1/2021","6/30/2024","$300K - $3.1M","Right","Reasonable","Very Strong","6'1""","180 lbs","133","33",120,138,7,10,11,13,11,7,12,13,7,4,10,11,6,11,16,12,14,12,10,11,13,10,11,13,6,11,12,11,12,10,14,13,15,15,14,17,13,7,13,11,12,10,7,11,14,1,13,13,12,1,2,3,1,2,2,3,1,3,2,2
"8540",58123738,"Matvey Safonov","2/25/1999 (24 years old)","GK","Krasnodar","Russian Premier League","RUS","No","3/1/2021","6/30/2026","$600K - $11M","Right","Reasonable","Very Strong","6'4""","191 lbs","135","-",130,145,5,2,1,3,10,7,1,3,2,2,10,3,1,9,9,13,13,15,13,14,6,8,13,1,13,10,12,10,11,13,12,16,12,12,10,15,13,13,12,12,11,13,5,14,13,3,14,9,15,15,13,17,11,13,13,7,10,11,12,14
"8541",2000099877,"Viktor Đukanović","1/29/2004 (19 years old)","AM (RLC)","Hammarby IF","Swedish Premier Division","MNE","No","1/6/2023","12/31/2027","$1.5M - $3.2M","Right","Reasonable","Very Strong","6'0""","163 lbs","70","12",114,137,9,11,13,13,13,10,7,14,5,6,12,9,9,13,9,12,13,13,12,12,13,12,5,13,9,10,11,10,13,11,11,11,10,13,12,10,7,12,13,13,13,10,6,11,8,5,12,13,13,3,3,3,3,3,4,1,4,4,1,2
"8542",62249962,"Sergej Joksimović","8/16/2002 (20 years old)","GK","Jedinstvo (BP)","Montenegrin First League","MNE","No","6/10/2022","6/30/2024","$60K - $600K","Right Only","Weak","Very Strong","6'0""","154 lbs","80","-",100,137,4,3,1,1,8,6,2,3,3,3,12,3,3,4,5,13,11,10,12,12,6,2,6,2,13,11,10,10,13,11,11,12,15,11,10,8,11,15,9,11,12,10,7,16,7,6,12,12,8,10,11,12,8,11,13,11,6,8,11,14
"8543",2000196926,"Lazar Stanišić","9/8/2004 (18 years old)","M/AM (C)","Dečić","Montenegrin First League","MNE","No","7/1/2022","6/30/2025","$45K - $450K","Right","Weak","Very Strong","5'7""","138 lbs","25","4",95,135,11,9,13,16,13,11,11,13,9,6,13,7,11,13,11,14,9,9,9,11,18,11,2,11,11,12,11,15,12,13,12,6,11,12,10,4,12,12,13,12,10,9,6,12,8,1,11,10,12,3,3,2,1,3,3,2,1,3,1,3
"8544",62235998,"Andrija Radulović","7/3/2002 (20 years old)","M/AM (L)","Radnik Surdulica","Serbian SuperLeague","MNE","No","2/9/2022","6/30/2026","$35K - $350K","Left","Very Strong","Reasonable","5'10""","149 lbs","64","16",109,135,11,13,13,11,11,11,4,13,9,8,11,12,11,13,10,10,8,9,9,11,12,14,10,9,9,8,12,11,13,12,8,9,8,14,10,10,12,12,11,12,11,9,5,12,10,5,12,10,15,4,3,2,2,2,4,4,1,1,4,2
"8545",18087977,"Matija Šarkić","7/23/1997 (25 years old)","GK","Wolves","English Premier Division","MNE","No","7/27/2020","6/30/2026","$1.5M - $3.2M","Right Only","Weak","Very Strong","6'4""","167 lbs","78","-",119,135,3,3,3,1,8,6,6,1,1,3,10,2,2,9,6,13,12,10,13,11,13,5,7,2,12,11,11,11,11,13,10,15,14,10,12,7,13,14,11,12,10,13,14,13,8,3,13,12,13,11,8,17,9,11,11,13,5,12,13,15
"8546",62178166,"Ilija Vukotić","1/7/1999 (24 years old)","DM, M (C)","BVT","Portuguese Premier League","MNE","No","7/1/2022","6/30/2025","$80K - $800K","Left Only","Very Strong","Weak","6'3""","167 lbs","101","5",115,132,11,12,12,8,13,10,11,11,10,12,14,12,8,14,13,12,14,13,12,12,12,12,12,11,13,14,13,13,11,12,14,14,13,13,13,13,13,12,11,12,12,10,10,11,10,7,14,13,13,3,3,4,2,3,4,2,3,2,2,3
"8547",14026358,"Esteban Saveljich","5/20/1991 (32 years old)","D (C)","Vallecano","Spanish First Division","MNE","No","6/14/2021","6/30/2023","$0 - $75K","Right Only","Weak","Very Strong","6'2""","180 lbs","219","8",123,132,4,5,6,5,9,5,13,5,7,14,11,6,13,10,11,13,15,12,14,13,12,5,16,7,14,14,6,13,12,11,12,13,12,13,15,15,5,9,15,15,10,7,8,12,14,6,11,13,14,2,2,3,2,2,3,3,2,1,2,4
"8548",62248956,"Nikola Janjić","7/14/2002 (20 years old)","WB (L), AM (RLC)","Osijek","Croatian First League","MNE","No","1/5/2022","6/30/2026","$22K - $220K","Left Only","Very Strong","Weak","5'8""","154 lbs","67","11",108,131,11,12,10,11,12,7,7,11,6,6,11,12,12,11,12,11,12,12,11,11,12,12,8,12,12,10,9,10,14,13,11,6,11,13,12,11,16,12,11,12,12,11,12,10,8,6,12,10,10,3,3,3,3,1,1,1,3,2,2,2
"8549",62053514,"Filip Stojković","1/22/1993 (30 years old)","D (RC), WB/M (R)","LASK","Austrian Premier Division","MNE","No","7/1/2022","6/30/2025","$250K - $2.6M","Right Only","Weak","Very Strong","5'11""","167 lbs","283","7",121,130,11,13,9,6,11,8,8,9,13,12,12,10,14,11,15,13,14,13,13,13,12,11,15,12,14,15,10,14,13,12,12,8,12,13,14,12,9,11,10,9,13,6,11,14,13,15,12,11,10,2,2,3,4,3,1,1,1,1,1,3
"8550",62060583,"Mirko Ivanić","9/13/1993 (29 years old)","M (C), AM (LC)","Crvena zvezda","Serbian SuperLeague","MNE","No","10/22/2021","6/30/2025","$250K - $2.5M","Right","Reasonable","Very Strong","6'0""","154 lbs","304","92",130,130,12,12,14,12,14,13,12,14,7,7,14,14,8,15,10,15,12,11,11,13,12,14,12,14,8,15,14,13,13,13,11,10,11,12,12,11,10,12,13,13,12,14,7,13,9,9,14,13,12,1,3,1,3,2,2,3,3,1,1,1
"8551",58159066,"Vladislav Torop","11/7/2003 (19 years old)","GK","CSKA Moscow","Russian Premier League","RUS","No","12/30/2021","6/30/2026","$475K - $4.9M","Left Only","Very Strong","Weak","6'2""","189 lbs","2","-",93,145,1,1,2,3,8,1,2,3,1,3,9,2,1,8,5,10,11,15,13,11,12,3,8,3,12,12,5,12,7,8,9,13,12,8,11,14,1,14,14,14,12,14,4,11,4,6,13,13,15,14,10,13,7,7,10,13,5,11,13,11
"8552",62144924,"Nikola Šipčić","5/17/1995 (28 years old)","D (C)","Tenerife","Spanish Second Division","MNE","No","7/31/2019","6/30/2025","$120K - $1.2M","Right","Weak","Very Strong","6'4""","182 lbs","228","11",118,129,6,5,9,8,10,7,13,7,10,14,10,8,13,9,12,12,14,12,13,12,13,8,14,8,13,14,9,14,10,10,11,14,13,12,14,15,9,14,13,15,12,14,12,13,9,6,14,13,13,3,4,3,2,2,3,1,3,2,2,3
"8553",5768595,"Marko Vešović","8/28/1991 (31 years old)","D/WB/M/AM (R)","Qarabağ","Azeri Premier League","MNE","No","5/31/2021","6/30/2023","$2K - $18K","Right Only","Very Weak","Very Strong","5'11""","165 lbs","305","22",111,129,8,11,12,7,12,7,9,9,13,10,11,10,11,11,16,12,12,10,9,6,17,12,11,13,11,12,9,18,14,13,12,9,17,14,15,12,14,5,4,9,14,13,10,16,16,12,12,14,10,1,4,3,3,1,1,2,2,4,2,3
"8554",62239188,"Andrija Ražnatović","12/24/2000 (22 years old)","D/WB (L)","Budućnost","Montenegrin First League","MNE","No","1/12/2021","6/30/2024","$0","Left","Very Strong","Weak","6'2""","174 lbs","126","11",110,129,10,11,9,5,10,7,7,10,11,10,10,6,11,9,12,12,11,10,9,13,15,5,10,11,12,12,10,12,14,12,12,14,10,14,12,10,11,13,12,11,9,13,6,7,12,4,11,11,12,1,2,3,2,1,2,3,4,3,3,1
"8555",2000147009,"Dušan Vuković","8/6/2002 (20 years old)","AM (RL), ST (C)","Sutjeska","Montenegrin First League","MNE","No","7/1/2018","6/30/2024","$375K - $1.1M","Right","Reasonable","Very Strong","6'0""","171 lbs","63","8",105,129,8,12,10,10,15,10,16,7,7,9,16,5,7,12,13,10,10,10,11,10,7,12,11,11,8,11,11,12,12,13,6,11,7,12,9,9,10,12,9,11,12,14,8,17,15,6,12,10,17,2,3,2,3,2,1,2,3,3,1,1
"8556",62216185,"Slobodan Rubežić","3/21/2000 (23 years old)","D (C)","Novi Pazar","Serbian SuperLeague","MNE","No","6/30/2021","6/30/2026","$250K - $750K","Right","Weak","Very Strong","6'4""","185 lbs","71","4",105,129,5,5,8,5,12,1,14,7,5,14,8,2,13,9,16,13,14,9,13,7,11,5,13,8,13,12,10,13,9,9,11,15,12,9,13,14,18,12,11,12,12,10,8,13,11,8,13,13,11,4,2,1,3,2,1,1,1,3,1,3
"8557",62199775,"Marko Rakonjac","4/25/2000 (23 years old)","ST (C)","Crvena zvezda","Serbian SuperLeague","MNE","No","6/1/2022","6/30/2026","$160K - $1.6M","Right Only","Weak","Very Strong","6'3""","165 lbs","110","24",112,128,8,10,10,12,12,8,13,10,4,6,12,10,5,12,11,12,11,13,11,12,13,10,6,13,8,16,12,13,12,12,13,15,10,13,14,12,5,12,13,11,10,10,10,11,11,11,10,10,8,2,2,3,4,4,2,3,1,4,2,2
"8558",62097738,"Igor Vujačić","8/8/1994 (28 years old)","D (C)","Partizan","Serbian SuperLeague","MNE","No","6/15/2019","6/30/2025","$275K - $2.7M","Right","Weak","Very Strong","6'2""","187 lbs","271","20",119,128,5,7,7,6,11,7,13,11,8,13,10,12,13,9,15,14,16,11,11,10,15,8,14,8,13,14,10,14,12,11,14,16,13,12,13,14,9,13,14,13,12,15,8,12,13,8,13,12,12,3,2,3,1,3,3,3,1,2,2,2
"8559",62093810,"Aleksandar Boljević","12/12/1995 (27 years old)","AM (RL)","Standard","Jupiler Pro League","MNE","No","6/30/2019","6/30/2023","$0 - $120K","Right","Fairly Strong","Very Strong","6'1""","165 lbs","269","34",111,128,9,12,12,9,11,9,10,10,8,5,11,8,4,11,7,11,12,10,12,9,8,12,5,7,6,9,8,10,15,10,11,10,13,15,14,10,9,18,9,11,11,12,5,10,10,3,11,15,12,3,1,1,4,2,1,3,1,1,1,1
"8560",2000121076,"Andrej Bajović","6/6/2003 (20 years old)","DM, M (C)","Dečić","Montenegrin First League","MNE","No","8/1/2022","6/30/2025","$90K - $900K","Right","Weak","Very Strong","5'11""","163 lbs","80","3",97,128,9,9,11,9,12,9,9,15,7,8,11,9,13,12,6,13,10,13,12,11,14,5,12,13,13,10,12,14,10,10,10,11,14,10,10,10,11,9,8,11,8,11,15,11,5,4,11,8,15,1,1,1,3,3,1,2,2,3,1,2
"8561",62230060,"Ognjen Gašević","4/2/2002 (21 years old)","WB/AM (L)","Budućnost","Montenegrin First League","MNE","No","6/11/2023","6/30/2025","$120K - $1.2M","Left","Very Strong","Weak","5'11""","156 lbs","114","6",104,128,12,12,11,11,14,7,9,10,6,8,14,4,9,11,6,12,9,12,10,10,12,11,13,12,3,12,12,12,13,12,12,11,7,13,12,6,14,13,12,11,15,9,11,5,6,4,12,11,9,3,3,3,1,1,2,2,1,3,3,2
"8562",58092242,"Alexey Miranchuk","10/17/1995 (27 years old)","M (R), AM (RC)","Atalanta","Italian Serie A","RUS","No","9/1/2020","6/30/2024","$7.4M","Left","Very Strong","Reasonable","6'0""","163 lbs","247","40",137,144,13,11,15,14,15,14,6,13,4,8,15,13,9,16,7,15,10,14,12,15,13,16,9,14,8,13,14,13,13,14,13,10,11,13,12,10,13,14,8,14,12,12,9,13,9,8,11,14,10,2,2,2,2,1,2,2,1,3,1,3
"8563",62075647,"Danijel Petković","5/25/1993 (30 years old)","GK","Kisvárda","Hungarian Division I","MNE","No","2/3/2023","6/30/2025","$110K - $1.1M","Right","Reasonable","Very Strong","6'5""","198 lbs","184","-",118,127,4,1,2,2,6,6,2,1,3,2,13,1,1,10,8,12,13,12,12,11,13,2,11,1,13,12,12,11,9,13,12,17,10,9,11,12,12,10,10,12,11,10,7,12,14,8,11,13,10,9,10,12,8,12,14,12,7,12,12,15
"8564",2000196824,"Vladimir Perišić","8/26/2004 (18 years old)","AM (RL), ST (C)","Budućnost","Montenegrin First League","MNE","No","7/1/2020","6/30/2024","$35K - $325K","Right","Weak","Very Strong","6'0""","167 lbs","19","-",95,127,11,11,15,14,9,5,11,10,9,9,12,7,7,12,7,11,9,8,9,9,11,15,5,15,9,10,9,11,12,11,10,7,8,12,7,7,10,10,11,12,11,10,14,5,8,8,12,13,12,1,1,1,2,2,1,1,2,3,3,1
"8565",2000157417,"Aldin Mušović","11/10/2002 (20 years old)","ST (C)","Jedinstvo (BP)","Montenegrin First League","MNE","Yes","6/12/2023","6/30/2024","$80K - $240K","Right Only","Weak","Very Strong","6'3""","176 lbs","105","19",93,127,8,9,14,11,14,8,11,8,5,8,9,8,6,14,14,13,1,13,8,11,2,13,6,11,9,8,7,9,11,11,13,13,14,12,13,13,12,12,11,11,11,13,9,5,6,3,15,12,11,3,1,2,2,3,3,2,3,4,3,1
"8566",62082695,"Vladimir Rodić","9/7/1993 (29 years old)","WB (R), M/AM (RL)","Östers IF","Swedish First Division Elite","MNE","No","2/26/2022","12/31/2023","$14K - $130K","Right","Weak","Very Strong","5'9""","163 lbs","271","39",103,127,12,12,11,10,12,11,7,10,7,8,11,7,8,12,11,12,10,11,11,11,12,14,6,12,10,11,13,11,12,12,10,8,12,12,12,8,12,8,8,14,12,7,9,11,12,13,9,11,12,2,4,3,1,2,2,3,3,3,3,3
"8567",62176200,"Lazar Carević","3/16/1999 (24 years old)","GK","Vojvodina","Serbian SuperLeague","MNE","No","6/18/2022","6/30/2026","$100K - $1M","Right","Weak","Very Strong","6'5""","187 lbs","124","-",114,126,6,3,2,1,11,8,8,3,3,1,11,8,3,9,9,12,12,11,12,11,13,5,11,5,11,12,11,9,9,12,13,15,11,8,6,13,1,12,11,13,12,11,11,12,5,9,13,12,13,11,13,13,11,11,13,14,5,11,10,14
"8568",2000291138,"Petar Aničić","7/12/2004 (18 years old)","AM (RC)","Sutjeska","Montenegrin First League","MNE","No","6/24/2022","6/30/2026","$130K - $1.3M","Left","Very Strong","Weak","6'3""","176 lbs","2","-",92,126,12,12,14,13,11,9,8,11,4,9,11,8,10,10,6,7,10,8,10,12,12,13,12,8,8,10,12,11,12,12,11,15,10,11,11,7,11,13,12,11,11,13,5,3,8,6,20,10,18,2,2,2,1,1,1,3,3,4,3,2
"8569",2000043109,"Arnel Kujović","3/14/2002 (21 years old)","DM, M/AM (C)","Energie Cottbus","German Regional Division Northeast","MNE","Yes","2/2/2022","6/30/2024","$95K - $275K","Right Only","Weak","Very Strong","6'0""","174 lbs","66","3",99,126,9,9,11,15,15,9,9,10,8,11,10,4,15,15,14,13,9,5,8,9,13,14,8,7,10,10,13,13,15,15,11,6,7,15,8,9,17,11,10,11,12,11,9,12,10,1,11,10,10,1,3,3,2,1,2,3,1,1,3,3
"8570",62082866,"Marko Bakić","11/1/1993 (29 years old)","DM, M/AM (C)","OFI","Greek Super League 1","MNE","No","1/18/2023","6/30/2024","$300K - $3.1M","Right","Reasonable","Very Strong","6'1""","169 lbs","217","25",115,125,12,11,10,8,12,13,9,13,7,9,14,11,11,14,12,11,12,13,11,13,12,13,8,11,10,14,14,12,11,12,13,11,13,12,12,12,12,10,11,11,12,10,12,10,6,8,10,13,15,1,2,1,2,4,3,1,4,3,3,1
"8571",2000180110,"Šaban Kolić","1/18/2004 (19 years old)","GK","Nacional da Madeira","Portuguese Second League","MNE","Yes","8/2/2022","6/30/2026","$20K - $200K","Right Only","Very Weak","Very Strong","6'1""","174 lbs","38","-",95,125,6,3,1,3,3,8,1,2,1,1,14,2,1,1,5,10,15,8,7,14,7,3,9,1,9,9,7,8,10,14,9,10,7,8,4,7,11,12,8,10,10,11,7,10,8,4,13,9,19,10,11,13,12,12,11,11,5,12,11,11
"8572",62096200,"Marko Janković","7/9/1995 (27 years old)","M (R), AM (RLC)","Qarabağ","Azeri Premier League","MNE","No","7/1/2022","5/31/2025","$85K - $850K","Left","Very Strong","Reasonable","5'8""","147 lbs","211","21",106,125,11,13,14,10,12,12,7,12,3,7,13,13,8,14,11,11,11,11,9,10,12,14,12,12,7,12,13,12,12,13,11,7,11,12,10,9,14,11,11,13,13,13,11,9,8,9,11,12,12,1,3,2,1,2,1,1,1,1,3,2
"8573",58153778,"Konstantin Tyukavin","6/22/2002 (20 years old)","ST (C)","Dinamo Moscow","Russian Premier League","RUS","No","6/18/2021","6/30/2024","$6M - $9.2M","Right","Reasonable","Very Strong","5'11""","171 lbs","84","24",119,144,9,9,10,14,14,4,12,10,5,6,11,14,7,12,13,15,13,12,13,13,16,11,7,15,9,14,13,10,13,13,12,13,15,12,10,11,4,15,9,13,13,14,4,12,8,7,12,16,17,2,2,3,3,2,3,2,3,2,3,3
"8574",2000121104,"Damjan Mugoša","5/16/2003 (20 years old)","ST (C)","GOŠK","Bosnian Premier League","MNE","No","1/2/2023","6/30/2024","$0","Right","Weak","Very Strong","6'1""","169 lbs","48","10",94,125,8,6,14,11,14,8,14,7,1,8,8,5,5,14,5,7,9,10,9,11,7,13,12,12,9,8,9,9,11,10,9,13,15,11,12,8,12,15,10,10,10,14,6,6,13,8,19,9,18,1,2,2,3,3,3,2,4,1,2,4
"8575",62220049,"Bojan Roganović","9/28/2000 (22 years old)","D/WB (L)","Torpedo Moscow","Russian First Division","MNE","No","9/7/2022","6/10/2025","$1.7M - $3.6M","Left","Very Strong","Reasonable","6'1""","176 lbs","110","1",109,125,11,11,13,8,11,9,8,8,8,12,11,11,10,11,13,13,12,13,12,11,12,7,9,8,12,12,8,9,12,11,10,11,13,13,15,11,15,12,11,12,10,12,12,11,6,8,10,12,17,1,1,3,4,1,2,1,2,3,2,4
"8576",62260566,"Marko Matanović","7/17/2000 (22 years old)","M/AM (C)","Sutjeska","Montenegrin First League","MNE","No","4/14/2023","6/30/2024","$130K - $1.3M","Right","Reasonable","Very Strong","5'10""","163 lbs","122","13",109,124,10,7,12,14,12,8,6,12,3,9,11,5,9,12,6,11,10,11,11,12,8,10,14,14,12,11,16,9,12,13,11,7,10,12,11,8,13,12,8,12,11,12,5,4,13,2,20,10,7,1,3,1,2,2,1,3,1,2,2,1
"8577",2000099891,"Matija Krivokapić","3/19/2003 (20 years old)","ST (C)","Dun. Streda","Slovak First Division","MNE","No","2/1/2023","6/30/2026","$8K - $85K","Right","Weak","Very Strong","6'2""","189 lbs","47","10",91,124,7,8,12,11,15,9,12,8,8,8,10,4,4,11,14,11,10,10,8,11,11,13,3,12,8,9,10,10,10,12,8,10,8,11,10,12,11,12,11,12,11,11,14,14,6,7,12,9,13,4,2,1,3,3,2,2,1,1,2,3
"8578",2000180006,"Danijel Nikolić","9/13/2004 (18 years old)","ST (C)","Sutjeska","Montenegrin First League","MNE","No","6/13/2022","6/30/2024","$0 - $100K","Right","Reasonable","Very Strong","5'9""","156 lbs","7","2",81,124,8,9,15,11,12,8,15,9,5,7,9,3,4,12,9,9,9,11,9,11,5,10,8,10,7,8,8,9,10,10,9,5,8,10,9,9,11,15,11,11,9,11,6,6,9,1,9,13,14,2,1,2,3,2,2,2,2,3,2,1
"8579",2000105316,"Nikola Ivezić","4/1/2003 (20 years old)","GK","Lommel SK","Belgian Challenger Pro League","MNE","No","7/1/2022","6/30/2024","$170K - $1.7M","Right Only","Weak","Very Strong","6'4""","180 lbs","82","-",104,124,3,3,2,1,5,7,3,1,2,1,16,3,3,9,5,12,11,11,10,11,12,1,10,1,12,11,10,10,11,11,11,15,6,12,5,10,11,7,9,13,13,12,12,15,12,3,13,9,15,11,7,11,8,13,13,12,12,13,12,12
"8580",62127256,"Nemanja Cavnić","9/5/1995 (27 years old)","D (C)","HB Køge","NordicBet Liga","MNE","No","7/1/2021","6/30/2024","$0 - $14K","Right Only","Weak","Very Strong","6'4""","189 lbs","292","8",95,124,6,7,7,7,11,7,13,5,8,12,10,8,12,8,13,10,10,10,11,10,11,5,10,10,12,8,8,10,10,10,12,15,11,11,12,13,11,13,12,12,11,10,12,13,12,8,10,11,9,3,3,2,1,4,3,3,1,2,2,2
"8581",27132705,"Filip Đukić","8/6/1999 (23 years old)","GK","Hvidovre IF","3F Superliga","MNE","Yes","1/27/2021","12/31/2025","$30K - $90K","Right","Reasonable","Very Strong","5'11""","158 lbs","116","-",94,124,4,2,3,2,11,7,7,3,3,1,11,2,2,11,9,8,11,11,10,8,11,2,11,1,9,11,8,7,11,10,9,10,11,10,8,8,9,10,12,10,5,15,5,8,4,7,12,13,13,12,12,13,15,13,11,12,14,12,10,8
"8582",2000181479,"Goran Aković","6/6/2002 (21 years old)","GK","Bokelj","Montenegrin Second League","MNE","No","2/15/2023","6/30/2024","$12K - $130K","Right","Weak","Very Strong","6'2""","171 lbs","67","-",95,124,5,3,3,3,2,8,1,3,2,3,7,5,3,5,13,12,11,9,11,13,10,1,1,2,12,9,8,8,10,14,9,14,10,12,3,7,11,9,9,12,11,15,11,5,12,8,14,10,14,12,13,10,13,11,14,12,5,11,11,10
"8583",2000300685,"Marko Tadić","2/25/2006 (17 years old)","ST (C)","Partizan","Serbian SuperLeague","MNE","No","6/12/2023","6/30/2026","$700K - $1.5M","Right","Reasonable","Very Strong","6'4""","176 lbs","-","-",90,124,8,5,14,14,11,8,14,9,3,6,11,8,6,14,7,9,4,9,6,11,14,13,9,13,8,8,11,9,13,8,6,11,9,9,7,12,8,10,10,9,8,9,12,17,6,1,20,10,16,1,3,1,2,2,3,2,3,1,3,2
"8584",8053234,"Igor Akinfeev","4/8/1986 (37 years old)","GK","CSKA Moscow","Russian Premier League","RUS","No","5/20/2022","6/30/2024","$190K - $1.9M","Right","Fairly Strong","Very Strong","6'1""","171 lbs","543","-",134,157,4,3,3,2,10,6,8,1,1,1,11,18,3,10,11,16,10,16,15,15,18,10,17,2,16,5,10,9,10,12,12,10,13,9,10,13,15,12,14,20,14,20,5,14,7,5,18,11,1,14,8,14,17,14,15,13,3,18,10,8
"8585",58123749,"Daniil Utkin","10/12/1999 (23 years old)","M/AM (C)","Rostov","Russian Premier League","RUS","No","6/16/2022","6/10/2026","$5.6M - $10.5M","Left","Very Strong","Reasonable","6'0""","158 lbs","138","31",127,143,15,13,13,10,13,16,10,14,8,9,14,8,10,13,10,12,12,12,14,12,16,14,12,14,9,13,16,14,12,12,10,10,14,12,14,9,9,13,10,10,12,10,12,13,11,7,12,9,15,1,2,2,3,2,2,3,1,2,4,1
"8586",62220461,"Anto Babić","1/25/2000 (23 years old)","D (C)","Sutjeska","Montenegrin First League","MNE","No","6/20/2022","6/30/2024","$350K - $1M","Right","Weak","Very Strong","6'1""","171 lbs","100","7",102,124,7,7,7,5,10,3,11,2,5,12,11,13,12,10,10,11,11,10,12,12,13,7,13,10,10,10,7,12,11,11,11,11,15,11,12,13,15,12,11,11,10,12,15,3,5,3,13,12,19,1,3,2,1,3,3,3,3,2,1,2
"8587",5005078,"Jonny Evans","1/3/1988 (35 years old)","D (C)","Leicester","Sky Bet Championship","NIR","No","12/31/2020","6/30/2023","$40K - $400K","Right","Strong","Very Strong","6'2""","169 lbs","385","17",139,155,4,5,10,6,12,4,15,3,9,14,12,5,15,13,12,16,14,15,15,13,15,3,15,6,15,14,13,14,11,10,14,15,10,10,12,14,10,18,16,15,14,16,16,14,8,6,17,14,17,2,3,1,3,3,1,1,1,2,3,4
"8588",28105687,"Jamal Lewis","1/25/1998 (25 years old)","D/WB/M/AM (L)","Newcastle","English Premier Division","NIR","No","9/8/2020","6/30/2025","$5.4M - $6.6M","Left","Very Strong","Weak","5'10""","154 lbs","123","1",124,154,4,11,12,6,12,6,11,8,5,12,12,6,12,13,10,12,12,12,12,11,14,5,2,11,11,13,10,14,14,13,15,10,18,15,16,10,10,10,12,17,10,12,7,13,2,2,12,16,12,3,1,3,3,2,3,2,1,1,3,3
"8589",2000008669,"Josh Clarke","7/28/2004 (18 years old)","GK","Celtic","Scottish Lowland League","NIR","Yes","8/11/2022","5/31/2024","$1.3M - $2.7M","Right","Reasonable","Very Strong","6'2""","185 lbs","24","-",75,150,4,1,2,1,6,7,1,2,3,1,8,1,3,1,5,10,11,10,7,14,6,2,2,3,9,8,5,7,12,9,8,14,12,11,3,6,10,11,11,12,11,10,5,7,10,4,11,12,16,8,7,9,5,8,12,11,7,10,11,10
"8590",52014865,"Stuart Dallas","4/19/1991 (32 years old)","D (RL), M (RLC), AM (RL)","Leeds","Sky Bet Championship","NIR","No","7/2/2021","6/30/2024","$4.4M - $8.4M","Right","Reasonable","Very Strong","6'0""","178 lbs","407","74",131,149,12,13,12,12,12,10,8,14,5,12,12,10,12,10,10,12,13,11,12,11,19,12,12,13,12,17,11,19,11,10,12,10,19,11,16,7,19,14,18,18,10,16,13,16,7,4,16,14,14,3,1,3,4,3,2,2,2,1,2,3
"8591",2000123638,"Jamie Donley","1/3/2005 (18 years old)","AM (C), ST (C)","Tottenham","English Premier Division","NIR","No","3/16/2023","6/30/2027","$22M - $34M","Left","Very Strong","Reasonable","5'9""","154 lbs","-","-",107,149,7,11,9,14,13,8,11,11,2,4,14,13,9,12,13,11,14,13,12,12,14,13,7,11,3,11,14,11,11,13,12,12,13,11,11,12,13,20,10,13,12,12,1,8,10,2,11,13,18,1,2,2,1,3,2,4,1,3,1,1
"8592",2000027898,"Shea Charles","11/5/2003 (19 years old)","DM, M (C)","Man City","English Premier Division","NIR","No","6/13/2022","6/30/2026","$12M - $18.5M","Right","Reasonable","Very Strong","6'2""","171 lbs","1","-",115,148,7,7,10,7,13,8,13,8,9,13,12,7,13,12,13,13,13,14,12,12,14,9,10,9,13,14,12,14,12,11,11,13,14,12,13,13,14,19,12,12,12,11,7,10,13,8,10,10,7,3,1,4,3,2,1,2,2,2,1,3
"8593",28068190,"Paddy McNair","4/27/1995 (28 years old)","D (C), DM, M (C)","Middlesbrough","Sky Bet Championship","NIR","No","12/1/2020","6/30/2024","$850K - $10.5M","Right","Reasonable","Very Strong","6'2""","158 lbs","224","19",124,145,13,14,9,12,12,13,13,12,8,10,12,12,11,13,9,14,11,13,12,12,15,12,13,12,14,13,12,14,12,11,13,12,14,12,14,13,16,10,12,14,11,9,9,11,10,6,13,12,4,3,1,1,1,3,1,2,2,1,3,1
"8594",28110835,"Daniel Ballard","9/22/1999 (23 years old)","D (C)","Sunderland","Sky Bet Championship","NIR","No","6/30/2022","6/30/2026","$5M - $6.4M","Right","Reasonable","Very Strong","6'2""","187 lbs","76","3",122,145,3,4,8,6,11,5,15,8,6,13,12,7,14,11,16,13,16,13,12,11,15,9,14,7,13,16,9,15,12,10,11,14,12,14,15,14,12,12,13,15,13,15,9,13,11,4,15,15,15,2,3,2,2,2,1,3,3,1,2,3
"8595",52094225,"Trai Hume","3/18/2002 (21 years old)","D (R), WB (RL), M (C)","Sunderland","Sky Bet Championship","NIR","No","6/9/2023","6/30/2027","$7.8M - $9.4M","Right","Reasonable","Very Strong","5'11""","156 lbs","86","9",121,143,5,10,11,6,13,7,14,9,11,15,14,6,15,9,13,10,14,14,12,12,16,5,6,13,11,11,12,13,12,11,13,11,10,12,13,12,12,17,10,11,13,13,3,9,13,6,11,9,16,2,3,2,2,2,3,2,2,1,3,2
"8596",58127846,"Igor Diveev","9/27/1999 (23 years old)","D (C)","CSKA Moscow","Russian Premier League","RUS","No","6/9/2023","6/30/2028","$600K - $9M","Right Only","Weak","Very Strong","6'4""","187 lbs","110","8",126,143,9,5,7,8,8,12,13,14,6,14,11,12,13,8,14,13,16,13,15,13,16,4,5,10,14,14,5,12,11,10,13,15,17,13,14,15,16,18,16,15,13,10,7,14,5,4,12,13,18,3,1,3,3,1,2,2,2,2,3,2
"8597",2000006171,"Jack Patterson","10/16/2005 (17 years old)","D (C), DM, M (C)","Everton","English Premier Division","NIR","No","10/21/2022","6/30/2025","$140K - $1.4M","Right","Reasonable","Very Strong","5'10""","149 lbs","4","-",69,143,1,4,4,5,7,5,6,2,5,12,10,2,11,9,10,8,7,10,7,13,9,5,11,5,7,7,11,12,10,12,6,5,17,11,11,8,12,14,9,12,12,11,14,7,10,2,7,11,7,2,2,1,3,3,1,1,4,3,1,3
"8598",5112574,"Steven Davis","1/1/1985 (38 years old)","M (RC)","Rangers","cinch Premiership","NIR","No","5/31/2023","5/31/2026","$80K - $800K","Right","Reasonable","Very Strong","5'8""","154 lbs","556","36",120,142,15,10,10,9,14,13,6,10,10,13,15,11,11,15,13,14,12,13,14,14,14,11,18,15,14,18,15,14,9,11,15,6,16,9,13,8,14,15,13,14,14,16,2,14,7,3,14,18,15,3,3,3,4,1,2,3,3,1,3,2
"8599",28127166,"Conor Bradley","7/9/2003 (19 years old)","D/WB (R)","Liverpool","English Premier Division","NIR","No","7/26/2021","6/30/2025","$16M - $24M","Right","Reasonable","Very Strong","5'11""","156 lbs","41","5",122,142,5,10,10,8,12,6,7,8,8,11,10,8,10,13,9,11,11,11,11,10,13,12,8,12,10,13,11,12,17,16,14,9,15,17,13,8,10,12,10,12,13,13,7,11,7,4,12,15,14,1,1,3,3,2,2,3,3,3,2,1
"8600",2000258482,"Tom Atcheson","9/22/2006 (16 years old)","D (RC), DM","Blackburn","Sky Bet Championship","NIR","No","6/12/2023","6/30/2025","$120K - $1.2M","Right","Reasonable","Very Strong","6'4""","169 lbs","-","-",60,140,6,8,6,2,9,6,13,7,6,7,9,5,13,10,9,8,8,11,7,4,12,5,1,6,14,7,10,8,12,8,7,15,13,13,5,7,12,19,11,12,9,12,13,7,12,5,5,12,12,3,3,1,3,1,2,2,1,1,2,1
"8601",52085051,"Kofi Balmer","9/19/2000 (22 years old)","D (C)","Crystal Palace","English Premier Division","NIR","No","8/11/2022","6/30/2026","$16K - $150K","Right","Reasonable","Very Strong","6'0""","180 lbs","115","11",105,139,4,5,8,6,11,4,14,5,15,13,10,6,12,10,15,11,13,12,12,12,15,8,12,7,12,13,10,12,11,10,12,12,12,10,11,13,8,13,11,15,12,13,7,13,11,5,13,15,14,2,3,2,1,2,3,2,1,3,2,1
"8602",2000269134,"Cole Brannigan","5/12/2007 (16 years old)","M (LC), AM (L)","Linfield","Sports Direct Premiership","NIR","No","7/1/2021","5/31/2026","$0","Left","Very Strong","Weak","5'11""","138 lbs","-","-",53,137,7,11,10,11,10,5,5,7,1,1,6,1,7,6,9,5,1,5,6,9,11,6,8,7,4,7,11,11,9,12,6,8,13,12,6,3,11,19,9,12,11,12,15,10,6,3,10,12,9,2,1,2,2,2,1,2,2,4,2,3
"8603",28106932,"Shayne Lavery","12/8/1998 (24 years old)","AM (L), ST (C)","Blackpool","Sky Bet League One","NIR","Yes","5/16/2023","6/30/2024","$240K - $2.4M","Right","Reasonable","Very Strong","6'0""","160 lbs","127","43",112,135,6,9,11,15,10,5,11,8,4,6,8,10,9,11,17,12,16,12,11,11,15,10,3,14,6,12,10,18,14,13,12,11,10,13,12,12,11,19,11,13,11,13,5,7,10,3,13,13,12,2,1,1,2,3,1,1,2,1,2,1
"8604",29141886,"Bailey Peacock-Farrell","10/29/1996 (26 years old)","GK","Burnley","English Premier Division","NIR","No","8/21/2020","6/30/2024","$60K - $600K","Left","Very Strong","Reasonable","6'4""","160 lbs","99","-",116,135,3,2,2,1,8,6,8,3,1,3,10,1,2,11,4,14,16,12,11,7,12,2,6,1,10,10,10,11,11,13,11,16,12,6,11,12,13,13,14,13,15,12,5,13,1,2,9,13,7,12,14,14,14,16,14,13,13,11,13,16
"8605",28042863,"George Saville","6/1/1993 (30 years old)","DM, M (C)","Millwall","Sky Bet Championship","NIR","No","7/2/2021","6/30/2024","$240K - $2.4M","Left","Very Strong","Reasonable","6'0""","163 lbs","350","35",116,135,12,9,10,10,11,12,10,11,7,12,12,10,13,12,15,12,15,13,13,13,13,10,14,14,12,15,12,15,11,11,14,11,13,10,14,12,10,12,9,9,10,12,4,15,13,8,12,10,8,2,1,2,3,3,3,2,1,3,1,1
"8606",29139716,"Luke Southwood","12/6/1997 (25 years old)","GK","Reading","Sky Bet League One","NIR","No","6/15/2020","6/30/2025","$230K - $2.3M","Right","Reasonable","Very Strong","6'1""","163 lbs","151","-",112,135,6,1,1,1,10,7,5,3,3,2,10,2,3,8,5,11,8,12,12,10,3,3,12,1,12,12,11,11,10,17,13,11,12,9,9,7,11,17,13,13,13,11,3,4,10,8,10,9,15,12,16,14,4,14,11,14,7,10,12,11
"8607",58137500,"Danil Glebov","11/3/1999 (23 years old)","DM, M (C)","Rostov","Russian Premier League","RUS","No","5/20/2023","6/10/2028","$650K - $8.4M","Right","Reasonable","Very Strong","5'10""","149 lbs","123","9",127,143,10,10,11,11,13,8,9,13,4,14,14,7,13,13,10,14,14,11,15,13,12,8,15,12,13,15,10,13,13,13,14,9,12,13,14,9,14,12,14,13,10,10,5,13,9,1,15,14,13,2,3,3,3,2,1,3,1,4,3,1
"8608",2000027031,"Isaac Price","9/26/2003 (19 years old)","M/AM (C)","Everton","English Premier Division","NIR","Yes","6/13/2022","6/30/2025","$50K - $500K","Right Only","Weak","Very Strong","6'0""","169 lbs","2","-",100,135,11,13,10,13,11,11,11,11,5,10,12,6,9,12,12,14,10,10,7,9,12,14,12,13,13,15,11,10,13,9,9,12,12,13,7,11,11,16,9,12,12,12,5,18,10,1,18,9,8,2,2,3,2,3,2,3,3,1,3,1
"8609",28102012,"Conor Hazard","3/5/1998 (25 years old)","GK","Celtic","cinch Premiership","NIR","No","6/15/2020","5/31/2025","$70K - $700K","Left","Very Strong","Reasonable","6'6""","180 lbs","62","-",106,135,4,1,1,3,7,7,9,3,2,2,7,1,1,7,10,11,9,10,10,10,14,3,6,1,10,14,8,12,10,14,12,18,12,8,14,12,9,15,15,10,12,13,4,7,6,3,10,14,15,10,7,12,10,11,12,12,4,10,12,18
"8610",90091510,"Paddy Lane","2/18/2001 (22 years old)","M/AM (RL)","Portsmouth","Sky Bet League One","NIR","No","1/31/2023","6/30/2026","$475K - $4.8M","Left","Very Strong","Fairly Strong","5'9""","143 lbs","132","15",107,135,13,13,13,11,12,10,6,10,5,4,12,10,8,13,15,10,12,12,10,10,13,13,7,12,9,11,12,13,12,12,12,8,14,11,12,11,12,7,14,12,10,11,8,10,8,6,12,14,13,1,3,2,1,2,3,1,3,2,2,2
"8611",28010490,"Oliver Norwood","4/12/1991 (32 years old)","DM, M (C)","Sheff Utd","English Premier Division","NIR","No","6/10/2020","6/30/2024","$6.4M - $9.8M","Right","Reasonable","Very Strong","5'11""","169 lbs","457","26",126,133,13,13,10,11,12,12,10,11,6,11,15,12,12,14,13,12,11,13,13,13,14,11,13,12,14,13,14,13,12,12,12,10,14,11,14,10,12,12,10,14,11,11,5,13,12,5,14,12,6,2,1,2,2,2,2,4,2,2,3,1
"8612",28127118,"Sean McAllister","9/15/2002 (20 years old)","AM (RLC)","Everton","English Premier Division","NIR","No","4/19/2023","6/30/2024","$230K - $9.2M","Right","Weak","Very Strong","5'10""","160 lbs","-","-",100,131,11,15,11,10,8,9,10,10,10,8,14,6,6,11,14,10,4,13,11,9,14,11,13,11,10,13,8,12,14,9,7,10,13,12,11,8,16,14,9,10,12,11,11,12,14,5,10,10,15,3,3,1,1,2,2,3,2,1,2,2
"8613",61088006,"Ali McCann","12/4/1999 (23 years old)","DM, M (C)","Preston","Sky Bet Championship","NIR","No","8/31/2021","6/30/2025","$50K - $6.4M","Right","Reasonable","Very Strong","5'9""","141 lbs","143","8",116,130,7,8,11,9,13,7,9,8,4,12,14,4,15,12,9,14,11,14,10,12,16,8,7,13,12,14,13,15,11,11,10,9,15,12,13,12,9,15,12,14,15,16,4,12,4,11,12,16,12,2,1,1,1,1,1,3,3,2,4,3
"8614",29129083,"Dion Charles","10/7/1995 (27 years old)","ST (C)","Bolton","Sky Bet League One","NIR","No","1/1/2022","6/30/2026","$55K - $550K","Right","Reasonable","Very Strong","5'10""","154 lbs","280","84",111,130,7,9,11,15,11,7,10,11,4,5,10,16,5,10,11,12,12,13,11,12,12,11,10,13,8,12,10,12,13,12,9,9,11,13,13,13,11,12,14,7,11,5,5,12,5,12,11,16,12,3,1,1,1,1,2,3,1,2,1,3
"8615",2000251043,"Calum Moreland","2/15/2007 (16 years old)","D (LC)","Linfield","Sports Direct Premiership","NIR","No","7/1/2022","5/31/2026","$0","Left","Very Strong","Weak","6'1""","154 lbs","-","-",55,130,6,9,6,8,9,3,10,7,8,10,7,3,12,6,15,9,9,8,10,7,5,5,6,7,8,8,8,9,9,9,9,15,13,9,8,5,12,15,12,12,11,8,9,16,11,5,6,11,9,2,2,3,3,1,1,2,3,2,1,3
"8616",52023552,"Liam Boyce","4/8/1991 (32 years old)","AM (C), ST (C)","Hearts","cinch Premiership","NIR","Yes","12/16/2022","5/31/2024","$110K - $1.1M","Right","Fairly Strong","Very Strong","6'0""","187 lbs","375","166",111,130,4,8,11,13,15,8,14,9,8,7,10,13,7,13,13,12,15,13,11,10,14,13,7,13,6,13,13,13,10,9,13,13,13,12,11,12,4,12,12,15,12,14,13,12,13,9,11,12,8,1,3,2,2,3,2,1,3,2,3,3
"8617",2000170569,"Brendan Hamilton","5/20/2006 (17 years old)","D/WB (L)","Aberdeen","cinch Premiership","NIR","No","7/1/2022","5/31/2025","$230K - $650K","Left","Very Strong","Reasonable","5'7""","141 lbs","-","-",65,130,4,9,6,5,12,2,8,1,7,9,9,1,13,7,11,13,8,8,7,9,3,5,2,7,6,8,7,8,13,13,3,3,13,12,10,9,12,16,13,12,13,10,9,9,6,4,20,12,19,1,2,3,1,1,3,2,1,2,1,3
"8618",58147636,"Daniil Khlusevich","2/26/2001 (22 years old)","D (RL), WB/M/AM (R)","Spartak Moscow","Russian Premier League","RUS","No","1/1/2022","6/30/2026","$450K - $10M","Right","Fairly Strong","Very Strong","6'1""","169 lbs","81","8",123,143,10,10,12,10,11,11,12,12,5,9,11,13,10,11,11,12,13,12,12,11,14,13,6,11,11,13,9,14,12,11,12,11,12,14,15,10,15,14,13,13,13,11,5,14,6,2,13,14,7,1,3,3,2,3,3,3,4,1,3,3
"8619",28028683,"Ben Reeves","11/19/1991 (31 years old)","M (C), AM (LC)","Gillingham","Sky Bet League Two","NIR","No","7/1/2021","6/30/2024","$2K - $18K","Left","Very Strong","Reasonable","5'10""","147 lbs","268","35",85,128,12,11,8,8,12,11,5,11,5,6,11,6,9,14,6,11,10,12,10,10,12,13,7,12,10,11,10,11,9,10,11,5,9,10,13,8,14,14,11,14,13,13,18,12,6,4,8,12,10,3,4,3,1,3,1,3,2,2,3,1
"8620",29079829,"Cameron McGeehan","4/6/1995 (28 years old)","DM, M/AM (C)","Oostende","Belgian Challenger Pro League","NIR","No","8/6/2020","6/30/2023","$22K - $65K","Right Only","Weak","Very Strong","5'11""","156 lbs","242","47",103,128,11,11,11,10,11,11,10,11,2,9,13,13,11,11,13,12,13,12,12,10,16,10,13,13,11,14,12,14,10,11,12,11,14,12,13,12,11,16,14,15,15,12,5,14,9,2,13,12,12,1,1,2,2,1,3,1,3,1,2,1
"8621",28002947,"Corry Evans","7/30/1990 (32 years old)","DM, M (C)","Sunderland","Sky Bet Championship","NIR","No","2/22/2023","6/30/2024","$85K - $850K","Right","Reasonable","Very Strong","5'11""","152 lbs","357","11",119,128,5,7,7,6,13,5,10,8,5,12,13,7,14,12,14,16,14,12,12,13,8,7,13,10,14,16,11,15,10,13,12,9,15,10,14,12,11,17,15,16,14,14,18,10,11,3,14,12,12,1,1,3,2,2,3,2,1,1,1,2
"8622",52065667,"Conor McMenamin","8/24/1995 (27 years old)","AM (RLC)","Glentoran","Sports Direct Premiership","NIR","Yes","1/31/2021","5/31/2024","$16K - $160K","Left","Very Strong","Reasonable","6'0""","156 lbs","220","72",109,128,11,13,15,14,11,11,11,11,7,7,12,13,9,12,10,11,10,12,8,9,9,14,7,11,11,10,11,10,13,11,10,7,12,13,12,10,14,10,12,12,10,11,7,14,7,12,12,12,7,1,2,3,2,2,1,1,3,3,2,2
"8623",2000006533,"Conor Falls","1/2/2004 (19 years old)","M/AM (C)","Huddersfield","Sky Bet Championship","NIR","No","7/11/2022","6/30/2025","$400K - $1.2M","Right Only","Weak","Very Strong","5'9""","145 lbs","5","-",75,128,3,7,9,9,13,7,7,6,4,7,13,5,9,12,10,9,8,10,7,11,10,11,1,9,13,8,14,13,6,11,8,8,11,10,11,6,15,18,10,11,9,11,14,6,9,7,18,12,20,1,3,3,3,1,2,2,2,3,1,3
"8624",29125339,"Jordan Thompson","1/3/1997 (26 years old)","WB (L), M (LC)","Stoke","Sky Bet Championship","NIR","No","4/29/2022","6/30/2024","$1.1M","Left","Very Strong","Reasonable","5'9""","143 lbs","206","7",113,128,12,12,13,11,12,12,7,11,4,8,12,3,11,12,16,13,13,11,13,9,11,13,3,12,16,15,13,17,12,12,9,8,14,11,15,11,11,7,13,14,8,13,13,12,5,4,7,10,8,1,3,2,2,2,3,1,3,3,1,3
"8625",2000006159,"Terry Devlin","11/6/2003 (19 years old)","DM, M (C)","Glentoran","Sports Direct Premiership","NIR","No","8/31/2022","5/31/2024","$0","Right","Reasonable","Very Strong","5'10""","169 lbs","79","4",94,127,7,9,12,8,11,7,9,5,4,12,11,4,13,12,6,13,11,13,10,9,7,7,10,14,13,11,10,14,12,11,13,9,11,10,11,12,8,18,10,10,11,12,4,11,4,4,11,13,12,1,3,3,1,3,1,3,3,1,2,3
"8626",52079995,"Paul Smyth","9/10/1997 (25 years old)","AM (RL)","Leyton Orient","Sky Bet League One","NIR","Yes","7/1/2021","6/30/2025","$30K - $300K","Right Only","Weak","Very Strong","5'8""","152 lbs","201","37",110,127,7,11,14,11,13,8,4,14,6,6,9,10,7,13,10,9,12,12,10,9,15,14,5,11,6,11,7,13,16,15,9,8,10,14,10,7,15,7,14,10,15,11,17,10,9,8,11,15,14,3,1,1,1,3,2,2,3,1,1,3
"8627",28121364,"Sam McClelland","1/4/2002 (21 years old)","D (C)","Chelsea","English Premier Division","NIR","No","7/1/2018","6/30/2028","$40K - $375K","Right","Reasonable","Very Strong","6'3""","176 lbs","27","1",89,127,3,3,4,5,8,4,14,2,7,11,8,5,10,8,14,12,16,9,14,9,9,3,19,4,12,17,6,13,9,7,13,14,10,10,10,11,2,11,11,13,5,12,5,8,9,3,11,12,13,3,1,1,2,2,2,2,3,1,1,2
"8628",90037889,"Conor Washington","5/18/1992 (31 years old)","AM (RL), ST (C)","Rotherham","Sky Bet Championship","NIR","No","7/1/2022","6/30/2025","$0","Right","Reasonable","Very Strong","5'10""","163 lbs","398","127",106,126,7,9,10,12,11,8,9,9,6,5,10,13,6,11,12,12,12,10,9,12,14,11,7,13,6,13,10,15,14,11,14,10,14,13,13,12,10,14,11,13,7,12,10,8,9,10,10,12,8,2,2,2,3,3,2,2,1,2,3,2
"8629",2000158934,"Kirill Stolbov","4/8/2004 (19 years old)","M/AM (C)","Zenit","Russian Premier League","RUS","No","7/1/2020","6/30/2024","$24K - $240K","Right","Fairly Strong","Very Strong","5'10""","167 lbs","16","4",82,142,9,9,11,11,11,9,8,10,8,11,11,8,9,11,6,9,9,11,11,10,10,13,12,11,6,10,11,14,11,10,10,7,15,7,9,9,12,15,11,11,10,10,9,9,9,7,12,13,16,2,2,2,2,1,1,3,3,2,3,2
"8630",2000177584,"Reece Evans","9/25/2005 (17 years old)","AM (C), ST (C)","Leicester","Sky Bet Championship","NIR","No","7/1/2022","6/30/2024","$60K - $600K","Right","Reasonable","Very Strong","6'0""","152 lbs","-","-",65,126,5,6,7,12,10,5,7,7,3,3,7,4,4,12,11,8,7,12,6,5,2,13,6,10,7,5,7,9,13,13,4,5,14,13,5,3,7,16,11,10,9,11,15,2,8,5,8,12,15,2,2,2,1,2,1,3,1,1,1,4
"8631",28125646,"JJ McKiernan","1/18/2002 (21 years old)","DM, M/AM (C)","Watford","Sky Bet Championship","NIR","Yes","12/20/2018","6/30/2025","$28K - $275K","Right","Weak","Very Strong","6'1""","178 lbs","42","4",97,126,7,9,11,10,12,7,10,11,5,7,12,8,9,12,7,10,9,12,9,11,15,8,8,11,8,11,10,13,11,12,12,11,14,11,13,11,12,14,12,13,14,11,6,10,5,5,11,12,13,1,1,3,1,2,2,2,3,1,3,1
"8632",52070703,"Gavin Whyte","1/31/1996 (27 years old)","AM (R)","Cardiff","Sky Bet Championship","NIR","No","7/30/2019","6/30/2025","$14K - $140K","Right","Weak","Very Strong","5'10""","147 lbs","270","56",108,126,11,11,12,8,11,12,6,9,6,9,11,12,10,12,10,12,12,11,11,10,12,13,6,12,12,13,11,15,14,13,12,10,12,12,12,11,11,12,14,13,10,12,6,14,7,7,11,10,9,3,1,3,3,1,3,3,3,2,1,3
"8633",2000010612,"Dylan Graham","10/31/2004 (18 years old)","GK","Everton","English Premier Division","NIR","No","7/8/2022","6/30/2023","$150K - $1.5M","Right","Weak","Very Strong","6'0""","160 lbs","3","-",75,126,3,3,3,2,1,6,1,1,3,3,7,3,3,6,12,6,15,6,7,8,7,1,10,1,12,8,7,6,12,14,8,7,17,13,2,7,10,14,11,11,12,10,13,1,12,5,14,10,10,8,6,10,3,11,5,9,5,8,13,11
"8634",52070605,"Rory Holden","8/23/1997 (25 years old)","M/AM (RLC)","Port Vale","Sky Bet League One","NIR","Yes","7/29/2022","6/30/2024","$14K - $40K","Left Only","Very Strong","Weak","5'7""","132 lbs","85","7",76,125,8,9,10,8,10,12,9,10,6,5,10,9,8,10,9,10,11,11,9,12,9,11,8,10,12,12,10,15,10,11,10,7,11,9,9,9,9,15,11,12,12,5,19,9,5,4,12,8,10,3,3,4,1,1,2,3,1,1,1,2
"8635",52082898,"Eoin Toal","2/15/1999 (24 years old)","D (C)","Bolton","Sky Bet League One","NIR","Yes","7/20/2022","6/30/2025","$300K - $3M","Right","Reasonable","Very Strong","6'3""","176 lbs","187","8",115,125,4,4,8,6,10,6,16,4,8,12,12,5,14,12,13,13,13,13,9,13,12,6,11,12,12,11,11,12,12,11,10,13,13,12,12,13,8,11,11,12,15,14,6,12,7,9,13,14,11,1,3,2,1,2,3,1,3,2,1,1
"8636",52001053,"Niall McGinn","7/20/1987 (35 years old)","M/AM (RL)","Glentoran","Sports Direct Premiership","NIR","No","1/9/2023","6/30/2024","$8K - $24K","Right","Reasonable","Very Strong","6'0""","154 lbs","461","99",87,125,10,12,13,13,12,13,10,11,9,7,14,12,4,14,7,12,7,12,11,11,10,12,8,15,9,10,14,7,8,11,9,9,12,9,9,6,8,9,15,10,9,11,12,12,8,9,13,7,17,1,1,2,3,3,3,2,3,2,2,2
"8637",89059700,"Ciaron Brown","1/14/1998 (25 years old)","D (LC)","Oxford United","Sky Bet League One","NIR","No","7/1/2022","6/30/2024","$100K - $1M","Left","Very Strong","Weak","6'1""","167 lbs","187","7",111,125,7,6,10,7,10,5,13,4,18,13,10,8,12,10,13,12,14,11,12,13,15,5,12,10,13,12,9,13,10,10,12,12,10,10,13,14,10,13,12,13,13,12,8,12,8,9,13,14,15,2,2,2,3,4,3,3,2,1,2,2
"8638",29174739,"Alfie McCalmont","3/25/2000 (23 years old)","DM, M (C)","Leeds","Sky Bet Championship","NIR","No","6/15/2020","6/30/2027","$26K - $275K","Right","Reasonable","Very Strong","5'9""","143 lbs","77","11",99,125,10,9,10,9,11,10,6,11,3,8,11,5,10,12,12,11,12,13,11,10,13,10,6,12,12,14,11,15,12,13,14,6,13,11,13,7,14,15,10,13,12,10,4,12,8,2,10,11,14,2,3,3,3,1,1,2,3,3,3,2
"8639",29107356,"Callum Camps","11/30/1995 (27 years old)","M/AM (C)","Stockport","Sky Bet League Two","NIR","No","7/4/2022","6/30/2025","$45K - $475K","Right","Reasonable","Very Strong","5'9""","145 lbs","308","41",99,125,10,10,12,10,13,11,8,12,4,7,13,9,9,13,12,12,11,13,10,10,12,12,8,11,9,11,13,11,11,12,13,9,11,11,11,10,10,9,10,10,11,8,9,10,8,3,10,12,1,3,2,3,3,3,2,2,3,2,3,1
"8640",2000111633,"Pavel Meleshin","3/25/2004 (19 years old)","ST (C)","Spartak Moscow","Russian Premier League","RUS","No","7/1/2022","6/30/2025","$2.4M - $5M","Right","Fairly Strong","Very Strong","6'2""","176 lbs","8","1",95,141,9,8,10,11,12,10,10,8,6,6,8,6,6,11,6,11,10,11,12,9,6,14,5,12,8,8,7,11,11,10,11,13,12,12,10,11,9,14,11,13,12,8,6,12,11,8,15,10,16,3,1,4,3,2,3,3,2,1,3,3
"8641",5204730,"Michael McGovern","7/12/1984 (38 years old)","GK","Norwich","Sky Bet Championship","NIR","No","6/14/2021","6/30/2024","$0 - $26K","Right","Weak","Very Strong","6'3""","196 lbs","302","-",107,125,3,3,2,1,9,5,6,3,2,3,7,3,3,5,7,12,13,11,13,11,17,1,12,7,12,16,10,15,9,12,12,12,12,8,15,14,13,14,15,17,16,13,3,15,5,5,15,12,18,10,8,14,11,12,8,12,2,13,9,12
"8642",85033422,"Geoffrey Kondogbia","2/15/1993 (30 years old)","DM, M (C)","A. Madrid","Spanish First Division","CTA","Yes","11/3/2020","6/30/2026","$5.8M - $8.6M","Left Only","Very Strong","Weak","6'2""","176 lbs","322","13",149,155,8,11,15,12,15,8,14,16,7,12,15,9,15,16,16,14,16,12,11,13,13,14,14,13,15,14,13,15,14,14,16,14,15,14,16,16,12,14,14,15,13,13,9,12,13,9,13,15,11,3,2,2,2,1,2,3,2,3,2,1
"8643",85088003,"Wilfried Zahibo","8/21/1993 (29 years old)","DM, M (C)","FC Borgo","French National 2 - C","CTA","Yes","7/1/2022","6/30/2023","$1.5K - $14K","Right","Weak","Very Strong","6'2""","176 lbs","185","8",105,125,8,6,10,8,10,10,13,11,8,11,12,5,13,12,15,11,13,10,10,12,15,9,8,10,12,13,10,13,11,10,12,14,14,12,13,14,8,17,11,14,12,10,7,10,8,2,10,12,13,1,3,1,1,2,3,3,2,2,2,3
"8644",85096272,"Amos Youga","12/8/1992 (30 years old)","D (C), DM, M (C)","CSKA-Sofia","Bulgarian First League","CTA","Yes","4/27/2023","6/30/2026","$300K - $3M","Right","Reasonable","Very Strong","6'1""","182 lbs","245","10",120,120,4,10,9,7,11,9,14,8,16,12,11,10,14,10,14,13,16,10,13,11,14,7,13,9,13,17,10,15,10,8,11,14,15,11,13,16,10,15,11,13,12,13,7,14,13,7,13,12,14,2,1,2,3,2,2,3,1,2,1,1
"8645",85128056,"Cédric Yambéré","11/6/1990 (32 years old)","D (C)","Chania","Greek Super League 2 South","CTA","Yes","9/30/2022","6/30/2023","$0 - $30K","Right Only","Weak","Very Strong","6'3""","185 lbs","211","11",105,120,4,5,10,8,7,6,12,6,9,12,10,5,11,7,15,12,15,11,12,10,14,6,12,10,13,12,8,11,12,11,16,16,16,12,12,14,12,7,13,8,8,14,6,15,13,7,11,12,13,3,1,1,2,1,3,3,4,4,2,1
"8646",49055713,"Marco Majouga","5/9/2001 (22 years old)","AM (RLC), ST (C)","Botev Vratsa","Bulgarian First League","CTA","Yes","2/7/2023","6/30/2024","$180K - $550K","Right Only","Weak","Very Strong","6'0""","171 lbs","49","3",91,118,8,11,12,9,10,8,9,11,5,7,10,10,8,11,6,11,10,6,9,8,10,10,5,9,10,12,10,11,13,11,11,11,14,12,10,13,9,9,7,11,12,13,5,10,10,4,11,11,12,2,2,1,1,3,2,2,1,1,1,2
"8647",49038418,"Dominique Youfeigane","2/7/2000 (23 years old)","GK","EA Guingamp","Ligue 2 BKT","CTA","Yes","6/15/2020","6/30/2026","$40K - $400K","Right","Weak","Very Strong","6'2""","185 lbs","8","-",100,118,5,3,3,1,7,8,2,2,3,3,9,2,2,7,13,9,13,11,9,10,13,1,10,2,10,12,8,8,10,12,12,14,14,9,10,14,11,12,11,14,13,16,7,11,5,7,11,12,15,12,9,12,7,10,10,13,9,12,10,13
"8648",36127713,"Louis Mafouta","7/2/1994 (28 years old)","ST (C)","QRM","Ligue 2 BKT","CTA","Yes","7/1/2022","6/30/2025","$0","Right","Weak","Very Strong","6'1""","171 lbs","185","63",113,118,5,9,12,12,11,5,12,9,5,6,12,12,6,12,6,11,13,13,11,11,13,11,9,15,5,13,10,13,14,12,12,13,14,14,13,12,11,13,6,8,11,11,11,12,5,5,13,6,9,3,3,3,3,2,2,3,3,3,2,2
"8649",49062125,"Hamissou Dangabo","1/15/2003 (20 years old)","AM (L), ST (C)","FC Nantes","French National 3 - Group D","CTA","Yes","6/9/2023","6/30/2026","$400K - $1.2M","Right","Weak","Very Strong","5'11""","163 lbs","-","-",85,118,6,10,13,10,11,6,13,7,2,5,11,4,2,13,15,10,3,10,7,10,4,13,12,13,7,6,7,8,13,13,6,8,8,13,6,6,10,12,11,13,10,10,13,1,5,6,10,11,15,3,3,1,4,2,3,3,1,1,1,3
"8650",85050446,"Geoffrey Lembet","9/23/1988 (34 years old)","GK","CS Sedan Ardennes","French Regional Divisions","CTA","Yes","1/29/2019","6/30/2025","$18K - $180K","Left Only","Very Strong","Weak","6'1""","165 lbs","151","-",99,116,3,1,2,2,8,4,8,3,1,3,7,1,3,8,7,13,13,12,12,9,17,6,12,2,12,12,8,7,11,13,12,13,13,11,12,12,1,12,15,18,12,14,8,12,7,5,12,13,16,10,11,13,9,12,7,10,6,13,12,11
"8651",2000013729,"Yegor Ushakov","12/2/2002 (20 years old)","M (RL)","CSKA Moscow","Russian Premier League","RUS","No","5/20/2022","6/30/2026","$275K - $800K","Right","Reasonable","Very Strong","5'9""","149 lbs","11","1",95,141,9,9,12,8,10,8,6,6,7,7,10,7,8,12,8,9,11,10,12,10,13,8,13,12,9,13,8,13,14,14,10,7,14,13,10,6,13,12,9,13,12,10,12,10,12,5,12,10,12,1,2,2,2,3,1,3,1,2,1,1
"8652",33077599,"Sterling Yatéké","9/15/1999 (23 years old)","ST (C)","FC Helsingør","NordicBet Liga","CTA","No","8/12/2022","6/30/2024","$16K - $160K","Right","Reasonable","Very Strong","6'2""","176 lbs","129","42",91,116,6,6,7,8,10,5,10,7,5,4,8,13,6,10,11,8,11,9,8,8,10,9,4,12,6,11,8,12,16,11,11,13,12,14,12,14,8,10,11,11,13,14,7,6,5,7,9,9,13,3,1,1,1,4,1,1,1,2,1,2
"8653",49037548,"Goduine Koyalipou","2/15/2000 (23 years old)","AM (R), ST (C)","US Avranches","French National","CTA","Yes","6/17/2021","6/30/2026","$35K - $350K","Right","Fairly Strong","Very Strong","6'0""","180 lbs","97","23",105,116,7,12,14,10,13,8,14,8,6,5,10,11,6,13,10,8,12,9,6,9,13,15,5,11,7,7,9,10,14,9,10,12,11,14,11,12,7,15,10,8,9,11,12,9,6,1,12,15,17,3,3,3,3,1,3,1,2,4,1,3
"8654",13170378,"Samuel Nlend","3/15/1995 (28 years old)","AM (R), ST (C)","Bisha","Saudi Second Division Group B","CTA","No","1/1/2022","6/30/2023","$16K - $150K","Left","Very Strong","Reasonable","6'1""","167 lbs","4","3",100,114,7,10,13,12,13,7,10,7,1,5,10,3,6,13,11,10,5,12,8,13,6,13,8,13,7,7,6,8,13,11,8,9,8,17,13,5,14,10,9,13,11,14,11,15,5,6,20,10,11,1,2,3,2,3,2,3,1,3,2,2
"8655",48042654,"Calvin Bombo","1/18/1999 (24 years old)","DM, M (C)","CA Vitry","French National 3 - Group H","CTA","Yes","11/1/2022","6/30/2024","$16K - $160K","Right","Weak","Very Strong","6'2""","147 lbs","14","3",81,110,4,6,10,6,11,6,10,8,9,11,12,9,12,10,11,12,11,12,10,8,9,9,11,10,12,12,11,12,11,11,11,11,13,10,12,11,9,11,11,11,9,11,8,9,7,7,10,10,10,3,2,1,2,3,1,2,1,2,4,3
"8656",34008867,"Manassé Enza-Yamissi","9/28/1989 (33 years old)","D (LC)","Stade Poitevin FC","French National 3 - Group C","CTA","Yes","8/20/2022","6/30/2024","$2K - $18K","Left Only","Very Strong","Weak","6'3""","191 lbs","186","3",87,110,5,5,5,5,8,5,11,5,10,12,8,5,12,8,12,11,11,10,11,11,12,5,7,11,12,12,7,11,10,12,11,13,13,10,12,12,11,18,11,11,11,10,10,11,11,6,10,12,14,2,2,1,2,1,3,3,1,3,1,2
"8657",2000085140,"Christian Yawanendji","5/16/2002 (21 years old)","AM (R), ST (C)","Gasogi","Rwandan Premier Division","CTA","No","7/1/2021","6/30/2024","$0 - $40K","Right","Strong","Very Strong","5'5""","132 lbs","-","-",82,107,8,11,11,15,14,8,8,10,4,8,13,9,8,9,5,13,6,7,9,10,2,8,15,8,8,9,10,10,9,10,9,4,12,11,9,2,10,10,8,10,11,11,7,4,13,1,13,11,18,1,3,3,2,3,3,2,2,3,1,3
"8658",2000085161,"Alfred Gombe-Fei","11/1/2001 (21 years old)","ST (C)","Vyškov","-","CTA","No","10/20/2021","6/30/2024","$60K - $170K","Right","Weak","Very Strong","6'2""","176 lbs","19","4",82,107,4,2,8,13,13,6,8,5,1,6,12,8,1,9,8,9,8,7,7,10,7,10,6,11,7,7,6,12,13,11,8,12,13,11,8,10,10,16,11,10,9,12,10,18,15,4,10,11,18,2,4,2,2,1,2,1,1,3,2,2
"8659",91206730,"Peter Guinari","6/2/2001 (22 years old)","D (RC)","Wiltz","Luxembourg National Division","CTA","Yes","7/28/2022","6/30/2025","$0 - $55K","Right Only","Weak","Very Strong","6'3""","178 lbs","56","1",81,107,4,9,4,1,9,1,12,5,7,14,8,6,14,5,15,10,9,8,6,14,14,5,9,7,14,7,6,9,11,8,8,11,11,8,11,6,17,14,9,8,12,10,11,9,7,7,18,10,15,3,1,2,4,1,3,2,3,1,2,2
"8660",49040845,"Axel Urie","4/14/1999 (24 years old)","M/AM (RL)","Concarneau","Ligue 2 BKT","CTA","Yes","9/16/2022","6/30/2025","$180K - $550K","Left","Very Strong","Weak","5'11""","158 lbs","39","2",95,107,7,10,11,8,13,4,6,8,7,4,12,7,6,11,8,9,7,9,6,12,11,10,8,10,7,6,8,7,14,12,8,7,13,13,10,7,8,13,12,10,12,12,10,8,8,7,11,11,8,3,2,3,3,3,3,3,3,3,2,3
"8661",48043760,"Khamis Digol","9/28/1998 (24 years old)","D/WB (R)","Vendée Fontenay Foot","French National 3 - Group D","CTA","Yes","2/1/2023","6/30/2024","$0 - $90K","Right Only","Weak","Very Strong","6'2""","169 lbs","33","1",80,105,7,10,9,6,10,7,9,7,11,10,10,7,11,10,9,10,9,9,7,10,14,10,8,10,11,9,9,10,13,11,10,9,13,12,11,11,11,15,14,11,11,10,9,9,9,4,10,13,18,2,4,3,3,2,1,3,3,3,2,3
"8662",8085570,"Artem Dzyuba","8/22/1988 (34 years old)","ST (C)","Lokomotiv Moscow","Russian Premier League","RUS","No","5/25/2023","6/30/2024","$170K - $1.7M","Right","Fairly Strong","Very Strong","6'5""","207 lbs","405","157",124,140,7,9,10,15,13,8,16,9,9,7,12,15,6,13,14,14,18,15,13,16,13,11,15,14,12,14,13,9,7,7,13,16,16,8,11,18,11,13,10,15,13,12,12,17,13,17,15,15,9,2,3,2,2,2,3,1,2,1,2,2
"8663",85057007,"Lionel Zouma","9/10/1993 (29 years old)","D (C)","Vevey-Sports","Swiss First League Classic Group 1","CTA","Yes","2/3/2021","6/30/2025","$2K - $18K","Right Only","Very Weak","Very Strong","6'5""","171 lbs","115","5",79,105,6,7,8,6,9,6,13,8,9,12,8,6,11,9,13,12,15,9,10,8,16,6,8,7,11,13,9,12,8,8,14,14,11,9,10,13,8,13,13,14,9,13,9,12,13,8,12,12,9,3,1,1,2,2,3,1,2,3,1,3
"8664",13103506,"Salif Kéïta","4/10/1990 (33 years old)","D (C)","SCAF Tocages","Central African Premier Division","CTA","No","11/8/2020","6/30/2024","$0","Right","Strong","Very Strong","6'0""","176 lbs","58","-",80,105,5,3,5,6,8,7,14,5,1,14,8,3,10,4,5,14,9,8,8,11,16,5,10,7,14,7,4,8,8,11,8,8,8,8,10,6,10,15,11,13,13,11,7,12,12,5,8,11,12,1,2,1,2,2,1,2,3,3,2,2
"8665",2000291716,"Kylan Chasseport","6/8/2007 (16 years old)","D (C)","Niort","French National","CTA","Yes","7/1/2022","6/30/2026","$50K - $500K","Right","Reasonable","Very Strong","5'10""","136 lbs","-","-",64,102,2,1,2,4,7,4,14,2,4,14,7,1,14,6,12,9,8,6,6,14,17,5,6,2,9,3,6,7,9,12,7,5,14,10,5,4,8,17,12,11,13,12,10,5,12,2,9,12,16,3,4,1,3,2,3,1,2,3,2,3
"8666",2000188092,"Tony Biakolo","8/27/2006 (16 years old)","D (C)","Toulouse FC","Ligue 1 Uber Eats","CTA","Yes","7/1/2022","6/30/2026","$65K - $650K","Right Only","Weak","Very Strong","6'2""","169 lbs","-","-",64,101,6,1,1,2,7,6,10,4,1,11,7,2,10,6,14,9,8,5,8,14,14,5,1,3,14,6,2,7,9,12,7,11,12,8,8,5,12,15,8,10,14,12,5,13,8,3,18,11,12,4,1,2,2,2,2,1,4,3,3,1
"8667",13128578,"Brice Zimbori","5/22/1989 (34 years old)","DM, M (C)","Les Anges de Fatima","Central African Premier Division","CTA","No","6/14/2021","6/30/2024","$0","Right Only","Weak","Very Strong","6'0""","174 lbs","-","-",75,100,7,8,7,6,12,7,6,9,3,9,14,5,13,11,7,9,8,9,7,14,11,6,12,8,9,8,11,12,11,8,8,6,11,8,8,7,12,16,12,10,11,12,6,13,13,5,18,11,12,3,2,3,1,1,1,3,2,3,2,1
"8668",2000085133,"Chadrack Djendo","12/15/2003 (19 years old)","AM (C), ST (C)","DFC 8","Central African Premier Division","CTA","No","7/1/2019","6/30/2024","$0","Right","Reasonable","Very Strong","5'11""","158 lbs","-","-",63,100,5,1,9,12,11,5,5,7,1,5,7,6,4,11,10,8,7,8,6,10,14,12,3,5,6,6,8,7,12,10,7,8,7,11,10,5,8,16,12,13,12,11,7,8,8,8,11,13,11,1,4,2,4,3,2,3,1,2,2,3
"8669",85120133,"Dylan Mboumbouni","2/20/1996 (27 years old)","D (C)","CS Mioveni","Romanian Second League","CTA","Yes","1/13/2023","6/30/2024","$240K - $750K","Right","Reasonable","Very Strong","6'0""","165 lbs","70","-",96,99,5,6,8,5,12,11,11,10,5,13,12,6,12,11,13,12,12,8,10,8,11,11,7,7,13,12,8,12,11,12,12,11,13,11,12,13,10,17,11,13,8,13,10,11,12,3,11,9,12,1,2,3,1,1,4,3,3,2,1,2
"8670",2000280696,"Tieri Godame","7/9/2002 (20 years old)","AM (L), ST (C)","FC Challans","French National 3 - Group D","CTA","Yes","7/1/2021","6/30/2024","$0 - $80K","Left Only","Very Strong","Weak","6'0""","158 lbs","38","11",72,97,7,11,12,14,13,7,13,8,1,6,12,3,3,9,5,12,8,10,5,7,13,10,12,13,8,6,5,9,13,9,8,7,15,12,7,5,9,17,13,12,12,13,13,8,7,5,15,11,16,3,2,1,3,2,2,4,3,3,1,2
"8671",13231073,"Melvin Ngam-Ngam","3/9/2000 (23 years old)","D (R)","Les Anges de Fatima","Central African Premier Division","CTA","No","6/15/2020","6/30/2024","$0","Right","Reasonable","Very Strong","5'8""","134 lbs","-","-",72,97,4,11,6,4,10,2,8,5,1,10,8,7,10,8,9,11,9,8,10,14,8,8,12,6,10,7,8,8,13,13,8,7,12,11,5,5,14,17,11,12,12,10,5,1,6,4,9,13,12,2,2,2,3,1,1,3,2,3,3,1
"8672",2000250111,"Noah Ato-Zandanga","7/5/2003 (19 years old)","D (R), DM, M (C)","Santanyí","Spanish Federation Third Group 11","CTA","No","7/1/2022","6/30/2024","$1.5K - $16K","Right","Fairly Strong","Very Strong","6'0""","160 lbs","-","-",58,97,8,10,5,6,9,6,7,8,1,8,9,5,12,8,6,9,7,8,9,13,8,5,12,4,6,7,7,8,5,10,7,7,18,8,6,5,13,17,12,11,11,10,11,7,8,6,8,12,7,3,1,1,1,1,3,2,4,2,1,3
"8673",58154550,"Danila Khotulev","10/1/2002 (20 years old)","D (C)","Orenburg","Russian Premier League","RUS","No","1/5/2023","6/30/2026","$160K - $7.8M","Left","Very Strong","Strong","6'2""","180 lbs","45","1",103,140,9,6,8,9,8,6,10,7,5,14,8,10,12,8,15,8,12,8,12,11,10,7,9,9,12,9,9,8,10,9,8,14,8,11,11,12,13,19,12,11,8,12,10,14,8,2,12,11,15,3,2,3,3,2,3,3,1,1,1,3
"8674",2000049444,"Ruben Kokolo","3/27/2000 (23 years old)","ST (C)","Paris 13 Atlético","French National 2 - B","CTA","No","7/1/2022","6/30/2023","$0 - $5K","Right","Reasonable","Very Strong","6'2""","171 lbs","21","3",82,97,5,6,11,14,7,6,10,3,3,6,8,7,6,12,7,14,8,10,8,9,3,11,14,12,7,7,7,8,13,11,8,9,15,10,11,6,12,19,9,14,11,13,5,10,7,6,16,11,13,1,4,2,1,2,3,1,2,3,3,2
"8675",12007225,"Alladoum Kolimba","8/11/1987 (35 years old)","GK","Wikki Tourists","Nigerian Second Division","CTA","No","9/30/2020","9/1/2023","$0","Right","Reasonable","Very Strong","6'4""","176 lbs","8","-",86,97,4,3,3,3,2,7,1,1,1,2,12,2,3,5,10,11,14,8,9,14,5,1,9,3,11,8,7,7,7,12,4,12,11,7,7,8,13,18,12,12,11,13,13,7,10,4,15,10,7,7,10,10,15,9,8,9,5,7,10,12
"8676",13231066,"Marc Yapéndé","8/20/2002 (20 years old)","D/WB (L)","Bamboutos","Cameroonian MTN Elite One Group A","CTA","No","7/1/2022","6/30/2024","$0 - $80K","Left","Very Strong","Reasonable","5'8""","149 lbs","-","-",78,95,6,10,10,8,11,3,11,6,10,13,10,2,10,10,15,12,11,7,11,11,4,9,2,9,11,16,10,12,12,12,11,5,16,10,7,8,17,15,11,11,14,9,12,6,7,4,12,11,8,4,3,2,3,3,2,3,3,1,4,3
"8677",211255,"Yacoub Youmbi","4/1/1994 (29 years old)","DM, M (C)","Naft Al-Basra","Iraqi Premier League","CTA","No","9/2/2021","7/31/2023","$500 - $6K","Right","Reasonable","Very Strong","6'0""","171 lbs","40","1",85,95,6,6,5,7,13,6,13,8,1,9,8,1,13,13,14,12,8,7,8,13,7,6,10,7,9,7,8,12,13,12,7,5,8,13,13,13,14,19,12,11,12,11,7,6,5,3,10,7,20,1,3,1,3,1,2,1,1,1,3,4
"8678",13129701,"Moussa Limane","5/7/1992 (31 years old)","AM (RC), ST (C)","Hamilton United","League1 Ontario","CTA","No","7/2/2022","-","$0","Right Only","Weak","Very Strong","5'8""","141 lbs","-","-",82,95,7,9,6,12,12,7,9,8,3,7,13,3,6,9,6,11,7,9,8,11,18,8,3,14,8,8,8,9,10,14,8,3,14,11,13,6,11,16,12,10,12,12,11,4,9,4,8,12,17,2,4,3,2,1,3,1,1,2,3,2
"8679",13234862,"Jospin Gaopandia","4/19/1999 (24 years old)","DM, M (C)","Les Anges de Fatima","Central African Premier Division","CTA","No","6/15/2020","6/30/2024","$0","Left","Very Strong","Reasonable","5'10""","154 lbs","-","-",80,95,6,6,3,7,13,6,5,5,2,8,12,2,13,9,9,7,8,5,7,13,14,5,7,8,12,7,6,12,13,13,7,3,11,12,13,5,13,12,11,13,13,9,6,2,13,4,8,11,16,1,1,2,2,2,1,4,3,2,3,3
"8680",39066259,"Jordan Damachoua","7/10/1991 (31 years old)","D (RC)","KF","Icelandic Second Division","CTA","Yes","7/16/2022","-","$0","Right","Reasonable","Very Strong","6'1""","158 lbs","112","13",75,95,4,11,5,4,7,1,13,1,4,11,7,3,13,6,11,9,9,6,10,8,11,5,12,6,13,6,3,8,9,11,7,13,8,10,13,5,15,11,14,9,8,12,6,6,5,2,10,11,13,3,4,3,2,1,1,2,1,2,2,2
"8681",2000114576,"Delphin Mokonou","10/28/2000 (22 years old)","ST (C)","DFC 8","Central African Premier Division","CTA","No","7/1/2020","6/30/2024","$0","Right","Reasonable","Very Strong","6'2""","171 lbs","-","-",75,95,6,3,11,12,13,6,13,8,5,6,7,2,4,10,6,9,3,9,6,5,4,10,9,13,7,6,8,8,13,9,7,13,15,11,6,6,12,19,11,12,10,10,11,4,8,2,19,8,13,4,1,2,3,3,1,3,4,1,1,3
"8682",2000049910,"Gisbert Tristan Zarambaud","7/8/1997 (25 years old)","D (L)","CA Pontarlier","French National 3 - Group J","CTA","Yes","7/1/2022","6/30/2024","$14K - $140K","Left","Very Strong","Reasonable","5'5""","134 lbs","49","1",82,94,6,10,4,4,12,1,6,4,7,8,8,1,13,9,8,9,9,8,8,12,14,5,12,7,8,8,8,8,14,13,8,4,13,13,13,5,14,20,12,11,11,7,10,3,5,8,13,10,11,3,1,1,1,2,1,3,1,3,3,1
"8683",43392220,"Eleoenai Tompte","1/18/1999 (24 years old)","AM (RL), ST (C)","ASV Siegendorf","Austrian Burgenland League","CTA","No","2/1/2022","6/30/2024","$0","Right Only","Very Weak","Very Strong","5'10""","154 lbs","74","24",82,92,4,8,12,8,7,6,8,7,6,6,10,4,5,12,8,7,4,7,6,8,15,12,9,9,6,7,7,11,13,13,12,7,8,13,13,8,10,10,12,11,12,9,5,10,7,7,13,11,7,1,1,2,3,3,3,3,3,1,2,2
"8684",58133486,"Alexandr Chernikov","2/1/2000 (23 years old)","DM","Krasnodar","Russian Premier League","RUS","No","6/20/2022","6/30/2026","$550K - $5.6M","Right","Weak","Very Strong","6'0""","176 lbs","103","6",120,140,10,9,10,8,10,8,14,12,8,11,13,4,15,10,16,13,18,11,13,11,8,5,12,11,13,15,9,16,12,12,14,12,13,12,15,13,18,18,12,12,10,12,11,12,14,1,15,12,14,1,2,1,3,1,2,2,3,2,4,2
"8685",48045824,"Henri Saunié","4/28/1996 (27 years old)","D (RL), WB (R)","Meyrin","Swiss First League Classic Group 1","CTA","Yes","2/20/2023","6/30/2025","$0","Right Only","Weak","Very Strong","6'0""","163 lbs","67","6",76,92,5,10,6,7,10,3,11,4,3,8,9,5,10,7,11,9,9,9,8,11,19,5,10,7,6,9,8,9,13,9,11,11,15,12,14,12,12,13,10,13,10,13,5,15,6,3,11,10,7,3,1,3,3,2,4,3,1,2,3,2
"8686",2000011494,"Séverin Tatolna","1/10/2002 (21 years old)","ST (C)","Umeå FC","Swedish Third Division North Norrland","CTA","Yes","1/18/2023","12/31/2024","$0 - $10K","Left Only","Very Strong","Weak","6'1""","167 lbs","99","19",62,90,7,7,7,7,8,7,9,8,7,8,7,8,8,8,12,8,7,7,8,7,10,8,7,8,7,8,7,8,12,10,12,12,12,12,12,12,12,10,10,10,10,10,5,10,8,5,9,10,14,4,2,3,3,2,2,3,1,1,3,3
"8687",12054100,"Romaric Lignanzi","9/9/1988 (34 years old)","DM, M (C)","Canon 105","Gabonese Premier Division","CTA","No","1/1/2019","6/30/2024","$0","Right Only","Weak","Very Strong","6'1""","180 lbs","10","-",73,90,6,6,2,7,13,4,6,12,4,7,10,5,12,9,5,8,5,7,8,13,9,7,11,7,12,7,10,6,10,9,13,8,14,10,13,13,12,14,9,12,11,13,14,4,12,3,7,11,9,2,3,1,2,2,3,3,2,3,1,3
"8688",2000085162,"Flory Yangao","1/13/2002 (21 years old)","D/WB (R)","ORB","Central African Premier Division","CTA","No","7/1/2019","6/30/2024","$0 - $3K","Right","Strong","Very Strong","6'0""","165 lbs","-","-",70,90,5,11,3,7,9,3,7,1,4,8,8,3,10,7,12,9,9,8,11,6,20,10,12,7,8,8,7,8,14,14,6,6,7,14,5,5,12,10,12,10,10,12,14,12,5,6,15,11,19,2,2,1,2,1,2,3,2,3,2,1
"8689",7546192,"Calvin","5/10/1986 (37 years old)","D (RC), DM","Frontiera Curtici","Romanian Fourth League Arad","CTA","Yes","6/22/2022","6/30/2023","$0","Right Only","Weak","Very Strong","6'1""","167 lbs","237","8",54,90,2,8,7,6,8,7,11,10,4,11,8,9,10,7,13,8,12,12,10,7,11,10,11,2,9,9,8,9,8,7,6,9,12,8,8,9,10,11,13,12,12,10,3,11,7,5,11,10,10,1,3,1,1,2,1,3,1,3,1,1
"8690",2000095747,"Duhamel Mabengue","10/10/2001 (21 years old)","ST (C)","Stade de Bertoua","Cameroonian Lower Divisions","CTA","No","1/1/2022","6/30/2024","$500 - $4.5K","Right","Reasonable","Very Strong","5'10""","152 lbs","-","-",61,90,5,4,8,13,8,5,13,5,1,4,5,4,2,8,5,12,4,11,1,11,5,13,6,10,5,5,5,5,13,11,3,5,15,12,10,6,9,17,12,11,12,10,6,8,5,5,9,10,10,3,3,3,3,2,1,2,3,3,2,3
"8691",2000017594,"César Manzoki Lobi","7/24/1998 (24 years old)","ST (C)","DL Pro","Chinese Super League","CTA","No","1/1/2023","12/31/2023","$16K - $150K","Right","Reasonable","Very Strong","6'2""","176 lbs","23","3",80,90,4,6,14,14,13,6,13,8,6,5,6,5,1,8,6,8,7,6,8,12,6,10,14,11,8,7,7,11,11,10,7,8,6,11,9,6,12,20,10,12,10,11,7,6,9,1,9,12,7,2,3,1,2,2,1,2,3,2,2,1
"8692",13210753,"Sadock Ndobé","9/9/1998 (24 years old)","D/WB (L)","Les Anges de Fatima","Central African Premier Division","CTA","No","7/1/2022","6/30/2024","$1.5K - $4K","Left","Very Strong","Reasonable","6'3""","171 lbs","-","-",76,90,5,10,5,1,8,1,6,1,4,8,8,1,13,7,12,8,6,4,7,13,12,5,10,6,9,7,5,8,13,9,7,15,15,13,13,7,12,15,10,12,12,8,13,10,7,2,11,13,15,1,3,1,2,3,2,2,3,1,3,1
"8693",2000234271,"Vénuste Baboula","8/23/1998 (24 years old)","M (L), AM (RL)","Racing CFF","French National 2 - C","CTA","Yes","7/1/2020","6/30/2025","$6K - $65K","Right Only","Weak","Very Strong","5'9""","165 lbs","48","13",84,90,6,8,12,8,13,6,6,8,6,6,5,6,8,9,9,6,3,9,5,7,9,9,8,8,6,8,10,12,13,13,8,7,10,13,13,4,13,13,12,10,10,10,8,9,8,6,11,10,13,1,2,3,1,3,3,2,3,2,2,2
"8694",2000114593,"Melky Ndokomandji","9/4/1997 (25 years old)","DM, M (C)","Bamboutos","Cameroonian MTN Elite One Group A","CTA","No","7/1/2022","6/30/2024","$22K - $65K","Right","Reasonable","Very Strong","6'1""","171 lbs","-","-",83,90,6,2,3,6,11,6,7,7,4,10,13,5,12,8,5,9,8,8,6,13,10,5,13,7,13,7,8,12,13,13,6,11,8,13,7,6,12,12,9,10,12,11,15,7,7,4,11,11,15,2,3,1,3,1,2,2,2,1,1,2
"8695",58156290,"Sergey Pinyaev","11/2/2004 (18 years old)","M (L), AM (RL)","Lokomotiv Moscow","Russian Premier League","RUS","No","12/28/2022","12/31/2026","$1.1M - $11M","Right","Reasonable","Very Strong","5'6""","138 lbs","78","9",119,152,13,13,14,10,15,12,7,12,6,6,11,11,11,14,5,10,9,12,11,13,3,15,4,14,8,8,13,11,14,16,13,5,12,13,9,5,11,12,13,11,12,10,14,3,9,1,16,10,12,1,2,3,2,4,2,1,3,3,2,2
"8696",58031133,"Magomed Ozdoev","11/5/1992 (30 years old)","DM, M (C)","Fatih Karagümrük","Turkish Super League","RUS","No","7/28/2022","6/30/2025","$475K - $1.4M","Right","Reasonable","Very Strong","6'0""","169 lbs","269","21",120,140,10,10,11,10,13,10,10,13,8,12,14,13,13,14,13,13,12,12,13,13,12,12,13,12,10,14,13,14,13,13,12,11,14,11,12,11,13,7,8,11,9,12,8,9,5,12,13,13,10,2,1,3,1,1,2,2,1,1,1,1
"8697",2000114972,"Georgino M'Vondo-Ze","8/12/1997 (25 years old)","M/AM (C)","Biesheim ASC","French National 2 - D","CTA","Yes","2/1/2023","6/30/2023","$0 - $6K","Right Only","Weak","Very Strong","6'3""","178 lbs","96","25",78,89,5,7,6,11,14,3,5,6,5,8,9,4,8,11,11,12,7,8,8,11,10,10,13,11,9,8,9,7,14,10,7,13,11,10,12,7,11,14,13,11,12,9,7,7,12,7,12,11,18,1,3,3,1,1,1,3,2,2,3,3
"8698",11023165,"Amir Rrahmani","2/24/1994 (29 years old)","D (C)","Parthenope","Italian Serie A","KOS","No","5/26/2023","6/30/2027","$47M - $57M","Right","Fairly Strong","Very Strong","6'4""","182 lbs","279","16",150,154,4,9,8,10,11,5,16,8,11,15,12,7,16,10,15,15,15,13,14,14,15,4,11,10,14,15,10,16,12,11,15,16,14,13,14,16,12,12,10,15,14,13,8,13,12,6,13,14,12,4,3,1,3,1,1,3,3,3,3,3
"8699",28108492,"Arijanet Murić","11/7/1998 (24 years old)","GK","Burnley","English Premier Division","KOS","Yes","7/22/2022","6/30/2026","$10.5M - $15.5M","Right Only","Weak","Very Strong","6'6""","191 lbs","93","-",128,150,3,3,2,1,13,6,4,2,1,3,12,2,3,12,16,14,17,12,13,12,15,1,7,2,12,12,11,11,12,12,12,18,13,16,10,13,14,10,16,16,13,9,7,6,6,13,14,12,15,12,14,15,12,14,8,12,5,10,12,16
"8700",11024791,"Milot Rashica","6/28/1996 (26 years old)","AM (RL)","Norwich","Sky Bet Championship","KOS","No","7/1/2021","6/30/2025","$850K - $5.6M","Right","Weak","Very Strong","5'10""","160 lbs","252","48",135,146,12,14,13,12,13,9,6,11,7,10,12,10,7,13,14,12,13,12,15,13,12,11,7,11,9,16,11,15,15,16,13,7,13,14,15,13,12,14,14,14,11,9,10,12,6,10,15,16,16,2,1,1,2,1,3,3,3,1,3,1
"8701",11022221,"Vedat Muriqi","4/24/1994 (29 years old)","ST (C)","Mallorca","Spanish First Division","KOS","No","7/25/2022","6/30/2027","$15.5M - $18.5M","Left","Very Strong","Reasonable","6'4""","202 lbs","305","91",141,144,4,9,10,14,12,3,17,12,3,8,11,15,7,11,16,16,18,13,15,14,17,12,12,15,11,19,13,19,10,10,16,17,16,11,16,18,5,15,13,15,17,17,7,14,7,5,15,15,14,2,3,2,2,1,1,3,3,3,2,2
"8702",18104985,"Edon Zhegrova","3/31/1999 (24 years old)","M (RL), AM (RLC)","LOSC","Ligue 1 Uber Eats","KOS","Yes","1/14/2022","6/30/2026","$10M - $12M","Left","Very Strong","Weak","5'11""","158 lbs","117","16",132,141,12,12,16,10,16,10,4,12,4,4,12,12,6,16,7,11,13,13,10,11,11,17,4,12,5,10,10,11,15,15,14,7,12,16,12,8,8,7,5,11,17,8,11,12,8,14,10,18,8,1,3,1,1,2,1,1,3,1,2,2
"8703",30046616,"Bler Thaçi","5/18/1999 (24 years old)","M (RC)","Ramiz Sadiku","Kosovan First League Group B","KOS","No","7/15/2022","6/30/2023","$0","Right","Reasonable","Very Strong","5'8""","141 lbs","47","6",64,140,7,10,7,7,13,5,5,6,5,6,11,5,7,11,11,10,4,9,7,5,8,5,12,7,6,7,8,12,13,13,7,1,17,13,13,4,12,7,12,11,13,12,11,15,11,1,12,11,8,2,2,2,1,1,2,3,2,2,2,1
"8704",18086509,"Mërgim Vojvoda","2/1/1995 (28 years old)","D/WB/M (RL)","Torino","Italian Serie A","KOS","Yes","9/1/2020","6/30/2024","$6M - $11M","Right","Reasonable","Very Strong","6'1""","171 lbs","236","5",133,139,7,14,12,8,13,8,12,9,12,11,12,6,13,14,14,12,14,12,12,12,14,13,11,11,12,14,11,14,13,13,12,13,12,14,12,13,15,11,14,13,12,11,5,11,12,5,13,13,15,1,3,2,2,2,2,1,2,2,1,3
"8705",30045976,"Albion Rrahmani","8/31/2000 (22 years old)","ST (C)","Ballkani","Kosovan Superleague","KOS","No","6/23/2021","6/30/2024","$160K - $1.6M","Right","Fairly Strong","Very Strong","6'2""","176 lbs","88","55",117,137,5,9,12,14,12,9,13,11,3,5,12,13,6,12,12,12,12,9,11,10,15,10,8,14,12,11,12,12,13,14,11,13,13,14,11,11,7,12,12,12,12,7,5,12,10,11,12,15,13,1,2,3,2,3,1,1,2,3,2,1
"8706",91108276,"Leart Paqarada","10/8/1994 (28 years old)","D/WB (L)","St. Pauli","Bundesliga 2","KOS","Yes","8/2/2020","6/30/2025","$650K - $6.4M","Left","Very Strong","Weak","6'0""","167 lbs","280","12",128,135,15,16,11,8,13,15,7,13,15,11,13,12,12,14,14,12,12,12,11,12,13,13,14,13,12,12,13,12,13,12,12,11,18,14,15,10,10,10,12,15,14,13,4,15,8,8,15,14,8,1,2,2,3,2,1,1,3,3,2,3
"8707",2000180458,"Denis Makarov","12/31/2005 (17 years old)","M (C), AM (RLC), ST (C)","Rubin","Russian Premier League","RUS","No","2/21/2022","6/30/2024","$180K - $1.8M","Right","Weak","Very Strong","6'0""","158 lbs","-","-",60,140,5,5,6,6,7,7,5,7,5,5,8,9,6,7,9,6,6,7,7,12,2,11,2,8,5,6,7,6,12,10,8,10,8,12,12,8,11,11,12,11,9,11,9,10,7,1,8,13,8,2,1,2,2,2,2,3,2,2,3,3
"8708",84154015,"Betim Fazliji","4/25/1999 (24 years old)","D (C), DM","St. Pauli","Bundesliga 2","KOS","Yes","7/15/2022","6/30/2025","$50K - $475K","Right","Reasonable","Very Strong","6'1""","174 lbs","136","10",117,135,3,8,9,7,13,8,12,12,11,12,13,8,13,12,13,13,14,12,11,13,13,8,8,10,13,15,12,14,12,10,12,12,13,13,13,12,15,12,11,13,10,13,8,10,8,7,12,13,8,1,3,2,2,3,3,2,4,3,3,3
"8709",53087151,"Bersant Celina","9/9/1996 (26 years old)","M/AM (LC)","Dijon FCO","French National","KOS","Yes","9/9/2020","6/30/2024","$110K - $1.1M","Right","Reasonable","Very Strong","5'11""","145 lbs","224","26",115,135,13,13,14,10,14,13,5,14,5,5,13,10,4,14,8,10,6,12,10,10,15,16,5,12,7,10,13,10,14,14,12,8,12,13,12,7,10,9,14,13,8,15,8,17,5,16,12,16,13,2,2,3,1,1,1,3,1,1,2,2
"8710",93140783,"Ismet Lushaku","9/22/2000 (22 years old)","M (C), AM (LC)","Varbergs BoIS","Swedish Premier Division","KOS","Yes","1/17/2022","12/31/2025","$75K - $750K","Right","Reasonable","Very Strong","5'10""","171 lbs","88","2",104,135,10,12,12,7,13,9,6,10,6,8,13,9,9,13,13,12,12,13,11,12,12,12,5,12,10,12,12,12,12,12,9,10,12,12,13,9,11,8,9,11,12,12,5,10,12,8,11,12,14,1,2,3,2,3,1,1,1,2,1,2
"8711",29233144,"Adrion Pajaziti","11/16/2002 (20 years old)","M/AM (C)","Haugesund","Norwegian Premier Division","KOS","No","8/19/2022","6/30/2025","$5.8M - $8.6M","Right","Reasonable","Very Strong","5'10""","156 lbs","22","-",100,135,5,10,9,11,14,8,7,13,8,10,12,5,8,11,15,10,6,9,7,14,16,8,7,12,8,13,13,12,11,9,14,9,9,10,10,9,11,13,9,11,10,10,10,18,6,6,19,11,18,3,3,2,1,3,2,3,2,2,3,2
"8712",18003625,"Samir Ujkani","7/5/1988 (34 years old)","GK","Empoli","Italian Serie A","KOS","Yes","8/31/2021","6/30/2024","$18K - $55K","Right Only","Weak","Very Strong","6'2""","171 lbs","215","-",104,134,1,1,7,1,8,1,9,1,5,1,8,1,5,8,2,13,12,13,12,11,15,9,10,5,12,10,7,12,11,11,12,13,14,9,10,11,13,12,12,15,12,12,1,14,9,1,13,15,10,12,10,12,11,13,12,12,9,13,11,11
"8713",47104819,"Veton Tusha","12/29/2002 (20 years old)","AM (RLC), ST (C)","Ballkani","Kosovan Superleague","KOS","No","9/2/2022","6/30/2025","$0","Right","Reasonable","Very Strong","6'0""","176 lbs","45","3",90,133,5,8,13,13,13,7,7,9,7,7,13,4,3,13,12,6,9,9,8,13,14,13,12,10,7,8,8,9,13,13,8,8,11,10,10,6,13,8,9,12,11,10,13,5,13,5,10,11,12,2,3,3,3,3,2,1,1,2,1,3
"8714",93031731,"Arber Zeneli","2/25/1995 (28 years old)","AM (RLC)","Reims","Ligue 1 Uber Eats","KOS","Yes","5/17/2022","6/30/2025","$0","Right","Weak","Very Strong","5'9""","156 lbs","210","36",130,133,11,13,15,11,13,11,7,9,5,5,14,8,5,14,10,10,11,12,12,12,11,14,5,14,9,12,12,11,16,16,11,9,12,15,12,10,7,12,12,13,11,10,11,8,7,5,12,14,16,3,3,2,2,2,1,3,2,2,3,2
"8715",98038184,"Kreshnik Hajrizi","5/28/1999 (24 years old)","D (C)","Lugano","Swiss Super League","KOS","Yes","7/1/2021","6/30/2024","$275K - $2.7M","Right","Strong","Very Strong","6'1""","171 lbs","150","4",121,131,4,6,8,4,10,2,13,6,7,13,10,8,13,9,12,13,13,11,14,12,15,7,11,7,13,13,6,12,11,11,13,13,13,12,14,13,8,18,9,10,12,8,9,10,15,6,12,11,20,1,1,2,1,3,1,1,2,1,3,3
"8716",30049935,"Ermal Krasniqi","9/7/1998 (24 years old)","AM (RL), ST (C)","CFR Cluj","Romanian First League","KOS","No","1/10/2023","6/30/2026","$190K - $1.9M","Right","Reasonable","Very Strong","6'2""","169 lbs","148","74",118,130,13,12,14,12,13,13,11,11,8,6,13,12,7,14,10,12,10,12,10,11,14,12,8,12,8,11,12,11,13,13,12,11,12,13,11,11,12,14,13,13,12,10,5,10,5,2,12,13,14,3,4,3,2,3,2,1,2,1,1,3
"8717",53045627,"Valon Berisha","2/7/1993 (30 years old)","M/AM (LC)","Reims","Ligue 1 Uber Eats","KOS","Yes","7/9/2020","6/30/2024","$140K - $1.4M","Right","Reasonable","Very Strong","5'9""","154 lbs","312","36",119,130,10,10,12,10,12,11,8,9,4,6,12,15,8,13,15,12,14,12,10,11,13,12,10,14,8,11,12,12,14,15,8,7,16,14,13,13,10,9,14,15,12,13,12,11,12,10,12,12,11,3,3,3,2,3,2,3,1,1,2,2
"8718",58159001,"Daniil Denisov","10/21/2002 (20 years old)","D (R), DM","Spartak Moscow","Russian Premier League","RUS","No","2/7/2022","5/31/2026","$5.2M - $9.8M","Right","Fairly Strong","Very Strong","6'1""","167 lbs","89","1",118,140,8,8,8,7,11,11,11,11,8,13,12,10,12,11,16,11,16,13,13,12,16,7,10,9,11,16,9,16,10,11,12,11,10,13,14,11,13,14,14,13,16,10,13,17,14,1,14,13,12,3,3,3,3,1,1,3,3,4,3,4
"8719",93014199,"Loret Sadiku","7/28/1991 (31 years old)","D (C), DM, M (C)","Hammarby IF","Swedish Premier Division","KOS","Yes","2/18/2022","12/31/2024","Not for Sale","Right","Reasonable","Very Strong","5'11""","147 lbs","320","12",116,130,8,11,8,6,12,9,12,10,7,13,13,10,13,11,13,14,16,12,13,13,14,7,13,11,14,14,12,14,11,8,14,10,14,12,14,12,10,13,13,15,14,12,13,15,11,9,14,11,14,1,2,1,1,3,2,2,3,1,2,3
"8720",84153687,"Shkëlqim Vladi","9/21/2000 (22 years old)","AM (C), ST (C)","Aarau","Swiss Challenge League","KOS","Yes","7/1/2022","6/30/2025","$0","Right","Fairly Strong","Very Strong","6'1""","180 lbs","81","37",111,130,11,9,11,13,12,11,9,10,7,8,12,12,6,12,10,12,12,13,10,10,12,11,7,10,8,11,10,13,12,12,10,12,11,11,13,13,12,17,11,13,10,12,11,12,9,6,11,13,14,2,1,3,1,1,3,2,2,3,2,2
"8721",92088303,"Florent Muslija","7/6/1998 (24 years old)","M/AM (LC)","Paderborn","Bundesliga 2","KOS","Yes","12/28/2022","6/30/2025","$240K - $2.4M","Right Only","Weak","Very Strong","5'8""","143 lbs","168","27",123,130,14,12,15,11,13,16,6,13,6,8,14,16,11,15,14,11,11,12,10,12,13,15,6,12,8,12,14,12,15,15,10,6,16,14,12,8,16,10,9,10,10,11,3,12,6,11,13,15,8,2,2,1,3,3,2,1,1,1,3,1
"8722",91005179,"Alban Meha","4/26/1986 (37 years old)","M (L), AM (RLC)","Kassel","German Regional Division Southwest","KOS","No","7/1/2019","6/30/2024","$500 - $6K","Left","Very Strong","Reasonable","5'8""","163 lbs","333","84",94,130,16,14,9,10,14,17,7,16,6,6,13,12,7,12,9,12,8,13,9,11,9,15,11,10,8,10,15,8,9,8,9,6,9,8,8,7,12,15,9,14,12,14,15,11,6,9,13,11,10,1,3,1,2,1,1,3,3,2,1,3
"8723",2000262753,"Dardan Destani","10/15/2006 (16 years old)","M/AM (C)","Basel","Swiss Super League","KOS","No","7/1/2021","6/30/2026","$275K - $850K","Right Only","Weak","Very Strong","5'11""","134 lbs","-","-",74,129,8,8,12,10,12,10,7,10,2,4,11,10,5,12,12,11,7,10,7,8,17,14,7,11,6,11,11,11,13,13,10,8,13,11,8,5,6,13,10,12,11,11,12,4,5,1,9,12,11,1,1,1,1,1,3,3,1,3,1,2
"8724",91119626,"Donis Avdijaj","8/25/1996 (26 years old)","AM (RLC), ST (C)","TSV Hartberg","Austrian Premier Division","KOS","Yes","7/31/2022","6/30/2025","$0","Right","Fairly Strong","Very Strong","5'8""","154 lbs","158","37",117,129,11,12,14,11,13,12,9,11,5,5,13,10,6,15,10,13,13,9,8,10,9,17,9,15,8,10,14,10,13,14,12,7,13,11,12,11,12,7,8,6,14,5,9,12,10,18,13,15,10,2,3,2,1,3,2,2,1,2,3,2
"8725",84160872,"Alban Ajdini","7/9/1999 (23 years old)","M/AM (RLC)","Stade Lausanne-Ouchy","Swiss Super League","KOS","Yes","7/1/2021","6/30/2023","$70K - $700K","Right","Strong","Very Strong","5'11""","158 lbs","113","27",117,129,8,10,14,12,13,9,10,12,4,4,11,13,5,13,8,14,5,14,10,12,7,13,6,14,5,11,12,11,13,12,11,9,12,12,12,7,14,13,12,9,11,10,6,14,4,3,12,11,20,2,1,2,3,1,2,3,3,3,2,2
"8726",93101763,"Patriot Sejdiu","5/5/2000 (23 years old)","M (R), AM (RL)","Malmö FF","Swedish Premier Division","KOS","Yes","10/3/2022","6/30/2027","$26K - $250K","Left Only","Very Strong","Weak","5'10""","154 lbs","37","9",108,128,12,12,14,13,12,11,7,13,6,7,10,12,7,13,12,10,11,12,10,9,12,13,7,10,9,8,11,10,14,15,10,9,10,14,10,7,11,8,8,8,12,11,12,9,11,12,9,11,10,2,1,4,4,2,1,3,2,3,3,1
"8727",2000173448,"Lindon Emërllahu","12/7/2002 (20 years old)","DM, M (C)","Ballkani","Kosovan Superleague","KOS","No","7/1/2020","6/30/2026","$130K - $1.3M","Right","Fairly Strong","Very Strong","6'1""","169 lbs","46","-",95,128,8,8,4,5,14,8,5,9,3,12,8,3,14,11,7,9,9,9,10,13,13,5,9,3,7,9,11,13,14,14,9,11,8,12,8,6,13,10,12,11,10,13,8,7,14,2,14,12,9,1,3,2,1,1,3,3,2,1,1,1
"8728",93070505,"Astrit Selmani","5/13/1997 (26 years old)","ST (C)","FC Midtjylland","3F Superliga","KOS","Yes","7/18/2022","5/31/2025","$900K - $1.9M","Right","Reasonable","Very Strong","6'1""","180 lbs","204","74",110,128,4,7,11,11,10,7,14,9,4,6,8,12,11,11,18,12,17,11,13,12,15,9,13,14,9,16,8,16,12,11,12,14,13,13,14,12,5,8,9,12,13,8,7,13,13,9,13,12,14,1,3,3,3,1,2,3,3,4,1,1
"8729",67011250,"Denis Cheryshev","12/26/1990 (32 years old)","M/AM (L)","Venezia","Italian Serie B","RUS","Yes","8/31/2022","6/30/2024","$100K - $1M","Left","Very Strong","Weak","5'10""","163 lbs","325","46",117,140,10,13,14,12,13,10,10,13,8,6,12,12,12,14,14,11,13,13,9,11,13,12,8,16,8,12,12,13,12,12,13,10,11,13,12,11,15,11,13,13,11,10,15,12,11,9,13,11,13,2,2,3,1,1,4,2,3,2,3,1
"8730",93123114,"Erion Sadiku","1/23/2002 (21 years old)","DM, M (C)","Örgryte IS","Swedish First Division Elite","KOS","Yes","8/1/2022","12/31/2025","$120K - $1.2M","Right","Reasonable","Very Strong","6'0""","154 lbs","52","3",90,127,10,10,10,7,11,10,9,10,8,9,11,9,9,11,10,12,10,12,11,10,13,8,8,10,12,12,11,12,11,8,11,11,12,12,12,11,9,12,12,13,13,10,5,12,7,7,11,13,15,3,2,2,1,3,1,3,2,3,3,4
"8731",98038235,"Idriz Voca","1/1/1997 (26 years old)","DM, M (C)","Cosenza","Italian Serie B","KOS","Yes","1/28/2022","6/30/2024","$80K - $800K","Right","Weak","Very Strong","5'11""","165 lbs","200","7",115,127,7,8,12,6,12,10,10,10,9,13,13,6,13,13,14,12,12,13,13,13,12,10,12,10,15,15,12,13,10,12,12,10,13,10,14,12,12,10,12,12,11,10,11,10,12,8,12,11,12,1,1,1,3,1,3,3,4,2,3,3
"8732",93146299,"Besfort Zeneli","11/21/2002 (20 years old)","M (RL), AM (RLC)","IF Elfsborg","Swedish Premier Division","KOS","Yes","1/6/2022","12/31/2023","$60K - $600K","Left","Very Strong","Weak","6'2""","156 lbs","2","-",100,127,7,11,11,8,12,8,8,10,5,7,11,10,7,12,9,10,11,11,11,11,13,9,6,11,9,11,11,11,12,11,11,14,12,13,12,11,10,12,12,12,12,12,5,15,6,5,11,12,14,3,2,1,2,3,1,3,3,2,1,2
"8733",84151603,"Toni Domgjoni","9/4/1998 (24 years old)","DM, M/AM (C)","Vitesse","Eredivisie","KOS","Yes","7/1/2021","6/30/2024","$65K - $650K","Right","Reasonable","Very Strong","5'10""","156 lbs","172","10",111,127,10,10,12,8,13,11,7,12,5,10,12,11,13,13,13,13,13,12,11,12,12,10,7,12,12,14,10,14,12,13,11,9,13,12,12,8,13,11,9,12,8,11,5,10,11,6,10,12,15,1,2,3,1,2,3,2,2,4,4,1
"8734",98059228,"Donat Rrudhani","5/2/1999 (24 years old)","M/AM (RLC)","Young Boys","Swiss Super League","KOS","No","6/8/2022","6/30/2026","$140K - $1.4M","Left","Very Strong","Reasonable","6'2""","171 lbs","168","36",118,127,9,11,13,9,11,9,10,10,4,9,12,10,7,13,10,11,12,11,12,12,14,10,12,11,9,14,10,13,13,13,11,12,15,13,13,11,18,13,12,15,10,12,6,10,5,8,14,13,15,4,2,1,2,2,2,3,1,1,1,3
"8735",98046271,"Ismajl Beka","10/31/1999 (23 years old)","D (LC)","Luzern","Swiss Super League","KOS","Yes","8/31/2022","6/30/2025","$85K - $850K","Left","Very Strong","Reasonable","6'6""","180 lbs","104","8",115,126,9,12,11,10,11,6,14,9,11,13,12,5,16,8,10,13,12,13,10,13,14,5,14,8,10,11,10,12,7,9,12,19,9,6,15,10,11,19,6,10,9,11,10,10,14,8,20,10,11,1,1,3,2,1,2,4,2,3,2,4
"8736",93097538,"Edi Sylisufaj","3/8/2000 (23 years old)","ST (C)","IK Sirius","Swedish Premier Division","KOS","Yes","1/3/2022","12/31/2025","$28K - $275K","Right","Reasonable","Very Strong","5'10""","176 lbs","115","17",96,126,7,11,12,11,12,7,10,11,6,5,10,7,5,12,8,11,8,12,11,12,11,11,7,11,7,11,10,11,12,12,11,8,12,12,12,11,5,12,12,12,10,19,5,8,6,5,11,12,12,3,3,2,3,3,1,2,2,2,1,3
"8737",84156563,"Lorik Emini","8/29/1999 (23 years old)","DM, M (C)","Luzern","Swiss Super League","KOS","Yes","6/15/2020","6/30/2025","$12K - $120K","Right","Strong","Very Strong","5'9""","160 lbs","116","13",105,126,8,11,7,8,9,10,7,8,6,12,13,9,12,11,15,14,13,9,10,12,15,7,13,11,12,12,9,15,10,9,7,8,9,10,12,8,12,10,10,10,11,8,13,11,12,11,11,13,12,1,3,3,1,2,3,2,2,1,3,1
"8738",53052272,"Elba Rashani","5/9/1993 (30 years old)","M (RL), AM (RLC)","Clermont","Ligue 1 Uber Eats","KOS","Yes","7/4/2022","6/30/2025","$550K - $5.6M","Left","Very Strong","Reasonable","5'11""","156 lbs","290","44",123,126,12,13,13,13,14,13,5,12,5,4,13,9,4,14,5,13,8,13,10,14,13,16,5,14,5,13,13,13,12,14,12,10,10,13,14,11,8,4,13,11,11,13,10,11,10,1,12,12,10,3,1,1,3,3,2,1,2,3,3,3
"8739",53074943,"Zymer Bytyqi","9/11/1996 (26 years old)","M/AM (RL)","Olympiacos","Greek Super League 1","KOS","Yes","1/31/2023","6/30/2025","$55K - $550K","Right","Fairly Strong","Very Strong","5'9""","154 lbs","266","40",120,125,10,15,15,11,15,12,5,13,4,4,13,11,5,14,10,10,9,12,9,12,10,15,4,11,8,12,13,12,13,14,13,7,11,13,10,8,13,10,10,10,9,8,8,11,6,16,11,11,9,3,1,2,1,2,3,1,2,1,2,2
"8740",58133578,"Mikhail Ignatov","5/4/2000 (23 years old)","M/AM (C)","Spartak Moscow","Russian Premier League","RUS","No","1/21/2022","6/30/2025","$550K - $5.4M","Right","Reasonable","Very Strong","6'0""","163 lbs","111","15",118,140,12,11,15,12,15,11,9,10,7,7,12,7,10,16,11,13,11,11,10,13,16,13,13,13,10,13,13,12,11,12,12,11,11,12,12,10,12,20,13,13,11,15,7,5,12,2,14,11,10,2,2,1,3,1,1,4,1,2,3,2
"8741",98009412,"Hekuran Kryeziu","2/12/1993 (30 years old)","DM, M (C)","Winterthur","Swiss Super League","KOS","Yes","7/1/2022","6/30/2025","$22K - $220K","Right","Weak","Very Strong","5'10""","154 lbs","275","6",97,125,7,7,8,5,11,7,12,8,10,13,11,4,14,11,15,13,12,10,14,11,12,8,13,9,13,14,8,14,10,10,13,9,12,9,11,10,11,13,11,11,9,13,8,12,13,8,13,12,17,2,2,1,1,3,4,2,2,1,3,3
"8742",30048084,"Lumbardh Dellova","1/1/1999 (24 years old)","D (RC), DM","Ballkani","Kosovan Superleague","KOS","No","1/1/2022","6/30/2025","$30K - $300K","Right","Fairly Strong","Very Strong","6'0""","174 lbs","87","7",92,125,4,9,11,2,10,8,12,7,2,13,10,4,11,11,10,10,10,7,7,12,11,10,11,8,14,9,10,10,7,12,9,10,11,7,14,10,16,9,8,11,10,13,13,12,10,7,7,10,20,1,1,2,2,3,1,4,1,1,1,1
"8743",98031298,"Florent Hadergjonaj","7/31/1994 (28 years old)","D (R)","Kasımpaşa","Turkish Super League","KOS","Yes","9/24/2020","6/30/2025","$0","Right","Fairly Strong","Very Strong","6'0""","160 lbs","283","11",110,125,6,14,8,5,12,5,9,5,12,12,12,8,12,12,7,12,10,10,13,10,14,8,8,12,13,14,8,14,12,11,8,12,15,15,15,9,12,16,12,15,14,9,8,10,9,12,15,13,11,2,3,3,2,1,3,3,2,1,2,3
"8744",98033030,"Fidan Aliti","10/3/1993 (29 years old)","D (LC), WB (L)","Zürich","Swiss Super League","KOS","Yes","5/27/2022","6/30/2025","$30K - $325K","Left","Very Strong","Fairly Strong","5'11""","169 lbs","312","12",111,125,6,10,6,6,8,6,13,7,8,13,11,6,13,8,16,13,14,11,13,12,13,7,12,7,13,14,10,13,11,8,13,13,12,12,12,13,6,6,7,12,14,9,8,14,14,10,12,11,12,1,4,3,1,3,2,3,1,3,3,1
"8745",53140434,"Kreshnik Krasniqi","12/22/2000 (22 years old)","DM, M (C)","Strømsgodset","Norwegian Premier Division","KOS","Yes","5/5/2022","12/31/2024","$190K - $1.9M","Right","Fairly Strong","Very Strong","6'0""","158 lbs","76","8",103,124,12,10,12,8,13,9,6,13,6,9,12,8,8,13,6,8,8,11,8,11,10,13,8,12,8,7,13,12,13,14,14,7,9,11,12,8,8,6,11,8,7,15,7,10,12,10,10,16,6,3,3,1,2,1,1,3,1,1,1,2
"8746",47064790,"Emir Sahiti","11/29/1998 (24 years old)","M (L), AM (RLC)","Hajduk","Croatian First League","KOS","No","12/8/2022","5/31/2026","$300K - $3.1M","Right","Fairly Strong","Very Strong","5'9""","143 lbs","153","20",114,124,13,13,12,11,11,8,6,10,7,6,11,9,7,12,13,12,11,12,11,9,14,13,7,13,6,8,11,13,14,14,9,8,14,14,13,8,13,10,9,13,12,11,7,10,8,7,12,12,15,1,3,3,3,3,1,3,2,3,1,3
"8747",11022149,"Bernard Berisha","10/24/1991 (31 years old)","M (L), AM (RLC)","Akhmat","Russian Premier League","KOS","No","8/9/2022","6/10/2025","Not for Sale","Right","Fairly Strong","Very Strong","5'7""","145 lbs","260","37",124,124,13,11,15,11,12,8,8,9,5,6,10,13,9,14,16,13,15,11,11,11,5,11,12,10,12,8,11,13,15,14,13,5,15,14,13,6,10,9,6,10,13,14,6,8,14,13,14,12,19,1,2,2,3,3,3,1,3,1,2,4
"8748",2000134330,"Pren Gjini","7/29/2005 (17 years old)","AM (R)","Black Stars","Swiss First League Classic Group 2","KOS","Yes","6/12/2023","6/30/2025","$0 - $18K","Right","Fairly Strong","Very Strong","5'9""","138 lbs","-","-",64,124,6,11,10,11,13,5,4,6,5,3,6,3,4,13,8,5,7,7,6,7,8,13,9,13,5,6,7,7,10,12,6,7,11,11,7,3,10,8,10,9,11,9,5,6,12,8,16,8,16,3,2,1,2,3,3,1,2,2,1,3
"8749",84161691,"Andi Hoti","3/2/2003 (20 years old)","D (C)","Inter","Italian Serie A","KOS","Yes","1/8/2020","6/30/2025","$26K - $275K","Right Only","Weak","Very Strong","6'3""","187 lbs","23","1",106,123,2,7,8,6,10,4,13,6,8,13,12,6,12,10,13,11,13,12,12,11,13,6,8,8,13,12,11,12,11,9,13,15,12,13,11,14,13,8,15,14,17,9,9,11,12,7,13,13,16,1,2,3,1,1,2,1,1,2,3,2
"8750",98030083,"Benjamin Kololli","5/15/1992 (31 years old)","M/AM (RL), ST (C)","Shimizu","J2 League","KOS","Yes","7/23/2021","1/31/2024","$18K - $190K","Right","Weak","Very Strong","6'0""","180 lbs","299","76",104,123,8,9,11,11,12,12,8,4,13,4,12,14,7,11,9,12,10,12,10,12,10,11,8,11,7,9,9,8,11,9,13,10,10,12,12,11,9,9,11,8,11,12,12,11,10,11,10,10,15,2,2,3,3,3,3,1,2,1,3,4
"8751",58092243,"Anton Miranchuk","10/17/1995 (27 years old)","M/AM (LC)","Lokomotiv Moscow","Russian Premier League","RUS","No","11/4/2020","6/30/2024","$850K - $5.6M","Right","Fairly Strong","Very Strong","6'1""","176 lbs","164","45",130,140,13,13,11,13,14,12,8,11,9,10,13,14,10,13,6,12,13,13,15,14,13,12,9,12,11,13,13,14,13,13,9,11,10,13,13,11,13,12,13,12,11,15,9,10,8,10,10,14,9,3,1,2,3,2,2,1,1,1,3,2
"8752",91206089,"Valon Zumberi","11/24/2002 (20 years old)","D (C)","HSV","Bundesliga 2","KOS","Yes","7/1/2021","6/30/2024","$500K - $1.5M","Right","Reasonable","Very Strong","6'2""","185 lbs","37","2",98,122,3,6,10,6,9,6,13,6,8,12,11,6,12,9,16,11,13,10,11,10,12,8,11,8,12,11,10,12,11,9,12,14,12,12,11,13,10,9,8,9,8,13,8,16,12,7,11,10,7,3,1,1,1,1,1,3,3,1,3,4
"8753",67157152,"Mariano","8/1/1993 (29 years old)","ST (C)","R. Madrid","Spanish First Division","DOM","Yes","6/15/2020","6/30/2023","$26K - $275K","Right","Reasonable","Very Strong","5'11""","169 lbs","185","73",136,154,5,8,12,15,12,13,16,12,5,5,11,14,5,12,14,14,17,11,11,11,18,8,11,13,10,9,10,17,15,11,12,15,15,15,14,14,7,9,10,10,12,19,15,14,10,14,14,3,6,3,2,2,2,1,1,3,2,2,3,2
"8754",2000223278,"Álex","2/16/2006 (17 years old)","M (L), AM (RL)","R.C. Alcobendas","Spanish Regional Division","DOM","Yes","1/1/2023","6/30/2024","$0 - $50K","Right","Reasonable","Very Strong","5'10""","147 lbs","-","-",62,144,9,11,13,9,13,14,5,5,1,4,9,7,5,12,11,3,6,12,5,4,14,10,2,12,5,6,9,11,13,10,6,6,11,12,6,5,14,10,13,11,10,10,6,14,11,4,10,13,11,1,1,3,3,4,4,3,2,2,2,2
"8755",2000045863,"Edison Azcona","11/21/2003 (19 years old)","AM (RLC)","Inter Miami","Major League Soccer","DOM","No","1/26/2021","12/31/2023","$200K - $2M","Right Only","Weak","Very Strong","5'6""","130 lbs","48","6",83,137,10,9,13,10,12,6,7,9,8,5,10,7,6,11,6,9,7,10,9,8,14,8,12,9,5,8,9,9,13,15,9,5,10,12,9,4,10,13,11,12,10,10,9,2,10,8,8,12,9,2,2,2,2,2,2,1,1,2,3,3
"8756",91139582,"Heinz Mörschel","8/24/1997 (25 years old)","M/AM (C)","Újpest","Hungarian Division I","DOM","Yes","2/28/2023","6/30/2025","$140K - $1.4M","Right","Reasonable","Very Strong","6'3""","165 lbs","154","33",114,127,15,13,12,13,13,15,9,14,8,5,14,13,5,14,8,11,10,13,11,11,10,14,5,12,6,10,14,11,12,12,12,14,13,12,13,13,11,10,13,11,14,12,10,9,6,10,8,12,7,3,2,1,2,4,3,2,1,3,3,1
"8757",91207276,"Fabian Messina","9/16/2002 (20 years old)","DM, M/AM (C)","FSV Frankfurt","German Regional Division Southwest","DOM","Yes","7/1/2022","6/30/2024","$45K - $475K","Right Only","Weak","Very Strong","5'6""","152 lbs","54","-",88,125,7,7,9,12,14,7,7,9,2,6,14,4,12,12,10,6,8,9,4,11,5,15,6,8,14,8,10,12,14,14,8,1,15,14,7,2,11,12,11,12,12,9,6,16,7,4,10,12,10,3,4,3,2,2,2,2,3,1,1,3
"8758",67065578,"Tano Bonnín","6/30/1990 (32 years old)","D (C)","Vibonese","Italian Serie D Grp. I","DOM","Yes","9/15/2022","6/30/2025","Not for Sale","Right Only","Weak","Very Strong","6'1""","163 lbs","302","6",94,115,4,4,5,4,9,5,12,6,8,13,9,5,13,10,11,12,13,11,12,11,15,7,12,8,12,12,6,12,10,10,13,12,14,10,12,13,12,12,10,14,12,11,7,14,9,6,13,16,12,1,3,2,3,1,1,2,2,2,2,2
"8759",82082350,"Edarlin Reyes","7/30/1997 (25 years old)","AM (RL), ST (C)","Always Ready","Bolivian Premier Division","DOM","No","7/1/2022","12/31/2023","$40K - $425K","Left","Very Strong","Reasonable","5'11""","145 lbs","118","23",108,115,10,12,13,12,11,10,9,10,4,5,12,12,6,12,9,12,11,11,11,13,9,12,10,11,11,12,9,11,12,12,11,11,12,12,12,12,10,8,10,12,8,10,6,12,8,10,9,12,12,2,3,2,1,2,1,2,2,1,1,1
"8760",43075231,"Antonio Santurro","2/29/1992 (31 years old)","GK","Parma","Italian Serie B","DOM","Yes","11/2/2022","6/30/2024","$1.5K - $12K","Right Only","Weak","Very Strong","6'4""","187 lbs","180","-",94,115,3,2,3,2,7,7,4,3,1,2,8,3,2,8,7,10,9,11,9,9,14,7,7,6,11,9,9,9,10,12,10,15,10,12,12,11,13,18,13,12,10,10,14,10,7,7,8,11,10,12,12,13,12,13,12,13,8,12,12,12
"8761",30001074,"César García","3/13/1993 (30 years old)","D (C)","Real Santa Cruz","Bolivian Premier Division","DOM","No","7/1/2021","12/31/2024","$45K - $475K","Right","Reasonable","Very Strong","6'1""","169 lbs","111","22",109,114,7,3,7,8,11,8,13,7,4,12,11,8,12,8,5,11,11,11,11,12,16,5,6,9,10,10,4,11,11,14,11,12,13,11,11,13,14,10,10,11,13,14,14,8,15,6,14,7,14,4,3,1,3,4,1,2,2,2,1,3
"8762",2102876,"Ari","12/11/1985 (37 years old)","ST (C)","ATL","Brazilian National Fourth Division","RUS","No","4/28/2023","12/31/2023","$0 - $30K","Right","Fairly Strong","Very Strong","5'11""","180 lbs","345","105",106,139,11,11,11,13,16,12,8,13,9,8,13,14,6,16,11,13,13,12,13,16,13,12,8,15,11,11,14,9,9,10,13,10,10,9,8,12,8,15,16,6,12,8,14,12,14,8,12,10,11,2,3,1,1,1,2,1,2,3,3,1
"8763",2000029832,"Michael Sambataro","12/4/2002 (20 years old)","D/WB/M (L)","Güemes (SdE)","Argentine Second Division","DOM","No","1/1/2023","12/31/2023","$75K - $750K","Left Only","Very Strong","Weak","5'7""","145 lbs","-","-",103,114,11,11,12,10,10,9,8,7,12,10,11,9,10,11,5,12,10,12,12,14,8,8,12,10,12,13,12,13,13,13,11,7,9,13,12,9,11,10,12,13,11,12,10,10,11,7,12,11,20,3,1,3,2,2,1,2,3,3,1,4
"8764",82080518,"Ronaldo Vásquez","6/30/1999 (23 years old)","M (LC), AM (RLC)","Pantoja","Liga Dominicana de Fútbol","DOM","No","1/1/2023","1/1/2025","$0 - $40K","Right","Reasonable","Very Strong","5'6""","149 lbs","58","16",100,113,7,8,14,11,11,8,5,14,4,3,10,4,2,13,9,9,10,9,10,8,12,15,15,8,11,9,11,8,11,9,14,3,10,14,11,14,10,10,13,10,10,15,5,10,8,5,13,12,8,1,2,2,1,3,1,1,1,3,2,1
"8765",86008162,"Eduardo Centeno","5/30/1984 (39 years old)","D (C)","Atlético Vega Real","Liga Dominicana de Fútbol","DOM","No","1/20/2022","12/31/2024","$0","Right","Fairly Strong","Very Strong","6'0""","198 lbs","62","5",75,111,4,3,1,4,8,1,11,5,4,12,7,1,14,3,10,11,9,5,8,14,16,5,5,7,12,7,6,8,11,9,6,13,14,11,6,6,8,14,12,9,12,13,14,1,12,4,11,12,15,1,1,3,4,2,1,3,3,4,2,3
"8766",91184466,"Luis Coordes","1/2/1999 (24 years old)","M (L), AM (RLC)","Ottensen","German Regional Division North","DOM","Yes","7/1/2022","6/30/2024","$16K - $160K","Right Only","Weak","Very Strong","5'11""","163 lbs","69","2",90,111,7,11,11,10,14,7,7,9,6,7,9,4,6,13,5,7,9,7,7,13,10,13,9,14,8,9,8,12,14,14,9,9,7,14,7,7,11,14,11,13,10,10,7,6,5,1,14,12,17,1,2,1,3,3,2,3,1,2,1,2
"8767",67248161,"Manny","3/1/1998 (25 years old)","D/WB/M (L)","S.D. Logroñés","Spanish Federation First Division A","DOM","Yes","6/30/2022","6/30/2024","$65K - $190K","Left Only","Very Strong","Weak","5'11""","152 lbs","117","6",95,110,8,9,10,8,10,8,6,6,5,13,11,6,14,10,13,10,9,10,10,14,13,5,3,9,9,9,6,13,10,12,9,10,15,13,14,4,13,12,11,11,10,11,11,12,12,1,20,10,20,2,2,1,3,1,2,3,1,1,4,1
"8768",67198925,"Fran Núñez","5/15/1995 (28 years old)","M (R), AM (RC)","Melilla","Spanish Federation First Division B","DOM","Yes","7/6/2021","6/30/2024","$0","Right","Reasonable","Very Strong","5'10""","141 lbs","233","35",98,110,8,11,10,7,9,5,7,9,7,5,10,3,7,11,9,10,9,9,10,10,11,12,11,11,8,8,12,10,14,12,8,7,12,14,12,9,12,11,11,11,11,10,7,13,7,7,10,13,19,2,1,1,4,2,2,2,3,2,3,3
"8769",43381380,"Gianluigi Sueva","1/1/2001 (22 years old)","M (R), AM (RL), ST (C)","Cosenza","Italian Serie B","DOM","Yes","6/15/2020","6/30/2024","$0","Right","Fairly Strong","Very Strong","5'9""","149 lbs","41","-",93,109,10,10,10,10,10,9,8,10,5,4,10,10,7,12,11,8,12,9,10,8,14,12,11,9,6,11,11,11,11,12,10,10,12,11,12,10,11,11,11,10,10,10,7,12,8,10,11,10,10,2,1,1,4,2,2,3,4,2,3,4
"8770",43339616,"Antonio Natalucci","8/1/2000 (22 years old)","D/WB/M/AM (R)","Cibao FC","Liga Dominicana de Fútbol","DOM","Yes","2/24/2023","12/31/2023","$0 - $20K","Right Only","Very Weak","Very Strong","6'0""","163 lbs","54","1",86,109,9,14,11,11,11,9,7,3,5,9,11,8,11,9,14,9,9,9,11,11,5,7,14,15,11,10,9,11,11,11,10,10,14,10,9,7,13,12,9,10,14,9,5,2,14,4,14,11,8,3,1,4,2,1,2,3,1,3,4,3
"8771",2000218429,"Derek Cuevas","1/7/2004 (19 years old)","AM (RL), ST (C)","Barcelona B","Spanish Federation First Division A","DOM","Yes","7/22/2022","6/30/2023","$4.5K - $14K","Right","Weak","Very Strong","5'6""","134 lbs","-","-",85,108,10,9,12,9,11,8,7,9,6,5,9,8,6,11,8,9,11,8,8,8,14,14,8,10,2,9,9,9,13,14,9,7,14,12,8,8,12,16,14,12,10,8,5,10,5,8,10,12,14,1,2,1,2,2,2,3,3,2,2,3
"8772",82080540,"Dorny Romero","1/24/1998 (25 years old)","AM (RL), ST (C)","Always Ready","Bolivian Premier Division","DOM","No","1/1/2023","12/31/2023","$16K - $160K","Right","Reasonable","Very Strong","6'3""","134 lbs","97","26",100,108,10,12,10,12,10,10,12,9,10,8,11,4,10,11,8,11,4,12,12,10,5,8,10,12,12,11,12,12,10,16,11,15,12,11,10,11,13,12,12,10,11,11,14,4,11,3,6,10,19,2,1,4,3,2,2,2,3,2,2,3
"8773",58151771,"Alexandr Siljanov","2/17/2001 (22 years old)","D (RL)","Lokomotiv Moscow","Russian Premier League","RUS","No","5/27/2021","5/31/2026","$375K - $3.7M","Right Only","Weak","Very Strong","6'1""","178 lbs","69","4",119,139,10,10,13,10,11,8,14,9,10,14,12,7,13,12,12,13,13,12,13,13,17,12,8,9,12,14,9,11,13,11,14,12,11,15,14,12,9,18,8,12,10,12,9,12,11,4,15,10,17,3,2,1,2,3,1,3,4,1,4,1
"8774",2000205449,"Xavier Valdez","11/23/2003 (19 years old)","GK","Houston","Major League Soccer","DOM","No","2/27/2022","12/31/2024","$1M - $2.1M","Left Only","Very Strong","Weak","6'6""","182 lbs","14","-",92,108,3,2,1,1,1,5,1,3,1,2,10,2,2,4,11,11,13,6,9,14,4,2,6,1,12,9,8,8,13,6,9,17,5,14,5,8,12,20,11,12,11,12,9,5,5,5,18,12,20,8,9,11,9,12,11,8,9,10,12,15
"8775",82076323,"Gerard Lavergne","1/25/1999 (24 years old)","M (C)","Pantoja","Liga Dominicana de Fútbol","DOM","No","1/19/2022","12/31/2024","$0 - $2K","Right","Reasonable","Very Strong","5'8""","143 lbs","30","3",78,108,7,5,7,7,12,7,3,5,2,9,9,2,9,9,15,11,5,8,8,14,4,6,2,11,8,13,9,12,14,10,10,7,8,13,14,7,14,19,13,11,11,12,10,4,11,8,20,9,18,4,3,3,1,3,2,1,2,3,3,3
"8776",2000065761,"Christian Schwieren","2/9/2003 (20 years old)","D (C), DM","Uerdingen","German Div. Lower Rhine","DOM","Yes","1/26/2023","6/30/2023","$0","Right Only","Weak","Very Strong","6'1""","171 lbs","-","-",75,106,2,4,4,4,9,5,9,7,1,11,12,4,11,8,13,14,9,8,12,14,14,5,4,7,12,13,7,12,11,9,8,12,8,10,10,7,11,17,13,9,9,10,14,2,13,1,10,13,11,1,1,2,1,2,3,1,3,2,3,2
"8777",2000019511,"Andrés Lindberg","2/2/2004 (19 years old)","M/AM (R)","IF Elfsborg","Swedish Premier Division","DOM","Yes","6/13/2022","11/30/2023","$500 - $2.5K","Left Only","Very Strong","Weak","5'8""","145 lbs","-","-",50,106,5,10,11,8,8,5,5,6,5,3,10,1,6,11,10,7,5,5,6,10,12,11,13,9,3,6,8,11,8,13,6,5,12,13,7,4,12,10,10,10,10,10,10,9,9,5,9,11,14,3,1,2,3,3,2,2,3,2,1,1
"8778",91143526,"Rudolf González","7/2/1998 (24 years old)","D/WB/M/AM (R)","Bonn","German Div. Middle Rhine","DOM","Yes","4/24/2021","6/30/2025","$16K - $150K","Right Only","Weak","Very Strong","5'9""","149 lbs","124","11",86,105,8,12,7,12,11,5,4,5,7,7,8,3,9,7,11,9,8,8,6,14,9,9,12,13,8,8,8,9,14,14,8,8,9,14,8,5,16,15,10,12,12,12,6,8,7,2,11,11,17,1,3,1,3,4,2,2,3,4,2,2
"8779",29192706,"Carlos Heredia","9/28/1998 (24 years old)","AM (C)","Cibao FC","Liga Dominicana de Fútbol","DOM","Yes","1/1/2023","12/31/2023","$0 - $5K","Left","Very Strong","Reasonable","5'10""","152 lbs","17","1",85,105,3,1,8,10,13,6,6,8,1,7,12,4,4,13,8,8,6,12,6,13,17,13,11,10,8,7,9,11,13,13,7,6,8,13,6,10,12,13,9,13,11,10,6,15,5,2,5,10,13,1,3,3,2,3,2,3,3,3,3,2
"8780",67157255,"Carlos Julio Martínez","2/4/1994 (29 years old)","D (RL), WB/M/AM (R)","A. Baleares","Spanish Federation First Division B","DOM","Yes","1/1/2023","6/30/2024","$2K - $22K","Right","Reasonable","Very Strong","5'7""","160 lbs","252","4",90,105,9,11,10,6,10,8,9,7,14,11,11,8,12,11,11,11,12,11,10,10,11,8,8,7,10,12,10,12,12,12,12,6,13,12,12,7,12,13,13,13,11,11,8,4,12,4,10,9,11,1,1,1,2,3,3,3,3,2,2,2
"8781",2000116356,"Alex Jiménez","1/13/2002 (21 years old)","DM, M (C)","C.P. San Cristóbal","Spanish Federation Third Group 5","DOM","Yes","7/1/2022","6/30/2023","$0 - $4.5K","Right","Fairly Strong","Very Strong","6'0""","167 lbs","9","-",80,105,7,7,5,7,14,7,8,9,2,8,9,7,14,9,11,9,8,7,9,11,14,5,6,7,12,8,8,11,13,11,8,11,12,12,6,8,17,20,11,8,11,14,11,17,9,8,12,10,11,2,1,1,2,1,1,2,1,2,2,1
"8782",30001079,"Miguel Lloyd","10/23/1982 (40 years old)","GK","Cibao FC","Liga Dominicana de Fútbol","DOM","No","1/1/2023","12/31/2023","$0","Right","Reasonable","Very Strong","6'2""","171 lbs","336","-",75,105,3,2,3,1,2,4,1,3,2,1,10,3,3,7,10,10,10,7,9,15,15,2,16,1,12,15,7,9,6,10,6,11,15,6,5,6,10,10,15,15,10,10,12,8,15,3,12,10,18,7,5,6,5,6,9,14,9,12,8,15
"8783",82076372,"Juan Ángeles","10/16/2000 (22 years old)","AM (R), ST (C)","Moca FC","Liga Dominicana de Fútbol","DOM","No","1/1/2023","12/31/2023","$0 - $10K","Right","Fairly Strong","Very Strong","5'5""","127 lbs","45","10",63,105,5,6,13,10,9,5,9,6,1,5,11,5,2,7,5,11,7,5,6,8,12,13,1,9,6,5,7,7,13,13,6,1,8,13,8,1,9,13,11,11,11,9,8,4,5,7,11,11,18,4,2,3,2,3,3,1,1,2,3,1
"8784",2000081811,"Yaroslav Gladyshev","5/5/2003 (20 years old)","AM (R), ST (C)","Dinamo Moscow","Russian Premier League","RUS","No","12/15/2022","6/30/2026","$450K - $4.5M","Left","Very Strong","Reasonable","5'11""","154 lbs","59","19",108,139,10,10,12,14,11,8,6,11,3,3,12,12,8,11,6,11,10,12,12,10,17,5,10,14,7,10,12,12,15,12,10,10,15,15,11,8,3,15,11,12,13,14,11,12,12,3,11,10,15,3,2,1,2,1,1,2,1,2,2,1
"8785",67258830,"Jairo Bueno","9/10/1998 (24 years old)","D (RC)","Cibao FC","Liga Dominicana de Fútbol","DOM","Yes","2/17/2023","12/31/2024","$0 - $5K","Right","Reasonable","Very Strong","6'0""","165 lbs","64","2",70,105,4,8,3,5,8,1,10,5,2,13,7,1,9,4,13,8,9,7,6,10,5,5,3,4,13,6,6,8,11,13,7,6,11,13,12,8,9,13,11,9,13,12,14,7,9,7,10,11,19,3,1,3,1,1,1,3,4,3,1,1
"8786",82082365,"Luiyi De Lucas","8/31/1994 (28 years old)","D (C)","Livingston","cinch Premiership","DOM","Yes","7/1/2022","6/30/2024","$100K - $300K","Right Only","Weak","Very Strong","6'3""","182 lbs","167","6",98,105,3,8,11,10,9,9,14,9,8,13,11,4,12,10,12,10,10,9,8,9,15,9,14,11,13,11,9,10,8,10,11,10,11,9,12,15,9,17,11,10,12,12,6,11,10,7,7,11,14,1,1,2,2,3,2,3,2,2,2,1
"8787",2000148214,"Yohan Parra","4/25/2000 (23 years old)","ST (C)","Cibao FC","Liga Dominicana de Fútbol","DOM","No","1/1/2023","12/31/2024","$18K - $170K","Right Only","Weak","Very Strong","6'3""","163 lbs","15","5",104,104,8,6,14,14,12,8,14,6,7,8,7,9,3,12,8,10,9,12,9,14,16,12,12,14,7,8,9,9,13,12,9,14,10,12,9,7,11,14,10,10,11,12,13,8,13,2,12,11,17,3,2,4,1,1,3,3,4,2,2,3
"8788",2000297909,"Jorge Espinal","3/4/2005 (18 years old)","ST (C)","Barcelona B","Spanish Federation First Division A","DOM","Yes","6/2/2021","6/30/2024","$100K - $300K","Right","Reasonable","Very Strong","6'1""","160 lbs","2","-",80,104,5,7,10,12,11,8,12,9,5,5,9,11,6,11,7,8,9,11,8,9,14,12,9,11,5,8,8,7,11,12,12,11,14,12,9,9,8,14,12,12,14,8,6,12,8,10,12,12,16,1,1,3,2,1,3,1,1,1,3,2
"8789",82085026,"Juan Carlos Pineda","1/12/2000 (23 years old)","M (R), AM (RLC), ST (C)","U. Adarve","Spanish Federation Second Group 5","DOM","Yes","7/1/2022","6/30/2025","$0 - $75K","Right","Reasonable","Very Strong","5'11""","154 lbs","108","11",79,104,3,7,12,14,8,7,9,14,5,4,12,6,6,9,11,9,5,8,6,9,7,8,12,12,7,8,9,7,14,10,14,7,13,10,7,4,13,16,12,12,11,12,10,5,6,1,9,7,13,2,2,1,2,2,1,2,2,1,3,1
"8790",2000148210,"Julio Fernández","5/26/1998 (25 years old)","DM, M (C)","Cibao FC","Liga Dominicana de Fútbol","DOM","No","6/15/2020","12/31/2024","$0 - $26K","Right Only","Weak","Very Strong","5'8""","154 lbs","8","1",98,104,8,8,6,9,11,8,8,7,4,8,13,7,14,8,10,8,9,8,10,9,12,8,9,9,14,9,14,13,14,14,5,2,5,14,14,8,11,12,12,12,7,11,8,5,15,3,14,12,7,3,3,1,1,3,3,3,2,1,2,1
"8791",2000106646,"Charbel Wehbe","5/8/2004 (19 years old)","D/WB (R)","Oviedo B","Spanish Federation Second Group 1","DOM","Yes","3/31/2023","6/30/2026","$30K - $300K","Right Only","Weak","Very Strong","5'11""","154 lbs","24","1",76,103,8,8,3,8,6,3,9,5,4,9,9,6,15,10,9,8,10,9,9,15,18,6,3,5,9,14,5,13,13,11,11,8,15,11,9,5,10,12,13,12,11,12,9,4,11,4,8,11,18,1,1,1,1,1,4,3,2,3,1,2
"8792",2000097428,"Roberto Victoria","9/22/2001 (21 years old)","M/AM (L)","Delfines del Este","Liga Dominicana de Fútbol","DOM","No","1/1/2021","12/31/2024","$0 - $5K","Left","Very Strong","Reasonable","5'8""","147 lbs","-","-",73,101,6,9,10,9,12,6,3,2,1,5,10,3,7,7,11,11,4,6,7,11,12,10,8,7,6,7,8,11,12,13,7,5,8,13,6,4,10,17,14,13,11,11,5,15,13,5,19,9,10,2,3,1,3,1,1,2,2,2,2,2
"8793",2000148212,"Jean Luis Martínez","9/27/2001 (21 years old)","AM (LC)","Cibao FC","Liga Dominicana de Fútbol","DOM","No","1/1/2023","12/31/2023","$0 - $10K","Right","Reasonable","Very Strong","5'3""","130 lbs","8","-",68,101,5,7,13,9,13,5,5,6,4,4,8,1,5,12,12,3,7,4,5,10,12,12,5,3,5,7,5,12,13,13,6,1,15,13,7,1,15,15,12,9,12,12,12,2,7,4,11,11,7,3,3,1,2,1,2,2,1,1,4,2
"8794",82085020,"Brian López","11/20/1999 (23 years old)","D (C)","Real Santa Cruz","Bolivian Premier Division","DOM","Yes","1/1/2023","12/31/2023","$0 - $65K","Right Only","Weak","Very Strong","6'0""","174 lbs","87","7",80,100,5,3,1,1,8,5,14,5,7,14,3,4,14,7,9,11,9,8,11,10,8,5,12,7,13,7,5,8,11,14,8,9,13,12,5,5,12,18,11,14,9,12,14,14,15,2,20,8,19,3,3,2,2,1,2,1,1,2,4,1
"8795",2000183587,"Denis Bokov","10/6/2005 (17 years old)","AM (RL), ST (C)","Dinamo Moscow","Russian Premier League","RUS","No","7/1/2021","12/31/2025","$35K - $350K","Right Only","Weak","Very Strong","5'11""","154 lbs","19","4",61,139,4,6,11,10,12,7,7,6,1,4,9,4,1,11,7,10,5,8,5,8,13,17,4,7,3,6,8,5,13,15,6,9,12,13,6,8,8,11,10,10,10,11,17,20,6,2,13,10,17,2,4,3,1,3,3,3,4,1,2,2
"8796",82082312,"Wilman Modesta","12/24/1995 (27 years old)","DM, M (C)","Pantoja","Liga Dominicana de Fútbol","DOM","No","1/5/2023","12/31/2023","$0 - $16K","Right","Reasonable","Very Strong","5'4""","134 lbs","69","-",95,100,9,8,9,9,13,9,9,9,5,11,8,6,15,8,15,12,10,12,13,15,11,5,10,10,13,8,9,13,11,8,10,4,7,11,15,5,12,16,14,13,11,14,15,9,6,3,12,10,7,3,3,1,3,2,2,1,2,1,3,1
"8797",2000148201,"Kleffer Martes","1/13/2003 (20 years old)","D (C)","Pantoja","Liga Dominicana de Fútbol","DOM","No","1/1/2023","1/1/2024","$2.5K - $8K","Right Only","Weak","Very Strong","6'3""","191 lbs","-","-",70,99,4,5,4,6,6,2,15,6,8,10,10,6,7,12,15,7,10,7,10,9,10,6,5,10,10,8,10,11,8,6,12,15,10,8,10,12,10,14,10,10,12,10,7,7,6,7,9,9,11,3,2,1,4,1,2,1,2,2,1,2
"8798",2000249744,"Francisco Marizan","3/28/2006 (17 years old)","D/WB (R), DM","FC Volendam","Eredivisie","DOM","Yes","7/1/2021","6/30/2026","$50K - $500K","Right","Reasonable","Very Strong","5'10""","149 lbs","5","-",66,97,5,9,8,3,10,7,6,4,7,9,7,6,12,9,12,7,8,9,10,11,5,5,4,7,6,8,7,9,12,15,8,9,15,14,5,8,12,11,11,11,10,10,13,8,5,8,9,10,9,2,3,3,4,3,2,2,1,3,2,2
"8799",82083321,"Oliver Durán","12/21/1997 (25 years old)","AM (L)","Jarabacoa","Liga Dominicana de Fútbol","DOM","No","2/1/2022","12/31/2024","$0","Left","Very Strong","Reasonable","5'10""","152 lbs","46","3",61,96,4,9,12,8,9,2,4,5,2,3,11,2,4,8,7,7,2,7,5,11,14,11,9,8,4,4,6,9,12,12,5,4,15,12,12,4,11,10,13,10,9,11,11,12,9,8,10,11,9,2,3,4,3,2,2,2,3,1,3,2
"8800",2000044864,"Diego Llorente","10/8/2001 (21 years old)","AM (R)","Leça","Portuguese Porto First Division Serie 1","DOM","Yes","6/30/2022","6/30/2026","$0 - $14K","Right Only","Weak","Very Strong","5'10""","165 lbs","15","-",75,95,7,11,11,7,8,4,6,6,3,5,7,3,3,10,12,8,7,8,6,11,7,10,10,10,6,7,5,8,13,13,7,8,8,13,8,3,12,11,11,9,12,8,5,11,9,5,12,10,10,3,1,3,1,2,1,2,2,3,1,1
"8801",19000524,"Odalis Báez","9/29/1983 (39 years old)","GK","Moca FC","Liga Dominicana de Fútbol","DOM","No","1/1/2023","12/31/2023","$0","Right Only","Weak","Very Strong","6'3""","191 lbs","104","-",70,95,3,1,1,1,6,5,5,3,2,3,7,1,2,8,12,7,13,7,9,6,13,2,9,1,10,6,5,9,10,13,12,12,14,8,7,12,11,18,12,9,13,12,12,11,11,3,11,12,12,10,10,12,15,10,8,7,10,6,6,14
"8802",67211780,"Edipo","6/27/1993 (29 years old)","AM (RLC)","Almazán","Spanish Federation Third Group 8","DOM","Yes","1/2/2021","6/30/2024","$0","Right","Reasonable","Very Strong","5'9""","154 lbs","246","69",87,95,6,11,11,10,11,6,7,7,3,4,13,5,4,13,7,9,2,8,7,7,6,13,3,11,6,7,9,8,13,13,7,6,9,13,12,7,15,20,12,12,10,8,8,15,13,4,11,13,7,1,1,2,3,1,3,3,3,3,1,2
"8803",2000173071,"Yordy Álvarez","12/3/2005 (17 years old)","M (C)","Delfines del Este","Liga Dominicana de Fútbol","DOM","No","1/1/2022","12/31/2024","$0","Right","Strong","Very Strong","5'4""","130 lbs","-","-",60,95,6,8,5,4,10,4,8,6,3,9,10,8,10,11,14,8,5,6,9,16,5,5,10,10,6,9,5,10,7,8,9,3,13,7,14,1,10,16,11,9,8,12,5,12,14,5,8,10,18,2,3,3,2,1,2,3,1,3,1,3
"8804",67232124,"Júnior","7/4/1997 (25 years old)","M/AM (RL)","C.D. Estepona","Spanish Federation Second Group 4","DOM","Yes","9/2/2022","6/30/2024","$0 - $50K","Right","Fairly Strong","Very Strong","5'7""","143 lbs","139","12",76,95,7,9,14,7,14,7,6,6,2,5,12,3,8,12,11,8,6,11,8,14,7,13,11,11,7,11,9,6,9,13,8,7,15,10,6,2,15,16,12,11,11,12,7,11,15,4,20,8,9,1,3,2,2,3,3,2,1,2,4,1
"8805",2000030298,"Nowend Lorenzo","11/2/2002 (20 years old)","AM (RL)","Atlético Pamplona B","Spanish Federation First Division A","DOM","Yes","7/1/2021","6/30/2024","$28K - $275K","Right","Reasonable","Very Strong","5'11""","167 lbs","56","6",88,94,6,8,12,11,10,7,6,7,5,4,11,8,6,12,6,7,11,10,11,12,16,12,7,12,8,11,9,10,13,11,11,7,8,12,11,9,9,19,11,10,12,12,6,9,6,1,10,10,13,1,2,4,1,1,1,3,3,1,4,1
"8806",58104594,"Alexandr Golovin","5/30/1996 (27 years old)","M/AM (LC)","AS Monaco","Ligue 1 Uber Eats","RUS","No","2/28/2023","6/30/2026","$44M - $66M","Right","Fairly Strong","Very Strong","5'11""","152 lbs","218","31",149,152,14,13,16,12,15,13,7,14,3,10,16,13,11,16,13,13,12,12,14,13,15,15,11,13,11,14,16,14,14,15,14,10,14,14,13,10,15,12,14,16,17,15,10,15,8,4,13,15,10,1,1,4,3,3,2,2,1,1,2,1
"8807",58159027,"Daniil Odoevskiy","1/22/2003 (20 years old)","GK","Zenit","Russian Premier League","RUS","No","7/17/2019","6/30/2026","$35K - $350K","Right","Reasonable","Very Strong","6'3""","171 lbs","23","-",103,139,4,1,3,2,9,8,3,3,1,3,11,1,1,10,5,12,10,14,10,10,10,1,5,2,11,9,10,10,10,9,10,14,10,9,10,11,11,15,10,12,13,7,6,13,15,2,14,12,20,12,11,14,11,10,11,14,5,12,12,12
"8808",37069476,"Darlin van der Werff","5/24/2000 (23 years old)","M (R), AM (RL), ST (C)","Halberstadt","German Div. North East - South","DOM","Yes","7/1/2022","6/30/2026","$0","Right Only","Weak","Very Strong","5'11""","152 lbs","50","8",76,93,7,11,12,11,9,5,4,6,5,5,8,1,4,10,15,7,5,7,6,12,17,12,9,12,5,6,6,7,15,12,6,9,12,12,6,4,12,13,11,11,11,11,10,8,5,4,9,13,18,1,1,1,1,1,1,3,2,1,3,3
"8809",95071289,"Zito Luvumbo","3/9/2002 (21 years old)","AM (RL), ST (C)","Cagliari","Italian Serie A","ANG","No","7/1/2022","6/30/2025","$20M - $24M","Left","Very Strong","Weak","5'7""","143 lbs","70","10",128,153,12,12,16,10,13,10,9,10,3,2,12,11,3,14,10,12,7,12,8,9,13,16,5,11,3,8,11,8,15,15,11,7,15,17,13,13,7,12,12,13,14,10,5,12,5,7,10,20,13,2,3,1,4,1,1,1,4,3,1,1
"8810",83103196,"M'Bala Nzola","8/18/1996 (26 years old)","ST (C)","Spezia","Italian Serie B","ANG","Yes","10/7/2020","6/30/2026","$750K - $7.4M","Left","Very Strong","Weak","6'1""","180 lbs","209","59",137,145,4,12,13,14,13,9,13,11,4,5,12,14,7,14,18,13,13,12,11,12,16,9,8,14,7,15,11,14,15,13,16,12,17,16,15,17,14,6,9,17,12,8,3,12,10,9,12,17,10,1,3,2,1,1,1,2,2,1,3,2
"8811",13129531,"Bastos","3/27/1991 (32 years old)","D (C)","Al-Ahli (KSA)","Saudi Professional League","ANG","No","9/8/2022","6/30/2025","Not for Sale","Right","Reasonable","Very Strong","6'0""","169 lbs","212","17",127,145,7,7,12,10,10,6,13,10,10,14,12,6,16,12,19,15,15,12,13,11,16,12,8,7,11,15,10,16,14,14,15,12,16,14,13,12,11,14,15,17,11,14,6,12,9,5,13,14,15,2,3,1,4,1,2,1,2,3,3,1
"8812",55024865,"Hélder Costa","1/12/1994 (29 years old)","AM (RL)","Leeds","Sky Bet Championship","ANG","Yes","7/7/2020","6/30/2024","$2.1M - $4.4M","Left","Very Strong","Weak","5'10""","169 lbs","306","45",120,145,12,12,14,10,14,11,6,11,2,5,11,11,5,15,9,11,10,12,9,9,13,16,7,13,5,9,12,13,15,14,12,8,12,15,13,10,12,14,15,12,11,12,9,12,10,5,12,14,12,4,2,3,2,1,4,3,3,1,3,2
"8813",95081596,"Beni Mukendi","5/21/2002 (21 years old)","DM, M (C)","Casa Pia","Portuguese Premier League","ANG","No","1/26/2023","6/30/2027","$700K - $7.2M","Right","Weak","Very Strong","5'11""","160 lbs","63","-",117,142,8,10,14,8,12,5,7,8,5,9,13,6,14,13,15,12,13,12,13,11,12,10,9,12,12,13,13,14,13,14,10,10,12,14,16,10,13,12,13,13,14,13,7,11,7,3,13,13,17,1,2,3,2,2,1,3,3,2,1,3
"8814",18070768,"Clinton Mata","11/7/1992 (30 years old)","D (RC), WB/M (R)","Club Brugge","Jupiler Pro League","ANG","Yes","6/14/2021","6/30/2026","$4.9M - $7.4M","Right Only","Weak","Very Strong","5'11""","158 lbs","318","9",132,140,7,12,12,8,11,11,10,9,13,15,13,12,13,12,14,12,15,11,15,12,15,14,14,14,14,14,10,14,13,12,13,10,15,14,14,14,12,10,12,14,14,14,15,14,12,8,15,14,14,3,1,3,2,2,1,1,1,1,1,1
"8815",55027975,"Ivan Cavaleiro","10/18/1993 (29 years old)","AM (RLC), ST (C)","Fulham","English Premier Division","ANG","Yes","6/14/2021","6/30/2024","$0","Right","Reasonable","Very Strong","5'9""","176 lbs","327","56",130,138,11,12,13,14,14,8,8,11,3,3,14,12,4,15,14,12,12,11,9,11,14,16,8,15,11,12,13,14,15,14,11,8,10,14,12,11,12,11,10,13,12,11,7,13,10,8,12,15,12,2,3,2,1,2,4,3,1,2,2,1
"8816",95080710,"Depú","1/8/2000 (23 years old)","ST (C)","Gil Vicente","Portuguese Premier League","ANG","No","1/31/2023","6/30/2026","$425K - $4.2M","Right","Reasonable","Very Strong","5'8""","163 lbs","67","33",123,138,6,8,13,15,12,5,13,8,4,6,9,11,6,13,10,15,16,12,9,12,16,13,6,14,6,13,11,12,14,13,11,11,18,14,13,13,13,13,11,11,12,5,12,8,6,12,10,10,12,1,2,3,2,1,2,3,1,1,2,1
"8817",854824,"Nando Rafael","1/10/1984 (39 years old)","ST (C)","Union Niederrad","German Lower Division","ANG","Yes","9/13/2021","6/30/2024","$0 - $16K","Right","Reasonable","Very Strong","5'11""","185 lbs","275","86",75,135,5,8,10,10,12,9,11,9,8,6,9,12,6,12,12,10,12,10,9,9,15,14,7,12,6,11,8,11,8,9,12,11,9,7,9,12,5,12,17,17,12,16,9,8,4,10,10,12,12,2,1,3,1,2,1,2,1,1,1,1
"8818",2000242232,"Victor Okishor","12/30/2006 (16 years old)","M (C), AM (LC)","Dinamo Moscow","Russian Premier League","RUS","No","7/1/2022","12/31/2025","$100K - $1M","Right Only","Weak","Very Strong","5'11""","145 lbs","10","-",56,138,5,7,9,9,9,5,3,5,5,6,12,4,6,12,8,6,6,9,3,7,16,12,5,5,4,6,12,11,13,13,6,5,14,13,11,3,10,17,12,13,10,11,5,10,8,7,8,12,13,3,2,3,1,1,1,2,2,1,1,2
"8819",727982,"Mateus","6/18/1984 (38 years old)","AM (RL), ST (C)","Leiria","Portuguese Second League","ANG","Yes","12/27/2022","6/30/2024","$0","Right","Weak","Very Strong","5'9""","165 lbs","456","112",78,134,10,11,11,12,12,11,10,11,6,5,11,13,10,13,10,7,10,11,10,11,14,14,12,13,7,8,12,11,9,8,5,8,12,9,5,12,11,15,14,17,12,12,9,12,8,8,13,14,15,1,2,2,3,1,2,3,3,1,3,3
"8820",55009688,"Wilson Eduardo","7/8/1990 (32 years old)","AM (RL), ST (C)","Alanyaspor","Turkish Super League","ANG","Yes","8/16/2021","6/30/2024","$0","Right","Reasonable","Very Strong","5'10""","160 lbs","301","69",110,134,13,12,12,12,13,12,12,12,5,6,13,12,11,13,14,12,12,11,11,10,14,14,10,12,8,10,13,12,10,12,12,12,11,12,13,11,13,15,11,15,12,13,5,11,6,6,13,12,10,2,4,3,3,1,4,2,1,2,1,3
"8821",95079792,"Zini","7/3/2002 (20 years old)","AM (L), ST (C)","AEK","Greek Super League 1","ANG","No","7/1/2018","6/30/2024","$120K - $1.2M","Right","Weak","Very Strong","5'11""","165 lbs","57","20",105,134,5,10,12,12,12,7,12,10,3,7,10,11,5,13,12,11,12,12,10,10,13,14,5,12,7,11,10,12,14,13,12,12,14,13,11,11,12,14,13,13,12,11,5,11,5,6,9,11,15,1,1,3,2,1,3,3,2,2,3,2
"8822",95080787,"Kialonda Gaspar","9/27/1997 (25 years old)","D (C)","Estrela da Amadora SAD","Portuguese Premier League","ANG","No","7/20/2022","6/30/2026","$7.4M - $9.4M","Right","Reasonable","Very Strong","6'4""","194 lbs","105","5",133,134,6,7,11,8,10,4,13,8,10,15,11,12,14,10,16,14,17,9,14,12,15,6,16,8,14,14,12,14,12,10,13,16,15,13,14,14,10,11,7,14,15,11,6,13,13,12,14,14,17,1,3,1,2,3,2,2,1,1,2,2
"8823",98035163,"Dereck Kutesa","12/6/1997 (25 years old)","M/AM (RL)","Servette","Swiss Super League","ANG","Yes","7/1/2022","6/30/2025","$110K - $1.1M","Right","Weak","Very Strong","5'10""","167 lbs","227","22",118,132,10,12,15,10,13,7,8,8,4,5,12,8,5,14,8,10,7,12,11,10,12,14,8,12,5,11,10,11,16,14,12,7,12,14,12,11,11,9,8,12,13,6,9,6,9,8,11,12,7,3,3,1,2,2,4,3,2,2,2,3
"8824",83209861,"Rui Modesto","10/7/1999 (23 years old)","D/WB/M/AM (R)","AIK","Swedish Premier Division","ANG","Yes","1/1/2023","12/31/2025","$850K - $1.8M","Right","Reasonable","Very Strong","5'11""","145 lbs","86","11",115,131,6,12,13,11,12,7,7,7,10,6,11,9,9,12,10,11,11,11,11,11,13,13,6,13,7,10,11,10,14,13,8,12,15,13,14,8,14,12,12,14,11,13,4,13,8,5,12,14,14,3,3,1,2,3,2,2,3,3,1,2
"8825",29041503,"Jérémie Bela","4/8/1993 (30 years old)","WB/M/AM (RL)","Clermont","Ligue 1 Uber Eats","ANG","Yes","8/2/2022","6/30/2024","$50K - $500K","Right","Reasonable","Very Strong","5'8""","152 lbs","273","37",112,131,11,13,13,11,12,12,5,12,6,4,12,11,3,13,8,11,12,11,9,10,12,12,6,12,8,11,10,12,12,12,12,7,11,13,12,9,9,16,16,9,10,9,7,11,5,7,10,13,15,1,1,4,1,3,2,1,2,3,1,2
"8826",55027972,"Bruno Gaspar","4/21/1993 (30 years old)","D/WB (R)","VTSC","Portuguese Premier League","ANG","Yes","1/31/2022","6/30/2026","$170K - $1.7M","Right","Reasonable","Very Strong","5'11""","154 lbs","185","2",117,130,8,13,11,9,12,6,9,7,11,10,12,8,12,12,13,11,13,12,11,9,14,11,9,12,12,13,13,14,14,13,12,10,11,14,13,10,14,14,10,15,12,12,13,10,14,6,12,12,9,3,2,1,3,2,3,1,3,3,3,4
"8827",55060704,"Lucas João","9/4/1993 (29 years old)","ST (C)","Reading","Sky Bet League One","ANG","Yes","8/6/2019","6/30/2025","$230K - $2.3M","Right","Strong","Very Strong","6'4""","176 lbs","315","90",112,130,6,7,12,14,14,7,14,12,6,6,9,13,6,13,10,9,11,13,9,8,13,14,6,9,5,8,9,8,10,13,14,14,15,11,12,14,4,12,12,14,11,12,10,11,6,5,10,15,13,1,2,3,1,4,1,4,3,1,4,1
"8828",2000182605,"Maya","8/15/2004 (18 years old)","M/AM (C)","Gil Vicente","Portuguese Premier League","ANG","No","9/6/2022","6/30/2024","$900K - $1.9M","Right","Fairly Strong","Very Strong","5'9""","143 lbs","28","3",92,130,8,8,11,9,12,6,5,12,4,6,11,9,8,12,10,9,12,10,8,9,13,10,5,11,5,13,10,13,12,12,13,6,13,12,13,8,13,18,10,12,9,11,7,16,11,2,12,11,14,3,2,1,1,1,1,2,1,2,3,2
"8829",2000091232,"Igor Dmitriev","7/24/2004 (18 years old)","M/AM (L)","Leningradets","Russian First Division","RUS","No","7/1/2020","6/30/2024","$55K - $550K","Left","Very Strong","Reasonable","5'10""","141 lbs","46","11",91,138,7,11,12,11,9,8,8,6,8,5,12,10,8,10,11,8,9,11,9,10,16,9,11,11,8,9,10,10,14,11,4,8,9,14,8,5,12,14,10,12,13,12,7,12,8,2,10,9,19,2,3,2,1,1,2,2,3,2,3,3
"8830",13153816,"Mabululu","6/1/1992 (31 years old)","ST (C)","Al-Ittihad","Egyptian Premier League","ANG","No","9/8/2021","7/31/2024","Not for Sale","Right Only","Weak","Very Strong","5'10""","171 lbs","202","82",115,130,11,11,16,16,15,10,16,7,8,10,12,7,8,10,9,14,8,11,11,16,17,15,10,16,12,11,10,11,13,10,12,11,9,12,9,11,13,20,10,9,11,14,9,13,11,6,12,14,19,2,1,1,3,3,2,2,1,2,2,3
"8831",13153835,"Gélson Dala","7/13/1996 (26 years old)","AM (LC), ST (C)","Al-Wakrah","Qatar Stars League","ANG","Yes","7/2/2022","5/31/2025","$7M - $9M","Right","Fairly Strong","Very Strong","5'9""","147 lbs","210","89",125,130,7,9,15,13,14,7,10,13,6,5,12,13,5,14,10,12,8,14,11,12,11,15,9,15,6,12,14,9,14,15,11,8,15,14,12,8,10,10,12,13,15,14,8,15,5,6,12,14,14,2,2,4,1,2,4,2,2,3,1,3
"8832",83219473,"Elliot Simões","12/20/1999 (23 years old)","AM (LC), ST (C)","Salford","Sky Bet League Two","ANG","Yes","7/21/2022","6/30/2025","$100K - $300K","Right","Reasonable","Very Strong","5'9""","152 lbs","75","3",92,130,8,8,12,9,11,8,8,9,3,5,9,10,5,11,10,6,7,10,4,6,10,12,4,9,4,10,9,10,15,13,11,8,11,14,10,8,12,11,12,11,14,12,4,12,7,4,5,12,15,3,4,4,1,2,3,1,3,1,1,3
"8833",2000179620,"Pedro Bondo","11/16/2004 (18 years old)","D/WB (L)","Petro de Luanda","-","ANG","No","7/1/2022","6/30/2024","$0","Left Only","Very Strong","Weak","5'10""","154 lbs","63","-",77,129,8,11,12,5,10,6,7,7,15,8,8,4,10,10,13,8,12,8,8,8,13,9,5,11,7,11,7,12,12,11,8,10,13,13,13,9,11,15,10,12,14,11,5,18,11,1,8,10,16,3,2,3,3,2,1,3,3,2,4,4
"8834",95053297,"Show","3/6/1999 (24 years old)","DM, M (C)","Ludogorets","Bulgarian First League","ANG","No","8/28/2021","6/30/2025","$1.3M - $2.7M","Right","Weak","Very Strong","5'11""","165 lbs","164","5",113,128,5,7,10,6,11,8,11,10,4,12,13,9,13,11,17,13,15,11,13,11,15,7,8,8,12,15,10,14,13,12,13,10,15,13,16,13,10,13,15,17,8,11,4,12,14,5,15,14,14,2,4,3,1,3,1,2,2,1,3,3
"8835",55017367,"Fredy","3/27/1990 (33 years old)","DM, M/AM (C)","Antalyaspor","Turkish Super League","ANG","Yes","8/31/2021","6/30/2024","$30K - $325K","Right","Reasonable","Very Strong","5'7""","154 lbs","366","55",115,128,13,12,15,10,13,11,8,12,6,9,13,14,10,13,14,12,11,12,10,12,12,13,11,13,9,13,11,13,13,13,12,5,14,11,12,10,15,13,13,15,14,12,7,12,7,5,12,16,13,3,3,2,2,3,2,2,2,2,3,1
"8836",2000225958,"Manuel Keliano","1/16/2003 (20 years old)","M/AM (C)","1º de Agosto","Angolan Championship","ANG","No","7/1/2021","6/30/2024","$0","Right","Weak","Very Strong","6'1""","174 lbs","32","2",92,128,11,10,13,9,11,10,9,12,6,8,12,11,8,13,11,9,11,10,9,9,13,10,7,11,8,11,11,12,12,11,12,12,14,12,13,11,14,13,11,13,12,14,11,10,7,5,11,8,11,3,4,1,3,1,2,3,2,2,1,3
"8837",92090146,"Kevin Bukusu","2/27/2001 (22 years old)","D (C)","Wolfsberger AC","Austrian Premier Division","ANG","Yes","8/31/2022","6/30/2025","$200K - $2M","Left","Very Strong","Reasonable","6'2""","200 lbs","40","-",92,127,3,5,5,6,11,5,12,5,11,11,9,8,12,10,9,11,12,9,9,11,13,6,9,7,11,11,7,10,10,10,12,13,13,12,10,13,8,12,12,13,11,12,5,12,7,9,13,13,9,2,3,1,1,1,2,3,2,2,1,2
"8838",95053303,"Nélson da Luz","2/4/1998 (25 years old)","AM (RL)","VTSC","Portuguese Premier League","ANG","No","9/11/2020","6/30/2025","$75K - $750K","Left","Very Strong","Weak","5'10""","163 lbs","145","15",117,126,10,10,15,12,13,10,10,10,5,4,11,11,5,14,11,13,8,12,11,11,13,14,8,12,7,10,12,13,15,15,9,6,13,14,12,7,10,13,8,5,11,5,4,13,6,3,10,12,10,1,3,2,1,1,2,3,3,2,3,1
"8839",13135755,"Ary Papel","3/3/1994 (29 years old)","AM (RLC)","Al-Akhdar","Libyan First Division","ANG","No","10/17/2021","6/30/2024","$12K - $120K","Right","Weak","Very Strong","5'7""","160 lbs","179","74",107,126,10,12,14,11,14,7,11,10,6,5,10,1,5,15,12,12,8,8,8,8,8,16,6,12,6,10,10,9,14,14,10,8,14,14,11,8,8,5,12,8,8,14,4,10,13,15,9,15,15,2,3,2,3,3,1,1,4,4,4,3
"8840",58133082,"Alexandr Sobolev","3/7/1997 (26 years old)","ST (C)","Spartak Moscow","Russian Premier League","RUS","No","8/13/2021","6/30/2026","$4.4M - $6.6M","Right","Fairly Strong","Very Strong","6'5""","187 lbs","174","69",134,138,8,7,12,15,13,9,15,12,5,8,12,16,9,14,12,14,13,14,14,13,16,14,12,14,11,13,13,10,10,12,12,16,12,12,13,14,5,9,7,16,14,12,9,16,14,13,12,15,10,1,2,3,2,2,2,3,3,3,3,2
"8841",91174012,"Anderson Lucoqui","7/6/1997 (25 years old)","D/WB (L)","Mainz 05","Bundesliga","ANG","Yes","7/1/2021","6/30/2027","$0","Left","Very Strong","Reasonable","5'11""","165 lbs","115","2",114,125,6,11,11,7,11,6,9,7,15,11,10,6,13,11,14,11,15,9,10,9,11,12,4,12,12,12,10,13,15,12,12,10,14,15,14,12,14,12,12,8,8,10,8,14,10,13,10,11,8,2,4,3,3,2,2,2,2,2,1,1
"8842",95070177,"Picas","2/14/2001 (22 years old)","AM (RL), ST (C)","Chaves","Portuguese Premier League","ANG","No","1/3/2022","6/30/2025","$110K - $325K","Right","Reasonable","Very Strong","5'7""","149 lbs","95","11",100,125,4,10,13,15,14,5,11,8,5,9,15,12,6,9,12,8,8,13,10,7,13,10,15,12,6,10,11,11,14,13,10,8,11,14,9,2,11,17,8,11,11,11,13,1,5,6,14,20,12,3,3,3,2,1,3,2,3,2,2,3
"8843",55063253,"Estrela","9/22/1995 (27 years old)","DM, M (C)","Erzurumspor FK","Turkish 1. League","ANG","Yes","8/10/2021","6/30/2023","$40K - $120K","Right","Weak","Very Strong","5'8""","154 lbs","175","4",115,125,3,7,12,5,12,4,11,9,7,12,12,7,14,12,12,11,14,12,13,11,8,6,11,12,12,12,11,18,13,14,13,10,12,11,16,13,7,12,6,14,9,8,5,10,8,10,12,10,9,2,3,1,3,2,3,1,2,1,2,3
"8844",67054790,"Jonás Ramalho","6/10/1993 (30 years old)","D (RC)","Málaga","Spanish Federation First Division B","ANG","Yes","7/15/2022","6/30/2025","$140K - $1.4M","Right","Fairly Strong","Very Strong","6'1""","167 lbs","289","7",115,125,3,11,10,8,12,6,13,6,11,13,10,8,13,12,13,13,12,13,10,11,11,10,13,7,13,13,8,14,12,11,11,11,12,12,12,14,12,17,10,12,13,13,11,13,9,6,13,14,11,1,1,1,2,1,2,2,3,3,1,2
"8845",55067813,"Núrio","3/24/1995 (28 years old)","D/WB (L)","AA Gent","Jupiler Pro League","ANG","Yes","7/1/2020","6/30/2024","$700K - $1.5M","Left","Very Strong","Weak","5'10""","158 lbs","285","6",121,125,5,13,12,7,12,8,10,9,12,12,12,9,14,13,15,13,14,13,14,12,12,13,12,12,12,13,9,14,14,12,12,10,13,14,13,11,12,15,10,10,11,9,7,7,13,6,13,13,12,2,3,3,1,1,4,2,1,4,1,2
"8846",55008689,"Djalma","5/30/1987 (36 years old)","M/AM (RL)","Trofense","Portuguese Third Division - North","ANG","Yes","3/3/2022","6/30/2024","$30K - $90K","Right","Fairly Strong","Very Strong","5'9""","160 lbs","363","60",108,125,13,11,13,9,11,12,8,9,8,9,11,11,8,13,12,10,10,8,10,9,14,13,8,11,9,10,11,12,14,12,13,7,8,14,8,11,13,13,10,14,12,14,13,9,7,6,10,14,15,3,2,2,1,3,1,3,3,1,2,1
"8847",95079788,"Maestro","8/4/2003 (19 years old)","M (C), AM (RC)","SLB B","Portuguese Second League","ANG","No","7/25/2022","6/30/2026","$140K - $1.4M","Right Only","Weak","Very Strong","5'8""","147 lbs","31","1",85,125,7,9,10,14,13,5,7,8,4,3,12,5,8,14,12,10,3,8,8,10,11,13,8,13,4,8,8,13,14,10,8,4,12,13,8,6,13,17,11,10,12,11,11,12,7,3,20,8,9,3,2,3,1,1,3,1,1,4,1,3
"8848",2000141390,"Miro","4/22/2003 (20 years old)","ST (C)","Gil Vicente","Portuguese Premier League","ANG","No","7/1/2022","6/30/2025","$150K - $1.5M","Right","Reasonable","Very Strong","6'2""","185 lbs","11","11",95,124,8,6,14,12,14,8,14,6,2,8,6,7,3,14,8,11,6,14,9,6,15,15,8,14,7,13,6,13,13,14,6,9,13,13,9,9,10,13,12,11,10,9,5,5,13,4,15,11,20,2,1,2,1,1,1,3,4,1,1,3
"8849",2000186384,"Gilberto","3/10/2001 (22 years old)","AM (RL)","Petro de Luanda","-","ANG","No","6/27/2022","5/31/2025","$55K - $550K","Right","Weak","Very Strong","5'9""","145 lbs","44","15",104,124,6,10,12,13,12,6,11,11,6,4,9,8,4,12,9,11,9,12,8,8,10,13,4,13,5,8,9,9,15,15,12,10,11,14,11,8,16,12,13,12,12,10,8,11,5,7,12,9,9,1,2,2,3,1,3,2,2,3,4,3
"8850",37000270,"Dominique Kivuvu","9/16/1987 (35 years old)","D (C), DM, M (C)","ZSGOWMS","Dutch Tweede Klasse Zondag B","ANG","Yes","7/1/2019","-","$0","Right Only","Weak","Very Strong","6'2""","191 lbs","166","6",75,123,4,8,7,3,8,8,9,9,8,11,10,10,8,9,12,9,14,9,9,9,12,12,8,11,10,11,9,12,8,10,11,12,14,10,10,10,5,10,12,10,8,12,10,10,8,5,13,10,10,2,4,2,2,2,3,1,3,2,3,2
"8851",58140558,"Nail Umyarov","6/27/2000 (22 years old)","DM, M (C)","Spartak Moscow","Russian Premier League","RUS","No","10/27/2021","6/30/2026","$180K - $9M","Right","Reasonable","Very Strong","6'0""","156 lbs","120","3",120,138,11,10,11,8,14,10,10,10,7,10,13,13,13,14,13,13,12,15,11,13,16,14,13,11,12,13,11,14,12,13,13,11,10,12,13,8,18,14,10,12,16,10,13,4,9,10,14,13,20,3,1,3,1,2,3,7,2,2,3,1
"8852",95073395,"Edmilson","2/6/1999 (24 years old)","DM, M (C)","Bravos do Maquis","Angolan Championship","ANG","No","2/9/2023","6/30/2024","$0","Right","Weak","Very Strong","5'11""","165 lbs","70","4",65,123,4,1,3,6,11,5,5,4,4,10,11,4,5,13,8,11,9,7,7,11,20,5,7,6,8,7,9,12,9,13,6,9,11,11,7,8,15,10,13,20,13,11,14,10,7,3,8,20,8,2,1,2,1,1,2,2,3,1,1,1
"8853",2000256727,"Valter Monteiro","11/8/2005 (17 years old)","M (C), AM (RLC)","Sagrada Esperança","Angolan Championship","ANG","No","7/1/2021","6/30/2025","$10K - $110K","Left","Very Strong","Reasonable","5'10""","138 lbs","11","2",85,122,8,8,14,10,12,8,6,10,5,6,8,6,7,13,12,9,12,8,7,6,13,12,4,11,8,10,9,11,12,14,10,7,11,12,10,7,12,15,10,9,13,12,12,12,10,3,10,11,18,2,2,1,3,3,2,3,2,3,3,1
"8854",13195830,"Milson","10/12/1999 (23 years old)","AM (RLC)","Pari NN","Russian Premier League","ANG","No","2/12/2022","6/30/2026","$160K - $1.6M","Right","Weak","Very Strong","5'7""","145 lbs","105","21",115,122,11,13,14,12,11,10,4,10,4,5,11,11,7,13,8,10,10,8,9,8,14,15,4,13,9,10,11,12,16,15,12,5,12,15,12,6,12,16,8,13,14,12,10,8,6,8,8,15,13,2,2,2,1,1,2,2,1,3,1,1
"8855",83212032,"Batxi","5/1/1998 (25 years old)","AM (RL)","Krasnodar","Russian Premier League","ANG","Yes","9/7/2022","6/30/2025","$375K - $3.8M","Right","Reasonable","Very Strong","5'9""","143 lbs","128","17",115,122,8,11,14,12,12,5,6,8,4,6,12,11,9,12,12,13,10,12,9,9,13,13,5,12,9,10,12,12,15,14,11,7,14,14,12,10,10,14,11,13,13,14,7,11,12,6,12,13,10,1,3,1,3,3,1,1,4,1,2,2
"8856",744635,"Ricardo Batista","11/19/1986 (36 years old)","GK","Casa Pia","Portuguese Premier League","ANG","Yes","6/7/2023","6/30/2025","Not for Sale","Left Only","Very Strong","Weak","6'4""","174 lbs","186","-",122,122,6,3,2,1,7,10,8,1,1,1,8,3,2,5,10,14,14,10,13,12,13,9,10,7,13,13,11,12,11,13,12,13,10,10,12,13,12,10,8,15,13,15,10,12,13,5,14,12,12,12,15,16,16,15,10,11,15,13,11,14
"8857",224211,"Capita","1/10/2002 (21 years old)","AM (RL)","Estrela da Amadora SAD","Portuguese Premier League","ANG","No","8/23/2022","6/30/2025","$16K - $160K","Right","Reasonable","Very Strong","5'7""","141 lbs","27","6",98,121,10,14,13,10,11,7,6,9,7,3,10,12,4,12,11,9,6,6,5,9,11,7,6,10,3,8,10,10,15,13,10,6,10,13,12,7,11,18,6,10,11,5,7,9,3,3,10,16,12,1,2,2,1,3,4,3,1,2,3,1
"8858",13195835,"Vá","8/24/1998 (24 years old)","M (R), AM (RL)","Apol. Limassol","Cypriot First Division","ANG","No","6/21/2022","6/30/2025","$18K - $170K","Right","Reasonable","Very Strong","5'5""","132 lbs","117","25",104,121,10,9,14,8,11,7,5,6,3,4,10,7,5,14,7,11,7,10,9,11,11,14,5,12,4,8,10,13,15,14,9,5,15,14,12,6,11,12,13,12,13,12,8,10,4,8,12,13,9,2,1,1,3,1,3,1,2,2,3,2
"8859",83335583,"Loide Augusto","2/26/2000 (23 years old)","AM (RL)","Mafra","Portuguese Second League","ANG","No","6/17/2022","6/30/2025","$60K - $600K","Right","Fairly Strong","Very Strong","5'11""","158 lbs","44","9",110,120,6,8,13,11,12,8,7,13,8,8,8,7,8,12,14,10,11,8,11,9,12,13,6,12,8,10,11,12,15,14,8,9,14,14,12,10,15,8,10,8,13,4,10,11,5,13,9,17,7,1,3,1,1,1,1,1,3,3,3,4
"8860",18070856,"Gigli Ndefe","3/2/1994 (29 years old)","D/WB (RL)","Slovan Liberec","Czech First Division","ANG","Yes","1/14/2021","12/31/2023","$110K - $1.1M","Right","Reasonable","Very Strong","5'11""","165 lbs","236","2",111,120,8,14,12,8,11,7,8,7,11,13,12,8,13,11,14,12,11,11,10,12,11,12,6,12,12,11,14,11,13,11,9,8,12,12,12,10,15,10,12,10,11,9,9,10,7,4,13,12,12,1,3,1,1,1,1,2,2,1,1,2
"8861",19086720,"Geraldo","11/23/1991 (31 years old)","AM (RLC), ST (C)","Ümraniyespor","Turkish 1. League","ANG","No","1/1/2023","6/30/2024","$0","Left","Very Strong","Fairly Strong","6'0""","147 lbs","263","25",115,120,5,10,15,9,12,9,8,11,5,4,13,7,5,13,9,10,8,11,6,9,12,15,8,13,5,10,10,10,15,15,10,6,14,13,11,8,9,15,7,12,12,10,8,10,7,6,7,12,15,2,2,1,2,3,2,3,1,1,1,3
"8862",58030755,"Alexandr Kokorin","3/19/1991 (32 years old)","AM (RC), ST (C)","Fiorentina","Italian Serie A","RUS","No","1/26/2021","6/30/2024","$40K - $375K","Right","Fairly Strong","Very Strong","6'0""","169 lbs","290","80",130,138,10,11,12,12,13,11,12,13,7,8,12,13,9,12,9,13,12,14,14,13,8,9,9,14,9,14,14,10,13,12,15,12,11,14,12,12,10,11,12,8,7,10,9,9,11,8,10,10,10,3,3,3,1,3,2,3,4,2,3,3
"8863",95073319,"Domingos Andrade","5/7/2003 (20 years old)","DM, M (C)","Sporting CP","Portuguese Premier League","ANG","No","5/19/2021","6/30/2025","$1K - $8K","Right Only","Weak","Very Strong","6'0""","158 lbs","17","-",80,120,6,7,10,6,11,6,7,8,7,8,12,8,11,11,7,11,8,10,10,10,12,11,7,7,10,13,12,11,12,12,10,11,13,12,12,10,11,14,11,14,12,8,8,5,4,2,11,11,7,2,4,4,1,2,2,2,3,1,1,2
"8864",37050603,"Albert Guðmundsson","6/15/1997 (25 years old)","AM (RLC), ST (C)","Genoa","Italian Serie A","ISL","Yes","1/31/2022","6/30/2026","$8.8M - $11M","Right","Reasonable","Very Strong","5'10""","160 lbs","198","58",140,153,14,15,16,13,16,13,9,12,4,5,13,14,6,16,11,10,8,13,9,12,12,17,4,12,9,13,14,8,15,16,12,7,14,14,13,10,12,4,9,7,12,10,13,10,11,13,11,13,15,1,1,3,3,1,2,2,3,2,3,1
"8865",39053746,"Hákon Rafn Valdimarsson","10/13/2001 (21 years old)","GK","IF Elfsborg","Swedish Premier Division","ISL","Yes","1/18/2022","12/31/2026","$350K - $3.4M","Right","Weak","Very Strong","6'2""","176 lbs","89","-",119,148,7,7,1,2,7,9,1,3,2,3,8,4,3,7,8,12,15,12,14,12,15,2,6,2,13,12,7,11,10,12,12,13,12,10,11,12,15,15,15,13,14,10,5,6,6,5,14,12,15,11,15,14,7,13,12,13,5,11,14,12
"8866",39056943,"Mikael Egill Ellertsson","3/11/2002 (21 years old)","M (C)","Venezia","Italian Serie B","ISL","Yes","1/26/2023","6/30/2027","$250K - $2.5M","Left","Very Strong","Reasonable","6'0""","163 lbs","41","2",116,148,6,7,13,12,13,7,8,9,5,12,12,8,12,13,8,12,12,11,12,12,14,12,10,13,13,13,11,12,13,13,11,10,17,13,13,12,10,14,13,14,12,12,8,11,8,10,13,14,13,3,3,2,1,1,4,3,2,3,2,2
"8867",39007034,"Jóhann Berg Guðmundsson","10/27/1990 (32 years old)","M/AM (RL)","Burnley","English Premier Division","ISL","Yes","1/31/2023","6/30/2024","$3.7M","Left","Very Strong","Reasonable","5'10""","174 lbs","391","44",125,146,12,13,13,11,12,14,10,13,5,7,14,14,7,13,12,13,11,14,11,12,14,13,5,12,11,15,14,15,12,12,13,13,15,12,14,12,10,13,14,16,13,12,13,14,4,4,11,16,12,2,3,3,3,1,3,1,3,3,1,1
"8868",39049583,"Elías Rafn Ólafsson","3/11/2000 (23 years old)","GK","FC Midtjylland","3F Superliga","ISL","Yes","12/31/2021","6/30/2026","$85K - $850K","Right","Fairly Strong","Very Strong","6'7""","207 lbs","68","-",117,145,4,3,1,3,9,7,10,2,3,1,8,1,3,9,5,12,11,11,11,11,14,2,7,3,10,12,8,10,11,13,10,19,11,9,8,15,14,7,11,10,13,10,8,5,12,5,8,9,8,9,7,14,7,14,8,13,13,11,14,17
"8869",39060464,"Hákon Arnar Haraldsson","4/10/2003 (20 years old)","M (C), AM (LC)","FC København","3F Superliga","ISL","Yes","6/27/2019","12/31/2024","$11.5M - $17M","Right","Fairly Strong","Very Strong","5'11""","147 lbs","40","8",128,144,13,10,13,11,13,12,10,12,3,4,13,5,6,14,12,13,15,11,12,13,16,17,6,14,6,14,14,16,13,14,13,10,15,13,16,7,14,14,12,16,14,15,8,14,6,4,12,16,16,1,3,3,2,1,2,2,2,2,3,2
"8870",2000123242,"Galdur Guðmundsson","4/14/2006 (17 years old)","AM (R), ST (C)","FC København","3F Superliga","ISL","Yes","7/1/2022","6/30/2025","$210K - $2.1M","Right","Strong","Very Strong","6'0""","154 lbs","1","-",85,142,7,10,11,13,10,7,5,9,7,7,7,9,8,14,9,6,7,11,8,11,11,13,7,5,8,8,11,7,13,13,9,8,12,12,9,5,16,16,11,12,10,13,14,3,9,8,7,10,20,3,2,2,2,3,1,3,1,1,2,2
"8871",39046379,"Arnór Sigurðsson","5/15/1999 (24 years old)","M (C), AM (RLC)","CSKA Moscow","Russian Premier League","ISL","Yes","7/30/2021","6/30/2024","$425K - $4.2M","Right","Reasonable","Very Strong","5'10""","165 lbs","131","27",129,140,9,12,14,13,14,12,10,11,5,7,13,13,7,14,13,13,13,14,13,13,15,15,8,14,11,13,13,12,14,14,12,8,14,13,12,11,12,14,10,14,14,10,12,12,8,5,13,14,13,2,3,2,2,1,1,3,2,1,3,1
"8872",27110041,"Mikael Anderson","7/1/1998 (24 years old)","M/AM (LC)","AGF","3F Superliga","ISL","Yes","8/31/2021","6/30/2026","$2.5M - $5.2M","Right","Fairly Strong","Very Strong","5'11""","154 lbs","144","21",125,140,10,12,14,12,13,11,6,13,2,6,12,12,5,14,10,13,8,11,11,13,13,15,4,13,8,9,12,13,15,13,12,9,13,14,11,8,10,8,9,9,10,4,10,14,10,13,12,18,11,2,3,1,3,1,2,2,1,3,2,1
"8873",58152186,"Fanil Sungatulin","12/24/2001 (21 years old)","DM","Ural","Russian Premier League","RUS","No","1/31/2023","6/30/2025","$475K - $4.6M","Right","Fairly Strong","Very Strong","5'10""","156 lbs","75","1",102,138,8,7,8,5,10,6,8,12,8,8,12,5,11,12,13,12,13,10,11,12,15,5,14,11,10,12,12,13,11,12,12,8,11,11,13,8,14,12,11,13,10,12,7,12,13,3,15,10,19,3,3,2,2,2,3,2,2,3,2,1
"8874",39062838,"Orri Steinn Óskarsson","8/29/2004 (18 years old)","M (R), AM (RL), ST (C)","Sønderjyske","NordicBet Liga","ISL","Yes","6/28/2021","6/30/2025","$200K - $9M","Right","Reasonable","Very Strong","6'2""","167 lbs","32","8",116,140,6,7,12,13,12,11,12,8,6,6,12,11,5,13,14,13,13,12,11,11,13,10,5,13,9,14,12,14,12,11,13,13,11,12,12,12,14,14,13,13,14,15,6,13,6,4,13,14,13,3,1,1,2,2,3,1,2,2,3,1
"8875",67269924,"Andri Lucas Guðjohnsen","1/29/2002 (21 years old)","ST (C)","IFK Norrköping","Swedish Premier Division","ISL","Yes","7/22/2022","12/31/2026","$130K - $1.3M","Right","Fairly Strong","Very Strong","6'2""","171 lbs","36","6",109,140,4,7,8,12,11,6,14,9,8,3,11,10,6,10,12,11,12,12,13,11,14,10,7,12,12,12,11,11,11,9,13,15,15,12,14,15,7,14,14,12,12,9,6,1,7,5,13,12,14,3,2,2,2,3,2,1,2,4,2,3
"8876",2000013008,"Adolf Daði Birgisson","6/3/2004 (19 years old)","AM (R), ST (C)","Stjarnan","Icelandic Premier Division","ISL","Yes","5/1/2022","12/31/2024","$26K - $250K","Right","Reasonable","Very Strong","5'11""","154 lbs","30","4",92,139,8,11,13,13,13,7,13,8,6,6,9,3,2,11,17,12,15,9,3,10,13,11,9,13,6,5,7,9,13,13,6,10,8,13,8,8,11,13,9,12,12,12,5,17,12,4,12,13,8,2,2,3,4,2,3,2,1,2,3,2
"8877",2000125859,"Adrían Nana Boateng","4/1/2005 (18 years old)","ST (C)","FH","Icelandic Premier Division","ISL","Yes","1/1/2021","10/31/2024","$0","Right","Reasonable","Very Strong","5'11""","138 lbs","-","-",65,139,5,2,13,13,11,5,13,6,1,5,6,6,1,13,5,7,4,8,6,6,9,13,11,10,5,5,2,6,12,10,6,6,9,12,9,4,10,16,10,9,12,13,10,6,15,2,7,10,8,1,1,3,3,2,1,2,3,2,1,3
"8878",39057014,"Davíð Snær Jóhannsson","6/15/2002 (20 years old)","M/AM (RC)","FH","Icelandic Premier Division","ISL","Yes","5/6/2022","10/31/2025","$22K - $230K","Right","Reasonable","Very Strong","5'10""","163 lbs","95","9",86,139,9,12,10,12,5,7,7,8,6,7,12,8,8,10,10,7,8,11,8,11,14,10,6,8,8,8,7,9,13,14,8,7,13,11,10,5,14,15,10,13,10,12,10,13,5,5,12,10,18,3,1,3,3,3,1,1,1,3,3,2
"8879",39029824,"Rúnar Alex Rúnarsson","2/18/1995 (28 years old)","GK","Arsenal","English Premier Division","ISL","Yes","9/21/2020","6/30/2024","$250K - $2.6M","Right","Reasonable","Very Strong","6'1""","167 lbs","147","-",115,138,3,3,2,3,13,5,7,3,2,3,10,3,1,10,14,13,12,9,12,10,10,10,10,3,12,13,11,12,10,15,10,14,12,10,13,11,11,13,11,12,7,10,5,13,5,9,11,15,9,12,10,15,10,13,12,14,9,12,11,12
"8880",39060486,"Kristian Nökkvi Hlynsson","1/23/2004 (19 years old)","M/AM (RLC)","Ajax","Keuken Kampioen Divisie","ISL","Yes","1/25/2022","6/30/2026","$900K - $9.8M","Right","Weak","Very Strong","5'3""","123 lbs","74","13",101,138,9,13,12,5,13,14,9,11,8,5,12,12,5,14,10,9,7,9,11,10,12,13,6,12,7,14,13,12,12,13,12,2,15,12,11,8,12,14,12,11,9,11,4,10,6,5,11,13,7,3,1,3,2,1,2,1,3,1,2,3
"8881",39008334,"Alfreð Finnbogason","2/1/1989 (34 years old)","ST (C)","Lyngby","3F Superliga","ISL","Yes","8/31/2022","6/30/2024","$95K - $950K","Right","Reasonable","Very Strong","6'0""","176 lbs","306","142",118,137,7,9,11,15,14,10,14,11,4,7,10,17,7,12,10,16,12,14,14,13,12,12,10,15,11,14,13,11,9,10,12,11,12,10,10,13,8,10,14,16,12,10,16,13,5,4,12,16,18,3,1,2,1,3,1,2,1,2,1,3
"8882",2000015468,"Elmar Kári Cogic","1/3/2002 (21 years old)","AM (RC)","Afturelding","Icelandic First Division","ISL","Yes","10/18/2022","12/31/2024","$0 - $110K","Left","Very Strong","Reasonable","5'10""","152 lbs","41","7",89,137,6,11,12,12,11,7,7,11,5,7,10,3,8,8,8,7,7,10,7,10,13,8,6,8,10,8,9,7,14,14,8,7,11,14,10,10,15,17,13,13,9,12,12,11,10,4,15,12,19,1,1,3,3,1,1,3,3,1,3,1
"8883",2000034716,"Jóhannes Kristinn Bjarnason","2/24/2005 (18 years old)","M/AM (C)","KR","Icelandic Premier Division","ISL","Yes","2/14/2023","10/31/2025","$28K - $275K","Right Only","Weak","Very Strong","5'11""","138 lbs","9","-",80,136,11,8,8,6,12,11,7,11,2,5,11,6,7,12,11,10,6,11,11,11,14,12,6,11,7,10,11,9,12,14,12,3,10,11,8,5,12,12,12,12,10,10,9,14,13,2,10,12,12,3,3,1,1,4,3,3,3,3,2,1
"8884",58133140,"Ivan Oblyakov","7/5/1998 (24 years old)","D/WB (L), DM, M (C)","CSKA Moscow","Russian Premier League","RUS","No","8/18/2022","6/30/2027","$170K - $6.6M","Left","Very Strong","Reasonable","5'9""","163 lbs","180","20",127,138,12,12,11,12,13,13,7,12,6,8,13,8,9,13,10,13,13,13,12,14,12,13,7,12,12,17,12,15,13,13,12,8,8,12,14,10,14,10,12,14,13,11,8,11,5,3,14,10,19,1,1,2,2,1,3,3,1,3,3,1
"8885",29190793,"Ísak Snær Þorvaldsson","5/1/2001 (22 years old)","M (C), AM (LC), ST (C)","Rosenborg","Norwegian Premier Division","ISL","Yes","1/1/2023","12/31/2027","$1.6M - $3.3M","Right","Reasonable","Very Strong","6'0""","160 lbs","59","19",113,135,9,10,13,13,12,10,10,10,8,7,12,8,9,13,12,11,11,13,10,10,12,13,3,11,8,11,14,11,12,12,12,13,10,12,12,13,9,11,10,13,11,9,5,7,9,4,10,13,11,1,3,1,3,3,3,1,2,3,3,2
"8886",39053441,"Patrik Sigurður Gunnarsson","11/15/2000 (22 years old)","GK","Viking","Norwegian Premier Division","ISL","Yes","1/18/2022","12/31/2025","$1.9M - $3.9M","Right Only","Weak","Very Strong","6'3""","185 lbs","70","-",114,135,2,1,1,3,9,1,6,2,1,3,9,3,1,8,11,12,14,14,11,11,15,4,6,5,12,10,9,12,9,14,12,16,12,9,12,13,1,7,13,16,12,12,5,12,3,6,13,15,13,13,11,11,12,12,11,14,4,14,12,14
"8887",39045459,"Stefán Teitur Þórðarson","10/16/1998 (24 years old)","DM, M (C)","Silkeborg IF","3F Superliga","ISL","Yes","10/5/2020","12/31/2024","$95K - $950K","Right","Fairly Strong","Very Strong","6'2""","182 lbs","154","25",114,135,9,10,7,10,13,10,10,9,14,12,15,5,12,15,14,12,10,7,12,15,15,7,4,11,12,11,10,13,15,13,9,14,10,13,9,11,14,12,11,13,13,8,11,4,5,4,11,11,16,2,1,2,1,2,3,3,2,3,3,2
"8888",39053303,"Þórir Jóhann Helgason","9/28/2000 (22 years old)","DM, M (C)","Salento","Italian Serie A","ISL","Yes","7/26/2021","6/30/2025","$26K - $275K","Right Only","Weak","Very Strong","6'2""","145 lbs","92","4",109,135,11,12,12,8,13,12,11,12,6,11,13,11,11,13,8,13,12,11,12,12,12,12,12,11,11,13,12,11,12,12,12,12,14,12,13,11,12,16,15,13,13,12,5,10,4,4,12,12,14,2,2,1,2,2,2,3,3,3,3,1
"8889",39056735,"Valgeir Friðriksson","9/24/2001 (21 years old)","D (RL), WB (R)","BK Häcken","Swedish Premier Division","ISL","Yes","1/22/2021","12/31/2024","$120K - $1.2M","Right","Reasonable","Very Strong","6'3""","180 lbs","64","3",115,133,8,11,11,4,11,8,11,7,13,13,12,7,13,11,8,11,11,11,13,12,13,5,6,12,13,13,11,14,12,11,12,16,12,13,13,13,11,14,14,12,12,10,7,10,7,5,13,13,14,3,3,2,3,1,2,3,3,1,3,2
"8890",2000097431,"Stígur Diljan Þórðarson","1/4/2006 (17 years old)","M/AM (RL)","Benfica","Portuguese Premier League","ISL","Yes","7/25/2022","6/30/2025","$45K - $425K","Right","Weak","Very Strong","6'0""","152 lbs","1","-",72,133,8,9,10,9,10,7,6,9,4,5,8,4,6,10,8,10,8,9,10,9,14,14,6,10,7,8,11,9,12,11,11,7,15,12,8,9,14,10,11,12,9,11,5,8,7,6,11,12,19,1,3,3,1,1,2,3,3,2,1,3
"8891",39056963,"Valgeir Valgeirsson","9/22/2002 (20 years old)","D/WB/M/AM (R)","Örebro SK","Swedish First Division Elite","ISL","Yes","8/2/2022","12/31/2024","$65K - $650K","Right","Reasonable","Very Strong","5'11""","165 lbs","79","10",94,133,5,9,7,9,12,7,6,7,5,7,11,8,9,11,15,11,14,11,13,11,16,8,9,12,9,15,9,16,10,12,11,9,15,11,13,10,16,17,15,15,10,9,8,11,6,5,12,13,10,3,3,3,3,3,2,1,1,1,2,1
"8892",39002766,"Björn Sigurðarson","2/26/1991 (32 years old)","ST (C)","ÍA","Icelandic First Division","ISL","Yes","4/27/2023","11/16/2023","$0 - $110K","Right","Reasonable","Very Strong","6'1""","178 lbs","284","63",110,132,6,9,12,13,14,9,14,11,4,5,12,14,6,13,13,16,8,12,12,12,15,13,9,14,8,12,12,10,10,10,13,13,12,11,9,12,10,16,14,15,11,13,20,9,13,6,10,15,12,1,1,3,3,2,2,3,2,2,1,3
"8893",39061707,"Logi Hrafn Róbertsson","7/22/2004 (18 years old)","D (C), DM","FH","Icelandic Premier Division","ISL","Yes","2/1/2022","12/31/2024","$6K - $65K","Right","Reasonable","Very Strong","6'2""","163 lbs","38","1",90,131,3,7,5,3,8,7,9,9,2,13,12,1,13,8,5,5,9,9,7,13,7,5,10,5,13,8,8,12,13,9,8,13,15,10,13,7,16,10,12,10,11,12,5,15,9,7,20,10,12,4,2,3,2,1,2,3,2,2,2,3
"8894",2000273159,"Nóel Atli Anórsson","9/30/2006 (16 years old)","D (LC), WB (L)","AaB","NordicBet Liga","ISL","Yes","9/30/2021","6/30/2025","$85K - $850K","Left","Very Strong","Weak","6'2""","160 lbs","-","-",75,131,6,12,8,8,11,2,5,2,8,10,12,3,13,11,8,9,10,6,8,8,10,5,9,4,9,12,11,14,13,11,15,12,13,11,9,4,10,17,10,10,11,11,13,1,12,4,11,11,15,3,1,1,4,1,3,1,2,1,3,3
"8895",58147376,"Danila Prokhin","5/24/2001 (22 years old)","D (C)","Rostov","Russian Premier League","RUS","No","6/5/2021","6/5/2026","$700K - $6.8M","Right Only","Weak","Very Strong","6'2""","163 lbs","81","3",109,138,7,9,6,10,10,8,14,14,9,11,10,10,12,10,12,13,13,11,14,11,13,5,12,10,13,15,8,15,10,10,11,14,6,13,13,10,7,13,10,12,12,13,15,14,7,2,14,12,11,1,2,4,2,1,1,2,3,3,1,1
"8896",39007683,"Jón Daði Böðvarsson","5/25/1992 (31 years old)","AM (RLC), ST (C)","Bolton","Sky Bet League One","ISL","Yes","1/20/2022","6/30/2026","Not for Sale","Right","Reasonable","Very Strong","6'3""","187 lbs","372","67",110,131,5,9,10,13,13,5,12,8,6,7,13,11,7,13,9,10,9,12,12,12,15,10,12,12,9,13,10,12,11,10,13,12,10,11,13,13,11,13,13,13,11,8,12,13,6,9,12,14,12,2,2,1,3,1,1,3,1,3,3,3
"8897",2000013013,"Eggert Aron Guðmundsson","2/8/2004 (19 years old)","DM, M (C)","Stjarnan","Icelandic Premier Division","ISL","Yes","1/1/2022","10/31/2024","$140K - $425K","Right","Reasonable","Very Strong","5'4""","130 lbs","47","5",108,131,10,9,10,12,16,10,10,10,5,12,13,10,14,16,14,12,10,12,8,11,3,5,8,12,8,8,14,13,16,14,12,3,6,13,8,3,15,12,12,9,9,12,8,15,8,6,6,10,7,1,3,2,3,2,3,3,4,1,3,3
"8898",39056706,"Andri Fannar Baldursson","1/10/2002 (21 years old)","DM, M (C)","Bologna","Italian Serie A","ISL","Yes","8/4/2020","6/30/2025","$80K - $800K","Right","Weak","Very Strong","6'2""","160 lbs","30","-",106,130,9,10,11,8,12,10,12,10,6,9,13,10,9,13,12,11,12,11,11,10,15,11,8,12,10,13,13,13,13,13,12,14,13,13,13,11,13,15,15,17,17,14,5,12,7,4,12,15,12,3,4,3,3,2,2,1,3,1,1,1
"8899",2000181825,"Breki Baldursson","8/11/2006 (16 years old)","M (C)","Fram","Icelandic Premier Division","ISL","Yes","1/1/2022","10/31/2025","$30K - $95K","Right","Reasonable","Very Strong","6'2""","147 lbs","4","-",85,130,8,8,9,9,9,8,8,6,7,11,10,7,12,14,7,8,8,8,9,14,11,5,1,8,9,9,12,14,7,10,8,15,9,10,14,7,6,10,11,12,10,12,5,4,12,1,11,11,13,2,1,1,3,3,3,2,1,1,3,2
"8900",39017860,"Sverrir Ingi Ingason","8/5/1993 (29 years old)","D (C)","PAOK","Greek Super League 1","ISL","Yes","6/15/2020","6/30/2024","$220K - $6.8M","Right Only","Weak","Very Strong","6'2""","182 lbs","310","29",124,130,6,7,9,10,10,7,13,11,13,14,11,8,15,8,13,16,14,12,14,12,16,9,16,9,12,14,7,16,11,10,13,15,14,12,13,13,5,12,15,13,15,12,6,15,6,3,14,15,15,3,2,3,3,1,3,2,1,2,2,3
"8901",769023,"Birkir Bjarnason","5/27/1988 (35 years old)","M/AM (C)","Viking","Norwegian Premier Division","ISL","Yes","3/29/2023","12/31/2024","Not for Sale","Right","Reasonable","Very Strong","6'0""","165 lbs","403","68",115,130,9,11,11,12,13,8,12,11,9,9,13,12,10,13,14,12,14,14,14,14,14,9,14,14,14,14,12,15,10,9,15,13,15,8,13,12,14,16,15,17,13,12,10,12,11,1,13,15,16,4,1,1,2,3,4,3,3,2,2,3
"8902",39017616,"Arnór Ingvi Traustason","4/30/1993 (30 years old)","DM, M/AM (LC)","IFK Norrköping","Swedish Premier Division","ISL","Yes","8/10/2022","12/31/2026","$300K - $3M","Right","Reasonable","Very Strong","6'0""","165 lbs","273","42",124,130,11,12,12,12,12,11,9,12,7,10,12,10,11,13,12,14,13,12,12,10,13,11,13,13,10,13,12,14,12,11,11,10,13,13,14,10,13,12,13,14,14,12,10,13,7,5,14,12,13,1,3,1,4,3,1,3,2,3,4,3
"8903",39054080,"Jason Daði Svanþórsson","12/31/1999 (23 years old)","M/AM (RC)","Breiðablik","Icelandic Premier Division","ISL","Yes","10/16/2021","10/31/2024","$40K - $400K","Right","Reasonable","Very Strong","5'11""","167 lbs","118","36",105,130,8,9,13,14,14,8,4,10,8,8,12,5,6,9,15,10,7,8,9,14,8,15,11,13,8,9,10,6,14,13,5,11,12,14,11,6,15,13,11,13,14,11,13,14,5,5,11,15,19,3,3,1,2,4,2,3,1,1,3,3
"8904",39046159,"Alfons Sampsted","4/6/1998 (25 years old)","D/WB (R)","FC Twente","Eredivisie","ISL","Yes","1/1/2023","6/30/2025","$200K - $2M","Right Only","Weak","Very Strong","5'11""","152 lbs","167","4",120,130,6,11,11,8,11,7,9,8,7,11,12,6,10,12,13,12,12,13,12,12,15,12,8,12,14,17,11,17,13,13,11,9,10,13,17,10,7,13,12,14,12,12,8,14,10,3,15,12,15,3,2,3,3,2,2,1,3,2,3,2
"8905",39049500,"Dagur Dan Þórhallsson","5/2/2000 (23 years old)","M/AM (C), ST (C)","Orlando City","Major League Soccer","ISL","Yes","1/31/2023","12/31/2024","$275K - $2.8M","Right","Reasonable","Very Strong","5'6""","136 lbs","102","17",105,130,10,10,11,7,11,10,11,12,10,11,12,5,12,12,10,11,9,8,12,11,8,8,7,11,12,12,10,14,12,12,11,10,12,11,13,10,14,16,11,12,11,11,9,9,5,4,12,10,9,1,1,2,1,3,3,3,3,1,1,2
"8906",2000242625,"Alexandr Koksharov","12/20/2004 (18 years old)","ST (C)","Krasnodar","Russian Premier League","RUS","No","7/1/2022","6/30/2025","$1.2M - $2.5M","Right","Reasonable","Very Strong","6'2""","156 lbs","10","1",85,137,7,6,10,14,13,7,12,7,5,5,5,8,2,11,7,11,4,8,4,12,7,10,5,14,5,6,7,8,13,13,4,11,9,14,4,8,12,16,12,12,12,10,12,16,5,8,8,12,17,1,1,2,3,2,3,2,2,1,2,3
"8907",39001034,"Aron Einar Gunnarsson","4/22/1989 (34 years old)","D (C), DM, M (C)","Al-Arabi","Qatar Stars League","ISL","Yes","6/30/2022","6/30/2024","$450K - $4.4M","Right","Weak","Very Strong","5'10""","154 lbs","485","39",130,130,8,11,11,11,12,9,13,11,16,13,13,12,14,13,15,13,17,14,13,13,16,11,17,12,14,16,12,16,10,10,13,10,14,12,14,14,12,10,15,18,12,12,4,14,12,6,14,14,14,2,3,1,1,3,1,2,2,2,2,1
"8908",39002452,"Viðar Örn Kjartansson","3/11/1990 (33 years old)","ST (C)","CSKA 1948","Bulgarian First League","ISL","Yes","6/1/2023","6/30/2024","$45K - $425K","Right","Reasonable","Very Strong","6'2""","189 lbs","403","167",110,130,6,7,9,15,12,11,12,12,6,5,11,14,8,12,9,13,10,14,14,14,12,10,8,14,7,9,8,10,10,11,14,13,10,10,10,13,3,10,12,10,13,5,9,13,8,10,9,14,13,4,3,1,3,3,2,3,2,2,2,2
"8909",39049465,"Viktor Örlygur Andrason","2/5/2000 (23 years old)","D (C), DM, M (C)","Víkingur R.","Icelandic Premier Division","ISL","Yes","4/1/2023","12/31/2025","$150K - $450K","Right","Reasonable","Very Strong","5'8""","145 lbs","91","5",105,130,5,9,6,7,14,8,9,10,4,11,12,1,13,9,6,9,9,5,8,13,11,8,5,9,14,6,11,5,13,14,9,3,15,14,8,7,13,18,11,13,10,13,14,13,8,1,12,11,12,1,2,4,3,3,2,2,2,2,3,3
"8910",2000127976,"Róbert Frosti Þorkelsson","8/18/2005 (17 years old)","D (R)","Stjarnan","Icelandic Premier Division","ISL","Yes","6/13/2022","12/31/2025","$14K - $140K","Right","Reasonable","Very Strong","5'10""","138 lbs","12","-",80,129,7,11,6,3,10,2,9,1,8,9,6,2,15,7,10,6,10,8,9,12,17,5,7,6,11,9,8,9,14,11,9,5,11,12,9,8,13,20,9,12,11,10,13,14,6,4,19,10,9,3,3,2,2,1,2,2,3,2,2,1
"8911",2000176717,"Kjartan Már Kjartansson","7/14/2006 (16 years old)","ST (C)","Stjarnan","Icelandic Premier Division","ISL","Yes","1/1/2022","10/31/2025","$2K - $6K","Right","Reasonable","Very Strong","6'0""","145 lbs","9","1",70,129,6,6,8,13,13,6,11,6,1,5,7,4,1,13,10,13,7,12,7,7,12,13,4,13,6,6,5,7,13,13,7,7,16,9,9,4,7,20,12,10,12,13,7,11,5,7,10,10,12,3,2,1,1,1,2,4,2,1,3,3
"8912",2000064698,"Þorsteinn Aron Antonsson","1/13/2004 (19 years old)","D (C)","Selfoss","Icelandic First Division","ISL","Yes","4/1/2023","11/16/2024","$0 - $110K","Right","Reasonable","Very Strong","6'6""","178 lbs","24","2",86,129,3,1,1,7,5,1,14,3,6,14,8,6,11,6,15,11,9,6,9,14,4,7,9,6,13,7,5,8,14,10,8,13,11,12,5,7,8,18,12,11,9,12,5,5,9,2,16,13,16,2,2,2,1,1,3,3,2,2,2,2
"8913",2000126228,"Amin Cosic","10/27/2005 (17 years old)","M (C), ST (C)","HK","Icelandic Premier Division","ISL","Yes","1/1/2022","10/31/2024","$0 - $8K","Right","Fairly Strong","Very Strong","5'11""","145 lbs","1","-",64,128,5,6,12,14,14,5,11,7,4,5,6,6,4,9,10,8,5,6,5,10,13,10,6,5,4,7,13,7,13,12,7,8,9,9,4,6,9,20,13,12,12,10,9,7,11,8,3,12,20,3,2,2,2,2,1,1,1,2,3,2
"8914",2000092644,"Jón Hrafn Barkarson","9/15/2003 (19 years old)","AM (C)","Leiknir","Icelandic First Division","ISL","Yes","3/29/2021","12/31/2024","$14K - $140K","Right","Reasonable","Very Strong","6'2""","160 lbs","16","-",85,128,7,9,12,11,13,6,6,8,7,6,8,3,7,8,10,12,8,5,5,14,12,8,9,11,6,8,12,9,14,13,4,8,12,14,9,5,11,19,13,13,12,12,8,10,7,5,8,9,17,3,2,1,2,3,1,2,3,1,1,4
"8915",2000176706,"Allan Purisevic","6/20/2006 (16 years old)","M (LC)","Stjarnan","Icelandic Premier Division","ISL","Yes","10/1/2022","10/31/2025","$0 - $24K","Left","Very Strong","Strong","5'11""","134 lbs","3","-",70,128,6,8,8,5,13,6,6,8,5,7,8,1,5,10,10,9,4,7,4,12,10,10,10,8,8,8,7,12,12,9,8,8,17,10,7,5,15,20,10,8,12,11,5,2,9,6,6,11,10,2,1,2,3,2,2,3,3,2,1,2
"8916",39056977,"Bjarki Bjarkason","5/11/2000 (23 years old)","M/AM (RL)","Foggia","Italian Serie C/C","ISL","Yes","10/29/2021","6/30/2024","$220K - $650K","Right Only","Weak","Very Strong","5'10""","156 lbs","84","9",106,126,6,12,13,8,13,9,6,10,8,6,12,8,9,13,11,10,11,12,12,13,12,7,10,13,9,12,10,12,13,13,9,6,7,13,13,9,12,9,11,11,10,11,6,8,5,7,12,15,11,1,2,3,2,3,1,1,2,2,1,3
"8917",19088277,"Mário Fernandes","9/19/1990 (32 years old)","D/WB (R)","INT","Brazilian National First Division","RUS","No","12/14/2022","12/31/2025","Not for Sale","Right","Reasonable","Very Strong","6'2""","178 lbs","317","10",134,150,6,11,13,7,15,6,13,5,6,11,13,8,13,15,12,16,18,13,14,14,18,13,7,14,12,13,10,12,15,13,12,13,13,15,13,12,13,17,16,20,18,20,7,16,5,3,15,11,16,1,4,1,4,1,3,3,2,1,1,3
"8918",58154548,"Kirill Kravtsov","6/14/2002 (20 years old)","DM, M (C)","Sochi","Russian Premier League","RUS","No","7/22/2022","6/10/2026","$150K - $7.4M","Right","Strong","Very Strong","6'2""","176 lbs","73","5",112,137,11,11,12,9,11,11,11,12,7,11,12,8,12,13,5,12,11,10,7,10,9,5,1,12,11,11,12,13,11,11,12,13,17,11,12,11,15,20,8,14,10,11,10,13,15,7,11,12,18,3,1,2,1,1,2,3,1,3,1,2
"8919",2000187677,"Maron Birnir Reynisson","12/27/2006 (16 years old)","D/M (C)","Fylkir","Icelandic Premier Division","ISL","Yes","12/27/2021","10/31/2025","$16K - $50K","Right","Reasonable","Very Strong","6'1""","149 lbs","1","-",68,126,5,6,2,1,12,6,7,5,1,7,10,1,13,7,9,10,7,3,5,13,11,5,11,7,10,6,10,8,14,13,7,13,12,14,6,5,10,13,10,12,12,14,13,19,6,6,8,10,8,2,3,1,3,1,1,1,3,3,2,2
"8920",23127918,"Mehdi Taremi","7/18/1992 (30 years old)","ST (C)","FC Porto","Portuguese Premier League","IRN","No","8/31/2020","6/30/2024","$27M - $41M","Right","Fairly Strong","Very Strong","6'2""","180 lbs","275","147",155,156,5,11,15,14,15,8,13,11,8,6,15,17,8,16,15,16,15,15,16,16,14,15,12,16,7,16,16,15,12,14,15,14,16,13,14,14,12,11,3,15,18,15,3,14,14,14,15,12,16,3,2,1,1,3,1,1,2,3,3,3
"8921",58098760,"Sardar Azmoun","1/1/1995 (28 years old)","AM (C), ST (C)","Bayer 04","Bundesliga","IRN","No","1/30/2022","6/30/2027","$210K - $6.6M","Right","Reasonable","Very Strong","6'1""","187 lbs","240","90",130,145,5,7,11,13,14,6,15,9,4,7,13,13,8,14,12,14,12,13,12,13,14,12,12,15,7,12,13,11,14,13,12,15,10,14,12,11,10,9,13,10,9,10,12,14,9,6,11,14,8,1,1,3,1,2,2,2,3,3,2,4
"8922",29223444,"Allahyar Sayyadmanesh","6/27/2001 (21 years old)","M/AM (RL), ST (C)","Hull","Sky Bet Championship","IRN","No","7/9/2022","6/30/2026","$8.2M - $12.5M","Right","Reasonable","Very Strong","6'0""","171 lbs","90","17",119,145,6,10,14,10,13,5,10,9,5,7,10,12,6,14,12,9,12,9,10,11,12,12,6,13,8,11,9,13,15,14,9,11,13,14,9,8,12,13,9,11,8,10,9,9,8,6,10,15,12,1,1,3,1,1,3,3,2,2,1,1
"8923",64039651,"Amir Hossein Hosseinzadeh","10/30/2000 (22 years old)","AM (RLC)","Charleroi","Jupiler Pro League","IRN","No","8/22/2022","6/30/2026","$85K - $850K","Right","Reasonable","Very Strong","5'10""","176 lbs","99","17",114,140,9,10,13,9,11,11,7,8,8,8,11,8,7,13,7,8,13,12,12,11,20,13,7,12,10,12,12,11,14,12,8,8,8,14,9,8,15,13,10,8,12,13,12,7,12,2,10,12,5,1,3,4,2,3,2,3,1,3,3,1
"8924",2000269273,"Nima Andarz","1/22/2006 (17 years old)","D (R)","KIA FA","Iranian Second Division Group B","IRN","No","6/13/2022","6/30/2024","$80K - $240K","Right","Reasonable","Very Strong","5'10""","149 lbs","-","-",90,139,6,14,7,1,11,4,9,6,8,7,9,3,13,6,13,10,10,5,9,14,12,7,11,5,9,9,9,9,14,10,4,6,14,11,14,7,11,19,10,11,10,12,6,11,5,2,11,11,19,1,2,2,4,1,2,3,2,1,3,3
"8925",37044889,"Alireza Jahanbakhsh","8/11/1993 (29 years old)","M (RL), AM (RLC)","Feyenoord","Eredivisie","IRN","No","7/17/2021","6/30/2024","$6.2M - $11M","Right","Reasonable","Very Strong","5'11""","171 lbs","299","72",131,139,13,14,14,13,14,13,9,14,14,6,14,12,5,14,12,11,14,12,10,12,14,13,13,14,7,13,14,15,13,12,12,11,9,12,12,11,13,10,14,15,12,14,7,13,7,8,12,18,12,2,1,3,3,4,2,3,1,2,1,4
"8926",23260467,"Majid Hosseini","6/20/1996 (26 years old)","D (C)","Kayserispor","Turkish Super League","IRN","No","8/6/2021","6/30/2026","$250K - $2.5M","Right","Weak","Very Strong","6'2""","171 lbs","162","5",120,135,4,6,7,6,8,7,13,5,6,14,8,5,14,8,14,14,18,12,15,12,15,5,14,8,13,14,6,14,11,12,14,12,14,9,14,13,6,14,10,10,10,10,9,10,14,7,12,13,10,3,1,1,3,2,3,3,3,3,1,2
"8927",23128049,"Morteza Pouraliganji","4/19/1992 (31 years old)","D (C), DM","Persepolis","Persian Gulf Premier League","IRN","No","6/6/2022","6/30/2024","$650K - $1.4M","Right","Reasonable","Very Strong","6'1""","165 lbs","212","18",115,135,4,6,9,6,9,8,12,10,9,14,8,6,14,9,16,10,18,9,14,13,14,8,11,10,10,13,10,15,9,10,13,14,16,9,13,13,13,12,11,15,11,9,8,11,4,5,12,13,9,4,1,2,1,3,3,2,1,3,2,2
"8928",29223779,"Mohammad Khodabandelou","9/7/1999 (23 years old)","DM, M/AM (C)","Gol Gohar","Persian Gulf Premier League","IRN","No","6/16/2022","6/30/2026","$0","Right","Strong","Very Strong","5'11""","163 lbs","100","7",108,134,8,8,8,10,14,8,8,10,6,10,14,4,13,14,14,12,9,11,10,14,9,13,14,13,10,9,13,13,13,7,14,11,12,8,14,5,14,15,10,12,13,11,5,12,5,2,12,11,17,2,1,1,3,2,3,3,1,4,2,3
"8929",58152145,"Nikita Iosifov","4/11/2001 (22 years old)","AM (RL)","Villarreal B","Spanish Second Division","RUS","No","7/1/2021","6/30/2026","$0","Right","Fairly Strong","Very Strong","5'9""","136 lbs","61","8",114,150,11,10,14,11,14,8,7,9,6,8,13,9,8,14,5,9,10,12,12,12,10,11,8,11,9,10,13,11,13,13,13,8,12,13,12,9,18,12,12,10,11,11,13,8,11,6,10,12,9,1,2,1,2,2,4,1,3,1,1,2
"8930",2000184600,"Mohammad Reza Bordbar","8/26/2004 (18 years old)","D (C), DM, M (C)","Malavan","Persian Gulf Premier League","IRN","No","6/13/2022","6/30/2026","$110K - $1.1M","Left","Very Strong","Strong","6'0""","163 lbs","6","-",101,133,9,8,5,4,14,9,10,8,4,10,14,4,11,11,7,9,10,11,10,15,4,5,14,9,10,14,13,11,6,8,14,12,10,10,11,5,14,11,11,11,12,11,12,11,11,6,9,11,18,3,1,4,2,1,1,2,2,3,3,3
"8931",1044516,"Milad Zeneyedpour","3/21/1986 (37 years old)","M (L), AM (RLC)","I-Kissat","Finnish Second Division Group B","IRN","No","3/24/2023","11/15/2023","$0 - $20K","Left Only","Very Strong","Very Weak","5'10""","154 lbs","323","57",98,132,11,12,11,11,13,14,4,15,1,2,14,14,2,13,15,15,10,13,7,14,14,16,11,13,4,12,14,8,10,13,8,6,10,11,11,8,5,5,12,14,10,10,5,15,4,4,14,12,18,3,2,3,3,1,3,2,2,4,3,1
"8932",93033389,"Saman Ghoddos","9/6/1993 (29 years old)","AM (RLC)","Brentford","English Premier Division","IRN","Yes","1/14/2021","6/30/2025","$2.1M - $4.4M","Right","Weak","Very Strong","5'9""","165 lbs","275","55",123,131,13,13,14,12,14,15,7,14,5,6,13,12,6,14,11,12,10,14,13,12,13,13,5,13,8,12,13,11,14,13,13,8,11,13,12,12,14,13,13,13,13,8,10,11,9,4,11,15,14,2,3,2,3,3,1,1,3,2,3,2
"8933",23309885,"Ahmad Nourollahi","2/2/1993 (30 years old)","DM, M (C)","Al-Wahda (UAE)","UAE Professional League","IRN","No","6/1/2023","6/30/2025","$5.4M - $10M","Right","Reasonable","Very Strong","6'1""","160 lbs","241","26",115,130,12,12,12,12,11,11,11,14,10,11,13,11,11,12,13,12,13,11,10,13,13,12,12,12,13,12,12,13,10,10,14,13,16,12,14,13,13,14,14,13,13,11,12,12,9,9,11,15,14,2,3,3,1,1,2,2,1,3,3,2
"8934",23260457,"Ali Gholizadeh","3/10/1996 (27 years old)","AM (RL)","Charleroi","Jupiler Pro League","IRN","No","6/15/2020","6/30/2025","$1.9M - $4M","Left Only","Very Strong","Weak","5'9""","152 lbs","204","29",115,130,11,11,14,10,13,11,9,8,5,6,10,14,9,13,12,12,14,14,12,13,14,16,7,14,8,12,11,14,13,12,11,8,12,13,13,13,14,11,11,12,10,12,11,8,6,6,14,9,8,4,4,1,1,3,1,2,2,3,3,2
"8935",23260427,"Alireza Beiranvand","9/21/1992 (30 years old)","GK","Persepolis","Persian Gulf Premier League","IRN","No","7/1/2022","6/30/2024","$120K - $1.2M","Right Only","Weak","Very Strong","6'4""","187 lbs","210","-",125,130,2,2,2,2,10,5,8,1,18,3,10,2,3,8,15,10,13,10,8,10,10,1,15,11,12,12,7,14,9,10,11,17,14,10,11,14,12,20,11,13,10,12,14,12,10,5,15,11,2,19,14,14,15,14,9,13,18,14,10,18
"8936",23061628,"Esmaeil Sharifat","9/7/1988 (34 years old)","D (R), AM (RLC)","Aluminium Arak","Persian Gulf Premier League","IRN","No","6/29/2022","6/30/2024","$12K - $120K","Left","Very Strong","Reasonable","5'5""","132 lbs","389","37",104,130,8,11,8,14,13,8,8,7,4,8,10,8,10,10,7,8,6,9,10,12,17,11,14,12,8,9,10,10,11,12,8,4,5,16,11,3,15,15,9,11,9,9,7,13,12,3,20,13,12,1,1,1,1,1,1,3,3,3,1,1
"8937",23127927,"Omid Ebrahimi","9/16/1987 (35 years old)","DM, M (C)","Al-Wakrah","Qatar Stars League","IRN","No","7/22/2021","6/30/2024","$0","Right","Weak","Very Strong","5'10""","163 lbs","343","61",110,130,13,9,8,10,12,13,11,15,9,12,13,15,12,12,11,13,11,13,12,13,3,9,15,8,13,13,12,13,9,10,13,9,13,9,11,12,11,16,11,9,11,12,10,13,5,6,14,8,9,3,3,3,2,1,4,1,3,1,2,1
"8938",23055744,"Bakhtiar Rahmani","9/23/1991 (31 years old)","M/AM (C)","Dalkurd FF","Swedish First Division North","IRN","No","1/13/2021","12/31/2023","$0 - $18K","Right Only","Weak","Very Strong","5'10""","165 lbs","330","45",82,130,12,11,10,9,10,11,10,11,7,9,11,11,10,11,12,11,11,11,11,11,10,11,10,9,11,11,11,11,10,8,12,9,12,11,10,11,14,9,10,13,14,9,14,13,10,8,11,8,12,2,1,4,1,2,3,2,2,2,2,3
"8939",2000219187,"Reza Ghandipour","1/13/2006 (17 years old)","AM (RL), ST (C)","Paykan","Persian Gulf Premier League","IRN","No","7/24/2022","6/30/2026","$60K - $600K","Left","Very Strong","Fairly Strong","5'10""","147 lbs","-","-",90,130,7,10,13,13,13,7,9,3,7,7,11,5,6,10,13,6,6,8,8,12,9,10,9,11,6,8,9,9,13,13,3,7,12,13,9,6,10,10,10,12,10,13,6,13,6,1,8,10,9,1,2,2,2,2,3,1,1,2,1,2
"8940",2000014077,"Arsen Zakharyan","5/26/2003 (20 years old)","M (C), AM (RLC)","Dinamo Moscow","Russian Premier League","RUS","No","6/13/2022","6/30/2024","$13.5M - $16M","Right","Fairly Strong","Very Strong","6'0""","158 lbs","84","22",126,149,14,11,12,13,13,12,6,12,4,5,14,13,5,14,7,12,8,13,9,15,9,15,8,14,10,13,16,11,13,13,12,13,8,13,10,9,12,11,11,10,10,8,9,4,6,7,9,17,19,3,2,2,3,1,2,1,2,3,1,2
"8941",2000048576,"Mohammad Hossein Zavari","1/11/2001 (22 years old)","M/AM (C)","Esteghlal","Persian Gulf Premier League","IRN","No","7/1/2022","6/30/2024","$120K - $1.2M","Right","Fairly Strong","Very Strong","5'10""","158 lbs","35","-",94,129,9,9,14,11,14,8,7,8,6,11,14,9,10,11,12,13,4,10,10,12,4,9,10,12,13,10,9,13,13,11,15,6,6,10,8,5,11,16,10,10,11,10,13,3,10,5,13,12,10,2,2,1,4,1,2,2,2,2,3,4
"8942",2000035952,"Mohammad Javad Kia","8/29/2001 (21 years old)","GK","Aluminium Arak","Persian Gulf Premier League","IRN","No","7/1/2022","6/30/2025","$0","Right","Reasonable","Very Strong","6'3""","178 lbs","3","-",78,129,2,1,1,2,1,4,1,3,2,3,8,2,1,5,12,8,14,6,9,10,11,2,8,2,8,7,6,4,12,12,7,10,8,11,1,5,11,19,9,12,12,12,9,13,8,6,7,11,18,10,5,13,5,9,13,13,5,9,11,6
"8943",2000184318,"Mohammad Ghorbani","5/21/2001 (22 years old)","D (C), DM, M (C)","Sepahan","Persian Gulf Premier League","IRN","No","8/21/2022","6/30/2025","$275K - $2.8M","Right","Reasonable","Very Strong","6'3""","182 lbs","31","-",108,129,7,4,4,4,15,9,11,10,1,12,15,2,15,10,15,8,10,10,9,15,6,6,6,8,11,14,8,13,11,11,10,14,7,11,14,8,17,20,13,9,9,11,6,13,9,3,12,13,13,3,1,1,1,3,2,2,3,2,1,1
"8944",23240168,"Saeid Ezatolahi","10/1/1996 (26 years old)","DM, M (C)","Vejle","3F Superliga","IRN","No","1/19/2022","12/31/2023","$140K - $1.4M","Right","Reasonable","Very Strong","6'3""","178 lbs","134","9",116,129,9,12,12,12,12,11,13,12,8,13,14,9,12,11,9,13,13,13,11,12,8,7,12,12,13,13,13,8,11,10,12,15,7,12,10,15,9,13,11,13,8,10,8,14,12,10,9,13,13,2,2,3,3,3,4,4,1,2,4,3
"8945",2000186418,"Amir Shahim","9/18/2003 (19 years old)","ST (C)","Malavan","Persian Gulf Premier League","IRN","No","7/3/2022","6/30/2023","$150K - $1.5M","Right","Reasonable","Very Strong","5'11""","165 lbs","31","12",92,129,6,6,13,13,13,7,13,5,1,4,8,7,4,13,8,10,7,11,7,12,14,13,12,11,5,7,8,8,13,8,8,10,12,12,9,9,11,10,10,10,12,10,7,17,5,8,12,11,14,1,1,1,1,1,4,3,2,3,3,1
"8946",2000103931,"Mohammad Mehdi Ahmadi","1/10/2001 (22 years old)","D/M (L)","Naft MIS","Azadegan League","IRN","No","6/12/2022","6/30/2025","$50K - $500K","Left","Very Strong","Fairly Strong","5'11""","158 lbs","64","-",95,128,9,11,11,7,13,5,8,7,5,10,8,8,11,12,14,6,10,11,10,15,5,10,12,10,11,10,13,11,14,13,5,9,14,13,7,7,13,12,13,10,11,13,7,9,9,2,12,10,12,3,1,3,3,2,3,1,3,2,2,2
"8947",23127761,"Ramin Rezaeian","3/21/1990 (33 years old)","D/WB/M (R)","Sepahan","Persian Gulf Premier League","IRN","No","7/15/2022","6/30/2024","$425K - $1.3M","Right Only","Weak","Very Strong","6'1""","182 lbs","322","59",122,127,16,17,11,8,15,16,11,9,12,11,12,7,12,11,15,12,14,11,13,12,11,11,14,12,12,12,9,12,14,11,14,12,7,13,13,13,12,15,11,11,12,10,9,12,8,15,14,18,8,1,2,3,3,4,1,2,2,3,1,1
"8948",2000247737,"Erfan Ghorbani","1/27/2003 (20 years old)","AM (L)","KIA FA","Iranian Second Division Group B","IRN","No","7/1/2021","6/30/2025","$130K - $400K","Right","Reasonable","Very Strong","5'9""","147 lbs","-","-",95,127,8,13,14,10,10,8,8,14,6,5,9,2,6,14,15,10,3,8,9,12,14,13,10,13,6,9,9,13,14,9,12,4,12,13,11,4,13,17,11,12,12,11,11,14,10,5,11,11,20,3,1,2,2,4,2,2,3,1,1,2
"8949",64048062,"Aria Barzegar","10/10/2002 (20 years old)","ST (C)","Naft MIS","Azadegan League","IRN","No","8/19/2022","6/30/2025","$10K - $110K","Right","Reasonable","Very Strong","6'2""","182 lbs","25","-",97,126,5,7,10,11,15,8,15,10,6,9,10,5,5,10,14,15,10,11,10,8,13,8,6,11,10,9,10,10,11,11,15,13,15,10,8,11,11,12,13,13,9,10,14,9,7,2,20,9,13,1,2,3,3,4,1,4,3,2,3,3
"8950",64039660,"Yasin Salmani","2/27/2002 (21 years old)","DM, M/AM (C)","Sepahan","Persian Gulf Premier League","IRN","No","6/13/2022","6/30/2026","$110K - $1.1M","Left","Very Strong","Strong","6'0""","165 lbs","48","7",108,126,6,6,10,13,8,1,8,11,6,10,13,7,14,13,15,10,9,10,4,14,8,13,11,11,9,13,8,13,13,11,11,6,11,13,14,6,15,17,11,13,8,12,9,7,9,5,12,10,8,2,3,3,3,1,2,3,3,2,1,2
"8951",58152189,"Ruslan Litvinov","8/18/2001 (21 years old)","D (C), DM","Spartak Moscow","Russian Premier League","RUS","No","2/7/2022","5/31/2026","$6.4M - $7.6M","Right","Reasonable","Very Strong","6'0""","160 lbs","85","8",124,149,7,6,10,8,11,10,12,12,2,12,13,12,12,12,16,14,16,14,16,12,13,5,12,8,12,14,11,15,12,12,12,12,12,13,16,10,13,14,16,14,13,15,10,7,10,1,15,13,16,2,3,3,3,3,2,2,1,3,2,3
"8952",2000247731,"Alireza Enayatzadeh","4/5/2004 (19 years old)","M (C)","Persepolis","Persian Gulf Premier League","IRN","No","7/1/2019","6/30/2026","$65K - $650K","Right","Reasonable","Very Strong","6'2""","169 lbs","-","-",96,126,9,9,8,9,15,9,9,10,1,11,15,5,8,13,5,9,9,7,9,14,2,8,10,11,9,8,14,10,9,13,10,11,13,12,10,5,13,14,12,10,14,11,6,13,5,7,9,13,7,1,3,2,3,1,4,3,1,3,3,2
"8953",23349097,"Milad Mohammadi","9/29/1993 (29 years old)","D/WB (L)","AEK","Greek Super League 1","IRN","No","9/17/2021","6/30/2024","$1.7M - $3.6M","Left","Very Strong","Fairly Strong","5'10""","174 lbs","209","5",120,125,9,12,11,8,11,8,10,10,13,11,11,8,13,11,12,11,12,10,13,9,10,10,6,11,11,12,10,14,14,15,12,9,13,14,13,11,14,11,12,13,10,12,5,9,8,7,9,13,13,1,3,3,3,2,1,1,2,2,2,1
"8954",2000122628,"Mohammad Reza Khaledabadi","4/30/2001 (22 years old)","GK","Havadar","Persian Gulf Premier League","IRN","No","9/6/2020","6/30/2027","$70K - $700K","Right","Reasonable","Very Strong","6'1""","167 lbs","17","-",102,125,2,1,2,2,5,4,1,1,1,3,9,3,2,1,14,9,13,9,9,14,12,3,10,3,13,9,8,5,11,12,9,10,13,14,1,6,11,18,10,13,8,10,6,3,9,6,12,9,19,11,12,14,10,8,12,14,5,8,9,14
"8955",23349118,"Mehrdad Mohammadi","9/29/1993 (29 years old)","AM (RL), ST (C)","Al-Sailiya","Qatar League","IRN","No","9/5/2022","6/30/2025","$1.2M - $12.5M","Left","Very Strong","Reasonable","5'10""","163 lbs","194","53",115,125,8,11,15,12,14,12,8,14,6,5,11,14,6,15,7,10,7,12,8,9,9,16,7,11,4,8,13,8,14,14,11,8,14,13,12,6,8,11,10,10,11,11,4,11,12,15,10,11,13,3,2,3,2,3,3,2,1,3,4,3
"8956",2000247730,"Mohammad Reza Torabi","7/18/2004 (18 years old)","DM, M (C)","Esteghlal","Persian Gulf Premier League","IRN","No","7/1/2022","6/30/2026","$80K - $800K","Right","Fairly Strong","Very Strong","6'0""","165 lbs","-","-",95,125,8,7,9,6,14,8,5,12,1,10,11,4,13,14,15,6,9,13,7,14,15,5,8,10,9,7,7,14,13,12,14,10,12,13,7,7,11,16,9,11,10,11,5,8,15,6,9,12,12,1,2,2,3,1,2,3,3,2,2,2
"8957",23340499,"Payam Niazmand","4/6/1995 (28 years old)","GK","PTM","Portuguese Premier League","IRN","No","7/12/2021","6/30/2024","$26K - $275K","Right","Reasonable","Very Strong","6'4""","185 lbs","147","-",120,125,4,1,2,3,10,5,3,2,2,1,11,2,1,8,15,15,11,11,13,12,19,1,12,3,13,13,12,12,9,11,12,17,12,10,11,13,11,10,11,14,10,10,9,8,8,3,13,14,5,13,14,13,10,13,12,14,7,11,13,17
"8958",23055737,"Karim Ansarifard","4/3/1990 (33 years old)","ST (C)","Omonoia","Cypriot First Division","IRN","No","8/30/2022","5/31/2024","$230K - $700K","Right","Fairly Strong","Very Strong","6'1""","171 lbs","394","138",115,125,5,8,12,13,12,8,12,9,5,6,11,14,7,13,13,13,15,13,12,12,14,13,11,13,7,9,11,12,11,12,13,12,12,12,12,13,8,9,12,14,14,11,8,13,8,11,13,14,13,2,3,3,1,1,3,3,1,2,3,2
"8959",23309136,"Ali Karimi","2/11/1994 (29 years old)","DM, M (C)","Kayserispor","Turkish Super League","IRN","No","7/8/2022","6/30/2024","$160K - $1.6M","Right","Reasonable","Very Strong","6'1""","167 lbs","188","14",110,125,8,9,10,7,13,11,12,13,6,10,15,7,13,12,16,13,10,13,12,13,11,10,9,10,12,12,12,14,9,9,10,13,11,12,11,13,10,15,10,12,13,13,15,10,17,4,12,12,10,2,2,1,2,2,3,1,2,1,2,1
"8960",23340580,"Omid Nourafkan","4/9/1997 (26 years old)","D (L), DM, M/AM (C)","Sepahan","Persian Gulf Premier League","IRN","No","1/30/2023","6/30/2026","$220K - $2.2M","Left","Very Strong","Reasonable","6'0""","171 lbs","164","20",116,125,13,13,11,10,12,13,12,14,8,11,13,11,12,14,16,13,8,14,13,12,13,10,15,10,12,16,14,13,10,11,13,13,12,10,14,12,14,10,11,14,13,15,11,14,8,11,12,14,6,1,1,2,2,2,3,1,3,3,1,3
"8961",23309575,"Mehdi Torabi","9/10/1994 (28 years old)","AM (RLC)","Persepolis","Persian Gulf Premier League","IRN","No","5/26/2022","6/30/2024","$130K - $1.3M","Right","Fairly Strong","Very Strong","5'11""","165 lbs","230","45",122,125,7,12,14,11,13,13,8,13,5,5,14,12,7,14,11,8,8,9,9,11,16,16,7,13,8,13,14,14,15,15,13,10,13,13,14,11,15,14,10,13,8,11,14,11,5,14,14,14,5,2,2,1,4,3,1,3,1,1,2,2
"8962",2000082330,"Daniil Khudyakov","1/9/2004 (19 years old)","GK","Lokomotiv Moscow","Russian Premier League","RUS","No","6/10/2021","6/30/2024","$1.1M - $11M","Right","Fairly Strong","Very Strong","6'4""","200 lbs","41","-",110,148,3,1,2,3,9,6,11,3,1,2,11,2,2,10,7,12,13,13,9,11,13,3,12,3,10,12,9,12,11,10,14,16,14,12,8,17,10,9,11,14,12,14,13,9,7,12,12,11,10,12,11,13,9,13,10,10,9,10,10,14
"8963",2000247735,"Alireza Safari Laksar","12/2/2003 (19 years old)","AM (L)","Saipa","Azadegan League","IRN","No","6/13/2022","6/30/2025","$30K - $300K","Right","Fairly Strong","Very Strong","6'0""","163 lbs","-","-",90,125,7,11,11,8,12,8,3,9,5,8,12,5,9,14,15,8,9,8,8,10,4,13,10,7,8,9,9,12,14,11,7,10,10,14,10,5,9,15,12,11,11,11,12,2,15,2,10,12,19,3,2,1,4,2,2,1,2,2,1,3
"8964",23034077,"Ehsan Hajsafi","2/25/1990 (33 years old)","D/WB (L), M (LC)","AEK","Greek Super League 1","IRN","No","5/10/2023","6/30/2024","$600K - $1.8M","Left","Very Strong","Weak","5'10""","178 lbs","458","57",120,125,13,13,10,8,12,12,9,13,16,11,13,10,11,12,12,12,12,13,13,12,14,12,12,11,11,14,12,14,12,14,13,9,15,11,13,10,16,15,13,16,12,15,6,15,6,6,15,12,13,3,3,2,2,2,3,2,2,3,1,3
"8965",2000034280,"Alireza Monazami","12/14/2002 (20 years old)","ST (C)","Naft MIS","Azadegan League","IRN","No","7/18/2022","6/30/2024","$30K - $300K","Right","Fairly Strong","Very Strong","5'11""","158 lbs","28","1",85,125,7,5,14,14,14,7,14,8,2,7,8,6,5,13,9,9,5,10,8,12,5,12,10,9,7,7,4,8,12,12,8,6,17,11,7,9,9,14,11,11,13,10,15,6,6,2,18,9,7,2,2,3,2,3,1,2,2,2,1,4
"8966",2000247662,"Mehran Feizabadi","2/21/2003 (20 years old)","D (C)","Esteghlal","Persian Gulf Premier League","IRN","No","7/7/2022","6/30/2026","$65K - $650K","Right","Reasonable","Very Strong","6'2""","171 lbs","-","-",100,125,4,2,7,4,12,8,13,8,6,13,12,6,17,11,9,13,11,14,11,11,14,6,8,11,9,11,11,10,13,13,12,13,12,13,9,7,15,13,10,11,13,12,5,12,9,5,10,8,7,2,3,3,3,2,2,3,2,4,1,2
"8967",2000112380,"Mohammad Omri","3/11/2000 (23 years old)","M (R), AM (RL)","Persepolis","Persian Gulf Premier League","IRN","No","8/1/2022","6/30/2027","$90K - $900K","Right","Fairly Strong","Very Strong","5'8""","145 lbs","29","4",103,125,7,11,13,9,13,7,7,8,1,7,9,6,7,13,6,9,4,9,8,9,15,13,3,11,7,8,8,11,13,12,13,6,13,13,13,6,15,19,12,11,13,12,12,5,13,2,13,10,10,3,3,1,2,2,2,1,3,2,1,2
"8968",2000103903,"Saman Fallah","12/1/2001 (21 years old)","D (C)","Paykan","Persian Gulf Premier League","IRN","No","7/1/2020","6/30/2027","$70K - $700K","Right","Fairly Strong","Very Strong","6'3""","180 lbs","56","3",110,125,6,4,3,7,16,4,12,7,11,12,16,4,16,11,9,9,12,10,9,13,7,7,14,11,16,11,9,12,8,12,12,17,16,9,9,9,12,13,14,8,9,11,12,6,6,6,20,10,19,2,3,4,3,2,2,1,3,2,1,2
"8969",2000192865,"Saeid Saharkhizan","6/26/2003 (19 years old)","ST (C)","Havadar","Persian Gulf Premier League","IRN","No","7/1/2022","6/30/2027","$0","Right","Fairly Strong","Very Strong","5'9""","149 lbs","7","3",102,124,8,9,12,13,13,10,14,10,3,7,11,4,6,12,15,13,12,10,11,13,5,9,4,12,11,15,10,12,9,10,13,9,12,13,13,6,11,15,11,14,9,12,14,7,12,8,15,11,7,2,1,2,2,2,1,3,1,3,1,3
"8970",2000244860,"Mojtaba Fakhrian","5/15/2003 (20 years old)","AM (R)","Aluminium Arak","Persian Gulf Premier League","IRN","No","7/1/2022","6/30/2026","$55K - $550K","Right","Reasonable","Very Strong","5'10""","147 lbs","3","-",94,124,7,10,13,8,13,7,5,11,7,4,10,1,7,13,7,7,9,8,7,13,10,12,12,12,7,8,9,12,13,13,5,8,14,13,9,3,13,20,9,11,8,10,7,18,6,7,13,12,9,1,3,3,1,1,3,3,3,3,2,3
"8971",2000192506,"Mohammad Javad Hosseinnejad","6/26/2003 (19 years old)","M/AM (C)","Sepahan","Persian Gulf Premier League","IRN","No","7/1/2020","6/30/2027","$130K - $1.3M","Left","Very Strong","Fairly Strong","5'11""","158 lbs","1","-",100,123,9,8,8,8,15,13,9,15,9,8,14,6,9,15,15,9,6,7,10,15,4,16,4,13,7,14,5,13,13,10,14,10,15,11,9,7,11,13,12,13,11,11,5,12,9,5,11,11,17,3,3,4,4,1,3,2,3,1,4,1
"8972",29224055,"Mohammed Reza Azadi","12/7/1999 (23 years old)","ST (C)","Aluminium Arak","Persian Gulf Premier League","IRN","No","2/14/2022","6/30/2027","$0","Right","Fairly Strong","Very Strong","6'2""","185 lbs","104","12",108,123,6,6,10,12,11,14,11,12,5,6,9,11,5,11,13,12,9,12,11,12,5,13,9,11,11,15,13,11,12,11,11,13,8,13,13,12,6,11,12,9,8,10,12,13,5,2,12,11,8,3,1,1,3,3,2,2,3,3,1,1
"8973",57178516,"Radu Drăguşin","2/3/2002 (21 years old)","D (RC)","Juventus","Italian Serie A","ROU","Yes","6/13/2022","6/30/2027","$6M - $9.2M","Right","Reasonable","Very Strong","6'3""","180 lbs","70","5",133,153,6,12,10,6,14,6,15,6,10,15,14,6,15,13,14,12,13,11,11,11,14,10,12,9,14,11,10,12,14,13,14,12,14,14,15,15,14,12,13,14,13,12,4,12,10,12,12,14,15,1,3,1,1,2,1,3,2,3,3,3
"8974",7545243,"Ciprian Tătăruşanu","2/9/1986 (37 years old)","GK","AC Milan","Italian Serie A","ROU","Yes","9/12/2020","6/30/2024","$4.5K - $45K","Right","Fairly Strong","Very Strong","6'6""","198 lbs","378","-",125,140,1,4,5,2,7,2,8,2,5,3,10,5,3,7,8,12,12,12,13,11,14,3,12,3,12,14,8,11,8,10,16,18,14,10,15,15,1,13,13,15,9,12,4,12,4,5,12,14,12,11,11,14,14,14,14,14,6,12,12,16
"8975",62035676,"Mirko Ivanovski","10/31/1989 (33 years old)","ST (C)","Concordia Chiajna","Romanian Second League","MKD","Yes","2/1/2023","6/30/2023","$0 - $10K","Right","Weak","Very Strong","6'0""","171 lbs","364","78",76,118,6,8,8,10,9,9,10,9,2,5,10,12,8,9,16,10,16,9,11,10,15,9,8,12,9,11,9,12,11,10,12,11,15,11,9,11,5,13,6,11,7,10,10,9,18,14,11,13,8,2,1,1,2,2,2,1,3,1,2,1
"8976",13160655,"Reinildo","1/21/1994 (29 years old)","D (LC), WB/AM (L)","A. Madrid","Spanish First Division","MOZ","No","1/31/2022","6/30/2025","$23M - $29M","Left Only","Very Strong","Weak","5'11""","149 lbs","167","6",147,152,8,14,14,8,13,9,13,8,9,13,13,7,14,13,14,14,14,13,15,13,16,9,6,13,12,16,12,17,16,13,9,12,14,15,16,13,14,11,12,17,14,12,4,13,10,7,15,14,17,2,2,4,3,2,3,3,3,2,2,4
"8977",95059117,"Geny","1/26/2001 (22 years old)","M/AM (RL)","Sporting CP","Portuguese Premier League","MOZ","No","9/1/2022","6/30/2026","$3.7M - $7.2M","Left Only","Very Strong","Weak","5'8""","143 lbs","55","5",120,136,11,12,15,11,13,11,8,11,7,6,12,11,7,14,10,12,10,12,9,9,12,15,6,12,8,10,12,12,15,15,13,8,12,14,12,8,15,10,9,14,13,14,8,5,6,8,10,13,11,3,3,2,2,4,3,1,3,1,1,2
"8978",12013851,"Mexer","9/8/1988 (34 years old)","D (C)","Estoril Praia","Portuguese Premier League","MOZ","No","8/24/2022","6/30/2024","$2.5K - $24K","Right","Weak","Very Strong","6'1""","176 lbs","366","11",106,136,5,6,7,6,11,10,14,10,9,13,10,10,13,11,15,12,13,11,12,10,13,6,12,10,12,12,8,12,9,11,14,14,11,10,11,14,9,13,13,15,12,16,12,13,9,4,12,13,13,1,3,1,2,2,3,2,1,4,3,2
"8979",13104485,"Zainadine Júnior","6/24/1988 (34 years old)","D (RC)","MRT","Portuguese Second League","MOZ","No","4/22/2022","6/30/2024","$35K - $110K","Right","Weak","Very Strong","5'10""","158 lbs","288","10",111,132,6,9,10,8,10,5,13,12,15,12,11,8,10,12,15,11,14,11,13,12,15,11,15,9,14,13,8,12,11,11,14,13,15,11,11,12,14,12,16,16,12,14,8,12,11,6,11,11,16,2,3,3,1,3,1,1,4,1,3,3
"8980",13192388,"Bruno Langa","10/31/1997 (25 years old)","D/WB/M (L)","Chaves","Portuguese Premier League","MOZ","No","6/23/2021","6/30/2025","$275K - $2.8M","Left Only","Very Strong","Weak","5'10""","160 lbs","139","11",122,130,8,11,15,8,12,7,7,8,11,8,10,7,11,13,11,13,12,8,11,9,14,15,8,12,11,12,12,13,16,15,12,6,15,16,14,10,13,10,10,14,13,11,5,13,12,5,12,13,12,3,3,3,1,4,2,3,1,3,1,4
"8981",13192334,"Luís Miquissone","7/25/1995 (27 years old)","AM (RLC), ST (C)","Al-Ahly","Egyptian Premier League","MOZ","No","8/1/2021","6/30/2025","$230K - $2.3M","Right","Strong","Very Strong","5'7""","134 lbs","95","36",110,130,8,10,11,12,8,8,9,10,7,8,10,9,8,11,6,10,9,12,8,10,14,11,3,11,9,7,10,12,15,12,13,4,14,13,12,1,14,14,12,14,11,13,5,9,15,1,12,11,15,3,1,2,3,1,2,1,2,1,2,1
"8982",83107368,"Guima","11/14/1995 (27 years old)","DM, M (C)","Chaves","Portuguese Premier League","MOZ","Yes","6/9/2023","6/30/2024","$220K - $2.2M","Right","Reasonable","Very Strong","5'11""","174 lbs","229","6",121,122,8,10,12,8,12,6,10,7,8,12,12,7,13,12,17,13,16,12,13,11,15,6,11,8,14,16,10,16,12,12,14,11,15,12,15,14,18,15,15,15,12,10,6,13,18,8,15,14,12,2,2,2,1,3,3,3,1,1,1,3
"8983",65037346,"Edmilson Dove","7/18/1994 (28 years old)","D (LC), WB (L)","Kaizer Chiefs","South African Premier Soccer League","MOZ","No","8/11/2022","6/30/2024","$40K - $425K","Left","Very Strong","Reasonable","5'11""","158 lbs","121","5",108,120,7,12,11,6,12,7,7,10,8,10,10,5,9,10,8,10,13,7,7,11,12,15,7,10,10,11,10,12,15,10,10,7,15,13,13,10,12,10,10,11,10,12,8,10,7,7,11,14,16,2,3,3,1,2,1,3,1,3,2,1
"8984",83103197,"Witi","8/26/1996 (26 years old)","D/WB/M (L), AM (RL)","Nacional da Madeira","Portuguese Second League","MOZ","Yes","5/14/2020","6/30/2024","$325K - $950K","Left Only","Very Strong","Weak","5'10""","145 lbs","175","8",109,120,11,11,13,12,12,10,7,10,10,7,10,10,8,11,8,11,10,13,9,9,12,17,6,10,10,10,11,8,14,13,10,6,14,14,13,6,15,13,8,12,11,14,3,11,3,5,9,12,13,2,3,1,3,2,1,2,1,3,4,2
"8985",57168149,"Valentin Mihăilă","2/2/2000 (23 years old)","AM (L)","Parma","Italian Serie B","ROU","Yes","10/5/2020","6/30/2025","$4.3M - $8.4M","Right","Strong","Very Strong","5'11""","143 lbs","125","21",120,140,6,11,13,11,12,8,7,10,3,6,11,5,6,13,7,10,8,9,9,11,13,14,6,11,5,10,12,12,15,14,11,7,10,15,13,8,12,15,13,14,11,12,14,11,5,5,11,13,10,4,4,3,2,1,2,3,2,3,3,2
"8986",55070953,"Pepo","3/24/1994 (29 years old)","M/AM (C)","Académica","Portuguese Third Division - South","MOZ","Yes","7/5/2022","6/30/2024","$0","Right Only","Weak","Very Strong","5'7""","149 lbs","243","24",105,118,14,10,12,8,13,14,4,12,5,6,14,13,7,14,7,9,9,13,12,13,14,17,11,13,10,13,14,12,12,14,12,5,11,12,11,6,11,14,11,12,9,13,5,12,6,7,12,14,12,3,3,3,2,1,3,2,3,3,1,2
"8987",65001691,"Dominguês","11/13/1983 (39 years old)","AM (RLC)","Royal AM","South African Premier Soccer League","MOZ","No","7/1/2021","6/30/2024","$1.5K - $14K","Right","Reasonable","Very Strong","5'8""","149 lbs","344","50",110,115,9,13,14,12,12,10,7,14,1,7,10,8,8,13,8,10,13,9,8,10,12,15,8,12,6,11,14,11,15,11,11,4,13,13,9,7,11,12,14,14,15,13,8,12,8,8,14,10,12,4,3,3,3,3,2,3,3,1,1,2
"8988",13117398,"Clésio","10/11/1994 (28 years old)","M (R), AM (RL)","FC Honka","Finnish Premier League","MOZ","No","2/28/2023","11/30/2024","$70K - $700K","Right","Reasonable","Very Strong","5'9""","138 lbs","183","15",96,115,8,10,10,6,8,6,11,8,8,4,7,9,6,9,13,10,12,8,8,7,9,16,6,13,6,8,7,12,16,14,10,8,16,14,13,7,14,16,13,14,8,13,7,8,4,6,10,10,10,1,2,2,1,4,2,1,3,3,2,3
"8989",2000181158,"Diego Luís","1/12/2004 (19 years old)","AM (RL)","Comércio Indústria","Portuguese Setúbal First Division","MOZ","No","7/1/2022","-","$0","Left","Very Strong","Reasonable","5'11""","141 lbs","2","-",55,114,4,7,12,6,12,4,1,5,4,3,9,1,5,11,12,3,6,3,5,6,12,12,10,11,4,5,6,9,12,10,10,9,15,12,11,2,10,15,12,12,11,12,10,16,5,8,10,11,18,3,1,1,3,2,1,1,3,1,2,1
"8990",55071849,"Reginaldo","6/4/1990 (33 years old)","AM (RL), ST (C)","KS Kastrioti","Albanian First Category","MOZ","No","1/31/2023","6/30/2024","$0","Right","Reasonable","Very Strong","5'8""","147 lbs","243","53",106,111,8,10,12,11,11,7,12,12,8,6,12,15,9,12,12,13,11,8,8,8,13,11,9,13,8,11,11,11,13,12,7,8,13,13,12,8,13,20,10,14,10,11,5,11,9,8,9,15,8,2,1,2,2,2,2,3,3,3,3,1
"8991",83137946,"Neymar","11/16/1997 (25 years old)","AM (RLC), ST (C)","UD Songo","Mozambican Premier Division","MOZ","No","2/15/2023","12/31/2023","$0 - $50K","Right","Weak","Very Strong","5'11""","158 lbs","82","5",86,111,10,10,13,8,11,8,7,8,3,4,11,4,4,12,6,7,7,11,6,12,9,10,8,10,8,13,12,9,12,12,11,10,13,11,12,10,8,11,11,14,9,9,6,11,5,6,11,12,11,1,4,3,1,3,3,1,2,2,1,2
"8992",92021348,"Boné Uaferro","1/4/1992 (31 years old)","D (C)","1. FC Saarbrücken","3. Liga","MOZ","Yes","6/2/2023","6/30/2024","$14K - $140K","Right","Reasonable","Very Strong","6'3""","194 lbs","302","9",96,110,4,4,5,4,7,2,12,8,5,11,11,6,12,9,15,11,10,9,8,11,11,7,15,6,13,9,11,10,9,8,11,14,12,9,9,12,17,13,13,13,13,12,14,15,10,6,15,12,6,3,1,3,1,2,1,3,1,4,1,1
"8993",65038898,"Jeitoso","4/5/1991 (32 years old)","D (LC)","Ferroviário de Maputo","Mozambican Premier Division","MOZ","No","1/15/2023","12/31/2023","$0 - $85K","Left","Very Strong","Weak","5'11""","160 lbs","75","3",105,110,5,12,6,4,9,2,7,6,9,15,9,4,15,9,9,10,10,9,13,15,8,5,11,6,11,9,9,10,13,13,10,11,12,12,11,12,12,11,12,10,10,12,12,12,11,2,10,12,18,2,1,3,3,2,4,1,3,3,3,2
"8994",2000083505,"Kimiss Zavala","5/8/2004 (19 years old)","GK","MRT B","Portugal Championship - Group A","MOZ","No","8/1/2022","6/30/2024","$0","Right Only","Weak","Very Strong","6'1""","160 lbs","3","-",62,110,4,3,3,1,1,7,1,1,2,1,8,1,2,1,9,5,10,4,8,13,12,1,5,3,12,6,5,5,8,13,6,10,13,11,1,5,9,16,9,13,10,12,11,9,7,3,15,12,14,12,8,11,5,10,8,13,5,10,5,12
"8995",2000058679,"Edson Mucuana","12/12/2003 (19 years old)","AM (RL)","Vilafranquense","Portuguese Lower Regional Divisions","MOZ","Yes","7/1/2020","-","$0","Right","Weak","Very Strong","5'9""","156 lbs","3","-",79,110,6,7,12,11,11,5,6,10,5,5,11,6,6,12,5,11,6,12,12,10,13,12,5,11,6,7,11,11,12,11,11,5,11,11,10,9,9,5,13,14,12,12,4,10,6,4,7,13,12,2,3,1,3,2,3,3,2,3,1,3
"8996",7549485,"Gabriel Torje","11/22/1989 (33 years old)","AM (RL)","Gençlerbirliği","Turkish 1. League","ROU","Yes","1/12/2023","6/30/2024","$90K - $275K","Right","Reasonable","Very Strong","5'6""","154 lbs","408","56",82,140,12,12,12,10,12,13,5,12,5,5,12,12,5,14,13,10,12,13,10,12,13,13,13,12,5,12,12,12,9,10,10,4,10,9,7,7,12,13,12,8,12,9,7,13,14,10,10,13,16,1,1,3,3,2,4,3,1,3,1,1
"8997",83185565,"Gildo","1/31/1995 (28 years old)","AM (RL)","Sp. Covilhã","Portuguese Third Division - South","MOZ","No","7/24/2022","6/30/2024","$60K - $180K","Left Only","Very Strong","Weak","5'7""","141 lbs","143","26",94,108,11,11,12,8,12,8,6,9,5,4,11,10,7,12,10,11,11,8,8,8,12,14,8,12,6,11,12,12,15,13,7,6,12,14,9,7,13,10,12,13,12,11,8,10,5,5,9,12,12,2,1,1,4,3,3,2,3,1,2,3
"8998",95060827,"Martinho","9/27/1999 (23 years old)","D (C)","Black Bulls","Mozambican Premier Division","MOZ","No","1/15/2022","12/31/2024","$3.5K - $35K","Left","Very Strong","Reasonable","6'0""","160 lbs","47","-",88,107,2,2,1,5,8,4,14,2,2,14,8,1,14,7,7,10,9,8,12,14,7,5,13,6,14,7,6,8,14,14,8,7,12,14,5,5,13,15,10,10,7,11,6,14,8,3,11,13,16,1,2,1,1,2,4,3,3,1,3,1
"8999",91157296,"David Malembana","10/11/1995 (27 years old)","D (C)","Lokomotiv Sofia","Bulgarian First League","MOZ","Yes","2/10/2022","6/30/2025","$26K - $250K","Right Only","Weak","Very Strong","6'5""","189 lbs","164","10",90,106,5,6,7,6,10,12,11,6,9,11,9,5,13,8,12,10,13,10,10,9,12,5,10,9,12,12,8,12,9,9,12,16,15,11,11,11,13,13,13,13,13,12,9,4,8,6,11,12,8,2,3,1,2,1,2,3,1,1,2,2
"9000",2000085079,"Dias Fumo","3/1/2002 (21 years old)","D (C)","Farense","Portuguese Premier League","MOZ","No","8/3/2021","6/30/2024","$7K - $70K","Right Only","Weak","Very Strong","6'3""","154 lbs","-","-",70,106,3,1,1,4,4,1,12,2,6,13,5,1,13,2,15,10,9,7,9,13,9,5,12,6,11,6,1,7,6,9,7,14,11,10,5,6,14,16,12,11,10,12,12,10,5,3,12,10,12,1,3,2,3,1,1,3,1,3,1,2
"9001",83335594,"Jeremias Nhambire","1/8/2000 (23 years old)","D/WB (R)","MRT B","Portugal Championship - Group A","MOZ","No","7/1/2022","6/30/2024","$0","Right Only","Weak","Very Strong","5'10""","152 lbs","3","-",72,105,5,11,6,5,8,1,4,3,6,8,7,1,12,8,9,6,9,6,11,10,15,5,11,6,8,7,7,6,13,13,7,7,13,13,11,4,19,14,12,13,12,15,7,2,9,5,20,10,9,4,2,3,4,3,2,3,3,1,2,1
"9002",2000083523,"Dércio Augusto","3/14/2002 (21 years old)","M (C)","Leixões","Portuguese Second League","MOZ","No","7/1/2022","7/24/2023","$0","Right Only","Weak","Very Strong","5'10""","156 lbs","31","6",70,103,5,3,4,4,10,7,4,9,1,9,13,4,6,10,9,8,7,7,8,12,8,5,8,9,7,8,14,9,14,14,8,8,15,13,5,7,14,11,9,12,10,11,8,5,7,4,9,12,14,4,2,2,1,1,1,3,1,2,4,3
"9003",224263,"Pablo Bechardas","5/17/2002 (21 years old)","AM (RL)","MRT","Portuguese Second League","MOZ","No","7/1/2021","6/30/2026","$0","Right","Reasonable","Very Strong","5'10""","143 lbs","5","-",79,102,8,13,11,9,11,4,8,6,7,7,13,1,7,10,5,11,3,9,9,12,3,9,14,9,8,8,8,8,8,11,8,7,9,12,10,5,17,17,12,11,10,13,12,1,8,2,16,11,14,3,1,2,3,1,2,3,3,4,3,2
"9004",2000188731,"Momed Ferreira","10/2/2003 (19 years old)","AM (RL)","Liga Desportiva","Mozambican Lower Division","MOZ","No","1/5/2022","12/31/2023","$1.5K - $14K","Right","Weak","Very Strong","5'11""","163 lbs","7","1",81,102,8,10,12,8,10,5,6,8,6,5,9,8,6,10,8,9,8,7,8,8,11,14,4,9,7,10,9,11,14,13,12,9,15,13,8,9,16,15,14,14,10,10,5,8,5,6,9,14,12,3,1,1,3,1,3,1,2,2,3,1
"9005",95055574,"Kamo-Kamo","7/19/1999 (23 years old)","AM (L), ST (C)","Vit. Setúbal","Portugal Championship - Group D","MOZ","No","7/1/2019","6/30/2025","$0 - $50K","Left Only","Very Strong","Weak","5'7""","143 lbs","59","14",86,100,5,10,12,10,11,6,7,8,10,4,9,11,4,12,11,7,9,8,9,9,10,10,7,10,5,7,8,8,14,12,10,6,18,13,13,8,10,13,13,13,11,10,8,8,5,6,14,11,20,3,1,2,2,1,4,3,3,2,3,3
"9006",95055576,"Ernan Siluane","9/7/1998 (24 years old)","GK","UD Songo","Mozambican Premier Division","MOZ","No","1/15/2022","12/31/2023","$0 - $35K","Right Only","Weak","Very Strong","6'1""","165 lbs","41","-",85,100,3,2,1,1,1,6,1,1,3,3,10,3,3,6,15,11,15,7,7,8,9,3,1,3,7,8,7,7,13,12,8,9,17,11,3,7,11,11,10,9,9,12,15,11,5,5,10,12,12,10,5,10,9,12,14,14,5,12,14,13
"9007",57122678,"Ianis Hagi","10/22/1998 (24 years old)","AM (RLC)","Rangers","cinch Premiership","ROU","Yes","12/15/2022","5/31/2025","$7.8M - $11.5M","Either","Very Strong","Very Strong","6'0""","158 lbs","162","34",125,139,16,16,13,13,15,17,6,15,5,7,15,14,5,16,9,13,12,12,13,10,13,14,13,12,8,13,14,14,9,11,12,8,14,9,12,10,12,12,14,14,15,12,5,15,10,8,11,15,15,2,1,3,4,2,3,2,3,1,4,2
"9008",95055357,"Raúl","5/4/1997 (26 years old)","M/AM (RL)","Ferroviário de Nacala","Mozambican Premier Division","MOZ","No","1/5/2022","12/31/2024","$26K - $80K","Left","Very Strong","Reasonable","5'4""","145 lbs","88","9",85,100,9,12,14,9,13,6,7,6,5,6,13,2,7,14,5,9,6,8,6,9,9,13,6,9,7,8,8,10,13,13,9,3,5,12,7,1,11,11,11,9,10,14,12,10,13,8,11,10,8,1,2,3,4,1,1,1,2,3,2,2
"9009",95059118,"Fidel Sousa","9/5/1999 (23 years old)","D/WB (R)","Black Bulls","Mozambican Premier Division","MOZ","No","1/15/2022","12/31/2023","$0 - $50K","Right Only","Weak","Very Strong","5'7""","152 lbs","36","6",80,100,3,9,9,4,10,2,7,6,8,10,10,5,10,8,7,10,10,7,10,12,7,10,3,8,7,9,7,10,15,15,9,5,12,15,8,7,18,13,12,11,11,11,9,12,5,1,10,11,18,3,3,3,1,2,1,2,3,2,2,4
"9010",95059116,"Abel Jochua","7/12/2000 (22 years old)","M/AM (C)","Salgueiros","Portugal Championship - Group B","MOZ","No","7/1/2022","6/30/2025","$0 - $85K","Right Only","Weak","Very Strong","5'8""","141 lbs","28","4",81,100,8,10,12,8,11,4,7,7,4,8,11,6,10,13,8,9,12,11,7,9,13,9,6,9,7,11,11,12,12,12,11,5,15,13,12,7,13,11,11,9,12,12,6,8,9,6,12,11,12,2,2,2,4,1,1,2,2,1,3,3
"9011",13199947,"Victor Guambe","10/8/1998 (24 years old)","GK","Costa do Sol","Mozambican Premier Division","MOZ","No","1/15/2022","12/31/2023","$1K - $9K","Right Only","Weak","Very Strong","5'11""","152 lbs","68","-",80,100,2,2,2,2,1,3,1,1,1,3,7,1,3,4,7,9,15,8,8,6,10,2,6,2,11,8,7,7,13,9,8,11,9,12,7,7,12,14,12,12,12,10,6,3,10,2,17,10,14,11,9,14,15,7,14,14,7,7,8,14
"9012",92056545,"Ronny Marcos","10/1/1993 (29 years old)","D/WB/M (L)","Offenbach","German Regional Division Southwest","MOZ","Yes","1/22/2021","6/30/2025","$85K - $250K","Left Only","Very Strong","Weak","5'9""","158 lbs","259","5",95,99,7,6,11,5,9,6,6,5,12,10,12,6,10,9,14,9,11,7,9,7,13,10,9,10,8,10,7,13,15,13,11,8,17,14,13,8,8,14,10,12,10,11,4,11,10,4,8,12,12,2,4,1,2,2,2,1,1,2,2,3
"9013",13198627,"Mapangane","12/12/1998 (24 years old)","DM, M (C)","Ferroviário de Maputo","Mozambican Premier Division","MOZ","No","7/1/2020","12/31/2024","$2K - $18K","Right Only","Weak","Very Strong","5'6""","132 lbs","67","-",81,99,7,5,6,7,10,7,7,9,3,9,10,3,14,10,12,9,6,9,9,13,3,5,13,8,10,8,8,11,14,14,8,5,6,14,8,2,13,14,9,11,10,10,9,4,5,5,9,11,20,3,1,1,2,3,2,1,1,3,3,3
"9014",95055570,"Júlio Franque","11/29/1996 (26 years old)","GK","Ferroviário de Maputo","Mozambican Premier Division","MOZ","No","1/15/2022","12/31/2023","$0 - $24K","Right Only","Weak","Very Strong","5'11""","171 lbs","56","-",82,99,2,1,3,1,6,4,1,1,1,3,8,3,3,5,10,6,11,7,7,14,9,2,11,3,10,8,7,7,12,11,5,11,12,10,2,7,12,13,9,11,10,10,6,7,13,4,11,11,16,10,14,13,5,10,10,14,10,8,8,10
"9015",95055569,"Mário","12/23/1998 (24 years old)","ST (C)","Ferroviário de Maputo","Mozambican Premier Division","MOZ","No","1/15/2022","12/31/2023","$12K - $35K","Right","Weak","Very Strong","5'6""","145 lbs","76","13",84,99,9,6,10,16,10,8,11,11,3,7,12,6,7,8,11,10,9,9,8,14,1,7,14,15,10,11,11,11,9,11,15,7,11,7,7,3,11,19,11,11,13,12,9,5,12,8,10,10,8,1,2,1,3,1,3,2,3,3,3,1
"9016",95059115,"Jesus","2/28/1999 (24 years old)","M/AM (L)","Black Bulls","Mozambican Premier Division","MOZ","No","1/15/2022","12/31/2023","$1K - $9K","Left","Very Strong","Reasonable","5'11""","167 lbs","27","9",80,99,7,10,9,10,13,6,6,7,6,6,10,2,7,12,12,8,8,7,8,9,17,12,10,13,7,8,5,8,13,13,8,9,11,13,13,8,13,19,11,11,12,11,10,7,10,4,9,11,14,1,2,3,4,3,2,1,2,3,3,1
"9017",95055921,"Chamboco","6/15/1998 (24 years old)","D (RC)","Black Bulls","Mozambican Premier Division","MOZ","No","1/15/2022","12/31/2024","$18K - $50K","Right Only","Weak","Very Strong","5'11""","152 lbs","47","-",80,99,6,11,4,3,9,6,10,3,2,14,8,1,10,4,5,7,9,8,9,13,13,6,13,6,11,7,5,8,14,14,8,6,14,14,13,10,14,11,12,10,13,11,5,10,13,2,7,11,12,2,2,1,2,2,3,2,1,3,3,1
"9018",57151131,"Olimpiu Moruţan","4/25/1999 (24 years old)","M (C), AM (RC)","Galatasaray","Turkish Super League","ROU","Yes","8/25/2021","6/30/2026","$900K - $5.8M","Left","Very Strong","Reasonable","5'8""","156 lbs","221","24",125,139,11,11,15,11,14,11,6,14,7,6,14,12,9,16,9,11,12,13,10,11,15,16,8,12,8,12,15,14,13,15,12,5,12,12,12,7,13,12,15,14,11,13,2,10,8,8,13,18,12,1,2,2,1,1,3,2,1,3,2,3
"9019",95059143,"Ivan Urrubal","1/3/1997 (26 years old)","GK","Black Bulls","Mozambican Premier Division","MOZ","No","1/15/2022","12/31/2023","$500 - $6K","Right Only","Weak","Very Strong","6'0""","185 lbs","36","-",80,99,5,2,3,1,5,9,1,3,3,1,5,3,2,1,5,12,14,5,7,13,5,2,7,2,7,7,6,6,12,13,7,10,13,10,6,9,8,12,12,14,11,12,10,5,6,2,8,12,17,6,7,11,11,6,10,9,5,6,8,13
"9020",95055754,"Salas","2/27/1998 (25 years old)","M/AM (RL)","Ferroviário de Nampula","Mozambican Premier Division","MOZ","No","1/15/2022","12/31/2023","$0 - $26K","Right","Reasonable","Very Strong","5'5""","132 lbs","42","13",80,99,4,9,10,8,13,6,6,7,6,6,11,1,7,13,12,11,6,9,6,10,17,13,13,9,4,7,4,8,13,13,7,3,16,13,11,1,13,20,13,13,11,11,7,7,7,5,11,13,19,3,2,3,1,3,4,2,1,1,1,3
"9021",95059142,"Melque","6/26/1997 (25 years old)","AM (R), ST (C)","Black Bulls","Mozambican Premier Division","MOZ","No","1/15/2022","12/31/2023","$0 - $26K","Right","Fairly Strong","Very Strong","5'8""","145 lbs","35","15",81,99,8,9,8,14,14,8,10,10,5,7,11,8,4,9,5,12,7,10,9,12,13,7,15,11,8,14,10,10,10,10,15,6,8,8,10,7,9,14,10,8,13,10,9,12,8,7,20,10,16,3,4,2,2,1,3,1,2,1,3,2
"9022",13192335,"Kambala","8/21/1991 (31 years old)","DM, M (C)","Magesi FC","South African National First Division Championship","MOZ","No","1/1/2023","6/30/2024","$1.5K - $14K","Right Only","Weak","Very Strong","6'0""","176 lbs","148","9",90,98,9,8,5,8,10,9,7,7,1,15,15,9,13,15,5,11,6,11,10,15,12,5,10,10,12,10,14,14,8,11,10,9,12,9,9,8,13,20,12,10,9,10,10,11,5,8,15,9,17,2,3,1,3,1,1,3,1,1,3,4
"9023",2000083604,"Foia","4/15/2001 (22 years old)","D (C)","Ferroviário da Beira","Mozambican Premier Division","MOZ","No","1/15/2022","12/31/2023","$0 - $45K","Right Only","Weak","Very Strong","6'0""","169 lbs","17","1",78,98,3,1,2,6,7,4,13,6,1,13,7,4,13,5,12,12,9,7,6,12,13,5,1,5,13,6,4,7,13,11,7,8,11,8,4,7,9,19,11,11,12,11,15,12,8,5,14,11,18,4,1,1,3,3,1,2,2,2,2,1
"9024",95060955,"Yude","6/19/1997 (25 years old)","M/AM (C)","Ferroviário de Maputo","Mozambican Premier Division","MOZ","No","1/15/2023","12/31/2023","$1K - $10K","Right","Weak","Very Strong","5'6""","132 lbs","60","2",82,98,7,5,9,12,14,7,4,9,7,8,14,5,9,9,10,9,6,10,8,9,16,9,6,13,9,8,11,12,14,10,8,1,13,13,7,5,14,12,11,11,10,12,14,7,8,5,12,10,10,1,1,1,1,1,3,3,1,4,1,2
"9025",2000131991,"Nazir Inusso","6/26/2000 (22 years old)","DM, M (C)","Ferroviário de Nacala","Mozambican Premier Division","MOZ","No","2/1/2023","12/31/2023","$2K - $18K","Left","Very Strong","Weak","5'7""","154 lbs","27","-",78,98,4,7,6,4,14,7,3,10,4,12,10,1,12,13,10,7,8,9,9,14,10,5,11,9,6,8,10,13,13,11,8,6,8,11,8,2,16,20,12,12,12,12,13,10,6,6,13,11,16,2,3,3,3,1,2,1,2,1,3,3
"9026",2000084222,"Mairoce","10/10/1998 (24 years old)","D (C)","Ferroviário de Nampula","Mozambican Premier Division","MOZ","No","2/1/2023","12/31/2023","$0 - $18K","Right Only","Weak","Very Strong","5'10""","160 lbs","12","-",78,98,5,1,1,1,7,2,13,1,2,14,3,2,14,7,9,10,9,7,8,13,8,5,9,4,10,6,1,8,13,13,7,5,12,13,10,10,12,10,11,11,10,11,11,10,6,7,10,11,7,1,1,1,1,1,1,2,1,2,3,1
"9027",2000084230,"Dilson Fumo","8/6/1998 (24 years old)","AM (RL), ST (C)","Ferroviário de Nacala","Mozambican Premier Division","MOZ","No","2/1/2023","12/31/2023","$0 - $26K","Left","Very Strong","Reasonable","5'7""","143 lbs","22","4",78,98,6,10,9,14,10,4,10,8,8,8,11,6,9,11,7,8,4,14,6,15,4,9,13,13,8,14,11,10,10,10,15,7,14,8,10,3,9,12,9,9,10,9,8,17,7,7,13,9,13,2,3,3,1,3,3,3,1,1,1,2
"9028",2000083608,"Neo","8/27/2000 (22 years old)","D (C)","Ferroviário de Nampula","Mozambican Premier Division","MOZ","No","2/1/2023","12/31/2023","$0 - $40K","Right Only","Weak","Very Strong","5'11""","149 lbs","5","-",78,98,3,2,2,2,6,1,11,3,2,13,7,1,13,6,12,13,9,7,8,13,15,5,12,6,13,6,5,7,8,13,7,8,13,10,10,5,11,14,10,10,10,11,13,1,8,3,20,12,14,3,1,4,1,1,3,3,1,3,3,3
"9029",57175882,"Louis Munteanu","6/16/2002 (20 years old)","AM (RL), ST (C)","Fiorentina","Italian Serie A","ROU","Yes","9/26/2020","6/30/2025","$250K - $2.6M","Right","Reasonable","Very Strong","6'0""","169 lbs","49","13",118,138,8,9,11,14,11,10,11,11,5,6,11,13,8,13,7,13,10,13,12,11,12,13,6,13,9,12,12,12,13,13,13,12,12,13,12,12,11,12,12,12,10,10,9,10,5,7,11,11,8,2,1,1,3,3,2,3,1,2,2,3
"9030",95056346,"Lau King","4/9/1995 (28 years old)","AM (R), ST (C)","Sagrada Esperança","Angolan Championship","MOZ","No","1/9/2023","5/31/2024","$24K - $240K","Right","Weak","Very Strong","6'2""","171 lbs","84","35",93,98,5,7,12,12,11,4,12,8,5,7,10,9,5,11,11,9,10,13,7,7,13,10,6,13,6,9,11,11,12,12,8,14,13,13,11,10,10,14,10,11,11,13,7,12,10,1,18,11,12,3,1,1,2,2,1,1,3,1,3,3
"9031",18026085,"Victor Wanyama","6/25/1991 (31 years old)","DM, M (C)","CF Montréal","Major League Soccer","KEN","No","1/6/2023","12/31/2024","Not for Sale","Right","Weak","Very Strong","6'0""","191 lbs","364","27",128,152,7,10,11,9,13,8,15,10,8,13,13,10,17,13,17,14,18,12,12,12,18,9,14,12,15,16,10,14,11,11,12,11,13,11,11,17,10,14,14,15,16,9,14,15,12,11,13,17,16,2,3,2,3,1,1,2,3,1,3,2
"9032",13164726,"Michael Olunga","3/26/1994 (29 years old)","ST (C)","Al-Duhail","Qatar Stars League","KEN","No","1/6/2021","5/31/2024","$8.2M - $12.5M","Left","Very Strong","Fairly Strong","6'3""","180 lbs","259","160",135,140,8,9,9,15,13,10,14,13,9,5,10,14,5,12,13,13,13,14,12,12,12,12,10,15,7,13,11,13,13,11,14,15,13,14,14,15,8,12,11,11,11,5,8,11,5,6,14,13,13,1,1,1,2,3,2,2,1,3,2,4
"9033",20046877,"Joseph Okumu","5/26/1997 (26 years old)","D (C)","AA Gent","Jupiler Pro League","KEN","No","7/1/2021","6/30/2025","$13M - $15.5M","Right","Reasonable","Very Strong","6'4""","165 lbs","123","2",130,140,6,13,8,6,12,8,13,8,8,13,13,6,13,12,15,13,14,13,13,13,15,9,10,10,13,12,14,12,13,11,14,17,14,13,13,14,4,11,12,14,14,10,5,11,12,5,14,14,14,3,3,2,2,3,1,3,1,3,2,1
"9034",13177967,"Erick Otieno","9/27/1996 (26 years old)","D/WB/M (L)","AIK","Swedish Premier Division","KEN","No","12/1/2019","12/31/2024","$75K - $750K","Left Only","Very Strong","Weak","5'7""","165 lbs","103","5",116,132,7,10,11,7,11,7,9,7,11,10,10,7,11,11,12,10,13,11,11,11,13,10,8,13,10,12,9,12,17,14,10,6,14,16,15,10,12,9,9,13,13,8,12,13,8,5,12,13,15,3,1,2,3,2,2,2,3,3,1,2
"9035",29161007,"Clarke Oduor","6/25/1999 (23 years old)","M (LC), AM (RL)","Barnsley","Sky Bet League One","KEN","No","8/8/2019","6/30/2026","$6K - $65K","Left","Very Strong","Weak","5'10""","154 lbs","60","2",93,130,11,11,12,8,10,10,8,6,7,7,11,9,9,10,8,8,7,11,9,9,11,11,4,11,9,10,10,12,13,12,11,9,12,13,12,8,12,12,11,11,11,10,4,10,3,4,10,12,14,3,2,2,1,1,3,3,4,3,2,2
"9036",12093322,"Lewis Bandi","12/1/2002 (20 years old)","D (RL)","AFC Leopards","Kenyan Premier Division","KEN","No","7/1/2020","6/30/2025","$0 - $50K","Right","Strong","Very Strong","5'10""","158 lbs","-","-",82,129,5,10,6,6,12,1,6,7,7,9,9,3,14,9,11,9,9,4,9,13,11,5,2,6,9,9,9,9,13,12,9,5,8,11,6,6,11,16,11,11,11,9,5,1,5,1,18,10,15,2,1,1,2,3,2,4,2,3,2,4
"9037",27119383,"Daniel Anyembe","7/22/1998 (24 years old)","D (RC), WB (R)","Viborg FF","3F Superliga","KEN","Yes","7/17/2021","6/30/2024","$70K - $700K","Right","Reasonable","Very Strong","6'2""","167 lbs","143","1",114,128,7,11,11,6,11,6,11,5,9,12,10,7,12,9,15,12,14,11,12,11,10,7,9,12,12,13,11,13,14,10,11,14,10,15,12,13,10,11,11,13,13,15,10,10,5,1,11,9,18,2,1,3,1,2,2,4,3,1,3,1
"9038",2000076953,"Philip Mayaka","11/20/2000 (22 years old)","DM, M (C)","Charlotte FC","Major League Soccer","KEN","No","1/4/2023","12/31/2023","$1.3M - $2.8M","Right","Reasonable","Very Strong","5'7""","136 lbs","46","3",97,125,8,7,8,7,9,7,7,9,6,10,12,5,12,11,16,10,12,11,12,11,7,5,12,9,12,13,10,13,12,13,11,7,10,12,14,7,5,10,12,8,9,10,8,14,14,9,10,8,12,1,1,1,1,1,9,1,1,1,1,6
"9039",2000013776,"Richard Odada","11/25/2000 (22 years old)","DM, M (C)","Philadelphia","Major League Soccer","KEN","No","8/2/2022","12/31/2024","$190K - $1.9M","Right","Fairly Strong","Very Strong","6'3""","180 lbs","62","-",107,125,10,10,11,10,12,7,11,11,5,9,12,6,11,12,13,11,10,11,11,11,11,10,8,13,12,12,11,13,10,11,12,14,13,11,13,14,8,11,11,11,9,10,8,11,10,4,8,13,13,4,2,3,3,1,1,3,1,3,4,2
"9040",2000094552,"Adrian Mazilu","9/13/2005 (17 years old)","AM (RL)","Farul Constanţa","Romanian First League","ROU","Yes","6/13/2022","6/30/2025","$700K - $6.8M","Left","Very Strong","Weak","6'1""","158 lbs","26","6",107,137,10,11,13,12,13,10,10,11,5,7,12,10,8,12,9,9,8,10,8,8,14,13,5,13,7,11,12,11,15,14,12,9,13,14,9,9,14,15,14,14,13,12,2,10,5,2,10,14,13,3,3,1,2,2,2,1,2,2,2,3
"9041",12093317,"Timothy Noor Ouma","6/10/2004 (19 years old)","M (C), AM (RLC)","IF Elfsborg","Swedish Premier Division","KEN","No","1/1/2022","12/31/2026","$300K - $900K","Right","Weak","Very Strong","6'0""","165 lbs","1","-",85,124,7,8,10,7,10,8,7,8,6,7,9,8,8,10,9,8,9,9,9,9,12,8,5,9,8,9,9,9,13,12,12,10,14,13,12,12,7,10,10,10,10,10,5,3,6,5,10,13,12,3,1,3,2,3,4,3,1,1,2,1
"9042",18032483,"Ayub Masika","9/10/1992 (30 years old)","M (R), AM (RL), ST (C)","NJ City","Chinese National First Division","KEN","Yes","3/13/2023","12/31/2023","$55K - $550K","Right Only","Weak","Very Strong","5'7""","145 lbs","178","38",116,121,7,12,13,10,13,8,5,8,6,6,12,9,10,14,14,12,14,11,11,11,14,9,3,12,5,9,10,12,15,14,6,6,11,15,10,5,16,11,9,11,10,12,18,8,5,6,10,14,12,1,1,3,1,3,1,3,4,3,3,3
"9043",12092701,"Collins Sichenje","9/19/2003 (19 years old)","D (C), DM, M (C)","KuPS","Finnish Premier League","KEN","No","3/31/2022","12/31/2026","$650K - $1.4M","Right","Weak","Very Strong","6'2""","187 lbs","15","-",100,120,6,9,6,6,8,7,11,8,8,11,7,7,12,9,18,11,14,12,12,10,13,8,8,10,9,10,9,11,12,11,14,10,12,13,13,14,7,10,10,12,12,9,5,3,11,5,11,12,12,3,3,2,2,1,3,1,2,3,2,3
"9044",65039786,"Masoud Juma","2/3/1996 (27 years old)","ST (C)","Al-Faisaly (KSA)","Saudi First Division League","KEN","No","7/1/2020","6/30/2024","$0","Right","Reasonable","Very Strong","6'1""","180 lbs","167","81",105,120,7,7,12,14,9,7,12,11,6,6,8,12,7,11,9,9,12,10,9,8,13,12,8,8,5,8,8,12,14,12,8,12,12,15,15,13,8,10,12,12,8,8,8,11,8,5,11,12,9,3,1,2,2,2,2,1,2,1,1,1
"9045",12087304,"Maxwell Mulili","6/27/2002 (20 years old)","GK","AFC Leopards","Kenyan Premier Division","KEN","No","7/4/2022","7/31/2025","$0 - $45K","Right","Reasonable","Very Strong","6'4""","176 lbs","-","-",70,117,1,1,1,3,2,4,1,1,1,2,8,3,1,1,5,8,11,6,11,12,3,1,4,1,8,6,5,5,9,13,5,9,14,9,3,5,11,14,15,11,10,12,8,11,11,6,12,13,16,6,11,12,12,6,8,12,6,7,8,10
"9046",12093092,"Bixente Otieno","9/21/2002 (20 years old)","GK","Muhoroni","Kenyan Premier Division","KEN","No","7/1/2019","6/30/2025","$0 - $65K","Right","Fairly Strong","Very Strong","5'7""","149 lbs","-","-",83,116,3,2,2,2,6,5,1,3,3,3,9,3,3,3,8,5,10,5,10,13,10,1,5,2,5,7,6,6,11,15,7,4,9,12,1,2,12,12,10,12,14,12,7,15,8,2,11,11,19,6,7,13,6,7,7,13,5,12,13,8
"9047",18115735,"Wilkims Ochieng","2/15/2003 (20 years old)","AM (RL)","Koper","Slovenian First League","KEN","Yes","1/4/2023","6/30/2026","$5K - $50K","Left Only","Very Strong","Weak","5'9""","156 lbs","22","-",90,116,10,12,12,8,7,5,10,8,8,7,11,3,7,12,9,9,6,9,6,12,2,9,9,16,10,11,9,12,14,12,8,7,7,16,5,8,11,17,11,11,11,12,11,7,5,8,14,11,9,2,3,4,1,3,3,3,1,2,1,1
"9048",93126967,"Anthony Wambani","8/7/1999 (23 years old)","D (C), DM, M (C)","Vasalunds IF","Swedish First Division North","KEN","Yes","6/15/2020","12/31/2023","$1K - $12K","Right","Weak","Very Strong","6'0""","176 lbs","121","15",83,116,6,9,6,7,9,6,10,7,7,10,10,6,11,10,13,11,12,10,11,10,13,6,6,11,11,12,9,12,11,10,12,11,12,10,12,13,12,9,10,12,12,10,5,11,13,7,12,12,12,1,1,1,2,3,1,2,1,3,4,3
"9049",13217607,"Joash Onyango","1/31/1993 (30 years old)","D (C)","Simba","Tanzanian Mainland Premier Division","KEN","No","8/10/2020","6/30/2025","$24K - $240K","Right","Reasonable","Very Strong","5'10""","165 lbs","154","2",105,115,3,5,6,5,8,6,15,5,4,13,11,7,13,11,16,13,12,13,11,12,11,5,12,10,12,11,9,11,12,12,13,11,13,14,12,12,9,20,10,9,9,11,5,14,11,8,10,11,13,4,1,1,1,2,2,3,1,2,2,2
"9050",12093043,"Henry Atola","12/21/2001 (21 years old)","AM (L), ST (C)","Norrby IF","Swedish First Division South","KEN","No","9/3/2021","9/1/2026","$18K - $190K","Right","Weak","Very Strong","6'0""","171 lbs","14","1",87,115,7,8,10,11,11,8,11,9,6,6,9,11,7,12,10,10,11,10,10,10,13,10,8,11,8,9,10,9,12,10,11,12,12,12,12,11,8,10,10,12,12,10,7,4,9,5,10,12,12,2,4,1,1,3,4,4,1,3,2,1
"9051",43134973,"Ionuţ Radu","5/28/1997 (26 years old)","GK","AJ Auxerre","Ligue 2 BKT","ROU","Yes","7/8/2022","6/30/2025","$1.5M - $3.2M","Right","Reasonable","Very Strong","6'2""","154 lbs","102","-",125,136,1,3,2,3,8,3,5,3,3,2,9,8,3,10,10,13,12,11,9,9,13,2,11,5,13,14,12,13,13,13,15,14,14,13,15,12,3,9,15,16,10,12,9,10,5,5,12,13,12,14,13,16,13,13,14,14,8,12,13,12
"9052",13117376,"Brian Onyango","7/24/1994 (28 years old)","D (C)","Sundowns","South African Premier Soccer League","KEN","No","7/1/2020","6/30/2024","$0 - $45K","Right","Weak","Very Strong","5'11""","167 lbs","234","15",110,115,5,4,5,9,11,4,15,9,2,11,10,9,11,8,8,13,12,11,11,14,6,5,13,9,15,6,10,11,13,12,11,10,10,11,9,9,14,19,9,10,11,12,6,10,8,4,7,12,16,2,2,2,3,3,2,2,1,1,2,1
"9053",18027756,"Johanna Omolo","7/31/1988 (34 years old)","DM, M (C)","URSL Visé","Belgian First National Amateur Division","KEN","Yes","10/3/2022","6/30/2024","$0","Right","Reasonable","Very Strong","5'10""","160 lbs","346","29",85,115,7,8,11,7,11,8,9,7,8,9,9,7,11,10,10,9,12,10,10,9,12,8,8,9,10,14,8,13,12,12,12,10,12,11,14,12,18,15,10,11,10,12,8,10,10,5,10,15,15,2,1,2,2,1,1,2,3,4,3,1
"9054",12093486,"Austin Odhiambo","12/16/1999 (23 years old)","M (C)","Gor Mahia","Kenyan Premier Division","KEN","No","7/1/2021","6/30/2023","$0 - $26K","Right","Strong","Very Strong","5'9""","152 lbs","-","-",84,115,6,6,6,4,13,6,4,8,1,10,10,2,8,12,6,9,8,13,5,13,13,5,10,8,8,7,13,12,13,13,5,6,9,11,7,5,15,19,12,12,10,12,12,7,6,5,13,11,12,1,4,2,2,2,1,2,3,3,3,3
"9055",93102574,"Eric Johana Omondi","8/18/1994 (28 years old)","AM (RL), ST (C)","Muangthong Utd","Thai League","KEN","No","7/22/2022","6/30/2025","$95K - $950K","Right","Reasonable","Very Strong","6'1""","165 lbs","219","48",98,114,5,8,12,11,11,6,8,7,5,5,8,6,8,11,13,10,8,11,10,10,11,11,4,12,5,9,8,10,14,12,11,12,13,14,13,8,5,10,10,10,10,7,6,6,12,7,9,12,12,1,2,1,2,1,3,2,2,1,3,3
"9056",59117870,"Alwyn Luheni Tera","1/18/1997 (26 years old)","D (R), DM","Ararat-Armenia","Armenian High League","KEN","No","7/1/2021","6/30/2024","$14K - $140K","Right","Reasonable","Very Strong","5'11""","171 lbs","167","9",100,113,8,10,5,7,13,8,7,10,3,12,13,6,14,8,5,9,9,10,9,14,15,5,12,8,10,10,9,13,14,14,10,9,13,14,8,14,13,14,11,11,14,12,9,9,7,7,11,10,12,3,3,2,1,3,1,3,3,3,3,2
"9057",13186099,"Amos Nondi","2/10/1997 (26 years old)","M (C)","Ararat-Armenia","Armenian High League","KEN","No","1/12/2023","6/30/2024","$5K - $55K","Right","Reasonable","Very Strong","5'7""","145 lbs","160","2",102,113,7,6,4,9,11,8,8,9,4,10,14,5,10,14,9,8,7,10,9,14,10,6,6,10,9,9,12,12,14,14,9,7,6,14,7,6,12,14,9,12,11,11,13,10,7,6,12,9,7,3,3,2,1,3,3,3,2,3,2,3
"9058",12086192,"Tobias Otieno","10/25/1998 (24 years old)","DM, M (C)","Tormenta FC","United States Soccer Leagues Division One","KEN","No","2/15/2022","11/30/2023","$20K - $190K","Right","Reasonable","Very Strong","5'10""","152 lbs","49","3",84,112,7,7,7,7,9,7,6,9,1,12,8,4,14,9,15,9,12,8,7,9,14,5,8,7,9,13,9,13,9,14,9,9,13,14,10,9,14,15,9,13,11,11,11,4,13,6,10,13,18,3,2,2,1,3,3,3,2,3,2,3
"9059",2000300731,"Stanley Wilson","2/8/2005 (18 years old)","M (C)","Kariobangi Sharks","Kenyan Premier Division","KEN","No","6/12/2023","6/30/2025","$1.5K - $14K","Right","Reasonable","Very Strong","6'2""","169 lbs","-","-",70,111,8,8,5,9,10,7,5,10,4,8,8,3,10,10,15,9,7,11,9,15,9,7,10,10,7,9,7,10,10,8,4,14,12,10,11,5,13,14,12,11,8,12,7,8,15,1,20,12,20,3,3,2,2,1,3,1,1,1,3,2
"9060",12093498,"Caleb Omondi","7/19/2002 (20 years old)","GK","Gor Mahia","Kenyan Premier Division","KEN","No","7/1/2020","6/30/2024","$0 - $90K","Right","Reasonable","Very Strong","6'6""","185 lbs","-","-",74,111,3,3,1,1,1,6,1,1,1,2,9,3,2,5,5,7,12,2,13,13,11,3,12,2,13,7,2,6,11,8,2,14,12,11,4,6,12,17,10,12,7,12,5,3,15,5,12,10,9,10,6,13,8,9,12,7,5,8,13,13
"9061",13145784,"Peter Opiyo","8/1/1992 (30 years old)","DM, M (C)","Nairobi City","Kenyan Premier Division","KEN","No","7/1/2020","6/30/2025","$0 - $65K","Right Only","Weak","Very Strong","5'10""","154 lbs","164","5",85,110,6,10,7,6,11,3,8,9,12,14,10,5,13,12,16,10,12,5,10,7,4,11,6,10,12,16,10,12,11,13,11,8,12,12,10,10,10,16,13,11,10,12,6,10,4,6,9,9,11,2,1,4,3,3,4,3,2,2,3,2
"9062",57113505,"Răzvan Marin","5/23/1996 (27 years old)","DM, M (C)","Cagliari","Italian Serie A","ROU","Yes","7/1/2021","6/30/2025","$4.9M - $9.2M","Right","Weak","Very Strong","5'10""","154 lbs","280","27",131,136,11,13,11,12,12,14,11,14,5,12,15,14,12,13,10,14,13,14,13,14,15,14,10,13,13,13,15,13,12,13,14,10,14,12,13,12,13,15,14,15,15,11,6,14,7,6,14,16,13,2,1,3,2,4,3,3,1,3,1,3
"9063",13211552,"Brian Bwire","6/19/2000 (22 years old)","GK","Tusker FC","Kenyan Premier Division","KEN","No","7/1/2021","6/30/2024","$0 - $110K","Right","Fairly Strong","Very Strong","6'4""","180 lbs","-","-",88,110,2,2,3,1,1,3,1,2,1,1,8,2,2,3,7,9,15,7,6,13,16,1,13,2,9,7,6,6,9,14,4,15,8,11,2,6,9,16,12,13,13,12,8,1,6,1,11,10,9,7,5,13,13,10,10,13,5,8,13,13
"9064",12086112,"Johnstone Omurwa","9/1/1998 (24 years old)","D (C)","Estrela da Amadora SAD","Portuguese Premier League","KEN","No","8/27/2022","6/30/2025","$140K - $1.4M","Right","Reasonable","Very Strong","6'3""","178 lbs","67","2",105,110,4,5,10,6,7,5,11,5,11,12,8,9,10,8,13,14,14,8,14,11,13,8,10,7,12,14,10,13,13,13,10,12,14,14,13,11,10,13,12,14,12,12,14,13,12,6,12,13,10,1,1,2,3,4,3,1,1,3,1,2
"9065",29222508,"Fidel Origa","12/12/2000 (22 years old)","DM, M (C)","Bandari FC","Kenyan Premier Division","KEN","No","7/26/2022","6/30/2025","$0 - $85K","Right","Reasonable","Very Strong","5'9""","145 lbs","-","-",82,110,4,7,8,6,14,7,7,11,1,8,10,4,14,14,11,5,8,9,8,12,13,5,5,9,14,8,11,12,14,13,3,4,13,14,7,5,14,17,11,14,11,11,12,5,15,4,20,9,10,1,1,1,3,2,1,2,2,3,3,2
"9066",13217630,"Sydney Lokale","9/19/2000 (22 years old)","ST (C)","Eloi-Lupopo","DR Congo Premier Division A","KEN","No","9/1/2022","6/30/2024","$110K - $1.1M","Right","Reasonable","Very Strong","6'2""","154 lbs","-","-",86,110,7,6,14,14,14,7,14,8,6,5,6,6,1,13,12,13,7,7,7,11,12,14,2,13,8,7,7,8,12,8,8,10,14,12,7,7,10,13,11,12,12,9,13,5,10,8,10,10,8,1,4,1,1,1,3,1,2,1,1,3
"9067",12086077,"Yusuf Mainge","12/26/1999 (23 years old)","D/WB (R)","Gor Mahia","Kenyan Premier Division","KEN","No","7/1/2021","6/30/2025","$26K - $75K","Right","Weak","Very Strong","5'8""","145 lbs","3","-",87,110,4,11,7,4,14,2,8,1,6,9,8,2,13,9,13,8,9,8,10,14,17,5,1,7,6,8,8,9,14,14,6,7,15,14,13,7,15,16,10,10,13,12,5,10,7,8,16,12,10,1,1,1,1,2,1,1,1,2,3,1
"9068",12086157,"Daniel Sakari","5/23/1999 (24 years old)","D/WB (R), DM","Tusker FC","Kenyan Premier Division","KEN","No","7/1/2021","6/30/2024","$50K - $150K","Right","Reasonable","Very Strong","5'11""","156 lbs","26","-",94,110,8,12,7,6,13,7,7,5,15,9,8,1,10,9,13,9,9,9,9,11,18,5,12,8,11,9,9,9,13,13,9,9,11,13,13,6,15,16,10,11,12,12,12,16,8,6,13,9,17,3,1,2,3,2,3,2,2,1,2,1
"9069",2000209226,"Daniel Musamali","1/20/2001 (22 years old)","AM (R)","Kenya Police","Kenyan Premier Division","KEN","No","7/1/2022","6/30/2025","$0 - $45K","Right","Reasonable","Very Strong","6'0""","156 lbs","-","-",72,108,7,11,9,7,13,6,6,2,6,4,11,1,6,12,15,4,7,8,6,9,14,12,1,9,4,7,5,12,13,11,7,7,14,12,13,4,11,16,11,12,10,11,11,7,5,3,10,12,20,2,1,2,2,2,3,1,1,1,3,3
"9070",2000257150,"Parmenas Ocholla","1/22/2003 (20 years old)","M/AM (L)","Gor Mahia","Kenyan Premier Division","KEN","No","7/1/2021","7/31/2024","$0 - $18K","Left Only","Very Strong","Weak","5'10""","147 lbs","-","-",66,108,8,11,14,10,10,6,6,7,3,6,13,2,6,11,5,4,5,8,8,11,10,10,7,5,7,7,7,8,10,11,7,6,15,13,9,5,12,11,13,11,13,10,5,2,8,5,9,13,14,3,3,1,1,2,3,3,2,1,2,1
"9071",12086193,"Joshua Nyatini","11/11/2000 (22 years old)","M (R), AM (RC)","Prisons SC","Tanzanian Mainland Premier Division","KEN","No","7/1/2022","6/30/2024","$0","Right","Reasonable","Very Strong","5'8""","138 lbs","-","-",78,108,9,12,9,9,14,7,4,9,7,5,13,4,7,13,14,9,7,9,8,9,10,12,8,12,7,8,8,13,13,11,6,3,15,12,9,4,17,20,15,11,9,10,9,16,5,1,13,12,10,3,3,2,4,1,2,4,3,2,3,3
"9072",12086184,"Patrick Otieno","12/24/2000 (22 years old)","AM (R), ST (C)","Kariobangi Sharks","Kenyan Premier Division","KEN","No","7/4/2019","6/30/2025","$0 - $40K","Right","Reasonable","Very Strong","5'9""","147 lbs","-","-",77,107,6,8,13,7,6,6,8,7,6,5,9,4,7,7,6,7,8,7,7,7,4,14,6,7,6,5,8,8,13,13,7,5,12,13,12,5,11,16,11,10,11,11,7,10,7,6,20,13,7,3,3,1,2,2,2,1,2,1,1,3
"9073",7540774,"Gabriel Tamaş","11/9/1983 (39 years old)","D (C)","Concordia Chiajna","Romanian Second League","ROU","Yes","1/9/2023","6/30/2024","$14K - $140K","Right Only","Weak","Very Strong","6'2""","187 lbs","497","21",100,136,3,12,8,6,12,12,13,11,5,13,11,7,13,10,14,12,12,10,8,12,6,11,13,12,12,12,11,12,8,8,12,15,14,8,12,15,10,4,14,4,14,8,10,12,12,20,15,5,14,1,3,2,3,2,2,3,2,3,3,3
"9074",13177941,"Jesse Were","4/19/1989 (34 years old)","AM (RL), ST (C)","Kansanshi Dynamos","Zambian Premier League","KEN","No","1/4/2022","1/1/2024","$0","Right Only","Very Weak","Very Strong","6'1""","174 lbs","162","152",87,106,5,6,11,13,10,5,12,10,4,4,10,14,5,11,10,11,5,12,10,11,12,9,8,14,8,11,9,9,11,9,9,12,13,12,12,12,9,18,11,11,13,9,5,11,11,7,12,8,10,1,2,1,2,1,2,3,4,1,1,3
"9075",13100845,"Humphrey Mieno","8/28/1989 (33 years old)","M (C), AM (RC)","Tusker FC","Kenyan Premier Division","KEN","No","8/8/2019","6/30/2023","$0","Right","Reasonable","Very Strong","5'11""","165 lbs","214","31",97,105,9,11,13,10,14,9,8,9,9,7,14,4,8,12,14,14,8,11,10,15,3,15,12,12,10,10,12,12,10,13,10,11,11,10,7,7,11,17,11,11,10,13,8,6,12,1,14,10,12,3,2,2,3,2,1,1,2,1,1,2
"9076",36114949,"Abud Omar","9/9/1992 (30 years old)","D/WB (L)","Kenya Police","Kenyan Premier Division","KEN","No","2/22/2023","6/30/2024","$35K - $100K","Left Only","Very Strong","Weak","5'10""","165 lbs","135","3",92,105,7,10,9,6,11,9,9,8,14,9,10,9,12,11,13,11,12,10,8,9,12,10,8,13,11,12,10,12,14,13,12,10,13,13,12,9,4,6,7,6,9,10,6,11,8,16,11,13,7,1,1,3,2,3,3,2,1,1,1,3
"9077",67252817,"Abdoul Kialy Koné","4/8/1997 (26 years old)","WB (R), M/AM (L), ST (C)","Castellón","Spanish Federation First Division B","KEN","No","7/1/2021","6/30/2024","$26K - $80K","Left Only","Very Strong","Weak","6'0""","160 lbs","173","26",98,105,8,10,13,12,13,8,9,10,8,8,14,4,9,8,8,8,8,9,9,10,5,13,7,14,9,9,6,12,10,14,12,7,6,16,11,5,10,19,11,12,14,11,7,13,13,6,13,13,17,3,1,2,3,2,4,2,1,1,3,3
"9078",13191081,"Kenneth Muguna","1/6/1996 (27 years old)","M (C), AM (RC)","Azam FC","Tanzanian Mainland Premier Division","KEN","No","7/1/2021","6/30/2024","$0","Left Only","Very Strong","Weak","5'9""","154 lbs","120","11",98,105,8,11,9,12,14,10,6,10,1,9,14,9,10,11,14,14,8,14,9,14,11,15,9,12,11,15,9,12,12,14,11,11,15,13,12,6,16,15,8,10,10,8,10,9,12,8,18,11,12,3,1,1,3,2,3,2,3,3,1,3
"9079",36128052,"Ismael Dunga","2/24/1993 (30 years old)","ST (C)","Tosu","J1 League","KEN","No","1/25/2021","12/31/2025","$0","Right","Reasonable","Very Strong","6'2""","176 lbs","119","30",78,105,6,9,13,13,13,3,9,7,2,6,7,7,3,11,10,6,8,9,7,7,6,11,6,8,6,6,8,8,13,13,7,9,13,13,4,8,11,12,9,12,11,8,9,11,11,12,19,12,13,1,2,3,1,1,2,2,3,2,2,1
"9080",12092713,"Musa Masika","6/3/2000 (23 years old)","AM (L), ST (C)","KCB","Kenyan Premier Division","KEN","No","3/28/2023","6/30/2025","$22K - $65K","Left","Very Strong","Reasonable","5'5""","149 lbs","-","-",82,105,9,13,14,14,12,7,13,6,1,7,13,5,4,8,5,9,6,9,9,9,7,11,14,9,7,7,8,9,14,8,3,1,15,12,8,1,9,14,8,10,12,11,5,2,15,5,10,12,10,1,1,1,1,3,2,2,1,1,1,2
"9081",13100593,"Paul Were","1/8/1991 (32 years old)","M/AM (RL)","Rayon Sports","Rwandan Premier Division","KEN","No","8/12/2022","6/30/2023","$0","Left Only","Very Strong","Weak","5'8""","156 lbs","151","13",90,105,11,13,12,8,8,10,7,9,7,8,8,3,7,12,11,15,12,8,7,7,10,11,8,12,7,8,8,11,13,13,10,8,13,13,9,8,11,13,10,9,9,8,8,7,6,9,13,12,13,3,3,3,3,3,4,1,3,2,1,3
"9082",12086168,"Thomas Teka","4/3/2000 (23 years old)","D (C)","Tusker FC","Kenyan Premier Division","KEN","No","7/1/2022","6/30/2025","$0 - $65K","Right","Reasonable","Very Strong","6'4""","187 lbs","-","-",83,105,3,2,1,1,8,1,14,5,4,14,8,4,14,4,6,9,9,8,8,14,17,5,13,7,8,7,4,8,12,9,8,13,12,12,6,9,13,12,12,11,12,11,9,10,5,2,8,8,13,3,1,2,3,3,1,2,2,3,2,1
"9083",12086162,"Peter Thiong'o","10/3/1999 (23 years old)","AM (R), ST (C)","AFC Leopards","Kenyan Premier Division","KEN","No","7/1/2020","7/30/2023","$0 - $8K","Right","Reasonable","Very Strong","5'11""","156 lbs","-","-",85,105,7,11,14,13,13,6,12,7,6,7,14,3,4,11,8,13,5,7,5,14,15,10,13,8,7,8,9,9,14,12,7,7,18,10,10,7,12,16,11,11,11,13,10,8,12,2,8,11,12,1,1,4,3,2,2,1,2,3,3,3
"9084",43192537,"Daniel Boloca","12/22/1998 (24 years old)","DM, M (C)","Frosinone","Italian Serie A","ROU","Yes","11/9/2020","6/30/2026","$6.4M - $7.8M","Right Only","Weak","Very Strong","6'2""","167 lbs","125","8",131,151,11,11,13,9,14,9,9,13,8,10,15,9,15,15,14,14,13,14,13,13,11,6,7,14,13,14,13,13,13,13,13,11,14,13,15,13,10,9,10,9,8,9,8,12,10,6,13,13,12,1,3,1,1,1,1,3,2,2,1,1
"9085",2000215521,"David Păcuraru","2/17/2006 (17 years old)","AM (C)","Farul Constanţa","Romanian First League","ROU","Yes","7/1/2022","6/30/2025","$550K - $1.6M","Left","Very Strong","Weak","5'9""","147 lbs","-","-",68,136,10,10,12,10,11,10,8,8,2,6,11,10,7,12,9,8,9,11,8,8,13,14,3,9,6,8,12,10,11,11,10,7,13,10,7,7,15,14,13,15,12,9,12,7,12,3,9,13,18,2,3,2,3,1,2,1,3,3,2,3
"9086",67228909,"Ismael Athuman","2/1/1995 (28 years old)","D (C), DM","Sabadell","Spanish Federation First Division A","KEN","Yes","6/30/2022","6/30/2024","$65K - $200K","Right","Reasonable","Very Strong","6'1""","178 lbs","106","4",97,105,6,7,9,9,11,7,13,8,9,12,13,7,13,12,8,9,9,10,10,9,9,12,8,9,11,12,11,12,13,11,11,14,12,13,13,12,12,10,10,10,8,9,11,9,10,8,10,8,11,3,2,2,1,3,2,2,1,1,3,3
"9087",65026087,"Percy Tau","5/13/1994 (29 years old)","AM (RLC), ST (C)","Al-Ahly","Egyptian Premier League","RSA","No","8/26/2021","7/31/2025","$800K - $5.6M","Left","Very Strong","Fairly Strong","5'9""","145 lbs","161","42",130,150,10,12,16,11,14,6,6,11,4,4,12,10,7,16,5,8,14,12,8,8,12,17,6,16,5,7,12,10,17,15,7,5,15,16,10,5,12,12,14,10,11,11,10,13,4,3,11,13,5,3,2,2,4,1,1,3,2,3,3,3
"9088",65033785,"Teboho Mokoena","1/24/1997 (26 years old)","M (C)","Sundowns","South African Premier Soccer League","RSA","No","1/27/2022","6/30/2026","$375K - $1.1M","Right","Fairly Strong","Very Strong","5'9""","149 lbs","159","17",128,150,11,11,11,7,12,9,9,12,2,11,14,6,16,16,6,14,11,11,12,13,14,5,6,12,12,12,11,14,15,14,11,10,11,13,9,9,16,16,9,12,12,12,5,14,12,5,11,10,15,1,1,2,2,3,1,1,3,3,1,1
"9089",5688651,"Itumeleng Khune","6/20/1987 (35 years old)","GK","Kaizer Chiefs","South African Premier Soccer League","RSA","No","6/14/2021","6/30/2024","$4K - $40K","Right","Reasonable","Very Strong","5'11""","176 lbs","293","-",105,150,6,5,7,6,8,8,6,5,9,8,15,9,8,10,6,11,15,8,9,10,20,14,16,10,8,7,10,6,9,8,7,10,10,6,8,7,6,10,12,13,20,20,16,18,5,3,7,15,16,17,11,14,8,9,16,14,12,11,12,9
"9090",65029935,"Aubrey Modiba","7/22/1995 (27 years old)","D/WB (L), M/AM (RL)","Sundowns","South African Premier Soccer League","RSA","No","7/1/2020","6/30/2024","$20K - $200K","Left","Very Strong","Fairly Strong","5'7""","145 lbs","180","23",118,150,5,11,12,6,11,9,7,6,9,10,10,4,10,10,9,9,9,12,8,7,14,14,9,12,9,10,9,14,15,12,10,7,13,13,11,7,18,13,14,11,11,11,8,13,5,7,15,13,10,2,3,4,1,1,3,2,3,2,3,3
"9091",65028567,"Rivaldo Coetzee","10/16/1996 (26 years old)","D (C), DM, M (C)","Sundowns","South African Premier Soccer League","RSA","No","10/1/2022","6/30/2026","$40K - $375K","Right","Reasonable","Very Strong","5'10""","165 lbs","145","3",119,145,4,7,7,8,11,4,12,12,5,14,18,3,10,13,6,13,12,11,11,12,18,4,12,17,17,12,15,12,13,9,11,13,10,12,12,11,5,15,12,12,12,11,19,10,4,7,16,13,11,1,1,2,2,2,2,1,3,2,3,1
"9092",65002797,"Oupa Manyisa","7/30/1988 (34 years old)","DM, M (C)","NB La Masia","South African National First Division Championship","RSA","No","1/2/2023","6/30/2024","$10K - $30K","Right","Reasonable","Very Strong","5'4""","132 lbs","226","15",102,145,6,9,12,8,11,8,8,10,6,15,14,6,10,13,12,9,12,12,13,11,14,10,11,11,13,13,10,11,14,11,10,7,12,15,12,10,12,10,12,13,14,14,5,13,5,6,12,12,18,3,2,1,3,2,1,2,1,3,1,1
"9093",65043378,"Bongokuhle Hlongwane","6/20/2000 (22 years old)","AM (RL), ST (C)","Minnesota","Major League Soccer","RSA","No","1/5/2022","12/31/2024","$900K - $11.5M","Right","Reasonable","Very Strong","6'0""","165 lbs","103","14",122,145,7,9,14,12,10,11,10,11,11,5,9,6,8,12,6,10,9,10,8,9,12,12,12,12,11,11,11,15,16,14,12,9,8,14,11,12,12,18,8,10,10,13,8,7,8,8,10,11,11,3,3,3,3,3,2,2,1,2,3,1
"9094",5690289,"Bernard Parker","3/16/1986 (37 years old)","AM (LC), ST (C)","TS Galaxy","South African Premier Soccer League","RSA","No","6/30/2022","6/30/2024","$4K - $12K","Left","Very Strong","Reasonable","5'10""","156 lbs","442","75",105,145,11,11,10,11,10,7,12,8,2,3,9,8,5,11,14,9,11,7,11,9,11,12,18,10,5,9,12,15,12,11,11,8,14,11,15,13,11,8,12,12,8,13,6,8,9,6,8,14,10,3,1,4,2,1,2,2,1,2,3,3
"9095",65025016,"Abbubaker Mobara","2/18/1994 (29 years old)","D (RC), WB (R), DM, M (C)","AmaZulu","South African Premier Soccer League","RSA","No","1/2/2022","6/30/2024","$80K - $800K","Right","Fairly Strong","Very Strong","5'10""","143 lbs","184","3",113,145,9,12,10,6,11,11,12,7,10,12,12,5,13,12,10,10,12,12,7,8,8,8,7,12,13,11,12,11,14,12,12,11,13,14,12,8,17,8,12,12,10,11,4,12,5,6,10,12,8,3,2,1,1,2,2,3,1,2,1,3
"9096",57146388,"Florinel Coman","4/10/1998 (25 years old)","AM (L), ST (C)","FCSB","Romanian First League","ROU","Yes","6/15/2020","6/30/2025","$550K - $5.4M","Right","Weak","Very Strong","6'0""","158 lbs","201","41",125,135,13,12,13,13,13,12,10,13,6,5,13,12,7,14,10,12,10,12,11,11,12,14,11,12,7,11,12,12,14,14,12,11,14,15,12,12,13,5,8,9,7,12,7,12,9,15,12,12,6,3,3,1,1,1,3,3,3,1,2,3
"9097",65030798,"Reeve Frosler","1/11/1998 (25 years old)","D/WB (RL), M (R)","Kaizer Chiefs","South African Premier Soccer League","RSA","No","6/15/2020","6/30/2024","$100K - $1M","Right","Strong","Very Strong","5'8""","156 lbs","115","3",114,145,7,10,11,5,9,6,8,6,10,12,10,10,11,12,12,11,14,12,9,9,15,8,9,10,13,12,7,11,16,7,11,8,14,14,14,11,10,9,14,13,11,13,7,10,8,3,13,13,13,1,1,3,2,3,2,1,1,1,3,3
"9098",2000202573,"Waylon Renecke","5/12/2006 (17 years old)","D (C)","Norwich","Sky Bet Championship","RSA","No","7/1/2022","6/30/2025","$750K - $1.6M","Left Only","Very Strong","Weak","6'0""","154 lbs","-","-",72,144,4,4,7,4,9,4,11,4,14,12,11,4,12,11,7,9,8,14,7,7,15,4,8,6,11,8,10,8,13,9,9,12,11,13,11,9,9,13,12,13,6,14,13,18,4,5,9,16,14,4,3,3,3,1,1,1,2,2,3,3
"9099",65035924,"Sipho Mbule","3/22/1998 (25 years old)","M (LC), AM (C)","Sundowns","South African Premier Soccer League","RSA","No","6/30/2022","6/30/2024","$70K - $700K","Right","Fairly Strong","Very Strong","5'11""","163 lbs","104","10",115,140,9,11,12,8,13,9,7,11,9,8,10,7,6,14,13,9,8,5,9,12,2,15,11,11,10,10,12,10,18,14,10,8,9,15,14,7,14,17,11,13,11,9,14,8,6,7,20,11,12,1,3,2,2,4,2,4,1,1,3,1
"9100",65010100,"Themba Zwane","8/3/1989 (33 years old)","M/AM (LC)","Sundowns","South African Premier Soccer League","RSA","No","6/14/2021","6/30/2024","$24K - $240K","Right","Reasonable","Very Strong","5'7""","145 lbs","272","57",130,140,13,13,17,11,13,11,9,14,6,9,15,10,10,13,8,11,8,10,12,9,12,13,7,12,8,11,16,10,15,12,12,8,15,14,15,10,8,8,8,12,10,13,7,11,9,3,12,12,12,4,3,1,2,3,2,3,2,2,1,2
"9101",65029979,"Siphelele Ntshangase","5/11/1993 (30 years old)","M (C), AM (LC)","Black Leopards","South African National First Division Championship","RSA","No","7/1/2022","6/30/2024","$14K - $140K","Right","Strong","Very Strong","5'9""","143 lbs","122","17",110,140,8,10,13,11,11,8,6,9,3,4,9,8,6,10,6,9,9,8,8,5,12,14,8,13,9,9,11,9,16,12,14,5,11,14,12,8,12,11,13,12,10,9,10,10,6,4,11,12,12,1,1,3,1,2,1,3,2,1,3,2
"9102",37007107,"Kermit Erasmus","7/8/1990 (32 years old)","AM (LC), ST (C)","Orlando Pirates","South African Premier Soccer League","RSA","No","9/22/2022","6/30/2024","$10K - $100K","Right","Fairly Strong","Very Strong","5'6""","138 lbs","279","67",112,140,8,10,14,10,13,11,10,15,5,3,11,12,6,13,6,11,11,10,9,8,11,16,5,14,7,8,12,10,13,14,7,5,11,13,11,7,9,14,12,12,10,8,9,13,6,9,10,13,10,2,1,1,3,1,2,1,1,1,2,3
"9103",65045975,"Evidence Makgopa","6/5/2000 (23 years old)","ST (C)","Orlando Pirates","South African Premier Soccer League","RSA","No","6/30/2022","6/30/2024","$24K - $240K","Right","Fairly Strong","Very Strong","6'2""","171 lbs","69","15",111,140,10,7,15,13,9,10,12,11,6,10,11,10,6,12,15,13,12,13,8,14,10,12,10,14,11,10,9,11,12,9,9,13,8,13,13,11,13,12,12,10,8,12,5,8,9,3,13,14,14,4,3,2,1,3,4,4,2,1,3,2
"9104",65008813,"Sibusiso Vilakazi","12/29/1989 (33 years old)","M/AM (C)","Sekhukhune Utd","South African Premier Soccer League","RSA","No","1/2/2023","6/30/2024","$90K - $275K","Right","Reasonable","Very Strong","5'7""","165 lbs","268","51",115,140,9,11,14,10,14,10,10,11,7,9,12,12,4,12,8,13,12,10,5,12,12,12,16,12,12,12,13,14,14,10,12,5,14,13,8,8,12,11,12,12,12,11,8,13,7,4,14,11,11,3,1,1,1,1,4,2,2,1,2,3
"9105",65040473,"Kegan Johannes","3/31/2001 (22 years old)","D (RC), WB (R)","SuperSport Utd","South African Premier Soccer League","RSA","No","7/1/2021","6/30/2025","$240K - $700K","Right","Reasonable","Very Strong","5'11""","154 lbs","100","7",108,140,6,11,9,3,11,7,12,6,9,11,11,7,13,10,15,15,10,10,9,15,1,6,9,9,14,10,9,10,13,15,10,7,11,14,10,8,16,13,11,12,10,11,10,11,13,2,20,13,7,1,2,2,3,1,1,2,4,1,2,3
"9106",65010067,"Erick Mathoho","3/1/1990 (33 years old)","D (C)","Kaizer Chiefs","South African Premier Soccer League","RSA","No","6/14/2021","6/30/2024","$2.5K - $24K","Right","Weak","Very Strong","6'6""","163 lbs","286","20",104,140,9,4,7,7,8,5,13,7,10,11,10,4,13,10,11,11,10,10,9,10,15,11,10,10,12,11,8,11,11,8,8,16,12,12,11,15,8,11,12,13,11,15,5,13,9,8,17,18,17,3,1,2,3,3,2,3,2,1,3,3
"9107",57163387,"Ştefan Târnovanu","5/9/2000 (23 years old)","GK","FCSB","Romanian First League","ROU","Yes","1/1/2021","6/30/2026","$190K - $1.9M","Right","Weak","Very Strong","6'6""","191 lbs","88","-",117,135,2,2,2,1,9,3,9,3,2,2,9,2,3,9,9,11,12,11,11,11,12,7,10,8,11,12,11,12,8,11,12,15,13,8,10,14,2,12,10,11,11,11,9,11,7,14,13,9,13,10,10,14,15,16,13,14,8,14,14,15
"9108",65028520,"Fagrie Lakay","5/31/1997 (26 years old)","AM (RC), ST (C)","Pyramids","Egyptian Premier League","RSA","No","1/31/2022","7/31/2024","$140K - $1.4M","Right","Reasonable","Very Strong","5'8""","158 lbs","150","27",113,140,9,10,12,12,11,8,7,12,3,7,11,9,10,12,9,7,13,9,11,9,14,11,7,12,11,13,13,13,15,8,13,5,14,13,13,10,10,14,13,12,12,14,8,14,3,4,12,15,13,1,2,3,3,3,2,3,2,1,4,3
"9109",65026986,"Morné Nel","5/23/1996 (27 years old)","M (C), AM (RC)","Cape Town Spurs","South African Premier Soccer League","RSA","No","9/30/2021","6/30/2024","$0 - $85K","Right","Fairly Strong","Very Strong","6'0""","171 lbs","79","-",97,140,7,9,11,5,12,9,8,10,3,5,13,6,7,13,9,11,8,10,8,8,15,11,9,12,13,11,14,12,15,11,7,10,12,13,9,9,10,8,13,12,11,8,9,12,9,6,13,15,14,3,2,2,3,2,3,4,3,1,1,2
"9110",65037417,"Oswin Appollis","5/25/2001 (22 years old)","M (RL), AM (RLC)","Polokwane City","South African Premier Soccer League","RSA","No","6/1/2023","6/30/2025","$150K - $425K","Right","Reasonable","Very Strong","5'8""","123 lbs","45","8",102,140,8,11,15,10,12,7,5,10,5,7,12,3,8,11,11,9,8,10,8,13,12,16,1,11,7,8,11,11,15,11,7,3,15,12,8,2,13,14,11,10,12,10,13,14,9,8,19,13,11,1,2,1,3,3,1,1,1,1,3,2
"9111",65008594,"Thulani Hlatshwayo","12/18/1989 (33 years old)","D (RC), DM, M (C)","SuperSport Utd","South African Premier Soccer League","RSA","No","7/1/2022","6/30/2024","$24K - $250K","Right","Reasonable","Very Strong","6'2""","200 lbs","289","23",115,140,8,9,10,5,7,8,14,8,11,12,12,5,12,14,14,10,13,13,13,13,14,5,4,11,14,12,9,12,13,9,11,13,10,12,11,15,11,12,9,9,10,14,11,7,12,3,10,8,5,2,2,1,1,1,1,2,3,3,4,3
"9112",65010073,"Thabo Matlaba","12/13/1987 (35 years old)","D/WB (RL), M (L)","Royal AM","South African Premier Soccer League","RSA","No","1/31/2022","6/30/2024","$12K - $35K","Either","Very Strong","Very Strong","5'6""","141 lbs","273","14",108,140,7,5,9,4,8,6,5,9,6,8,10,5,8,13,8,6,9,12,12,10,16,11,9,10,7,8,10,10,14,10,12,5,14,13,13,9,11,10,13,14,13,12,7,8,8,5,11,13,5,1,1,3,1,1,1,2,2,2,3,2
"9113",65039138,"Luke Fleurs","3/3/2000 (23 years old)","D (C)","SuperSport Utd","South African Premier Soccer League","RSA","No","7/1/2018","6/30/2025","$95K - $950K","Right","Fairly Strong","Very Strong","6'1""","176 lbs","83","2",104,140,5,5,8,5,8,5,12,5,7,10,10,3,11,7,11,10,13,7,10,15,7,6,3,8,11,9,7,10,14,14,10,10,11,13,11,11,18,10,12,4,12,15,8,12,5,3,14,13,12,3,1,2,2,1,3,2,3,3,3,3
"9114",65032746,"Siphesihle Ndlovu","9/30/1996 (26 years old)","AM (RLC)","SuperSport Utd","South African Premier Soccer League","RSA","No","1/2/2023","6/30/2025","$60K - $600K","Right","Fairly Strong","Very Strong","5'7""","141 lbs","131","8",108,140,10,11,15,7,12,8,6,8,4,4,11,7,6,11,6,6,7,9,8,7,14,15,8,11,5,11,13,12,15,9,11,4,12,14,11,6,11,12,12,12,11,10,8,13,7,5,12,12,8,3,2,3,3,4,2,1,1,3,2,3
"9115",2000142374,"Luphumlo Sifumba","7/12/2005 (17 years old)","M (C), AM (RLC)","Cape Town City","South African Premier Soccer League","RSA","No","6/13/2022","6/30/2025","$55K - $550K","Right","Reasonable","Very Strong","5'6""","125 lbs","3","-",88,140,7,9,10,12,14,7,5,6,2,7,13,3,5,14,12,9,8,7,8,14,7,14,10,12,6,8,11,13,12,10,8,5,15,12,11,1,14,17,8,10,12,10,10,12,5,7,15,10,11,3,2,2,2,3,2,2,3,2,1,2
"9116",65039540,"Lyle Foster","9/3/2000 (22 years old)","AM (L), ST (C)","Burnley","English Premier Division","RSA","No","1/23/2023","6/30/2027","$21M - $32M","Right","Fairly Strong","Very Strong","6'1""","165 lbs","92","15",128,138,6,7,13,14,13,8,12,11,5,6,11,12,6,13,11,12,11,14,13,12,13,13,10,13,6,12,12,12,14,12,13,14,12,15,10,15,9,12,12,12,8,11,7,11,5,5,13,14,14,3,1,2,3,1,1,3,3,2,3,3
"9117",65036461,"Gift Links","10/2/1998 (24 years old)","WB (L), AM (RLC)","AGF","3F Superliga","RSA","No","9/1/2019","6/30/2024","$600K - $1.8M","Left","Very Strong","Reasonable","5'7""","132 lbs","138","10",117,136,8,11,13,9,11,9,9,9,6,8,8,9,8,11,12,11,11,10,11,12,14,13,6,12,9,12,11,16,16,14,12,8,11,15,14,5,11,12,13,12,11,15,5,12,7,4,9,12,13,3,1,1,3,3,2,3,2,2,2,4
"9118",57187440,"Răzvan Sava","6/21/2002 (20 years old)","GK","CFR Cluj","-","ROU","Yes","1/28/2022","6/30/2024","$400K - $4.1M","Right Only","Weak","Very Strong","6'4""","182 lbs","13","-",109,135,1,3,1,1,7,4,7,1,3,3,7,1,3,7,10,11,12,11,11,11,13,6,7,2,12,10,8,10,8,12,12,17,14,8,8,12,12,12,12,12,12,10,5,11,7,7,13,12,8,12,11,14,9,14,12,14,7,13,13,15
"9119",65042832,"Cassius Mailula","6/12/2001 (22 years old)","M/AM (C)","Sundowns","South African Premier Soccer League","RSA","No","6/13/2022","6/30/2025","$0","Right","Reasonable","Very Strong","5'8""","154 lbs","17","9",115,135,9,10,10,13,11,11,5,9,3,6,12,9,5,11,6,11,11,13,9,15,14,13,12,8,11,12,12,12,17,11,14,6,13,15,14,7,11,11,11,11,10,11,5,10,4,6,12,10,9,3,3,1,3,1,3,1,1,3,1,2
"9120",2000248461,"Ime Okon","2/20/2004 (19 years old)","D (C), DM","SuperSport Utd","South African Premier Soccer League","RSA","No","7/1/2022","6/30/2026","$180K - $550K","Right","Fairly Strong","Very Strong","6'0""","160 lbs","-","-",99,135,4,7,5,5,12,8,10,9,2,14,13,4,13,10,15,13,9,5,7,14,5,7,7,3,14,9,10,10,9,12,10,11,13,11,7,9,10,18,13,9,10,12,5,14,6,2,7,11,12,2,2,3,4,3,2,3,1,3,2,4
"9121",2000146196,"Thapelo Maseko","11/11/2003 (19 years old)","M (C), AM (RLC)","SuperSport Utd","South African Premier Soccer League","RSA","No","7/1/2020","6/30/2025","$0","Left","Very Strong","Weak","5'10""","163 lbs","32","4",108,135,7,12,9,10,13,7,7,6,1,4,13,3,7,13,8,9,7,7,8,11,11,13,1,7,8,8,8,9,19,11,10,5,15,18,10,7,12,19,12,10,11,10,8,17,5,1,11,12,8,3,2,1,3,1,2,3,3,2,2,2
"9122",65032582,"Thendo Mukumela","1/30/1998 (25 years old)","D (RC), DM","AmaZulu","South African Premier Soccer League","RSA","No","7/1/2022","6/30/2024","$0 - $80K","Right","Fairly Strong","Very Strong","5'10""","180 lbs","93","17",98,135,5,5,11,7,6,8,7,13,7,10,10,7,12,10,7,10,10,9,14,15,11,5,4,10,11,11,6,12,14,15,8,7,16,12,11,10,12,17,13,13,13,11,3,11,6,7,5,12,13,3,1,2,1,3,1,1,1,1,3,3
"9123",65030536,"Tercious Malepe","2/18/1997 (26 years old)","D (LC), WB (L), DM, M (C)","AmaZulu","South African Premier Soccer League","RSA","No","6/15/2021","6/30/2024","$95K - $950K","Left","Very Strong","Reasonable","6'0""","160 lbs","138","2",108,135,6,7,9,5,8,4,7,5,5,12,10,5,10,9,12,10,15,11,8,12,17,3,14,9,9,12,7,14,14,9,10,8,18,13,17,11,10,8,14,15,12,12,6,8,6,1,10,12,14,2,1,2,3,2,1,1,1,4,1,1
"9124",65039757,"Sibusiso Mabiliso","4/19/1999 (24 years old)","D (L)","AmaZulu","South African Premier Soccer League","RSA","No","8/12/2022","6/30/2024","$230K - $700K","Left","Very Strong","Reasonable","5'10""","158 lbs","88","1",103,135,10,13,9,6,10,8,11,2,9,11,9,6,10,11,13,10,11,10,12,11,14,8,5,10,13,11,11,11,15,14,11,7,12,13,13,9,18,10,12,12,13,13,7,11,7,1,10,11,12,2,1,2,3,1,2,3,1,1,4,1
"9125",65039337,"Tashreeq Matthews","9/12/2000 (22 years old)","M (L), AM (LC), ST (C)","IK Sirius","Swedish Premier Division","RSA","No","8/10/2022","12/31/2026","$1.1M - $2.4M","Right","Reasonable","Very Strong","5'9""","154 lbs","76","7",116,135,10,10,13,11,12,9,6,9,5,7,10,9,7,13,10,11,10,12,11,11,12,14,7,12,9,10,11,11,14,14,9,7,12,14,13,7,13,12,12,12,12,8,8,9,7,10,12,12,13,4,3,1,1,3,4,4,3,3,2,3
"9126",65040260,"Njabulo Blom","12/11/1999 (23 years old)","D/WB (R), DM, M (C)","St. Louis CITY","Major League Soccer","RSA","No","12/23/2022","12/31/2024","$375K - $3.8M","Right","Fairly Strong","Very Strong","5'8""","156 lbs","88","-",110,135,6,7,7,6,12,10,8,8,1,13,13,8,11,12,8,10,9,11,8,9,10,8,11,10,10,13,11,13,15,13,11,8,14,14,16,11,14,15,13,11,11,13,6,11,6,4,9,11,13,2,2,3,3,2,2,2,3,2,3,3
"9127",65028618,"Gift Motupa","9/23/1994 (28 years old)","DM, AM (RC), ST (C)","Sundowns","South African Premier Soccer League","RSA","No","7/1/2020","6/30/2024","$40K - $375K","Right","Fairly Strong","Very Strong","5'11""","174 lbs","152","44",105,135,8,8,11,12,10,8,9,9,5,12,12,7,8,11,6,8,9,11,8,4,11,9,6,11,11,12,13,12,14,11,10,7,12,12,11,13,15,14,13,12,11,11,8,12,5,3,10,9,12,2,3,2,1,2,3,1,3,4,3,1
"9128",65025955,"Luther Singh","8/5/1997 (25 years old)","AM (RLC), ST (C)","FC København","3F Superliga","RSA","No","8/18/2021","6/30/2025","$40K - $375K","Right","Fairly Strong","Very Strong","5'7""","132 lbs","181","33",108,134,13,13,15,12,15,13,7,12,6,4,11,12,6,14,13,10,8,10,7,8,11,17,7,13,5,7,10,12,13,13,12,5,7,12,8,6,8,11,10,7,8,8,8,11,12,5,8,12,10,1,3,1,1,1,2,2,2,2,2,2
"9129",57175883,"Alexi Pitu","6/5/2002 (21 years old)","AM (RL)","Bordeaux","Ligue 2 BKT","ROU","Yes","1/26/2023","6/30/2027","$250K - $2.6M","Right","Reasonable","Very Strong","5'10""","154 lbs","105","8",115,135,10,12,14,10,13,10,9,11,8,9,12,9,9,12,9,12,11,11,11,13,11,10,9,13,9,11,12,12,13,12,9,8,11,14,13,6,12,15,12,10,14,11,8,10,9,5,10,10,12,2,2,3,3,1,2,2,1,3,3,4
"9130",2000187005,"Relebohile Mofokeng","10/4/2004 (18 years old)","M (C), AM (RLC)","Orlando Pirates","South African Premier Soccer League","RSA","No","7/1/2022","6/30/2025","$210K - $600K","Right","Fairly Strong","Very Strong","5'7""","132 lbs","2","1",101,133,8,10,13,8,13,8,8,5,8,7,12,3,10,13,8,7,6,7,6,14,15,13,11,13,7,9,13,13,14,14,9,6,11,14,10,6,13,10,11,10,11,10,5,11,10,3,10,11,19,2,3,1,3,2,1,3,1,3,2,1
"9131",65008929,"Dino Ndlovu","2/15/1990 (33 years old)","ST (C)","Boluspor","Turkish 1. League","RSA","No","1/2/2023","6/30/2024","$0","Left","Very Strong","Reasonable","6'0""","191 lbs","270","110",105,130,5,10,11,14,11,9,13,12,4,5,11,14,5,12,12,13,10,13,13,11,16,12,8,15,9,12,10,13,12,11,13,10,13,12,8,12,8,7,11,8,9,6,10,14,5,10,13,14,15,2,1,1,1,3,3,3,2,1,2,2
"9132",65045285,"Antonio Van Wyk","3/30/2002 (21 years old)","M (RL), AM (RLC)","Stellenbosch FC","South African Premier Soccer League","RSA","No","7/1/2020","6/30/2025","$210K - $650K","Right","Reasonable","Very Strong","5'10""","163 lbs","38","2",105,130,9,12,13,14,12,8,6,10,8,8,13,5,9,14,13,7,9,6,9,14,9,13,10,9,7,9,13,13,14,10,4,7,14,13,10,6,14,19,9,10,12,12,10,5,6,7,13,10,14,2,3,2,2,3,3,1,3,2,2,1
"9133",65010145,"Ronwen Williams","1/21/1992 (31 years old)","GK","Sundowns","South African Premier Soccer League","RSA","No","7/20/2022","6/30/2027","Not for Sale","Left","Very Strong","Fairly Strong","6'0""","174 lbs","305","-",125,130,4,4,8,3,12,6,9,5,12,3,9,5,9,13,8,12,14,10,14,13,6,13,7,8,11,9,10,9,9,9,9,13,10,12,13,12,5,16,12,9,9,12,8,14,10,7,16,11,15,14,8,16,15,15,13,15,10,13,15,14
"9134",65036380,"Siyabonga Ngezana","7/15/1997 (25 years old)","D (C)","Kaizer Chiefs","South African Premier Soccer League","RSA","No","6/15/2020","6/30/2024","$110K - $1.1M","Right","Weak","Very Strong","6'2""","187 lbs","95","6",111,130,6,8,10,8,10,8,14,8,8,12,11,8,13,10,12,12,12,11,11,11,12,9,8,9,12,12,9,12,12,12,13,14,14,12,12,14,12,20,10,10,13,11,8,10,8,2,10,9,7,1,2,1,2,2,1,3,1,3,2,3
"9135",65002459,"George Maluleka","1/7/1989 (34 years old)","M (C), AM (RC)","AmaZulu","South African Premier Soccer League","RSA","No","6/30/2022","6/30/2024","$2K - $22K","Right","Fairly Strong","Very Strong","5'7""","167 lbs","315","29",112,130,9,10,12,9,9,8,8,13,6,8,13,9,7,11,9,9,8,7,8,9,13,11,8,9,10,12,11,12,15,11,13,8,13,15,14,9,11,10,15,15,10,13,8,12,7,6,14,13,11,3,2,2,1,3,2,2,4,2,2,3
"9136",65039448,"Nkosingiphile Ngcobo","11/16/1999 (23 years old)","M (LC), AM (RLC)","Kaizer Chiefs","South African Premier Soccer League","RSA","No","6/15/2020","6/30/2025","$35K - $350K","Left","Very Strong","Reasonable","5'5""","132 lbs","58","6",106,130,7,8,15,7,11,7,5,9,1,4,11,5,4,13,5,8,3,10,8,10,6,13,12,11,5,8,11,9,17,13,13,5,14,14,7,7,11,13,9,9,13,10,7,12,7,8,8,10,18,3,3,3,2,2,3,3,1,3,1,1
"9137",65010055,"Lehlohonolo Majoro","8/19/1986 (36 years old)","ST (C)","AmaZulu","South African Premier Soccer League","RSA","No","7/1/2019","6/30/2024","$500 - $7K","Left","Very Strong","Reasonable","5'9""","165 lbs","270","71",103,130,12,8,11,15,11,7,13,9,3,4,9,13,8,8,8,8,8,11,12,8,13,16,8,14,13,9,13,11,15,12,12,9,13,15,13,10,11,11,13,10,11,9,3,10,8,9,12,18,11,3,2,1,3,1,2,1,3,3,2,2
"9138",65032160,"Rushine De Reuck","2/9/1996 (27 years old)","D (C)","Sundowns","South African Premier Soccer League","RSA","No","1/29/2021","6/30/2026","$80K - $800K","Right","Fairly Strong","Very Strong","6'0""","176 lbs","118","2",118,130,6,6,4,3,9,3,13,6,4,15,9,7,12,11,7,14,11,10,12,15,5,5,12,8,15,10,8,12,11,10,8,11,13,11,14,12,15,13,12,12,13,10,8,10,7,5,13,13,13,3,3,2,2,3,3,4,3,1,1,1
"9139",65036400,"Luke Le Roux","3/10/2000 (23 years old)","DM, M/AM (C)","Varbergs BoIS","Swedish Premier Division","RSA","No","2/4/2020","12/31/2023","$0","Right","Reasonable","Very Strong","5'11""","154 lbs","99","3",112,130,9,12,10,9,12,11,11,11,7,12,13,11,12,12,16,11,12,12,12,12,14,10,11,12,12,13,12,13,12,10,12,8,12,12,13,12,8,9,9,16,13,13,5,14,15,4,12,14,13,1,2,2,2,2,1,1,3,3,2,1
"9140",57087552,"Alexandru Băluţă","9/13/1993 (29 years old)","AM (RC), ST (C)","Puskás Akadémia","Hungarian Division I","ROU","Yes","8/1/2020","6/30/2025","$0","Right","Fairly Strong","Very Strong","5'5""","136 lbs","309","58",121,135,12,10,12,13,13,11,9,13,6,7,11,10,5,13,13,11,12,13,12,11,15,14,12,14,6,11,13,14,14,15,9,6,13,14,11,7,15,6,7,12,13,12,3,9,13,11,11,14,10,1,1,2,2,1,3,3,1,2,1,1
"9141",65030425,"Mothobi Mvala","6/14/1994 (28 years old)","DM, M (C)","Sundowns","South African Premier Soccer League","RSA","No","7/1/2020","6/30/2024","$250K - $750K","Right","Reasonable","Very Strong","5'10""","171 lbs","202","42",116,130,8,9,9,11,9,9,9,11,1,13,12,4,14,12,12,14,13,8,10,14,3,6,13,10,14,8,14,11,14,11,10,4,10,12,7,15,14,14,11,10,10,12,10,3,8,7,13,12,19,2,3,2,2,4,1,2,3,3,2,3
"9142",12011996,"Youssef Msakni","10/28/1990 (32 years old)","M (L), AM (LC)","Al-Duhail","Qatar Stars League","TUN","No","6/14/2021","6/30/2025","Not for Sale","Right","Reasonable","Very Strong","5'10""","160 lbs","267","136",125,150,12,12,15,12,14,12,7,14,4,5,14,12,6,15,12,14,10,14,11,12,14,16,13,14,7,10,15,11,13,14,13,9,13,13,11,9,8,9,10,14,11,12,14,17,8,8,12,13,7,1,3,2,3,3,3,2,1,2,2,1
"9143",85126092,"Ellyes Skhiri","5/10/1995 (28 years old)","DM, M (C)","1. FC Köln","Bundesliga","TUN","Yes","6/15/2020","6/30/2027","$25M - $38M","Right","Reasonable","Very Strong","6'1""","163 lbs","242","27",143,146,4,8,12,12,13,6,13,12,6,13,14,7,16,13,15,16,16,14,13,13,17,12,14,13,13,15,12,17,12,12,15,13,16,13,19,12,13,12,12,16,14,16,6,13,11,6,16,16,14,1,3,3,3,1,1,3,3,4,3,3
"9144",34011589,"Wahbi Khazri","2/8/1991 (32 years old)","AM (LC), ST (C)","Montpellier","Ligue 1 Uber Eats","TUN","Yes","7/1/2022","6/30/2023","$150K - $450K","Right","Fairly Strong","Very Strong","6'0""","167 lbs","410","95",128,145,16,14,14,13,14,15,7,13,5,4,13,13,5,15,11,12,12,14,12,12,13,17,12,12,7,12,14,14,12,13,14,9,12,12,12,12,12,9,10,13,11,16,5,15,13,7,10,15,6,4,2,3,1,3,2,4,2,1,3,1
"9145",12056378,"Ali Maâloul","1/1/1990 (33 years old)","D/WB/M (L)","Al-Ahly","Egyptian Premier League","TUN","No","12/30/2021","7/31/2024","Not for Sale","Left","Very Strong","Reasonable","5'9""","158 lbs","311","65",135,145,15,17,13,13,13,14,7,9,12,11,14,16,13,13,12,11,13,14,10,12,15,12,10,15,10,13,12,15,15,13,10,9,12,15,13,10,8,10,10,15,13,12,5,13,7,8,12,11,12,1,4,3,2,1,2,3,2,1,3,3
"9146",12014167,"Aymen Abdennour","8/6/1989 (33 years old)","D (C)","Rodez AF","Ligue 2 BKT","TUN","No","8/30/2022","6/30/2024","$12K - $110K","Left","Very Strong","Weak","6'0""","194 lbs","267","14",107,145,5,9,10,6,8,7,15,11,12,14,11,8,13,10,18,13,17,11,12,12,16,8,12,8,14,15,9,13,7,6,15,14,13,8,7,15,11,11,11,14,13,11,14,13,15,8,10,15,12,2,2,1,3,4,2,3,2,3,2,2
"9147",13198535,"Montassar Talbi","5/26/1998 (25 years old)","D (C)","FC Lorient","Ligue 1 Uber Eats","TUN","Yes","7/18/2022","6/30/2027","$8.8M - $11M","Right","Weak","Very Strong","6'3""","178 lbs","132","3",133,144,6,8,11,8,12,7,14,8,9,13,13,9,14,12,13,15,16,14,13,11,14,7,12,8,15,14,12,13,12,12,15,15,14,13,15,13,8,10,17,14,14,11,7,13,14,6,14,12,14,2,3,2,2,2,2,3,3,3,2,3
"9148",48044736,"Hamza Rafia","4/2/1999 (24 years old)","M (C), AM (RC)","Pescara","Italian Serie C/B","TUN","Yes","1/27/2023","6/30/2024","$325K - $3.3M","Right Only","Weak","Very Strong","5'11""","165 lbs","117","9",121,141,14,12,15,11,15,13,8,14,5,5,13,11,13,14,14,12,9,12,11,12,13,14,11,14,12,11,13,13,13,13,13,8,12,13,13,11,13,15,9,12,12,9,9,8,12,7,13,13,8,2,3,1,2,2,2,2,1,3,2,2
"9149",48036350,"Aïssa Laidouni","12/13/1996 (26 years old)","DM, M (C)","Union Berlin","Bundesliga","TUN","Yes","1/27/2023","6/30/2026","$6M - $9.2M","Right","Weak","Very Strong","6'0""","165 lbs","171","18",132,140,10,11,13,10,13,11,11,12,6,13,13,11,13,13,17,13,17,13,12,12,14,13,12,12,13,15,12,17,12,13,15,12,14,14,16,14,12,9,11,12,12,10,5,15,14,7,13,13,13,3,2,1,3,3,3,2,2,1,1,1
"9150",49056369,"Hannibal","1/21/2003 (20 years old)","M/AM (C)","Man UFC","English Premier Division","TUN","Yes","3/15/2021","6/30/2024","$28M - $34M","Right","Reasonable","Very Strong","6'0""","154 lbs","41","1",127,140,14,11,14,10,14,13,6,10,3,5,12,11,9,15,16,13,13,12,11,11,17,15,6,12,7,13,12,18,13,14,13,11,15,14,16,9,10,6,7,14,13,7,5,17,14,10,12,18,16,1,1,2,3,1,3,2,2,3,3,2
"9151",57142187,"Dennis Man","8/26/1998 (24 years old)","AM (R)","Parma","Italian Serie B","ROU","Yes","1/29/2021","6/30/2025","$200K - $2M","Left","Very Strong","Reasonable","6'0""","180 lbs","229","73",123,135,11,10,13,13,13,7,12,12,7,5,12,10,7,14,10,11,12,11,10,11,16,13,8,14,7,9,11,12,15,14,12,10,13,12,15,13,11,8,13,17,10,13,2,9,4,6,10,18,10,1,2,1,1,3,3,1,2,4,1,3
"9152",2000104343,"Mohamed Dhaoui","5/14/2003 (20 years old)","M (R), AM (RL)","Al-Ahly","Egyptian Premier League","TUN","No","1/5/2022","7/31/2027","$350K - $3.5M","Left","Very Strong","Weak","5'9""","141 lbs","32","6",103,139,10,12,14,11,13,8,6,10,5,4,11,8,5,13,7,13,8,12,12,9,14,15,8,10,5,8,11,12,14,13,13,7,12,13,10,6,13,10,6,13,12,12,7,14,13,7,18,12,13,3,1,2,1,1,3,3,1,2,2,3
"9153",2000023237,"Chaïm El Djebali","2/7/2004 (19 years old)","M/AM (C)","OL","French National 3 - Group K","TUN","Yes","6/13/2022","6/30/2025","$1.9M - $3.9M","Right Only","Weak","Very Strong","5'7""","134 lbs","-","-",94,138,9,10,14,11,12,9,5,9,2,10,14,12,11,13,15,10,6,9,8,14,11,14,12,11,9,14,12,10,11,14,13,6,11,12,6,12,14,13,3,12,13,12,6,15,12,5,10,10,17,1,3,2,3,3,1,3,2,2,3,1
"9154",2000121537,"Mohamed Wael Derbali","6/18/2003 (19 years old)","DM, M (C)","O. Béja","Ligue Professionnelle 1","TUN","Yes","8/20/2021","6/30/2025","$275K - $850K","Right","Weak","Very Strong","6'2""","180 lbs","32","-",110,138,9,11,12,9,13,7,11,8,7,9,13,7,12,13,13,12,9,12,12,11,15,7,10,12,12,15,12,14,12,12,14,14,15,12,13,12,9,13,2,14,12,13,12,14,10,3,11,14,13,2,2,3,3,2,2,3,3,2,1,3
"9155",13232260,"Mohamed Ali Ben Romdhane","9/6/1999 (23 years old)","DM, M (C)","ES Tunis","Ligue Professionnelle 1","TUN","No","6/15/2020","6/30/2026","$650K - $8.4M","Right","Reasonable","Very Strong","6'1""","174 lbs","93","19",127,138,12,11,13,12,11,12,9,12,6,10,14,14,13,13,12,14,14,12,13,11,14,13,11,14,10,15,12,15,14,12,13,11,16,12,15,13,11,3,13,13,13,10,5,15,9,5,16,15,6,3,4,2,3,3,3,3,1,3,1,1
"9156",28106393,"Yan Valery","2/22/1999 (24 years old)","D (RC)","Angers SCO","Ligue 2 BKT","TUN","Yes","9/1/2022","6/30/2026","$1.5M - $3.2M","Right","Reasonable","Very Strong","6'0""","165 lbs","80","2",117,135,7,13,13,7,12,7,12,7,11,13,12,8,13,12,12,10,11,10,10,11,3,10,5,6,12,12,10,12,15,13,13,13,14,14,15,9,13,20,9,11,11,11,6,9,6,2,10,10,19,1,3,2,3,1,2,2,2,1,1,1
"9157",2000072683,"Oussema Abid","8/10/2002 (20 years old)","DM, M/AM (C)","ES Sahel","Ligue Professionnelle 1","TUN","No","12/23/2021","6/30/2025","$450K - $4.4M","Right","Reasonable","Very Strong","5'9""","152 lbs","45","11",116,135,11,11,12,11,14,13,6,13,4,7,14,14,12,13,13,13,9,12,11,11,14,11,8,13,10,12,12,12,12,13,14,8,14,12,13,7,13,10,11,13,12,11,10,12,9,5,13,12,11,2,3,1,4,3,2,2,1,3,3,1
"9158",85059261,"Naïm Sliti","7/27/1992 (30 years old)","AM (RLC)","Al-Ettifaq","Saudi Professional League","TUN","Yes","8/11/2019","6/30/2026","$15.5M - $18.5M","Right","Fairly Strong","Very Strong","5'8""","167 lbs","282","47",125,135,11,10,14,12,15,14,7,12,6,8,14,13,5,15,8,12,8,14,10,11,12,13,13,14,5,7,14,10,13,14,13,8,13,13,13,11,14,10,15,14,10,13,6,12,8,5,12,15,10,1,3,3,1,3,3,3,2,1,1,1
"9159",918393,"Chaouki Ben Saada","7/1/1984 (38 years old)","AM (RLC)","SC Bastia","Ligue 2 BKT","TUN","Yes","7/1/2022","-","$0","Left","Very Strong","Weak","5'9""","158 lbs","475","44",89,135,11,12,12,9,12,12,7,12,5,2,12,12,3,13,10,11,10,11,12,11,11,13,5,11,6,12,13,10,10,11,12,8,11,11,10,11,10,17,17,12,15,16,12,12,6,5,11,10,11,3,2,3,3,3,4,1,4,4,4,3
"9160",83160147,"Elias Achouri","2/10/1999 (24 years old)","M/AM (RL)","Viborg FF","3F Superliga","TUN","Yes","8/31/2022","6/30/2024","$400K - $4M","Right","Fairly Strong","Very Strong","5'10""","154 lbs","70","17",130,135,12,13,15,12,15,9,7,9,7,4,12,11,6,15,13,14,10,12,12,11,10,15,8,13,6,13,12,12,15,14,13,9,12,14,13,7,12,10,8,13,11,11,6,10,5,8,11,14,15,3,1,2,2,3,4,1,1,1,3,1
"9161",8434244,"Yohan Benalouane","3/28/1987 (36 years old)","D (C)","Novara","Italian Serie C/A","TUN","Yes","7/14/2022","6/30/2024","$0 - $26K","Right","Reasonable","Very Strong","6'1""","189 lbs","237","7",98,135,5,9,11,6,12,6,14,8,6,13,10,8,12,11,16,12,15,12,9,12,13,9,12,7,11,13,9,12,7,7,15,14,10,8,8,15,6,3,6,16,11,12,9,14,17,14,10,13,12,3,3,1,2,1,2,3,1,1,1,3
"9162",57030125,"Alin Toşca","3/14/1992 (31 years old)","D (LC)","Benevento","Italian Serie C/C","ROU","Yes","1/30/2023","6/30/2024","$0","Left","Very Strong","Reasonable","5'11""","176 lbs","339","-",110,135,8,11,10,7,11,5,12,6,12,12,12,9,12,12,7,12,13,13,13,13,16,5,11,7,13,12,12,13,10,10,13,12,13,9,10,14,13,14,14,16,10,12,6,13,6,6,13,15,14,2,3,1,3,3,2,1,2,2,1,1
"9163",12063540,"Mortadha Ben Ouannes","7/2/1994 (28 years old)","M/AM (RL)","Kasımpaşa","Turkish Super League","TUN","No","7/5/2021","6/30/2025","$325K - $7.2M","Left","Very Strong","Weak","6'0""","171 lbs","154","19",125,135,12,13,13,10,13,12,10,10,10,12,13,7,10,14,12,14,12,14,12,13,13,13,8,14,11,14,14,12,11,12,13,9,14,14,13,13,15,13,12,14,13,11,8,13,8,2,14,9,7,3,3,3,1,2,3,1,3,2,4,1
"9164",2000010622,"Mootez Zaddem","1/5/2001 (22 years old)","DM, M (RC)","ES Tunis","Ligue Professionnelle 1","TUN","No","8/9/2022","6/30/2026","$400K - $4.1M","Right","Reasonable","Very Strong","6'1""","178 lbs","62","1",109,135,9,10,12,10,12,8,8,13,7,9,13,9,12,12,15,13,12,10,12,9,13,11,8,12,9,12,12,14,13,12,13,13,14,12,14,11,16,17,6,11,10,12,7,7,16,5,20,15,13,1,3,3,2,3,3,1,1,1,1,3
"9165",2000115189,"Mohamed Anas Haj","3/26/2005 (18 years old)","M/AM (C)","Parma","Italian Serie B","TUN","Yes","8/9/2021","6/30/2024","$350K - $1.1M","Right","Weak","Very Strong","5'9""","154 lbs","-","-",74,135,9,8,11,10,10,9,8,7,5,5,10,9,5,8,9,13,12,8,8,11,10,12,6,13,8,13,12,9,12,10,8,8,10,12,10,8,12,15,10,11,11,11,5,4,13,5,10,9,19,1,3,2,3,2,2,1,3,4,2,2
"9166",2000172734,"Mohamed Adem Ouertani","2/20/2003 (20 years old)","DM, M (C)","ES Sahel","Ligue Professionnelle 1","TUN","No","7/1/2021","6/30/2026","$250K - $2.5M","Right","Reasonable","Very Strong","6'0""","158 lbs","9","-",92,135,9,10,11,7,13,7,7,9,6,6,13,8,10,12,10,11,8,12,11,9,6,12,9,11,10,12,13,11,11,12,13,12,11,12,11,7,14,20,3,12,11,10,10,14,5,6,14,12,9,1,3,3,1,2,2,2,3,1,4,1
"9167",2000273248,"Mohamed Amine Jebali","7/12/2002 (20 years old)","M/AM (C)","ES Sahel","Ligue Professionnelle 1","TUN","No","2/4/2022","6/30/2027","$350K - $3.6M","Right","Reasonable","Very Strong","6'1""","158 lbs","-","-",100,135,8,10,12,9,13,10,7,9,5,7,13,5,10,13,12,11,12,12,12,11,14,14,8,11,9,12,12,11,12,13,12,7,13,12,10,6,13,16,7,12,15,11,11,2,15,5,10,12,10,1,2,3,3,2,1,3,3,3,3,4
"9168",91187786,"Omar Rekik","12/20/2001 (21 years old)","D (LC), DM","Arsenal","English Premier Division","TUN","Yes","1/7/2021","6/30/2024","$90K - $900K","Right","Fairly Strong","Very Strong","6'1""","176 lbs","26","1",106,135,5,9,11,7,12,8,12,10,6,11,12,7,12,12,12,12,12,12,11,11,14,12,10,10,11,12,12,12,11,10,12,13,12,12,12,12,12,13,14,12,13,10,11,13,11,9,12,13,15,1,3,3,2,4,1,2,2,3,3,1
"9169",13198531,"Maher Ben Seghaier","4/22/1996 (27 years old)","M/AM (L)","US Monastir","Ligue Professionnelle 1","TUN","No","8/5/2021","6/30/2025","$4K - $40K","Right Only","Weak","Very Strong","6'0""","167 lbs","64","5",90,135,9,10,14,9,13,11,8,11,6,5,12,7,3,14,9,12,5,12,9,7,8,16,5,12,6,8,11,10,14,12,12,8,7,12,9,7,6,13,6,6,10,11,15,12,13,14,8,12,6,3,2,1,1,2,1,2,2,3,2,2
"9170",13198346,"Mohamed Amine Ben Amor","5/3/1992 (31 years old)","DM, M (C)","ES Sahel","Ligue Professionnelle 1","TUN","No","6/14/2021","6/30/2025","Not for Sale","Right","Weak","Very Strong","5'11""","171 lbs","98","2",108,135,9,7,10,6,12,9,10,9,8,12,13,11,14,12,12,13,9,14,12,12,14,9,14,8,13,15,12,12,12,9,11,9,8,12,11,12,10,20,4,16,11,12,15,14,14,4,14,17,17,3,3,1,2,3,1,3,2,1,1,3
"9171",2000106505,"Elias Saad","12/27/1999 (23 years old)","M (L), AM (RLC)","St. Pauli","Bundesliga 2","TUN","Yes","1/1/2023","6/30/2025","$1.7M - $3.5M","Right Only","Weak","Very Strong","6'1""","158 lbs","96","42",118,134,11,9,16,12,14,11,6,9,6,7,13,11,8,16,11,12,10,12,11,12,15,16,4,12,7,11,13,12,15,16,10,10,13,12,11,7,12,13,11,13,13,12,7,12,5,6,13,15,16,1,1,1,2,3,3,3,2,2,1,3
"9172",13198333,"Ghaylene Chaalali","2/28/1994 (29 years old)","DM, M (C)","ES Tunis","Ligue Professionnelle 1","TUN","No","5/11/2020","6/30/2023","$95K - $275K","Right","Weak","Very Strong","5'10""","169 lbs","133","7",125,133,12,12,11,7,12,11,8,10,9,11,13,11,15,13,16,13,15,11,10,12,15,10,12,11,12,14,14,15,12,12,13,12,13,12,16,14,12,10,17,12,14,16,11,17,14,6,12,11,9,2,2,3,3,1,2,3,2,2,1,1
"9173",7542068,"Marius Constantin","10/25/1984 (38 years old)","D (C)","FC Argeş","Romanian Second League","ROU","Yes","6/15/2022","9/5/2023","$0 - $30K","Right","Reasonable","Very Strong","6'1""","176 lbs","450","20",80,134,5,8,7,8,10,9,13,9,8,12,8,12,13,9,14,12,13,10,11,12,14,7,12,8,13,13,6,11,6,6,11,12,12,6,6,12,6,10,12,14,7,11,12,14,14,8,12,12,10,1,2,2,1,1,3,3,2,2,1,4
"9174",2000071869,"Adem Garreb","5/22/2003 (20 years old)","M/AM (RL)","Club Africain","Ligue Professionnelle 1","TUN","No","7/17/2021","6/30/2025","$2.3M - $4.8M","Left Only","Very Strong","Weak","5'9""","154 lbs","39","3",103,133,9,11,14,7,12,7,5,8,6,5,11,8,4,14,6,11,9,11,10,10,13,14,7,9,5,11,10,12,15,14,11,9,12,14,10,6,12,17,10,12,14,10,12,8,11,4,13,15,9,3,3,3,1,1,2,2,2,2,2,1
"9175",27132918,"Anis Slimane","3/16/2001 (22 years old)","M/AM (C)","Brøndby IF","3F Superliga","TUN","Yes","6/30/2019","6/30/2024","$650K - $6.4M","Right","Strong","Very Strong","6'2""","165 lbs","122","11",116,133,8,9,11,10,12,12,11,10,6,11,13,8,11,12,14,12,12,11,11,11,11,13,6,13,11,13,12,13,12,11,11,14,12,12,11,13,12,6,1,10,9,9,11,14,5,14,9,12,19,2,2,2,3,2,3,3,2,2,1,3
"9176",48043981,"Dylan Bronn","6/19/1995 (27 years old)","D (RC)","Salernitana","Italian Serie A","TUN","Yes","8/12/2022","6/30/2025","$1.6M","Right","Weak","Very Strong","6'1""","169 lbs","240","18",121,132,6,8,10,8,10,8,14,6,7,14,13,12,14,10,14,13,14,13,11,11,10,5,12,8,13,13,9,14,12,11,14,13,11,13,14,14,13,20,3,12,12,12,11,8,10,6,11,14,16,4,3,3,2,3,2,1,3,3,2,2
"9177",12003063,"Chadi Hammami","6/14/1986 (36 years old)","DM, M (C)","CS Sfax","Ligue Professionnelle 1","TUN","No","6/30/2020","6/30/2024","$1.5K - $16K","Right Only","Weak","Very Strong","6'0""","174 lbs","228","43",101,131,9,10,10,10,12,8,10,8,9,13,13,11,12,12,13,13,12,12,12,12,11,8,14,12,13,14,12,10,11,11,12,11,14,10,10,11,11,10,5,15,9,13,6,9,10,7,16,11,14,3,1,3,1,3,2,3,1,2,3,1
"9178",8627187,"Issam Jemâa","1/28/1984 (39 years old)","AM (L), ST (C)","St-Esthève Esp Perpignan","French National 3 - Group B","TUN","No","7/1/2022","6/30/2023","$0 - $2.5K","Left","Very Strong","Weak","6'1""","182 lbs","264","91",79,131,7,9,12,9,11,9,13,10,5,3,11,12,4,14,10,11,11,10,8,7,13,12,10,12,6,10,7,9,11,8,11,11,10,10,8,11,10,13,13,10,8,12,12,14,12,15,10,14,13,1,2,3,2,3,3,2,3,2,3,1
"9179",85104572,"Mouez Hassen","3/5/1995 (28 years old)","GK","Club Africain","Ligue Professionnelle 1","TUN","Yes","9/8/2021","6/30/2023","$0 - $100K","Right Only","Weak","Very Strong","6'0""","154 lbs","122","-",109,131,6,1,2,2,11,8,3,2,2,2,12,2,2,9,9,11,14,12,11,11,13,2,10,1,10,12,9,8,11,14,10,12,10,12,10,12,1,12,15,12,10,14,14,13,8,8,10,14,7,9,13,14,14,13,13,10,10,12,11,11
"9180",12003109,"Zouheir DhaouadI","1/11/1988 (35 years old)","AM (RL)","Club Africain","Ligue Professionnelle 1","TUN","No","6/14/2021","6/30/2024","$40K - $120K","Left Only","Very Strong","Weak","5'11""","154 lbs","275","46",98,130,11,12,14,11,11,13,8,10,7,3,12,14,6,15,9,12,6,13,13,12,11,15,14,13,4,12,13,9,13,12,8,6,13,12,7,8,8,9,9,9,10,14,13,15,14,12,12,13,5,1,1,2,3,3,3,2,3,1,1,1
"9181",8438268,"Tijani Belaïd","9/6/1987 (35 years old)","AM (RC)","AS Marsa","Ligue Professionnelle 1","TUN","Yes","1/29/2023","6/30/2024","$0 - $16K","Right Only","Weak","Very Strong","5'11""","158 lbs","243","38",84,130,12,11,12,9,13,13,6,11,6,7,12,10,8,14,8,13,8,12,9,10,6,14,5,13,6,8,12,9,11,10,8,7,10,10,10,8,8,8,8,7,4,5,9,8,12,16,9,14,13,4,3,3,3,2,3,3,2,1,3,1
"9182",2000081300,"Raki Aouani","9/11/2004 (18 years old)","AM (RL), ST (C)","ES Sahel","Ligue Professionnelle 1","TUN","No","7/1/2020","6/30/2027","$375K - $3.7M","Right Only","Weak","Very Strong","5'10""","156 lbs","26","2",95,130,9,10,12,11,11,7,7,8,6,4,11,8,6,13,9,11,7,11,10,10,15,13,7,10,5,10,10,11,13,13,9,9,12,13,11,7,13,13,4,12,12,11,6,13,8,7,15,14,16,2,3,2,3,3,4,1,3,3,3,3
"9183",93033264,"Amor Layouni","10/3/1992 (30 years old)","M (L), AM (RL)","Vålerenga","Norwegian Premier Division","TUN","Yes","1/25/2021","12/31/2024","$75K - $750K","Left","Very Strong","Fairly Strong","6'3""","178 lbs","280","80",118,130,9,13,14,13,12,9,7,12,4,5,11,12,6,14,10,12,10,13,11,12,14,15,5,13,6,12,12,13,12,11,11,12,13,14,13,10,8,15,8,15,13,5,7,13,3,18,12,11,12,1,2,2,3,3,2,3,3,1,2,2
"9184",7549058,"Florin Costea","5/16/1985 (38 years old)","AM (L), ST (C)","ARO Muscelul Câmpulung","Romanian Third League Group 4","ROU","Yes","2/6/2023","6/30/2023","$0","Right Only","Weak","Very Strong","6'1""","176 lbs","289","118",62,134,9,9,12,8,12,11,9,12,5,2,10,14,2,15,9,8,9,9,9,9,8,13,9,13,5,5,9,5,10,11,10,12,8,10,8,11,10,10,10,10,9,12,9,12,10,10,7,6,8,2,1,2,3,3,2,3,3,3,3,1
"9185",12056229,"Mehdi Ressaïssi","3/5/1990 (33 years old)","D (C)","Al-Soukour","Libyan First Division","TUN","No","9/13/2022","6/30/2024","$14K - $45K","Right Only","Very Weak","Very Strong","6'0""","176 lbs","149","6",90,130,6,7,8,5,11,6,14,7,12,13,9,2,13,11,14,13,14,11,9,10,15,10,7,10,12,13,9,12,9,8,12,14,12,10,11,12,12,14,8,13,13,11,14,8,11,7,12,13,9,2,1,2,2,1,2,1,1,1,3,2
"9186",13198326,"Saad Bguir","3/22/1994 (29 years old)","AM (C)","Abha","Saudi Professional League","TUN","No","1/2/2022","6/30/2025","$8.8M - $13M","Left Only","Very Strong","Weak","5'9""","134 lbs","251","67",125,130,14,13,12,14,15,14,8,15,7,6,15,14,5,15,8,13,8,16,13,14,15,14,12,16,8,14,14,12,13,15,14,8,12,12,11,6,8,15,15,13,11,14,10,17,7,7,14,9,13,3,3,3,3,1,3,2,2,1,3,1
"9187",12056386,"Ferjani Sassi","3/18/1992 (31 years old)","DM, M (C)","Al-Duhail","Qatar Stars League","TUN","No","7/29/2021","6/30/2025","Not for Sale","Right","Weak","Very Strong","6'1""","176 lbs","266","31",120,130,11,11,13,10,14,11,12,14,4,9,15,14,10,16,11,12,9,13,10,12,11,14,9,13,12,14,14,12,11,11,14,12,12,12,12,12,11,10,11,11,10,10,8,10,2,5,13,11,12,4,2,1,1,1,3,4,2,2,2,2
"9188",12055958,"Rami Bedoui","1/19/1990 (33 years old)","D (C)","Club Africain","Ligue Professionnelle 1","TUN","No","1/14/2022","6/30/2023","$0 - $8K","Right Only","Very Weak","Very Strong","6'2""","180 lbs","168","11",105,130,6,7,8,6,11,9,12,8,12,12,12,7,13,11,14,13,13,11,10,12,13,6,8,11,13,12,11,13,12,11,11,14,15,11,12,12,11,11,5,11,10,10,8,12,11,7,12,8,11,1,2,3,1,2,3,2,3,1,1,3
"9189",12011990,"Mossaab Sassi","3/12/1990 (33 years old)","M/AM (RL)","ES Hammam-Sousse","Ligue Professionnelle 2","TUN","No","9/14/2021","6/30/2024","$60K - $600K","Left Only","Very Strong","Very Weak","6'0""","160 lbs","186","29",92,130,10,11,14,7,14,10,7,6,5,4,13,10,4,14,12,11,9,8,9,10,9,14,9,11,5,10,11,11,13,12,9,9,10,13,11,9,6,20,5,8,8,11,9,11,5,4,10,7,15,2,3,2,2,2,2,2,1,4,3,1
"9190",2000035741,"Zakaria El Ayeb","1/15/2003 (20 years old)","DM, M (C)","ES Tunis","Ligue Professionnelle 1","TUN","No","7/1/2020","6/30/2026","$1M - $2.2M","Right","Reasonable","Very Strong","6'2""","156 lbs","7","-",96,130,10,11,11,8,13,8,9,10,6,8,13,7,10,12,10,11,9,12,11,10,12,11,8,10,10,12,13,11,11,12,12,14,13,12,11,7,13,17,8,11,12,9,5,2,10,6,12,15,13,3,3,2,2,3,1,3,2,2,1,1
"9191",49038543,"Bassem Srarfi","6/25/1997 (25 years old)","AM (RLC)","Al-Arabi","Kuwaiti Premier League","TUN","No","1/9/2023","6/30/2024","$80K - $800K","Left Only","Very Strong","Weak","5'9""","156 lbs","127","12",107,130,8,11,14,10,12,8,6,8,5,5,12,10,5,15,6,11,7,11,9,9,9,15,6,13,7,11,13,11,14,13,12,6,14,14,12,9,11,3,9,8,7,12,7,13,10,5,9,14,7,1,2,2,2,3,4,4,2,3,1,3
"9192",2000081291,"Aziz Fellah","5/9/2002 (21 years old)","M/AM (C)","ES Tunis","Ligue Professionnelle 1","TUN","No","7/1/2022","6/30/2026","$2.5K - $24K","Left","Very Strong","Reasonable","5'9""","154 lbs","4","-",85,130,10,12,13,8,12,10,6,9,4,5,12,8,6,12,6,11,5,12,10,8,16,14,6,8,7,10,13,10,13,13,12,7,12,11,9,5,13,20,9,13,15,7,10,7,7,7,10,12,14,3,1,4,1,3,2,4,2,1,1,1
"9193",2000054577,"Houssem Teka","8/16/2000 (22 years old)","DM, M (C)","US Monastir","Ligue Professionnelle 1","TUN","No","6/15/2020","6/30/2026","$200K - $600K","Right","Weak","Very Strong","5'9""","149 lbs","83","2",114,130,9,12,12,8,13,7,6,11,6,9,14,7,12,13,12,13,8,13,11,11,15,12,10,13,10,13,12,13,13,14,12,9,15,13,16,7,14,16,11,14,11,13,6,14,12,1,12,11,9,3,3,1,2,4,2,2,3,2,1,2
"9194",13232121,"Alaa Ghram","7/24/2001 (21 years old)","D (C)","CS Sfax","Ligue Professionnelle 1","TUN","No","8/16/2021","6/30/2024","$2.5M - $5M","Right","Weak","Very Strong","6'3""","187 lbs","56","1",114,130,5,8,8,7,12,7,13,8,7,13,13,10,14,11,14,12,11,12,11,12,14,7,11,7,13,13,11,12,11,10,12,14,13,13,12,13,10,20,7,14,13,13,11,1,13,4,12,10,12,2,1,1,2,1,1,1,3,2,2,2
"9195",2000045306,"Rareş Ilie","4/19/2003 (20 years old)","M (C), AM (LC)","OGC Nice","French Regional 1 - Méditerranée","ROU","Yes","7/17/2022","6/30/2027","$180K - $1.8M","Right","Reasonable","Very Strong","6'1""","160 lbs","72","9",112,148,13,12,12,11,13,12,11,11,6,8,13,9,11,14,7,11,9,12,10,10,13,11,4,12,9,12,13,12,11,12,12,10,10,12,12,11,8,15,13,14,11,14,5,10,5,2,11,13,13,4,3,2,1,3,1,3,3,1,2,3
"9196",2000051013,"Cristian Mihai","9/23/2004 (18 years old)","M (C)","UTA Arad","Romanian First League","ROU","Yes","7/1/2020","6/30/2024","$1.7M - $3.7M","Right","Fairly Strong","Very Strong","6'0""","160 lbs","25","2",93,134,9,10,10,9,11,9,10,9,7,9,11,9,10,11,11,10,11,10,11,9,12,10,6,10,9,13,11,13,11,11,10,12,13,12,13,11,12,17,13,13,11,9,7,8,7,8,11,12,20,3,2,2,3,3,2,1,2,1,3,1
"9197",13229852,"Aymen Dahmen","1/28/1997 (26 years old)","GK","CS Sfax","Ligue Professionnelle 1","TUN","No","6/15/2020","6/30/2024","$400K - $4M","Right Only","Very Weak","Very Strong","6'2""","182 lbs","107","-",120,130,4,1,2,3,7,6,2,2,3,2,8,3,1,5,11,12,14,13,12,12,14,5,11,4,14,12,9,8,11,14,10,14,10,12,11,12,11,10,5,13,14,11,12,14,13,3,16,12,9,11,5,15,9,13,9,13,10,14,12,13
"9198",34009930,"Cédric Bakambu","4/11/1991 (32 years old)","ST (C)","Olympiacos","Greek Super League 1","COD","Yes","9/15/2022","6/30/2024","$160K - $1.6M","Right","Reasonable","Very Strong","6'0""","163 lbs","314","132",130,150,5,10,12,13,12,8,12,12,6,7,10,14,6,13,12,13,13,12,11,12,13,12,8,17,7,10,10,12,15,14,14,11,15,15,14,12,8,15,12,15,10,12,6,15,11,10,12,14,13,2,1,2,3,2,3,3,4,1,1,1
"9199",18006326,"Dieumerci Mbokani","11/22/1985 (37 years old)","ST (C)","SK Beveren","Belgian Challenger Pro League","COD","No","9/26/2022","6/30/2024","$20K - $200K","Right","Weak","Very Strong","6'1""","160 lbs","456","234",120,145,4,9,14,13,15,7,14,11,5,5,12,12,3,13,14,11,15,14,12,11,10,13,7,15,8,10,13,11,10,14,15,16,15,10,10,16,5,13,12,6,9,9,7,16,12,16,14,10,9,1,3,3,1,2,1,3,3,2,3,2
"9200",18057323,"Chancel Mbemba","8/8/1994 (28 years old)","D (RC)","OM","Ligue 1 Uber Eats","COD","Yes","7/15/2022","6/30/2025","$21M - $26M","Right","Fairly Strong","Very Strong","6'0""","176 lbs","242","17",142,145,4,9,11,6,12,4,15,10,4,15,14,7,14,12,11,14,15,11,13,13,15,10,13,11,12,15,11,15,15,13,16,13,14,15,15,14,14,15,13,16,13,9,13,15,8,5,14,14,14,2,3,3,3,1,3,2,1,1,1,1
"9201",28018844,"Benik Afobe","2/12/1993 (30 years old)","AM (L), ST (C)","Hatta","UAE Professional League","COD","No","1/9/2023","5/31/2024","$0","Right","Reasonable","Very Strong","6'0""","171 lbs","376","105",117,144,5,9,10,12,13,6,12,10,9,5,12,11,6,15,11,13,9,13,13,11,13,14,8,15,6,11,10,15,13,13,13,12,12,12,13,14,6,15,15,13,12,16,10,13,8,4,11,13,10,3,2,2,3,2,1,1,1,1,3,4
"9202",28101028,"Grady Diangana","4/19/1998 (25 years old)","M/AM (RL)","West Brom","Sky Bet Championship","COD","No","9/4/2020","6/30/2025","$5M - $7.6M","Left","Very Strong","Reasonable","5'11""","160 lbs","139","15",124,144,13,13,14,12,14,11,5,13,3,5,13,8,8,13,9,11,8,12,11,8,14,15,9,14,6,10,13,12,16,16,14,9,15,14,12,4,12,12,9,15,12,13,6,9,8,5,9,15,9,3,3,3,1,2,1,3,2,3,4,2
"9203",34001371,"Gaël Kakuta","6/21/1991 (31 years old)","AM (RLC), ST (C)","Amiens SC","Ligue 2 BKT","COD","Yes","10/5/2022","6/30/2026","Not for Sale","Left","Very Strong","Reasonable","5'8""","158 lbs","299","44",128,142,12,12,15,11,15,13,7,14,5,5,13,13,5,15,8,13,11,13,10,12,14,17,11,12,5,12,13,12,14,15,14,7,13,13,12,9,10,16,16,13,10,12,14,14,6,7,13,13,14,1,3,2,3,2,1,1,2,1,2,2
"9204",18081111,"Theo Bongonda","11/20/1995 (27 years old)","M (RL), AM (RLC)","Cádiz","Spanish First Division","COD","Yes","8/26/2022","6/30/2025","$275K - $2.7M","Left","Very Strong","Reasonable","5'10""","160 lbs","267","64",136,142,10,13,15,12,14,11,7,16,7,6,13,7,6,15,12,12,12,11,11,11,12,15,12,14,8,12,11,13,15,14,12,13,10,15,13,8,9,9,9,12,12,12,9,12,6,17,10,14,15,1,3,1,3,2,1,1,2,1,3,2
"9205",29132973,"Simon Banza","8/13/1996 (26 years old)","ST (C)","BRG","Portuguese Premier League","COD","Yes","7/19/2022","6/30/2027","$14.5M - $17.5M","Right","Fairly Strong","Very Strong","6'2""","165 lbs","177","53",137,140,8,10,12,15,13,7,18,10,8,4,9,12,5,12,15,16,16,12,13,12,14,12,7,16,6,11,12,13,12,12,11,16,15,13,13,13,10,11,10,12,14,8,6,11,5,7,13,13,18,1,2,1,1,3,4,3,1,2,2,1
"9206",85140175,"Yoane Wissa","9/3/1996 (26 years old)","M/AM (L), ST (C)","Brentford","English Premier Division","COD","Yes","5/4/2023","6/30/2026","$28M - $35M","Right Only","Weak","Very Strong","5'9""","163 lbs","244","66",137,140,10,13,14,14,12,11,9,12,8,6,14,13,8,14,12,13,13,13,13,13,13,13,8,14,8,14,13,14,15,14,12,8,14,15,14,12,14,14,15,14,12,13,7,13,8,6,13,13,12,2,1,1,3,1,2,1,1,3,1,2
"9207",2000105783,"Enes Sali","2/23/2006 (17 years old)","AM (L)","Farul Constanţa","Romanian First League","ROU","Yes","6/13/2022","6/30/2025","$210K - $2.1M","Right","Weak","Very Strong","5'5""","125 lbs","43","3",94,134,10,10,13,9,11,9,6,9,5,5,10,10,5,12,8,8,8,8,8,8,12,13,4,9,6,8,9,10,15,16,13,6,11,13,9,6,12,10,14,14,8,12,2,10,5,14,8,12,7,2,3,2,2,3,1,1,4,2,2,3
"9208",13187384,"Jackson Muleka","10/5/1999 (23 years old)","AM (RL), ST (C)","Beşiktaş","Turkish Super League","COD","No","7/7/2022","6/30/2027","$90K - $6.6M","Right","Fairly Strong","Very Strong","5'11""","169 lbs","100","37",115,140,1,4,12,13,12,1,14,10,1,2,11,8,2,13,12,14,12,12,12,12,14,12,10,14,5,14,11,14,13,12,13,12,14,12,14,12,13,13,10,10,11,13,5,10,11,6,12,13,15,3,3,2,2,1,2,1,3,1,3,3
"9209",85074537,"Arthur Masuaku","11/7/1993 (29 years old)","D (L)","Beşiktaş","Turkish Super League","COD","Yes","6/1/2023","6/30/2025","$9M - $10.5M","Left","Very Strong","Weak","5'10""","154 lbs","213","5",130,140,14,14,16,7,14,14,7,13,10,10,15,11,12,15,10,13,12,15,14,14,15,15,8,14,12,14,13,14,13,14,13,8,15,12,14,12,14,10,13,15,16,14,10,14,10,14,14,16,15,4,3,3,1,3,2,1,1,3,4,1
"9210",85095880,"Marcel Tisserand","1/10/1993 (30 years old)","D (C)","Al-Ettifaq","Saudi Professional League","COD","Yes","8/21/2022","6/30/2025","$9M - $14M","Right","Reasonable","Very Strong","6'1""","176 lbs","214","5",120,140,4,12,13,7,13,4,11,8,10,14,12,5,14,12,12,14,15,13,11,10,13,12,12,11,12,12,11,14,13,11,15,12,15,14,13,14,14,12,14,16,13,7,6,13,10,11,12,14,12,3,1,2,3,2,1,2,1,1,1,2
"9211",13134241,"Christian Luyindama","1/8/1994 (29 years old)","D (C)","Galatasaray","Turkish Super League","COD","No","6/1/2022","6/30/2024","$120K - $350K","Right Only","Weak","Very Strong","6'3""","200 lbs","128","8",100,140,4,5,8,5,8,8,15,6,8,13,8,7,14,8,17,13,14,10,11,10,12,10,13,6,11,12,10,12,7,7,12,16,10,10,14,17,5,12,7,7,13,12,16,11,11,7,12,13,13,3,4,2,3,3,1,2,1,2,1,1
"9212",13173388,"Meschack Elia","8/6/1997 (25 years old)","AM (R), ST (C)","Young Boys","Swiss Super League","COD","No","3/16/2023","6/30/2026","$8.8M - $13.5M","Right Only","Weak","Very Strong","5'8""","147 lbs","98","23",136,139,9,11,14,10,13,8,7,12,4,5,12,10,6,13,12,11,9,10,11,12,15,13,7,12,5,14,11,14,17,15,11,5,13,17,15,10,12,7,8,14,14,13,8,14,8,8,12,14,11,3,1,2,3,3,1,3,2,1,1,3
"9213",49054676,"Silas","10/6/1998 (24 years old)","WB/M (R), AM (RL), ST (C)","VfB Stuttgart","Bundesliga","COD","No","1/1/2023","6/30/2026","$1.2M - $12.5M","Right","Weak","Very Strong","6'2""","180 lbs","133","35",130,136,6,9,14,12,12,6,9,9,6,8,11,16,8,14,11,11,11,11,9,10,12,16,4,13,8,12,11,13,15,15,11,12,12,17,13,12,16,15,12,11,10,16,12,12,5,6,10,12,13,4,3,3,1,3,2,2,4,1,2,1
"9214",18107092,"Edo Kayembe","8/3/1998 (24 years old)","DM, M (C)","Watford","Sky Bet Championship","COD","No","1/7/2022","6/30/2026","$425K - $4.2M","Left Only","Very Strong","Weak","6'0""","180 lbs","107","4",116,135,7,7,11,10,12,12,10,14,7,12,12,7,15,12,17,13,14,13,12,12,14,12,10,7,8,13,11,12,14,11,14,11,14,14,14,17,12,14,12,7,8,15,10,2,14,1,12,12,13,3,3,3,1,3,3,3,2,1,3,2
"9215",18072298,"Samuel Bastien","9/26/1996 (26 years old)","DM, M (C)","Burnley","English Premier Division","COD","Yes","7/5/2022","6/30/2025","$220K - $9.2M","Right","Weak","Very Strong","5'9""","160 lbs","190","16",122,135,12,12,13,10,14,10,10,12,8,12,13,10,12,14,14,13,12,14,12,12,11,11,11,13,12,13,12,11,13,13,13,10,14,13,13,12,14,13,12,13,12,13,4,12,6,3,11,11,8,2,3,3,3,2,2,2,3,1,3,2
"9216",92023622,"Elias Kachunga","4/22/1992 (31 years old)","AM (RL)","Bolton","Sky Bet League One","COD","Yes","8/6/2021","6/30/2025","$18K - $180K","Right","Reasonable","Very Strong","5'10""","163 lbs","376","59",101,135,8,9,10,10,12,9,9,10,5,8,11,11,8,12,10,12,12,11,11,11,15,9,12,11,10,12,11,12,12,12,12,11,16,12,12,11,14,8,10,14,12,8,5,12,9,12,10,17,15,1,3,1,2,1,1,2,2,1,2,2
"9217",85059100,"Giannelli Imbula","9/12/1992 (30 years old)","DM, M (C)","Tuzlaspor","Turkish 1. League","COD","Yes","1/12/2023","6/30/2024","$0","Left","Very Strong","Reasonable","6'1""","185 lbs","274","12",105,135,4,10,12,8,15,9,9,10,7,8,13,7,10,15,9,13,12,15,11,12,7,10,9,11,13,5,13,10,8,11,14,12,14,10,10,13,8,13,8,5,9,4,9,14,13,16,6,15,6,1,3,3,3,1,2,1,3,1,2,3
"9218",67217491,"Andrei Raţiu","6/20/1998 (24 years old)","D/WB/M/AM (R)","Huesca","Spanish Second Division","ROU","Yes","8/4/2021","6/30/2024","$55K - $550K","Right","Weak","Very Strong","6'0""","176 lbs","202","8",120,133,5,12,12,7,10,7,8,8,8,11,11,6,11,12,11,9,12,9,11,13,10,12,8,11,11,13,11,13,14,13,13,11,13,14,14,14,15,12,9,10,11,11,4,12,8,5,11,11,10,3,3,1,1,2,1,2,1,2,1,3
"9219",28099976,"Marc Bola","12/9/1997 (25 years old)","D (LC), WB/M (L)","Middlesbrough","Sky Bet Championship","COD","No","7/28/2019","6/30/2025","$0","Left Only","Very Strong","Weak","6'1""","158 lbs","164","4",115,133,11,11,11,9,11,4,9,11,9,12,8,5,12,12,12,12,13,11,11,10,11,12,10,11,10,13,10,13,15,13,11,12,12,15,13,10,10,14,12,12,10,8,11,8,9,5,12,10,9,1,1,3,1,3,2,1,1,1,1,2
"9220",18116480,"John Nekadio","1/6/2002 (21 years old)","D (C)","Seraing FC","Belgian Challenger Pro League","COD","No","1/31/2023","6/30/2024","$130K - $1.3M","Right Only","Weak","Very Strong","6'5""","205 lbs","10","-",96,132,7,7,7,7,10,7,15,7,7,12,10,9,14,9,16,10,13,11,10,10,19,5,6,9,8,10,6,12,11,11,14,14,15,11,10,16,16,8,7,10,12,9,9,3,15,6,8,9,15,3,2,2,3,2,2,2,1,1,2,1
"9221",85136397,"Gédéon Kalulu","8/29/1997 (25 years old)","D (RLC)","FC Lorient","Ligue 1 Uber Eats","COD","Yes","7/1/2022","6/30/2026","$4.5M - $8.6M","Right","Weak","Very Strong","5'10""","171 lbs","133","2",125,132,7,12,11,8,12,7,10,9,11,13,12,11,14,12,11,14,14,14,12,12,15,7,12,13,13,14,12,14,13,14,14,9,14,13,14,11,14,13,12,14,10,13,6,11,9,1,12,11,14,4,3,3,1,3,2,4,3,2,3,3
"9222",29114978,"Aldo Kalulu","1/21/1996 (27 years old)","AM (RLC), ST (C)","FCSM","French National","COD","Yes","7/1/2021","6/30/2024","$250K - $2.5M","Right","Weak","Very Strong","5'5""","132 lbs","169","29",124,131,10,12,13,11,13,7,9,11,5,7,11,11,8,13,13,11,12,11,10,12,13,13,10,12,8,11,11,12,15,14,12,9,13,15,11,7,13,12,12,14,10,13,11,13,8,8,12,12,12,3,3,1,3,3,3,2,2,4,3,1
"9223",84153374,"Timothy Fayulu","7/24/1999 (23 years old)","GK","Sion","Swiss Challenge League","COD","Yes","6/15/2020","6/30/2024","$230K - $2.3M","Right Only","Weak","Very Strong","6'4""","185 lbs","61","-",113,131,3,1,2,1,1,5,2,3,1,2,13,3,1,4,8,12,13,10,9,10,11,8,8,1,11,12,11,12,11,13,12,18,15,11,11,13,14,11,11,13,9,12,11,19,5,6,12,11,13,13,13,14,12,14,11,13,11,10,13,14
"9224",85145281,"Dimitry Bertaud","6/6/1998 (25 years old)","GK","Montpellier","Ligue 1 Uber Eats","COD","Yes","9/24/2021","6/30/2025","$850K - $1.9M","Right Only","Weak","Very Strong","5'11""","187 lbs","24","-",119,130,6,3,2,2,12,10,1,1,1,1,13,4,3,12,14,13,13,10,13,12,13,3,7,3,14,12,10,10,10,12,14,9,13,9,13,12,1,10,12,14,12,14,7,13,12,8,13,12,20,10,13,15,11,14,11,13,7,12,13,10
"9225",13195048,"Ben Malango","5/11/1997 (26 years old)","ST (C)","Qatar SC","Qatar Stars League","COD","No","9/4/2022","5/31/2025","$6M - $9M","Right Only","Weak","Very Strong","6'3""","205 lbs","72","35",120,130,9,11,12,15,12,9,13,10,10,9,12,11,5,12,13,12,11,10,10,11,15,8,13,13,10,10,12,13,13,13,12,15,14,14,12,16,5,12,12,16,8,6,10,13,5,4,11,10,15,2,2,1,2,2,1,1,2,3,2,2
"9226",29022616,"Neeskens Kebano","3/10/1992 (31 years old)","AM (RLC)","Fulham","English Premier Division","COD","Yes","6/14/2021","6/30/2025","$240K - $9M","Right Only","Weak","Very Strong","5'8""","167 lbs","271","46",120,130,13,12,15,11,14,14,8,12,5,7,13,11,4,15,12,12,12,12,10,12,16,16,6,12,7,9,12,10,14,15,13,7,12,14,12,10,12,15,15,7,13,14,16,14,10,5,12,16,12,1,1,1,2,1,3,1,1,3,1,1
"9227",29080657,"Aaron Tshibola","1/2/1995 (28 years old)","M (C)","AEL","Cypriot First Division","COD","No","8/12/2022","6/30/2025","$160K - $475K","Right","Reasonable","Very Strong","6'3""","154 lbs","191","9",110,130,8,9,14,10,14,9,11,9,10,11,14,9,12,13,9,10,12,14,6,8,12,12,6,12,11,10,11,12,14,10,14,15,16,13,13,14,8,12,14,10,9,10,8,10,7,5,9,13,9,2,4,1,1,1,2,3,2,2,3,1
"9228",18018649,"Paul-José Mpoku","4/19/1992 (31 years old)","M (C), AM (RLC)","Incheon","Hana 1Q K LEAGUE 1","COD","Yes","12/12/2022","12/31/2025","Not for Sale","Right","Fairly Strong","Very Strong","5'10""","174 lbs","328","52",120,130,13,13,13,12,12,13,9,14,6,5,15,12,5,14,9,12,9,10,10,12,11,14,9,13,4,12,13,10,13,14,14,10,12,12,11,13,15,13,12,12,13,10,8,13,4,4,11,14,12,2,3,4,1,3,3,2,3,2,2,1
"9229",57148627,"Vladimir Screciu","1/13/2000 (23 years old)","D (C), DM","Universitatea Craiova","Romanian First League","ROU","Yes","7/1/2020","6/30/2025","$190K - $1.9M","Right","Weak","Very Strong","5'11""","154 lbs","132","1",117,133,6,5,9,6,12,6,13,10,9,13,12,6,14,11,9,12,13,12,13,12,11,8,8,11,13,13,11,14,12,12,14,13,12,12,13,13,15,15,12,13,11,13,5,11,6,5,9,11,8,4,1,1,2,2,3,1,2,3,1,1
"9230",8444104,"Larrys Mabiala","10/8/1987 (35 years old)","D (C)","Portland","Major League Soccer","COD","Yes","1/13/2021","12/31/2023","$16K - $170K","Right","Reasonable","Very Strong","6'2""","185 lbs","361","16",113,130,5,10,10,6,10,7,14,11,9,14,12,6,14,9,14,12,14,12,11,11,11,8,14,8,12,13,8,12,8,9,16,15,12,9,9,16,8,14,15,14,10,15,11,12,12,7,11,13,11,3,3,1,2,1,1,1,1,3,1,1
"9231",2000058963,"Patient Mwamba","11/15/2002 (20 years old)","M/AM (C)","TP Mazembe","DR Congo Premier Division A","COD","No","7/1/2021","6/30/2025","$40K - $425K","Left","Very Strong","Fairly Strong","6'0""","167 lbs","-","-",92,130,7,10,11,13,14,8,8,8,1,9,14,6,10,14,9,9,4,9,4,14,13,13,6,10,10,9,11,13,13,9,4,7,7,11,8,6,14,17,9,13,10,12,10,17,9,7,11,10,14,2,3,1,2,2,2,1,3,1,1,1
"9232",85140186,"Arnaud Lusamba","1/4/1997 (26 years old)","DM, M/AM (C)","Alanyaspor","Turkish Super League","COD","Yes","8/4/2022","6/30/2025","$200K - $2M","Right","Weak","Very Strong","5'10""","147 lbs","192","17",110,130,11,12,14,10,13,7,9,11,5,8,13,8,10,14,10,12,13,12,12,10,9,12,11,13,8,11,12,13,15,13,14,10,12,12,12,10,12,14,14,13,10,9,5,14,10,7,12,13,14,2,2,1,1,3,1,2,2,1,1,2
"9233",28060547,"Britt Assombalonga","12/6/1992 (30 years old)","ST (C)","Watford","Sky Bet Championship","COD","No","1/30/2023","6/30/2025","$210K - $2.1M","Right","Reasonable","Very Strong","5'10""","167 lbs","384","139",115,130,7,8,13,12,11,7,11,12,5,8,11,13,9,11,12,13,9,13,8,11,13,14,13,13,7,11,11,12,14,14,12,10,14,12,13,14,6,10,12,14,11,13,7,12,8,5,9,15,11,3,1,3,2,2,1,3,3,3,3,2
"9234",98033713,"Charles Pickel","5/15/1997 (26 years old)","DM, M (C)","Cremonese","Italian Serie B","COD","Yes","7/22/2022","6/30/2026","$4.7M - $9M","Right","Reasonable","Very Strong","6'2""","167 lbs","228","8",122,130,7,9,9,8,11,9,12,11,10,13,10,8,14,12,15,13,12,10,12,12,12,8,10,12,14,14,11,14,13,12,12,13,15,12,16,14,18,10,14,16,13,8,7,11,11,6,13,14,13,1,3,3,2,4,2,1,3,3,3,1
"9235",18081052,"Jonathan Okita","10/5/1996 (26 years old)","M (RL), AM (RLC), ST (C)","Zürich","Swiss Super League","COD","Yes","6/30/2022","6/30/2025","$75K - $7.4M","Left Only","Very Strong","Weak","5'11""","165 lbs","197","57",125,128,13,13,14,12,13,8,7,12,4,5,11,13,5,13,12,12,10,12,10,12,11,14,6,11,7,12,8,12,14,12,11,10,13,15,13,10,13,13,13,8,10,12,9,8,10,2,10,14,8,3,2,2,3,3,1,1,2,3,2,3
"9236",2000243103,"Meschack Tshimanga","12/19/2005 (17 years old)","AM (R), ST (C)","TP Mazembe","DR Congo Premier Division A","COD","No","7/1/2021","6/30/2025","$40K - $375K","Right","Fairly Strong","Very Strong","5'9""","136 lbs","-","-",65,128,5,8,10,13,10,5,12,7,3,5,10,6,1,12,5,6,6,10,6,10,3,12,11,10,6,6,7,7,13,11,6,6,12,13,8,3,9,19,12,10,11,9,11,7,8,5,9,9,15,1,3,3,3,1,2,2,1,3,1,1
"9237",85080017,"Nuke Mfulu","3/20/1994 (29 years old)","DM, M (C)","Las Palmas","Spanish First Division","COD","Yes","1/23/2023","6/30/2025","$2.1M - $4.5M","Right","Weak","Very Strong","6'0""","165 lbs","164","-",123,128,5,9,11,5,11,7,12,8,4,13,12,5,15,11,13,12,13,12,15,13,14,6,6,8,14,15,9,15,13,15,13,11,16,13,15,15,15,12,11,12,13,10,7,11,6,7,13,12,14,2,1,1,3,1,1,1,4,1,1,3
"9238",29141735,"Beryly Lubala","1/8/1998 (25 years old)","M (RL), AM (RLC)","Blackpool","Sky Bet League One","COD","No","9/1/2020","6/30/2024","$4.5K - $45K","Right Only","Weak","Very Strong","5'10""","160 lbs","72","13",87,128,9,10,12,11,10,12,10,12,5,5,10,8,5,10,8,11,11,11,9,8,5,12,8,11,8,9,10,11,13,12,10,9,13,12,12,10,8,12,13,7,10,10,5,10,7,13,8,10,12,3,1,2,1,1,2,2,1,2,3,2
"9239",23465502,"Oscar Maritu","8/17/1999 (23 years old)","ST (C)","CZ Mighty Lions","Chinese Super League","COD","No","1/1/2023","12/31/2023","$140K - $1.4M","Right","Reasonable","Very Strong","6'0""","176 lbs","114","56",110,127,8,11,14,12,10,10,11,8,5,4,11,12,4,12,13,12,11,9,11,11,17,13,5,12,5,10,11,12,15,14,11,12,13,14,11,10,12,15,12,11,13,10,11,13,5,5,12,11,13,3,1,3,2,3,1,2,3,2,1,3
"9240",57163398,"Claudiu Petrila","11/7/2000 (22 years old)","AM (L)","CFR Cluj","Romanian First League","ROU","Yes","8/26/2019","6/30/2024","$350K - $3.6M","Right","Weak","Very Strong","5'9""","147 lbs","166","41",117,133,12,12,13,13,12,13,7,10,2,7,12,9,8,13,9,11,11,11,11,9,16,10,8,12,7,12,11,13,15,14,11,9,14,15,11,9,11,12,10,12,9,11,7,9,7,5,13,15,11,2,2,2,1,3,2,2,1,3,2,1
"9241",85125689,"Samuel Moutoussamy","8/12/1996 (26 years old)","DM, M (C)","FC Nantes","Ligue 1 Uber Eats","COD","Yes","7/16/2019","6/30/2024","$2.4M - $5M","Left","Very Strong","Reasonable","5'9""","158 lbs","132","2",123,127,5,10,12,7,13,6,12,9,5,13,12,7,13,12,14,13,14,12,12,12,13,9,13,13,13,14,12,14,12,14,15,12,15,12,15,14,13,12,14,14,10,13,6,11,11,8,12,13,11,1,2,1,3,3,3,2,3,2,1,3
"9242",85039430,"Chris Mavinga","5/26/1991 (32 years old)","D (LC)","LA Galaxy","Major League Soccer","COD","Yes","1/5/2023","12/31/2024","Not for Sale","Left","Very Strong","Reasonable","6'1""","174 lbs","225","2",118,126,7,12,10,5,10,6,13,8,10,13,13,6,15,12,13,12,11,10,11,11,12,8,10,12,12,12,10,13,14,12,11,11,14,13,14,14,8,14,14,8,10,12,16,12,13,11,9,15,13,2,3,1,3,1,3,4,2,1,2,2
"9243",95053982,"Landu Langanga","10/15/1996 (26 years old)","GK","Sagrada Esperança","Angolan Championship","COD","No","7/1/2022","6/30/2024","$16K - $170K","Right Only","Weak","Very Strong","6'4""","207 lbs","65","-",92,126,4,3,3,2,2,8,1,1,1,3,11,2,3,1,12,12,13,8,9,13,7,2,5,3,9,8,5,7,10,14,8,12,12,10,7,6,14,15,11,12,11,8,8,6,8,4,20,10,9,11,6,13,13,8,12,11,5,8,13,13
"9244",8169253,"Hervé Kage","4/10/1989 (34 years old)","AM (RC), ST (C)","RE Virton","Belgian First National Amateur Division","COD","Yes","1/29/2022","6/30/2024","$35K - $110K","Right","Fairly Strong","Very Strong","5'10""","176 lbs","323","43",101,125,11,12,15,10,12,10,6,10,5,8,10,13,9,14,15,12,12,16,9,12,11,13,5,12,7,10,11,10,9,12,13,5,12,9,9,12,9,8,11,6,5,9,10,12,10,18,8,8,7,1,3,2,2,3,2,3,1,3,2,1
"9245",55079823,"André Bukia","3/3/1995 (28 years old)","AM (RLC)","Al-Batin","Saudi First Division League","COD","No","9/30/2021","6/30/2024","$75K - $750K","Left Only","Very Strong","Weak","5'8""","143 lbs","225","27",116,125,11,13,15,12,13,10,6,11,6,5,13,10,7,15,7,12,8,12,8,10,12,15,7,12,11,10,13,10,15,15,8,6,13,15,12,7,7,8,9,10,11,10,12,10,9,13,7,13,14,4,1,1,4,3,3,1,2,2,2,1
"9246",18076704,"Dieumerci Ndongala","6/14/1991 (31 years old)","M (R), AM (RL)","APOEL","Cypriot First Division","COD","Yes","8/18/2020","5/31/2024","$65K - $650K","Right Only","Weak","Very Strong","5'7""","130 lbs","300","44",110,125,10,11,15,9,13,11,5,9,5,4,13,7,5,14,15,11,14,11,12,12,14,12,8,10,5,9,8,10,15,13,10,4,13,14,12,9,12,12,12,8,12,14,7,11,6,11,13,12,8,3,2,1,2,3,1,1,4,3,3,3
"9247",2000080941,"Nathan Idumba Fasika","2/28/1999 (24 years old)","D (C)","Cape Town City","South African Premier Soccer League","COD","No","7/1/2021","6/30/2024","$70K - $220K","Right","Fairly Strong","Very Strong","6'4""","194 lbs","31","2",108,125,4,5,7,4,8,5,15,6,3,14,8,5,11,11,6,8,11,10,8,15,17,5,11,7,11,9,9,8,13,11,7,12,12,12,11,14,5,16,10,10,11,12,10,5,6,2,12,13,16,3,3,1,1,2,2,2,2,3,2,2
"9248",25049211,"Joel Ngandu Kayamba","4/17/1992 (31 years old)","AM (R)","Boluspor","Turkish 1. League","COD","No","7/27/2022","6/30/2024","$35K - $325K","Right","Reasonable","Very Strong","5'7""","145 lbs","215","26",105,125,10,12,12,8,14,8,7,12,6,8,7,12,9,13,14,9,10,7,9,9,12,14,9,11,9,12,11,13,12,13,10,7,10,15,13,9,12,7,7,10,13,10,10,12,12,14,11,13,13,3,4,1,1,1,1,3,2,3,1,2
"9249",2000077833,"Jean Baleke","4/17/2001 (22 years old)","AM (C), ST (C)","Simba","Tanzanian Mainland Premier Division","COD","No","1/2/2023","6/30/2025","$325K - $1M","Right","Reasonable","Very Strong","5'8""","147 lbs","35","20",104,125,9,10,11,13,12,5,11,11,7,5,9,10,5,11,13,13,11,10,8,9,13,9,8,13,4,9,9,13,14,13,8,11,18,13,12,10,14,13,11,11,13,11,7,6,8,3,13,13,19,1,2,3,1,2,3,2,1,1,3,2
"9250",13173989,"Kabongo Kasongo","7/18/1994 (28 years old)","ST (C)","Sakaryaspor","Turkish 1. League","COD","No","8/5/2022","6/30/2024","$950K - $2M","Right","Reasonable","Very Strong","6'1""","176 lbs","142","65",110,125,5,9,12,12,10,4,13,9,5,3,9,14,7,10,5,13,13,12,11,9,12,11,7,12,10,14,10,15,14,13,13,11,15,13,13,13,9,12,11,11,12,9,8,10,3,5,9,10,10,1,1,1,1,2,1,2,1,3,1,3
"9251",57142069,"Darius Olaru","3/3/1998 (25 years old)","M (C)","FCSB","Romanian First League","ROU","Yes","7/1/2019","6/30/2025","$2.8M - $5.6M","Right","Reasonable","Very Strong","5'10""","156 lbs","246","34",127,133,10,11,12,12,12,11,9,12,7,10,13,10,10,12,15,12,13,12,13,12,17,13,14,13,8,13,13,16,14,13,13,9,16,14,16,13,11,8,14,14,13,12,2,12,13,5,14,14,13,2,2,1,1,3,1,1,1,4,3,2
"9252",85121090,"Dylan Batubinsika","2/15/1996 (27 years old)","D (C)","Famalicão","Portuguese Premier League","COD","Yes","7/23/2021","6/30/2025","$0","Right","Weak","Very Strong","6'2""","185 lbs","120","6",121,125,8,9,9,6,10,8,14,9,5,14,10,8,13,10,13,13,14,11,11,13,11,6,12,9,13,13,8,13,11,10,13,14,14,12,13,15,18,13,13,14,12,12,8,3,13,4,12,12,12,1,4,2,3,1,1,2,1,3,3,1
"9253",83228124,"Beto","1/31/1998 (25 years old)","ST (C)","Udinese","Italian Serie A","GNB","Yes","7/1/2022","6/30/2026","$18.5M - $28M","Right","Weak","Very Strong","6'4""","171 lbs","180","60",142,150,5,7,12,15,12,6,15,12,6,6,12,11,6,12,15,14,12,14,13,13,16,11,8,15,8,13,10,16,16,13,14,16,14,16,13,16,10,10,17,13,15,5,3,10,11,14,15,15,15,2,1,3,2,3,2,1,2,2,2,1
"9254",2000107424,"Roger Fernandes","11/21/2005 (17 years old)","AM (RL)","BRG","Portuguese Premier League","GNB","Yes","12/2/2021","6/30/2024","$7.2M - $11M","Left","Very Strong","Weak","5'7""","143 lbs","34","4",111,143,10,12,15,10,14,9,8,10,5,3,12,8,5,14,10,10,7,12,8,9,12,18,3,11,4,8,12,9,15,15,9,6,14,15,12,4,8,12,6,14,14,9,13,13,4,3,8,13,16,3,2,1,1,3,3,1,3,3,2,1
"9255",83209467,"Famana Quizera","4/25/2002 (21 years old)","M (C), AM (RLC)","Ac. Viseu","Portuguese Second League","GNB","Yes","7/21/2022","6/30/2026","$130K - $1.3M","Right","Reasonable","Very Strong","5'8""","154 lbs","86","14",113,142,12,8,12,11,13,12,6,13,4,10,14,12,11,14,13,12,12,11,11,10,12,14,3,11,10,12,13,11,13,13,12,6,12,12,13,10,17,11,11,12,11,8,8,12,6,4,12,11,14,2,1,4,2,1,3,1,2,1,2,2
"9256",2000030160,"Franculino Djú","6/28/2004 (18 years old)","AM (R), ST (C)","Benfica","Portuguese Premier League","GNB","Yes","6/13/2022","6/30/2026","$110K - $1.1M","Left","Very Strong","Fairly Strong","6'0""","169 lbs","-","-",109,139,6,10,10,11,12,5,11,9,6,6,11,12,8,12,14,13,11,12,12,11,15,14,6,12,6,12,11,12,14,13,12,12,16,13,10,12,10,12,14,14,12,12,6,13,5,8,13,14,14,1,3,1,3,2,2,1,1,2,3,3
"9257",49038621,"Houboulang Mendes","5/4/1998 (25 years old)","D (RC), WB (R)","Almería","Spanish First Division","GNB","Yes","6/30/2022","6/30/2026","$2.7M - $5.6M","Right","Reasonable","Very Strong","6'0""","160 lbs","119","-",125,138,6,12,11,6,11,8,13,11,12,13,12,8,13,11,14,13,16,13,12,10,13,8,8,13,12,12,12,14,12,12,15,12,15,13,15,14,12,19,13,14,12,13,8,12,11,7,12,12,15,3,3,3,3,2,2,3,3,2,1,2
"9258",83320112,"Umaro Candé","8/28/2004 (18 years old)","AM (RL)","FC Porto B","Portuguese Second League","GNB","Yes","6/18/2021","6/30/2024","$180K - $1.8M","Right Only","Weak","Very Strong","5'6""","138 lbs","12","-",87,138,7,6,13,11,10,6,9,8,5,4,8,11,5,11,9,8,10,8,11,9,11,8,7,10,7,10,8,11,14,13,11,7,13,14,8,13,10,14,11,8,11,11,5,11,6,1,11,12,7,2,2,3,3,1,1,1,1,1,2,1
"9259",55067769,"Nanu","5/17/1994 (29 years old)","D/WB/M (R), AM (RL)","Santa Clara","Portuguese Second League","GNB","Yes","10/5/2020","6/30/2026","$18K - $55K","Right","Weak","Very Strong","5'10""","163 lbs","210","9",122,136,6,8,14,11,11,5,6,8,11,9,9,8,10,12,10,12,11,10,11,8,14,15,8,13,10,7,9,13,17,16,8,8,16,16,14,7,19,12,11,14,10,9,5,12,3,6,10,11,12,3,1,1,2,1,3,1,4,2,2,4
"9260",55060508,"Edgar Ié","5/1/1994 (29 years old)","D (RC)","Başakşehir FK","Turkish Super League","GNB","Yes","1/24/2023","6/30/2025","$200K - $2M","Right","Reasonable","Very Strong","6'0""","167 lbs","209","3",110,135,7,9,12,5,12,8,13,7,10,12,10,8,13,12,13,13,13,13,11,11,11,9,9,7,11,13,8,14,12,13,12,11,14,11,13,13,16,11,11,12,12,10,8,14,12,1,13,15,14,3,1,2,3,1,1,2,2,1,1,1
"9261",55024894,"Carlos Mané","3/11/1994 (29 years old)","AM (RLC)","Kayserispor","Turkish Super League","GNB","Yes","8/13/2021","6/30/2024","$190K - $8.4M","Right","Weak","Very Strong","5'8""","145 lbs","222","29",125,135,12,12,13,11,13,11,9,11,5,5,12,13,8,13,14,10,8,12,10,12,13,15,7,13,8,11,14,13,14,14,13,9,12,14,10,8,14,10,11,15,13,16,14,10,6,9,12,8,10,3,2,3,1,4,1,3,1,4,1,1
"9262",7542648,"Cristian Săpunaru","4/5/1984 (39 years old)","D (C)","FC Rapid","Romanian First League","ROU","Yes","5/5/2023","6/30/2024","$45K - $450K","Right","Weak","Very Strong","6'2""","178 lbs","450","38",118,133,6,9,7,9,11,6,13,7,11,14,11,11,14,11,16,14,15,13,12,13,17,10,18,14,13,14,11,12,9,8,10,14,16,11,13,14,9,7,12,14,15,18,16,15,14,10,15,15,15,2,2,4,1,1,1,2,3,4,3,3
"9263",55070279,"Mama Baldé","11/6/1995 (27 years old)","M (R), AM (RL), ST (C)","Troyes","Ligue 2 BKT","GNB","Yes","7/31/2021","6/30/2025","$1M - $6M","Right Only","Weak","Very Strong","5'9""","152 lbs","226","41",128,134,7,9,11,12,12,5,11,11,8,7,13,10,7,12,14,12,12,10,11,10,14,13,7,12,8,11,11,13,16,14,12,12,16,16,14,13,13,13,11,14,13,15,4,10,8,8,11,13,13,3,2,3,1,2,1,2,2,1,3,3
"9264",55022124,"Pelé","9/29/1991 (31 years old)","DM, M (C)","AS Monaco","Ligue 1 Uber Eats","GNB","Yes","6/14/2021","6/30/2025","$120K - $1.2M","Right","Reasonable","Very Strong","6'0""","165 lbs","218","20",113,132,10,9,12,10,12,8,12,12,10,13,13,14,13,12,12,10,13,11,12,10,13,10,13,10,13,13,11,13,12,9,14,11,16,11,12,16,13,12,13,14,12,9,10,13,9,9,12,13,15,1,1,3,3,1,3,3,2,3,2,3
"9265",55062422,"Carlos Embaló","11/25/1994 (28 years old)","AM (RL), ST (C)","Cittadella","Italian Serie B","GNB","Yes","7/1/2022","6/30/2024","$0","Left Only","Very Strong","Weak","5'10""","158 lbs","164","10",104,130,10,8,11,8,10,8,8,9,5,2,12,8,3,12,13,12,13,8,10,11,14,16,3,13,5,12,10,13,14,15,11,7,14,14,11,11,17,7,14,11,13,10,5,11,4,3,12,13,13,1,3,1,2,4,1,2,1,1,2,2
"9266",83209465,"Ronaldo Camará","1/5/2003 (20 years old)","M/AM (C)","Feirense","Portuguese Second League","GNB","Yes","1/31/2023","6/30/2024","$550K - $1.6M","Right","Weak","Very Strong","5'9""","152 lbs","31","2",96,130,11,12,13,10,13,11,8,13,4,8,13,8,8,13,14,12,12,8,9,10,12,10,10,11,9,10,14,10,11,11,15,8,14,11,10,10,14,8,10,8,13,7,6,12,14,16,11,12,13,2,1,4,2,3,1,4,3,2,1,3
"9267",27024985,"Eddi Gomes","11/17/1988 (34 years old)","D (C), DM","FC ESPM","Danish Lower Division","GNB","Yes","6/1/2022","-","$0","Right Only","Weak","Very Strong","6'5""","187 lbs","243","18",72,129,4,5,5,5,8,5,13,5,13,12,8,5,11,7,11,11,11,7,6,10,14,6,13,5,10,12,7,8,8,6,14,16,10,10,8,13,5,13,13,12,12,15,12,13,13,4,7,13,11,2,1,1,1,1,2,4,3,3,3,2
"9268",83228308,"Braima Sambú","3/20/2001 (22 years old)","M (C)","FC Porto B","Portuguese Second League","GNB","Yes","6/12/2023","6/30/2025","$0 - $45K","Right Only","Weak","Very Strong","6'0""","163 lbs","56","2",94,128,4,11,13,10,10,7,13,8,4,8,12,8,11,13,14,9,12,12,12,9,12,8,6,13,9,12,11,13,13,12,12,10,12,12,12,13,10,10,11,12,9,12,8,10,6,2,11,11,7,2,2,3,1,3,2,2,2,2,1,3
"9269",83195700,"Celton Biai","8/13/2000 (22 years old)","GK","VTSC","Portuguese Premier League","GNB","Yes","1/31/2020","6/30/2024","$120K - $1.2M","Right Only","Weak","Very Strong","6'2""","180 lbs","46","-",110,128,3,2,1,1,3,8,2,3,2,3,13,2,2,8,5,11,13,8,10,12,12,3,9,1,11,12,11,13,12,12,11,12,14,13,12,13,13,16,10,11,8,15,4,6,10,6,11,10,14,8,16,12,8,13,9,13,11,12,11,12
"9270",83191216,"Leandro Sanca","1/4/2000 (23 years old)","AM (RL)","Famalicão","Portuguese Premier League","GNB","Yes","8/30/2021","6/30/2024","$75K - $750K","Right","Fairly Strong","Very Strong","6'0""","160 lbs","79","7",116,127,10,12,14,10,13,10,10,10,6,4,12,12,5,13,9,10,7,10,10,8,12,14,7,13,6,12,13,12,14,14,11,8,12,14,12,8,11,12,12,12,8,8,10,11,8,5,10,12,10,1,1,2,2,4,2,3,2,4,1,2
"9271",2000137383,"Junior Moreira","3/26/2003 (20 years old)","M (C)","Cancún","Mexican Expansion League","GNB","No","7/1/2021","6/30/2024","$45K - $425K","Right","Fairly Strong","Very Strong","5'6""","136 lbs","47","1",92,127,10,7,8,7,8,10,10,9,5,9,10,11,12,11,12,11,12,12,10,12,14,11,11,10,12,11,11,13,9,10,11,11,13,11,14,13,12,11,9,12,12,11,12,10,11,8,11,11,16,2,2,2,4,2,3,4,2,2,2,1
"9272",85140143,"Alexandre Mendy","3/20/1994 (29 years old)","ST (C)","SM Caen","Ligue 2 BKT","GNB","Yes","10/1/2020","6/30/2025","$140K - $1.4M","Right","Weak","Very Strong","6'1""","185 lbs","220","62",116,127,3,6,11,12,13,7,12,10,5,6,10,14,5,13,13,12,15,12,11,12,11,10,6,10,6,13,7,12,13,11,15,13,15,15,15,17,5,16,13,12,11,11,6,10,10,7,12,12,11,1,4,2,1,3,2,1,3,3,3,1
"9273",2000151586,"Bogdan Ungureanu","4/1/2007 (16 years old)","GK","FC Rapid","Romanian First League","ROU","Yes","6/13/2022","6/30/2026","$120K - $1.2M","Right Only","Weak","Very Strong","6'2""","178 lbs","1","-",64,132,4,2,2,3,6,6,7,1,2,2,6,3,1,7,10,9,10,9,9,9,13,8,4,1,9,9,8,11,8,9,9,16,13,8,8,9,7,15,15,15,8,11,7,10,9,1,8,14,9,8,9,11,8,11,10,11,8,9,9,13
"9274",29179724,"Baba Fernandes","3/7/2000 (23 years old)","D (C)","Accrington","Sky Bet League Two","GNB","Yes","8/8/2022","6/30/2024","$40K - $400K","Right","Reasonable","Very Strong","6'2""","180 lbs","18","-",82,126,2,4,5,7,8,3,13,7,4,12,9,3,11,10,15,10,12,7,7,10,12,9,10,7,10,10,6,12,11,7,8,14,13,12,11,13,10,16,11,13,12,10,6,9,10,5,9,13,16,1,2,3,3,2,2,1,2,2,1,3
"9275",83257367,"Simão","2/2/1999 (24 years old)","D/WB/M/AM (L)","Coruña B","Spanish Federation Second Group 1","GNB","No","6/30/2021","6/30/2024","$14K - $130K","Left Only","Very Strong","Weak","6'0""","171 lbs","104","13",106,126,7,10,13,12,12,6,9,11,9,10,10,5,11,11,8,10,11,9,9,9,9,13,4,12,4,7,8,8,14,12,12,8,13,14,14,11,14,10,11,11,10,11,11,3,5,3,20,10,13,3,2,2,2,3,2,2,2,1,2,3
"9276",83149225,"Fali Candé","1/24/1998 (25 years old)","D (LC), WB (L)","FC Metz","Ligue 1 Uber Eats","GNB","Yes","1/26/2022","6/30/2026","$3.1M - $6.2M","Left Only","Very Strong","Weak","6'0""","180 lbs","109","4",123,126,13,12,10,8,11,14,9,8,11,13,13,8,13,11,12,13,12,12,12,12,13,5,11,10,13,13,12,14,14,12,14,8,12,13,13,14,15,14,13,14,12,13,4,11,5,5,12,13,14,3,1,1,2,3,3,3,3,1,3,1
"9277",55033299,"Nadjack","2/6/1994 (29 years old)","D/WB (R)","Grasshoppers","Swiss Super League","GNB","Yes","8/29/2020","6/30/2025","$24K - $230K","Right","Reasonable","Very Strong","6'0""","176 lbs","122","2",110,126,5,10,13,7,11,6,5,7,11,10,10,6,13,12,13,13,10,11,9,9,12,15,5,14,12,11,9,14,14,15,13,11,11,14,13,9,8,15,15,14,16,15,11,8,13,6,11,8,13,1,2,2,2,1,3,3,2,3,3,1
"9278",2000268514,"Fodé Pascoal","12/26/2004 (18 years old)","D (C)","BRG","Portuguese Premier League","GNB","No","2/10/2023","6/30/2026","$65K - $650K","Right","Reasonable","Very Strong","6'3""","169 lbs","-","-",70,126,1,1,1,2,6,1,12,5,4,12,5,5,12,4,9,8,8,6,8,12,13,5,9,2,12,5,3,6,12,12,6,10,13,12,10,4,14,16,11,11,12,11,8,4,5,5,13,10,8,4,1,1,4,2,1,3,1,2,1,3
"9279",90024677,"Panutche Camará","2/28/1997 (26 years old)","M (C)","Ipswich","Sky Bet Championship","GNB","Yes","9/1/2022","6/30/2024","$70K - $210K","Right Only","Weak","Very Strong","6'1""","154 lbs","194","16",106,125,5,7,10,8,8,5,9,7,3,10,10,8,13,10,9,13,14,9,10,10,14,11,7,13,9,18,12,20,12,10,15,13,17,15,18,12,12,11,12,13,10,10,6,10,6,8,10,13,12,1,4,1,2,2,2,4,3,1,3,1
"9280",67294790,"Clau Mendes","12/8/2000 (22 years old)","AM (R), ST (C)","Las Palmas","Spanish First Division","GNB","Yes","1/1/2020","6/30/2027","$45K - $450K","Left","Very Strong","Weak","5'11""","156 lbs","99","11",105,125,5,7,9,12,11,8,11,9,6,6,9,11,7,10,13,12,14,9,11,10,12,11,8,14,5,10,9,14,14,13,11,12,14,14,13,13,12,15,11,12,11,12,8,12,7,8,12,9,15,3,1,1,2,2,4,3,2,3,1,3
"9281",55082240,"Madi Queta","10/21/1998 (24 years old)","AM (RL)","Vilafranquense","Portuguese Lower Regional Divisions","GNB","Yes","1/20/2023","-","$0","Right Only","Weak","Very Strong","5'11""","171 lbs","143","11",95,125,9,11,13,10,11,5,7,9,3,4,11,8,4,13,11,11,10,11,8,7,13,14,5,10,6,9,9,13,14,12,11,10,14,15,11,11,9,12,7,13,11,12,5,11,6,5,10,10,14,1,2,1,1,1,1,3,3,3,2,3
"9282",48038818,"Steve Ambri","8/12/1997 (25 years old)","M/AM (RL)","Nîmes","French National","GNB","Yes","1/29/2023","6/30/2024","$110K - $1.1M","Left Only","Very Strong","Weak","5'10""","154 lbs","141","11",104,124,8,10,12,9,12,8,10,10,6,5,12,10,6,12,8,11,10,10,12,11,13,11,8,12,8,12,12,13,14,13,12,8,13,13,13,10,12,10,13,13,12,12,7,12,8,10,11,12,7,1,1,1,1,1,3,2,2,4,1,2
"9283",2000058029,"Mamadi Camará","12/31/2003 (19 years old)","AM (RL)","Reading","Sky Bet League One","GNB","Yes","6/24/2022","6/30/2024","$650K - $1.5M","Right","Reasonable","Very Strong","5'9""","147 lbs","11","-",89,124,10,10,13,9,9,10,7,8,6,5,9,6,6,9,9,10,9,11,8,7,12,12,8,10,7,9,8,8,14,13,12,7,15,13,11,8,8,10,11,14,9,10,11,7,5,5,11,10,14,3,1,1,1,3,1,2,3,3,2,2
"9284",57149439,"Alex Paşcanu","9/28/1998 (24 years old)","D (RC)","Ponferrada","Spanish Federation First Division A","ROU","Yes","2/17/2022","6/30/2024","$85K - $850K","Right","Fairly Strong","Very Strong","6'2""","165 lbs","133","6",125,132,7,10,11,9,11,7,13,8,9,13,11,7,13,9,12,12,13,11,12,11,13,4,10,9,13,11,8,14,12,12,12,13,13,13,14,14,12,19,11,10,8,11,4,11,7,3,13,11,11,4,2,2,1,1,3,2,1,2,1,1
"9285",2000076270,"Vando Félix","9/3/2002 (20 years old)","AM (RL)","Sporting CP B","Portuguese Third Division - South","GNB","No","7/19/2021","6/30/2026","$0 - $95K","Right","Weak","Very Strong","5'10""","152 lbs","43","4",83,124,6,10,12,7,10,5,6,7,4,5,7,6,6,12,7,7,6,8,7,8,9,13,3,10,6,8,8,8,14,14,7,7,12,14,10,7,13,20,11,11,10,13,8,10,7,3,12,10,13,3,3,1,3,2,2,1,3,2,3,2
"9286",55024975,"Gerso Fernandes","2/23/1991 (32 years old)","AM (RL)","Incheon","Hana 1Q K LEAGUE 1","GNB","Yes","1/10/2023","12/31/2024","Not for Sale","Left Only","Very Strong","Weak","5'8""","136 lbs","345","47",116,123,8,11,15,11,12,9,6,10,6,5,10,11,5,12,8,11,9,9,10,10,13,16,5,13,8,13,10,14,16,13,12,6,11,17,13,5,11,14,15,14,12,14,8,10,9,4,7,10,14,3,3,3,3,1,2,3,1,2,3,3
"9287",2000292771,"Juvenal Correia","1/17/2007 (16 years old)","AM (L)","Olivais e Moscavide","Portuguese Lisbon First Division","GNB","No","7/1/2022","6/30/2026","$0","Right","Reasonable","Very Strong","6'0""","141 lbs","-","-",60,122,8,12,14,11,14,6,6,3,6,5,11,5,7,9,10,4,6,4,3,9,8,10,5,14,5,7,5,11,13,10,7,7,9,11,6,4,11,17,10,14,10,8,6,14,6,7,5,12,8,1,2,1,3,2,1,1,3,1,3,2
"9288",55011410,"Leocísio Sami","12/18/1988 (34 years old)","AM (RL)","1º Dezembro","Portuguese Third Division - South","GNB","Yes","10/22/2022","6/30/2024","$0","Right","Reasonable","Very Strong","6'0""","171 lbs","304","44",70,122,10,11,10,8,10,11,8,11,7,6,10,12,8,10,12,9,10,9,9,8,12,11,7,10,8,11,9,8,10,9,10,12,12,11,10,12,11,14,12,14,13,14,7,11,8,5,10,12,13,3,3,1,1,2,4,1,2,1,3,2
"9289",2000128472,"Admilson Jorge Soares","1/22/2001 (22 years old)","D (C)","Racing Besançon","French National 2 - D","GNB","No","10/10/2022","6/30/2024","$18K - $180K","Right","Reasonable","Very Strong","6'1""","185 lbs","2","-",85,121,6,4,3,1,7,4,11,4,1,12,8,7,14,2,11,8,9,7,12,13,5,5,6,6,14,7,7,8,7,9,8,13,12,7,5,13,15,15,14,12,13,12,14,15,5,2,20,13,14,1,3,2,3,1,2,2,1,3,2,2
"9290",2000243272,"Mamadu Queta","1/21/2006 (17 years old)","D (C)","FC Porto","Portuguese Premier League","GNB","No","9/1/2022","6/30/2025","$60K - $600K","Right Only","Weak","Very Strong","6'2""","174 lbs","-","-",68,121,5,5,4,1,7,6,14,5,2,13,7,1,9,4,13,11,8,6,8,14,13,5,4,4,14,6,3,3,8,9,7,14,7,8,4,6,13,20,11,10,10,10,5,4,11,4,8,12,10,3,1,3,3,3,1,2,3,1,1,2
"9291",18052047,"Zinho Gano","10/13/1993 (29 years old)","ST (C)","Zulte Waregem","Belgian Challenger Pro League","GNB","Yes","7/1/2021","6/30/2024","$90K - $900K","Left","Very Strong","Reasonable","6'4""","189 lbs","239","78",115,121,8,8,9,13,10,9,16,9,8,9,12,8,9,10,14,12,14,10,12,12,11,8,10,12,8,14,12,14,9,13,14,19,12,11,13,14,14,13,10,12,12,11,10,11,8,2,12,15,9,1,2,2,2,2,1,1,1,1,1,3
"9292",55024939,"Francisco Júnior","1/18/1992 (31 years old)","M (C)","Sepsi OSK","Romanian First League","GNB","Yes","6/9/2022","6/30/2024","$28K - $275K","Right","Reasonable","Very Strong","5'8""","143 lbs","193","4",104,120,7,7,11,7,13,7,9,7,6,10,12,5,11,13,13,12,16,12,12,12,11,7,5,10,13,12,12,13,12,12,14,7,12,13,13,8,12,12,10,10,10,9,10,12,11,11,8,13,12,3,1,2,1,3,1,3,1,2,1,3
"9293",83111404,"Alfa Semedo","8/30/1997 (25 years old)","DM, M/AM (C)","Al-Tai","Saudi Professional League","GNB","Yes","8/10/2022","6/30/2024","$550K - $8.6M","Right","Fairly Strong","Very Strong","6'3""","165 lbs","183","12",115,120,11,10,13,9,11,10,13,12,9,11,12,10,12,13,15,13,13,12,9,8,13,11,11,12,10,13,12,13,12,12,12,15,14,13,14,12,16,13,14,16,9,10,7,11,14,13,11,13,13,4,2,2,2,3,1,2,2,3,3,1
"9294",83107661,"Valdu Té","8/14/1997 (25 years old)","ST (C)","YB Longding","Chinese National First Division","GNB","Yes","4/4/2023","12/31/2023","$100K - $300K","Right Only","Weak","Very Strong","6'2""","180 lbs","109","22",92,120,7,10,11,12,10,9,13,10,5,5,9,10,5,11,13,11,12,12,10,11,15,8,9,11,5,11,9,12,11,12,13,14,15,10,10,15,8,8,12,12,14,14,7,10,7,7,10,11,16,1,2,2,2,2,2,1,3,2,3,2
"9295",2000221462,"Mihai Toma","2/17/2007 (16 years old)","M (C), AM (LC)","FCSB","Romanian First League","ROU","Yes","7/1/2022","6/30/2026","$130K - $1.3M","Right","Fairly Strong","Very Strong","5'8""","141 lbs","8","1",74,132,11,10,11,8,11,10,7,7,2,7,11,11,7,12,10,10,8,10,9,9,12,12,10,9,7,12,12,10,10,11,11,7,10,8,8,8,11,17,9,11,11,10,8,10,10,2,11,8,6,3,4,3,2,3,1,1,2,1,3,1
"9296",28042870,"Toni Silva","9/15/1993 (29 years old)","M (R), AM (RL)","Aqsý","Kazakhstan Premier League","GNB","Yes","12/31/2022","12/31/2023","$0","Left","Very Strong","Weak","6'0""","163 lbs","205","37",100,120,10,9,15,12,12,8,10,10,4,6,10,8,6,14,8,10,10,10,10,9,11,14,4,13,4,8,9,9,14,14,10,11,14,14,12,9,10,6,5,7,8,7,6,12,6,15,12,16,15,2,3,2,2,3,4,1,1,2,1,3
"9297",50052951,"David Gomis","12/21/1992 (30 years old)","M/AM (RL)","Sabail","Azeri Premier League","GNB","Yes","1/14/2023","6/30/2023","$2.5K - $24K","Right Only","Weak","Very Strong","5'8""","149 lbs","260","33",105,119,10,11,14,10,11,10,6,10,8,6,10,12,5,13,10,11,13,11,11,10,11,10,7,12,6,10,9,11,15,13,12,8,13,12,12,11,10,12,10,10,12,12,7,11,12,11,11,12,8,2,2,2,1,3,2,2,2,2,2,4
"9298",2000172713,"Vasco Djú","1/15/2003 (20 years old)","DM","BRA","Brazilian National First Division","GNB","No","4/11/2022","12/31/2027","$0","Left Only","Very Strong","Weak","6'0""","169 lbs","-","-",75,119,9,7,11,11,10,9,9,11,9,9,11,5,8,10,8,11,10,10,8,8,8,8,10,12,10,12,11,14,11,11,10,11,14,11,12,9,15,14,12,11,9,10,6,17,11,1,9,9,13,1,2,1,2,1,1,2,1,3,1,1
"9299",2000106876,"Marciano Sanca","4/3/2004 (19 years old)","AM (RL)","Almería B","Spanish Federation Third Group 9","GNB","Yes","1/21/2021","6/30/2024","$85K - $850K","Right","Weak","Very Strong","6'1""","174 lbs","47","21",80,119,8,11,14,13,14,7,8,8,5,6,12,5,8,10,5,5,8,6,8,8,12,9,6,11,7,8,9,9,14,12,4,14,10,13,6,5,12,13,10,13,12,11,7,17,10,2,10,9,19,2,2,1,2,2,2,4,1,3,1,3
"9300",2000090392,"Mascherano","4/15/2003 (20 years old)","DM, M (C)","Sp. Bafatá","Bissau-Guinean Premier Division","GNB","No","1/1/2020","12/31/2025","$0","Right","Reasonable","Very Strong","6'1""","171 lbs","-","-",66,119,6,6,3,7,13,6,4,8,1,9,11,6,14,9,15,8,7,10,11,14,12,5,6,7,9,13,8,12,8,6,2,10,13,6,8,6,10,15,8,10,9,11,5,4,10,3,6,10,8,3,2,1,3,1,2,2,1,2,3,1
"9301",2000082351,"Cláudio Mendes","10/11/2002 (20 years old)","WB (R), DM, M (RC)","PTM","Portuguese Premier League","GNB","Yes","7/1/2022","6/30/2027","$20K - $190K","Right","Reasonable","Very Strong","5'9""","143 lbs","25","2",77,118,7,8,12,6,12,9,7,9,5,11,11,9,13,10,5,9,11,9,7,8,9,5,10,7,10,13,11,8,10,8,10,7,14,10,10,12,11,15,12,11,8,9,9,1,4,4,17,9,15,4,2,1,1,3,2,1,1,3,2,2
"9302",83169977,"Jefferson Encada","4/17/1998 (25 years old)","D/WB/M/AM (R)","Pharco","Egyptian Premier League","GNB","Yes","1/31/2022","7/31/2025","$140K - $425K","Right Only","Very Weak","Very Strong","6'2""","160 lbs","100","12",97,118,6,9,12,6,9,6,5,7,7,6,10,8,8,8,13,9,10,7,9,7,12,15,8,10,6,11,7,12,16,13,9,12,15,16,12,12,12,3,5,9,8,13,6,12,6,16,10,15,12,3,3,2,2,3,3,1,1,1,3,2
"9303",83111654,"Mimito Biai","12/12/1997 (25 years old)","DM, M (C)","FC Argeş","Romanian Second League","GNB","Yes","1/6/2023","6/30/2024","$85K - $850K","Right Only","Weak","Very Strong","5'10""","163 lbs","144","3",97,118,7,10,12,8,8,8,7,8,7,9,11,12,12,13,12,11,13,13,11,10,12,12,7,12,11,13,12,12,12,13,13,8,13,12,13,12,10,10,12,13,12,13,8,10,6,6,9,13,10,3,2,3,1,1,4,3,2,3,1,3
"9304",55082227,"Moreto Cassamá","2/16/1998 (25 years old)","M/AM (C)","Omonoia","Cypriot First Division","GNB","Yes","8/23/2022","5/31/2025","$160K - $1.6M","Right Only","Weak","Very Strong","5'5""","138 lbs","103","5",110,118,12,12,12,8,14,11,7,11,3,8,13,13,9,14,12,13,10,13,12,13,11,16,10,11,7,13,14,11,13,14,12,6,12,12,12,10,8,13,11,8,13,5,4,12,13,8,11,16,16,2,3,3,4,1,2,3,2,1,1,3
"9305",43296745,"Pedro Justiniano","4/18/2000 (23 years old)","D (C)","Radomiak","PKO Bank Polski Ekstraklasa","GNB","Yes","7/10/2022","6/30/2025","$90K - $275K","Right Only","Weak","Very Strong","6'3""","182 lbs","68","-",99,118,3,3,6,4,8,3,11,4,8,12,10,7,12,8,13,13,12,8,13,11,13,3,11,6,13,13,7,13,11,11,10,14,13,11,12,13,3,13,14,15,12,8,4,10,6,5,12,11,14,2,2,2,2,2,2,3,1,1,2,2
"9306",67173047,"Florin Andone","4/11/1993 (30 years old)","ST (C)","Las Palmas","Spanish First Division","ROU","Yes","9/1/2022","6/30/2025","$180K - $1.8M","Right","Weak","Very Strong","5'11""","171 lbs","251","74",122,148,10,11,13,14,13,11,12,12,9,6,13,13,7,14,14,13,14,11,13,13,17,13,13,14,7,14,10,15,13,12,13,11,9,14,11,13,10,8,14,14,15,12,16,14,11,6,9,15,14,2,2,1,1,3,1,2,2,1,4,4
"9307",7541477,"Claudiu Keşerü","12/2/1986 (36 years old)","ST (C)","UTA Arad","Romanian First League","ROU","Yes","5/31/2022","6/30/2024","$30K - $95K","Left","Very Strong","Reasonable","5'10""","171 lbs","515","223",90,131,11,11,10,13,11,13,12,13,6,6,11,14,7,12,11,12,8,12,12,11,13,14,14,11,8,8,11,8,7,8,13,9,12,8,9,10,8,12,11,18,16,16,9,15,11,6,16,14,14,1,3,4,1,3,2,1,1,1,2,3
"9308",83335560,"Hernâni Infande","4/3/2001 (22 years old)","AM (RL)","P. Ferreira","Portuguese Second League","GNB","Yes","9/3/2020","6/30/2024","$26K - $250K","Right","Weak","Very Strong","5'10""","145 lbs","49","8",105,117,7,11,14,11,12,8,10,11,5,4,11,10,5,12,11,9,11,9,8,9,11,13,5,12,5,10,13,11,14,14,10,11,10,14,12,7,17,11,8,9,10,8,13,4,10,12,8,14,15,3,2,3,1,2,4,2,1,1,3,2
"9309",36514846,"Steve Mounié","9/29/1994 (28 years old)","ST (C)","Brest","Ligue 1 Uber Eats","BEN","Yes","9/9/2020","6/30/2024","$325K - $8M","Right","Weak","Very Strong","6'3""","182 lbs","251","66",125,141,8,7,11,12,13,6,17,11,5,8,12,12,7,12,13,12,13,13,12,11,11,11,11,12,12,13,12,13,12,12,14,17,12,12,13,16,8,12,13,14,11,14,8,10,8,7,12,15,12,2,2,2,3,3,3,1,2,1,2,1
"9310",63037886,"Samson Akinyoola","3/3/2000 (23 years old)","ST (C)","Zamalek","Egyptian Premier League","BEN","No","9/19/2022","7/31/2025","$550K - $5.6M","Right","Fairly Strong","Very Strong","5'8""","171 lbs","76","28",114,140,5,11,12,14,11,7,12,8,5,5,10,13,5,13,10,12,11,12,11,13,15,15,15,14,7,15,13,14,13,12,12,7,18,13,14,13,8,10,12,12,9,11,4,4,7,11,13,18,15,1,2,3,1,1,2,1,3,2,1,1
"9311",47075787,"Aiyegun Tosin","6/26/1998 (24 years old)","AM (RL), ST (C)","Zürich","Swiss Super League","BEN","No","9/2/2019","6/30/2025","$475K - $4.7M","Right","Reasonable","Very Strong","5'10""","165 lbs","140","53",123,132,7,11,13,12,12,7,8,12,5,6,11,10,7,12,11,12,12,12,11,13,9,14,5,12,7,12,11,13,15,13,13,10,13,14,13,12,10,17,15,11,13,11,8,11,6,3,12,9,17,3,1,2,2,1,1,3,2,2,1,2
"9312",2000124946,"Junior Olaitan","5/9/2002 (21 years old)","M/AM (C)","Niort","French National 3 - Group D","BEN","No","1/31/2022","6/30/2025","$65K - $650K","Right","Reasonable","Very Strong","5'9""","160 lbs","39","3",98,130,6,7,13,10,12,8,10,11,14,6,11,12,6,14,13,7,12,8,6,10,11,15,7,14,10,5,9,13,14,13,14,10,13,13,13,14,10,11,11,12,12,13,8,11,12,8,10,12,18,3,3,3,2,2,3,3,2,1,3,3
"9313",2000218608,"Aminou Ibouraima","1/1/2005 (18 years old)","ST (C)","QRM","Ligue 2 BKT","BEN","No","7/1/2022","6/30/2024","$0 - $100K","Left Only","Very Strong","Weak","5'11""","174 lbs","-","-",75,128,3,5,9,11,13,5,13,7,5,5,7,6,4,11,12,8,8,7,5,11,15,12,1,10,6,6,7,7,13,11,7,10,17,12,6,11,11,16,13,14,11,13,6,2,5,4,18,12,19,1,3,2,3,3,4,2,1,1,4,3
"9314",49040150,"Mattéo Ahlinvi","7/2/1999 (23 years old)","DM, M (C)","Dijon FCO","French National","BEN","Yes","7/1/2021","6/30/2024","$0","Left","Very Strong","Reasonable","6'0""","149 lbs","64","4",109,127,7,11,10,10,10,9,6,13,3,11,13,7,11,11,4,13,10,14,11,14,11,12,8,14,13,13,12,14,11,10,12,8,12,9,12,13,13,12,11,16,14,14,10,13,10,4,12,10,12,1,1,3,2,2,2,4,3,1,3,1
"9315",48038034,"Olivier Verdon","10/5/1995 (27 years old)","D (C)","Ludogorets","Bulgarian First League","BEN","Yes","7/25/2022","6/30/2025","$425K - $4.3M","Right Only","Weak","Very Strong","6'3""","187 lbs","150","8",120,126,5,7,8,9,9,8,13,8,8,13,11,14,15,9,13,12,15,11,11,10,12,7,13,7,13,15,10,12,12,11,12,16,17,13,14,16,6,8,10,11,11,10,8,13,7,16,13,14,10,2,1,3,2,3,2,2,1,3,3,3
"9316",85048646,"Cédric Hountondji","1/19/1994 (29 years old)","D (C)","Angers SCO","Ligue 2 BKT","BEN","Yes","7/18/2022","6/30/2026","$400K - $4.1M","Right Only","Weak","Very Strong","6'5""","187 lbs","240","5",120,125,3,5,6,5,8,5,14,7,5,13,12,6,15,10,11,13,13,10,13,13,11,6,8,8,13,12,7,12,13,11,16,16,15,12,13,15,8,15,15,10,12,10,5,12,12,6,12,13,12,3,3,2,3,2,4,2,2,3,2,2
"9317",49059805,"Andréas Hountondji","7/11/2002 (20 years old)","AM (RL), ST (C)","US Orléans","French National","BEN","Yes","6/23/2022","6/30/2025","$275K - $800K","Right","Reasonable","Very Strong","6'3""","141 lbs","53","8",100,125,6,8,12,8,10,8,12,9,1,8,10,1,8,12,11,12,3,6,9,10,9,13,7,13,8,9,8,10,15,12,12,15,12,16,12,12,11,12,8,8,13,12,11,1,9,6,11,13,11,3,3,1,1,2,3,3,2,3,3,3
"9318",57003318,"Florin Gardoş","10/29/1988 (34 years old)","D (C)","Sparta Rm. Vâlcea","Romanian Fourth League Vâlcea","ROU","Yes","3/20/2023","-","$0","Right Only","Weak","Very Strong","6'4""","194 lbs","216","7",60,131,1,6,6,2,5,1,10,5,8,10,10,2,11,9,8,8,12,9,10,11,13,8,10,11,10,11,11,10,7,8,10,13,11,6,6,9,11,10,12,14,11,14,16,12,8,5,13,12,14,3,2,2,2,3,1,1,1,1,2,3
"9319",85114052,"Jordan Adéoti","3/12/1989 (34 years old)","D (C), DM, M (C)","Laval MFC","Ligue 2 BKT","BEN","Yes","7/5/2021","6/30/2024","$26K - $275K","Right","Weak","Very Strong","6'0""","178 lbs","407","23",108,124,5,11,10,8,12,10,12,10,6,12,12,8,13,12,14,12,15,12,13,11,14,8,10,11,12,13,11,12,11,10,14,11,15,12,13,12,10,10,11,13,12,14,6,15,14,7,12,11,18,2,4,3,2,3,4,2,2,2,1,1
"9320",43617163,"Angel Josuè Chibozo","7/1/2003 (19 years old)","AM (LC), ST (C)","Juventus","Italian Serie A","BEN","No","6/13/2022","6/30/2028","$110K - $1.1M","Right Only","Weak","Very Strong","5'9""","149 lbs","23","-",98,123,6,8,11,13,11,7,9,7,6,5,12,8,7,10,9,9,11,8,9,9,10,8,6,13,5,10,8,11,15,14,14,8,14,13,12,10,11,16,13,10,11,10,6,11,9,2,11,12,15,3,2,3,3,3,3,2,3,1,1,1
"9321",36515153,"Saturnin Allagbé","11/22/1993 (29 years old)","GK","Dijon FCO","French National","BEN","Yes","10/2/2020","6/30/2024","$160K - $475K","Right Only","Weak","Very Strong","6'2""","171 lbs","140","-",110,122,6,1,2,3,8,7,8,2,1,3,9,5,2,8,5,12,7,12,14,11,14,4,12,2,12,11,10,10,8,13,12,14,12,8,14,12,15,17,15,16,10,16,10,11,5,12,10,14,13,13,14,15,10,13,14,12,12,14,12,12
"9322",85069712,"Brandon Agounon","10/19/1994 (28 years old)","D/WB/M (R)","US Orléans","French National","BEN","Yes","7/1/2022","6/30/2024","$35K - $350K","Right Only","Weak","Very Strong","5'11""","149 lbs","191","5",100,121,6,12,12,6,12,5,9,6,5,12,12,8,11,12,13,12,12,11,9,10,11,11,7,13,9,11,12,12,13,13,12,11,14,13,13,10,13,8,10,12,9,10,6,10,8,8,11,10,10,2,2,1,1,1,3,1,1,3,2,2
"9323",49033328,"David Kiki","11/25/1993 (29 years old)","D (RL), WB (L)","Farul Constanţa","Romanian First League","BEN","Yes","6/25/2022","6/30/2024","$275K - $2.8M","Left","Very Strong","Weak","5'11""","165 lbs","216","11",117,120,7,11,14,8,12,8,12,8,9,12,12,6,13,12,10,12,14,12,10,10,9,4,6,12,10,13,10,14,14,14,12,12,14,14,13,12,8,17,10,12,10,13,8,13,12,7,12,12,13,3,1,2,3,1,3,1,1,4,1,1
"9324",85134635,"Sessi D'Almeida","11/20/1995 (27 years old)","DM, M (C)","Pau FC","Ligue 2 BKT","BEN","Yes","7/1/2022","6/30/2024","$50K - $475K","Right Only","Weak","Very Strong","5'10""","165 lbs","161","2",108,120,6,8,10,7,11,7,11,10,6,9,12,8,13,12,17,11,15,10,11,11,14,8,11,10,12,12,10,12,13,14,13,10,14,14,15,14,10,12,9,12,13,13,9,13,14,6,11,12,18,1,2,1,2,2,2,3,2,1,3,3
"9325",12095337,"Rodolfo Aloko","12/26/2006 (16 years old)","AM (LC), ST (C)","Dynamo d'Abomey","Beninese Ligue 1 - Pool B","BEN","No","7/1/2021","6/30/2026","$40K - $130K","Left","Very Strong","Reasonable","6'0""","147 lbs","-","-",73,118,6,7,13,13,13,6,8,8,4,4,10,8,7,9,5,5,6,9,5,9,2,14,3,11,5,7,8,8,13,8,7,9,17,9,10,5,7,19,9,10,12,11,12,13,7,7,9,10,16,2,1,1,1,3,1,2,1,1,3,3
"9326",13128251,"Jodel Dossou","3/17/1992 (31 years old)","M/AM (RL)","FCSM","French National","BEN","No","1/24/2023","6/30/2025","$65K - $650K","Left","Very Strong","Strong","5'7""","158 lbs","262","51",112,116,7,10,12,11,12,6,6,5,5,8,11,11,8,13,11,12,12,11,11,11,13,11,10,13,12,12,11,13,13,13,10,11,12,12,12,11,12,9,12,13,11,9,9,11,6,8,10,13,14,2,2,1,1,3,3,3,3,1,1,2
"9327",2000081276,"Tadjoudine Sakibou","11/16/2003 (19 years old)","M/AM (L)","ASPAC","Beninese Ligue 1 - Pool C","BEN","No","1/9/2021","6/30/2025","$18K - $170K","Left","Very Strong","Fairly Strong","5'8""","147 lbs","-","-",73,116,8,11,11,10,14,5,6,8,7,6,10,2,7,14,10,10,3,6,8,14,8,13,3,13,6,8,10,12,12,10,8,5,10,9,7,5,18,13,13,12,12,9,13,17,10,7,10,11,17,1,2,1,1,2,3,2,2,3,3,2
"9328",49063050,"Youssouf Assogba","8/21/2001 (21 years old)","D/WB (R)","Amiens SC","French Regional 1 - Hauts de France - Group A","BEN","No","6/28/2021","6/30/2024","$130K - $1.3M","Right","Reasonable","Very Strong","5'8""","156 lbs","44","2",92,116,6,11,8,6,8,5,12,11,11,12,8,5,11,10,15,9,15,11,11,9,8,8,12,9,12,13,8,9,12,9,12,10,13,12,12,12,10,19,14,10,12,11,8,10,7,6,10,13,14,1,1,2,3,2,1,1,3,3,3,4
"9329",29174451,"Dennis Politic","3/5/2000 (23 years old)","AM (RLC), ST (C)","Cremonese","Italian Serie B","ROU","Yes","1/21/2022","6/30/2026","$20K - $210K","Right","Weak","Very Strong","6'1""","171 lbs","68","8",105,130,10,10,13,13,13,11,8,12,3,3,12,12,5,13,10,12,9,12,11,11,13,13,8,12,7,10,12,11,12,12,12,9,14,13,10,11,13,13,13,15,12,8,4,11,8,12,11,13,13,2,3,3,1,1,1,2,1,3,2,1
"9330",67248406,"Mohamed Tijani","7/10/1997 (25 years old)","D (C)","Brno","Czech Second Division","BEN","No","7/1/2022","6/30/2025","$110K - $1.1M","Left","Very Strong","Reasonable","6'2""","200 lbs","110","6",105,115,6,7,5,5,12,3,15,11,6,12,10,8,13,8,14,10,11,12,11,12,1,5,8,11,13,11,6,12,12,11,12,14,15,12,9,15,14,12,12,9,12,10,14,6,12,3,12,9,13,3,1,1,3,3,1,1,3,1,3,2
"9331",2000068898,"Amiro Amadou","7/10/2002 (20 years old)","D (RC), DM, M (C)","Regensburg","3. Liga","BEN","Yes","1/31/2023","6/30/2024","$70K - $700K","Right Only","Weak","Very Strong","6'3""","176 lbs","44","1",79,115,4,9,5,5,8,6,8,5,1,13,9,3,13,8,5,10,9,8,8,13,6,5,4,6,13,7,8,8,13,10,7,12,13,11,9,6,13,17,10,9,10,12,7,9,8,3,20,10,12,3,3,4,1,3,1,1,1,1,2,3
"9332",13211258,"Rodrigue Kossi","12/31/1999 (23 years old)","D (C), DM, M (C)","Club Africain","Ligue Professionnelle 1","BEN","No","9/15/2018","6/30/2026","$55K - $550K","Right Only","Weak","Very Strong","5'10""","160 lbs","59","-",100,115,4,6,9,6,10,6,12,7,9,12,12,6,12,11,16,13,14,11,13,10,10,5,7,9,13,13,11,13,12,10,12,10,14,13,14,11,15,15,12,13,10,10,5,15,13,6,12,12,10,3,1,3,2,2,2,2,2,2,4,1
"9333",91013289,"Cebio Soukou","10/2/1992 (30 years old)","AM (RL), ST (C)","Bandırma Spor","Turkish 1. League","BEN","Yes","1/12/2023","6/30/2024","$400K - $1.2M","Right","Fairly Strong","Very Strong","6'1""","187 lbs","257","45",110,115,8,10,14,11,12,10,8,10,8,5,11,9,5,13,12,9,12,10,12,8,11,14,5,10,7,9,13,8,13,12,14,12,13,14,12,14,14,10,11,13,12,9,9,12,6,14,12,12,6,1,3,3,3,3,2,1,3,3,2,2
"9334",13232487,"Cyrille Aloya","12/18/2003 (19 years old)","D (RL), WB (R)","AS Dragons","Beninese Ligue 1 - Pool D","BEN","No","7/1/2019","6/30/2025","$4.5K - $45K","Right","Strong","Very Strong","5'10""","154 lbs","-","-",75,114,5,9,7,6,12,1,8,4,7,6,9,5,12,9,13,10,9,9,6,13,14,5,11,7,9,9,7,9,14,14,9,4,14,12,6,7,12,15,13,11,12,11,7,8,11,4,8,11,16,2,3,2,3,1,1,3,1,3,2,4
"9335",2000229701,"Dokou Dodo","5/4/2004 (19 years old)","DM, M (C)","Smouha","Egyptian Premier League","BEN","No","10/7/2022","7/31/2026","$140K - $425K","Right Only","Weak","Very Strong","5'10""","149 lbs","29","-",75,114,6,3,7,8,14,7,5,9,6,5,13,5,11,14,11,13,8,9,8,14,11,5,5,8,6,8,7,13,9,11,7,4,14,13,10,5,18,10,10,12,12,12,15,2,5,3,16,12,18,3,1,1,2,3,1,1,4,1,1,1
"9336",13196474,"Charbel Gomez","1/27/2001 (22 years old)","AM (RL)","Samgurali","Georgian National League","BEN","No","3/10/2023","12/31/2024","$35K - $350K","Right","Reasonable","Very Strong","6'0""","156 lbs","10","-",88,111,8,13,14,13,14,7,3,7,4,7,9,7,8,11,10,5,5,9,8,11,11,10,7,12,7,8,6,9,12,13,8,6,16,14,8,4,14,17,10,11,12,11,5,7,5,2,12,9,16,2,2,1,1,1,1,3,3,2,1,2
"9337",13194672,"Ibrahim Ogoulola","2/3/2000 (23 years old)","DM, M/AM (C)","ASPAC","Beninese Ligue 1 - Pool C","BEN","No","1/8/2021","6/30/2024","$22K - $210K","Right","Reasonable","Very Strong","5'9""","149 lbs","-","-",85,110,8,9,10,10,10,8,7,10,1,9,13,6,10,14,11,12,9,12,5,11,18,14,13,10,13,14,9,10,10,9,15,5,13,10,7,5,14,14,9,12,14,10,7,1,14,4,11,9,15,3,2,2,1,1,3,2,1,3,2,3
"9338",2000082488,"Arnaud Akakpo","12/12/1999 (23 years old)","D (C)","Adjidja FC","Beninese Ligue 1 - Pool D","BEN","No","7/1/2022","6/30/2024","$0 - $110K","Right","Fairly Strong","Very Strong","6'4""","176 lbs","-","-",78,110,4,1,4,6,4,1,12,2,2,13,5,2,13,2,7,12,9,7,11,13,13,5,10,6,11,6,1,6,12,10,7,10,17,10,4,7,12,17,11,10,9,12,9,7,13,6,10,10,7,1,3,1,1,3,2,1,2,1,2,1
"9339",19317908,"Aaron Ibilola","12/10/1997 (25 years old)","AM (C)","Real Noroeste","Brazilian National Fourth Division","BEN","No","3/10/2023","12/31/2023","$0","Right","Fairly Strong","Very Strong","5'5""","145 lbs","20","2",82,110,6,6,10,9,13,6,7,8,4,5,11,1,5,12,12,8,5,5,5,13,16,12,8,11,8,7,7,8,13,13,7,1,8,13,11,1,16,17,12,10,13,10,11,11,7,8,11,10,18,4,1,3,3,3,1,3,2,2,2,1
"9340",2000040817,"Alexandru Musi","7/17/2004 (18 years old)","M (C), AM (RLC)","Politehnica Iaşi","Romanian First League","ROU","Yes","7/1/2020","6/30/2026","$375K - $1.1M","Right","Weak","Very Strong","5'11""","154 lbs","38","12",101,130,11,11,12,9,11,10,9,10,4,8,11,4,8,12,13,10,12,10,10,9,14,12,3,11,7,11,12,12,14,13,9,10,13,13,11,9,16,7,10,11,9,7,4,8,14,4,11,12,12,2,2,4,2,2,2,3,1,2,2,1
"9341",12095004,"Rivaldo Alitonou","5/15/2003 (20 years old)","AM (RL)","Coton FC","Beninese Ligue 1 - Pool C","BEN","No","7/1/2021","6/30/2025","$14K - $130K","Left Only","Very Strong","Weak","6'0""","163 lbs","-","-",80,109,8,12,11,11,14,7,7,9,7,5,13,6,8,14,7,7,7,9,6,11,7,13,2,13,7,9,9,12,14,8,7,10,8,12,7,5,13,15,11,13,11,12,13,12,13,7,19,9,9,3,3,3,3,2,1,3,1,1,4,3
"9342",12014383,"Djiman Koukou","11/14/1990 (32 years old)","DM, M (C)","Vendée Herbiers Foot","French National 2 - B","BEN","No","7/1/2021","6/30/2024","$3.5K - $35K","Right Only","Weak","Very Strong","6'1""","180 lbs","308","6",90,109,4,6,9,6,10,6,12,10,6,12,9,7,12,10,13,12,13,11,12,10,13,8,10,7,12,12,8,12,12,11,14,12,14,12,13,13,8,14,13,12,11,12,5,12,13,7,12,12,13,2,3,1,2,2,4,3,4,1,3,1
"9343",2000155399,"Bruguel Ahouangbo","2/8/2002 (21 years old)","DM, M (C)","Oslo Football Academy","Senegalese Ligue 2","BEN","No","7/1/2021","6/30/2024","$0","Right","Fairly Strong","Very Strong","5'8""","141 lbs","-","-",89,108,8,8,8,7,10,8,8,9,3,8,10,5,14,10,15,8,15,10,13,10,5,5,6,9,10,14,6,13,10,14,9,13,11,11,8,12,12,16,10,12,9,10,8,2,9,7,10,10,17,3,2,4,2,2,1,1,2,3,2,2
"9344",13232490,"Abiola Katchon","12/17/2001 (21 years old)","GK","Adjidja FC","Beninese Ligue 1 - Pool D","BEN","No","7/1/2022","6/30/2024","$14K - $130K","Right Only","Weak","Very Strong","6'1""","169 lbs","9","-",80,107,3,2,1,1,1,6,1,2,3,1,11,3,3,1,7,14,12,8,5,14,4,2,4,2,9,8,7,7,11,6,8,12,12,13,4,6,13,17,11,11,12,10,12,15,7,2,20,10,16,9,7,14,10,7,8,14,5,10,11,14
"9345",48043502,"Maël Sedagondji","8/23/1999 (23 years old)","D (RC), WB (R)","US Créteil-Lusitanos","French National 2 - D","BEN","Yes","7/1/2022","6/30/2024","$0 - $45K","Left Only","Very Strong","Weak","6'2""","169 lbs","40","-",72,106,7,12,5,3,5,4,8,3,6,7,7,6,12,8,7,12,9,8,11,11,13,5,14,6,8,7,5,8,13,9,8,11,14,13,11,6,10,13,11,10,13,11,13,12,9,2,12,12,11,3,2,2,3,4,3,2,2,2,1,1
"9346",13165374,"Nafiou Badarou","7/18/1991 (31 years old)","D (RC), WB (R)","Buffles FC","Beninese Ligue 1 - Pool A","BEN","No","1/2/2021","6/30/2025","Not for Sale","Right Only","Weak","Very Strong","5'11""","171 lbs","90","4",89,105,7,10,8,4,10,3,10,6,8,15,10,4,15,10,13,11,10,10,10,11,15,6,6,8,10,9,9,10,11,10,10,7,14,12,10,7,9,10,10,11,11,10,13,13,13,8,16,12,14,2,1,1,3,2,4,3,2,1,2,1
"9347",50042435,"Désiré Segbé","5/6/1993 (30 years old)","ST (C)","FC Bayern","Bundesliga","BEN","Yes","8/1/2022","6/30/2024","$0","Right","Reasonable","Very Strong","5'11""","160 lbs","186","62",95,105,6,8,11,11,11,7,11,8,6,3,10,11,4,11,11,11,12,11,9,9,13,12,5,12,4,9,11,10,14,12,9,10,12,14,11,10,7,12,12,11,11,10,12,11,5,14,11,12,13,1,1,2,1,3,3,3,2,1,3,3
"9348",20048851,"Abdul Gaffar Ibrahim","12/30/1999 (23 years old)","D (L)","Ifodjè FC","Togolese Second Division","BEN","No","3/18/2021","6/30/2024","$500 - $6K","Left Only","Very Strong","Weak","5'9""","160 lbs","1","-",82,105,6,10,7,5,12,2,10,7,5,11,11,4,13,11,8,12,7,4,3,12,12,6,4,9,10,10,10,10,13,12,11,8,11,12,15,10,15,11,11,12,13,9,7,5,8,4,10,11,5,2,2,2,2,1,1,3,2,1,4,1
"9349",13134201,"Jacques Bessan","9/15/1993 (29 years old)","ST (C)","CS Chebba","Ligue Professionnelle 2","BEN","No","1/1/2023","6/30/2024","$0","Right Only","Weak","Very Strong","6'0""","167 lbs","144","40",97,105,6,6,10,14,12,7,12,9,6,4,9,11,7,11,13,12,11,10,9,11,13,9,7,13,5,9,9,12,12,10,12,13,11,13,12,12,6,13,13,10,8,11,8,14,13,4,13,12,10,3,2,1,2,1,1,3,1,3,2,3
"9350",13105530,"David Djigla","8/23/1995 (27 years old)","AM (RL)","Vendée Herbiers Foot","French National 2 - B","BEN","No","9/1/2022","6/30/2023","$0 - $10K","Right Only","Weak","Very Strong","5'9""","160 lbs","131","8",90,104,7,8,9,7,9,11,7,9,6,4,7,8,6,11,9,7,7,9,8,9,10,8,6,11,8,6,5,7,15,15,13,8,12,16,9,7,8,11,15,8,10,12,8,6,6,5,8,12,14,1,1,2,1,3,3,3,3,4,2,1
"9351",7549917,"Silviu Lung","6/4/1989 (34 years old)","GK","Al-Raed","Saudi Professional League","ROU","Yes","7/25/2022","6/30/2024","$800K - $1.7M","Right Only","Weak","Very Strong","6'2""","171 lbs","372","-",104,130,3,1,3,1,7,6,8,3,1,2,8,3,3,8,7,11,10,12,10,10,12,8,12,10,12,11,6,10,9,11,9,12,14,9,8,11,11,12,12,16,12,13,4,13,2,7,13,13,12,11,10,14,10,14,13,13,6,12,14,14
"9352",91206103,"Ryan Adigo","4/15/2001 (22 years old)","M/AM (R)","Phönix Lübeck","German Regional Division North","BEN","Yes","9/7/2022","6/30/2024","$0","Right Only","Weak","Very Strong","5'11""","156 lbs","57","-",82,104,4,8,11,6,10,6,4,7,1,6,12,2,7,10,5,4,5,8,7,11,16,13,8,11,4,7,5,12,13,13,7,10,12,13,13,4,14,20,9,9,11,11,6,5,7,7,10,9,20,3,1,1,2,2,1,4,4,2,1,1
"9353",13134195,"Nabil Yarou","6/16/1993 (29 years old)","D (C), DM","Coton FC","Beninese Ligue 1 - Pool C","BEN","No","8/5/2022","6/30/2025","$6K - $65K","Right Only","Weak","Very Strong","6'0""","154 lbs","31","2",92,103,7,6,5,7,10,8,8,6,5,9,10,5,14,8,10,13,10,9,8,14,12,6,9,6,14,8,9,10,14,14,9,9,18,14,14,6,12,10,9,11,12,11,7,8,10,4,9,10,16,1,1,2,3,3,2,1,2,3,3,2
"9354",2000107546,"Malick Tongui","12/29/2003 (19 years old)","M (R), AM (RL)","LYS FC","Ivorian Ligue 1","BEN","No","9/15/2022","6/30/2024","$0 - $100K","Right Only","Weak","Very Strong","5'10""","152 lbs","-","-",84,103,7,10,12,9,9,12,6,10,7,5,11,4,8,13,7,7,5,8,7,6,16,12,3,13,6,8,7,13,14,11,12,7,12,14,9,4,11,15,11,12,12,10,5,6,14,1,19,14,11,1,2,2,3,2,1,2,2,2,1,3
"9355",13187019,"Marcellin Koukpo","4/6/1995 (28 years old)","AM (R), ST (C)","CS Constantine","Algerian League 1","BEN","No","9/4/2021","6/30/2023","$0 - $2K","Right","Reasonable","Very Strong","5'10""","169 lbs","110","25",98,103,7,11,13,9,12,8,12,6,5,6,10,1,2,11,9,11,9,7,9,10,18,12,3,11,9,8,7,10,14,11,9,5,12,14,12,6,11,20,12,12,11,12,9,11,5,4,12,12,12,2,1,3,1,2,3,2,3,3,3,3
"9356",13187178,"Samadou Bourou","10/13/2000 (22 years old)","D/WB (L)","ASKO de Kara","Togolese First Division","BEN","No","1/1/2020","6/30/2025","$0 - $26K","Left Only","Very Strong","Weak","5'9""","147 lbs","-","-",85,103,5,9,7,3,7,3,6,6,1,11,11,8,15,9,8,14,10,9,10,15,12,9,1,8,7,9,8,14,9,12,9,9,15,10,15,6,14,18,10,10,12,11,15,17,6,2,10,11,16,1,2,1,2,1,2,3,1,3,3,3
"9357",2000076568,"Romaric Amoussou","12/10/2000 (22 years old)","AM (R), ST (C)","Coton FC","Beninese Ligue 1 - Pool C","BEN","No","7/1/2021","6/30/2025","$14K - $150K","Right Only","Weak","Very Strong","5'7""","136 lbs","-","-",82,102,7,10,14,14,14,6,9,7,7,7,13,10,4,14,5,13,8,13,9,7,14,13,3,14,7,8,9,9,14,13,5,3,8,13,5,1,10,16,10,11,11,10,12,9,5,7,10,9,15,2,2,2,3,2,3,1,1,3,2,2
"9358",13134208,"Jérôme Bonou","1/27/1994 (29 years old)","DM, M/AM (C)","Coton FC","Beninese Ligue 1 - Pool C","BEN","No","7/1/2021","6/30/2025","$26K - $250K","Right Only","Weak","Very Strong","6'0""","158 lbs","-","-",90,102,6,7,9,12,8,7,7,7,2,7,13,6,11,13,15,13,9,8,6,13,6,15,12,9,10,8,13,10,12,13,8,5,13,13,13,5,9,16,11,11,7,11,12,15,15,7,11,8,19,2,3,3,4,3,2,1,1,3,1,2
"9359",2000244578,"Mouyizou Sabi-Yo","11/10/2002 (20 years old)","D (RL)","Damissa","Beninese Ligue 1 - Pool A","BEN","No","7/1/2022","6/30/2024","$0 - $85K","Left","Very Strong","Reasonable","5'8""","145 lbs","-","-",72,101,5,7,7,3,11,1,8,3,4,9,8,5,14,8,11,5,9,7,12,14,5,8,11,7,7,8,6,8,14,12,8,5,13,14,7,6,15,20,10,10,13,11,8,18,9,7,11,13,16,1,3,1,2,2,2,3,1,3,1,3
"9360",2000288020,"Nassif Ganiou","12/3/2002 (20 years old)","D (LC)","Vita Club","DR Congo Premier Division B","BEN","No","7/1/2022","6/30/2026","$0 - $20K","Left","Very Strong","Reasonable","5'8""","152 lbs","-","-",60,100,7,10,6,4,7,2,8,4,2,9,8,2,14,7,11,9,8,8,6,14,11,5,10,6,11,7,5,8,10,11,8,6,13,10,7,6,13,15,10,11,11,11,11,10,8,7,20,9,8,3,2,2,2,1,3,1,1,3,3,2
"9361",8446396,"Yoann Djidonou","5/17/1986 (37 years old)","GK","SO Romorantin","French National 2 - B","BEN","Yes","6/14/2021","6/30/2024","$0 - $18K","Right Only","Weak","Very Strong","5'11""","174 lbs","406","-",86,100,3,2,3,3,8,4,6,1,1,2,7,8,3,8,6,12,11,11,12,10,16,7,8,2,11,10,7,6,10,12,12,10,15,9,13,12,1,15,15,13,14,13,5,16,6,5,14,13,15,6,10,13,13,11,9,11,8,10,10,10
"9362",57137478,"Marius Marin","8/30/1998 (24 years old)","DM, M (C)","Pisa","Italian Serie B","ROU","Yes","9/30/2021","6/30/2025","$350K - $3.5M","Right","Reasonable","Very Strong","5'11""","152 lbs","215","5",120,130,10,10,11,9,12,10,10,11,6,10,12,9,13,13,15,13,13,12,13,12,16,9,11,13,14,14,10,16,12,13,12,10,14,13,14,11,17,15,9,14,15,10,7,14,14,10,13,13,11,2,3,2,1,1,3,2,2,3,1,3
"9363",85057789,"Yannick Aguemon","2/11/1992 (31 years old)","AM (RL)","RE Virton","Belgian First National Amateur Division","BEN","Yes","7/22/2022","6/30/2023","$0","Right","Reasonable","Very Strong","5'10""","165 lbs","218","31",91,100,7,9,11,9,11,13,10,10,7,4,11,10,4,10,11,10,13,12,10,8,11,12,8,14,8,9,10,12,12,12,13,10,11,12,12,10,9,11,10,8,9,8,10,11,11,11,14,13,7,2,1,1,3,3,3,3,1,1,3,1
"9364",19038795,"Elkeson","7/13/1989 (33 years old)","AM (L), ST (C)","CD Rongcheng","Chinese Super League","CHN","No","2/23/2023","12/31/2024","Not for Sale","Right","Fairly Strong","Very Strong","5'11""","182 lbs","341","157",121,150,10,11,14,14,13,14,14,13,7,6,12,13,8,14,9,14,11,13,12,14,15,14,4,14,8,13,12,12,10,10,12,11,12,11,11,12,12,11,11,13,13,13,7,14,7,6,10,12,14,2,2,4,2,1,4,2,1,1,3,2
"9365",8833551,"Aloísio","6/19/1988 (34 years old)","ST (C)","AMG","Brazilian National First Division","CHN","No","3/31/2022","12/31/2023","$14K - $150K","Right","Reasonable","Very Strong","5'9""","196 lbs","298","120",122,143,7,10,14,14,13,10,11,11,2,5,11,13,8,12,16,13,16,13,13,13,15,13,11,14,8,13,12,14,12,12,14,8,13,12,10,15,12,10,5,14,12,13,11,12,15,10,13,11,12,1,2,3,4,3,3,1,2,1,1,1
"9366",19010155,"Alan","7/10/1989 (33 years old)","AM (RL), ST (C)","FLU","Brazilian National First Division","CHN","No","8/4/2022","6/30/2024","$28K - $275K","Right","Fairly Strong","Very Strong","5'11""","171 lbs","260","125",122,142,9,10,14,14,15,10,13,12,6,5,13,12,7,15,14,13,11,12,12,13,13,16,9,13,4,12,12,12,12,14,10,12,12,12,10,8,4,13,8,11,12,10,12,10,6,10,12,10,6,1,3,3,3,3,1,3,1,3,3,1
"9367",43143492,"Pedro Delgado","4/7/1997 (26 years old)","M (C), AM (RC)","Shandong","Chinese Super League","CHN","Yes","1/1/2019","12/31/2023","$80K - $800K","Left","Very Strong","Fairly Strong","6'2""","187 lbs","100","23",100,138,12,12,13,12,13,12,7,12,4,5,13,11,7,13,11,10,10,13,10,12,10,10,8,9,8,12,13,9,11,12,13,12,11,11,7,11,12,13,11,14,11,8,4,10,6,4,13,9,8,1,3,1,3,3,1,3,2,1,2,1
"9368",28058228,"Tyias Browning","5/27/1994 (29 years old)","D (RC)","SH Port","Chinese Super League","CHN","No","8/22/2022","1/31/2024","$350K - $8.4M","Right","Weak","Very Strong","6'1""","167 lbs","119","2",109,135,5,7,7,5,8,5,13,6,10,13,8,5,12,6,12,11,13,12,11,13,13,7,11,9,12,12,7,13,13,10,13,13,15,14,12,14,10,18,14,13,11,8,5,8,8,4,14,12,13,3,3,2,1,2,1,2,2,1,1,1
"9369",1016974,"Wu Lei","11/19/1991 (31 years old)","AM (RLC), ST (C)","SH Port","Chinese Super League","CHN","No","8/10/2022","7/31/2027","Not for Sale","Right","Reasonable","Very Strong","5'9""","145 lbs","425","177",123,134,7,10,12,11,12,10,11,9,3,2,11,13,5,11,11,14,10,12,13,13,16,13,11,16,6,12,12,14,14,14,12,9,12,14,12,9,9,11,12,17,18,18,3,14,6,6,15,15,14,3,1,3,4,2,2,3,4,1,2,2
"9370",1007777,"Yu Dabao","4/18/1988 (35 years old)","D (C), M/AM (R), ST (C)","Beijing","Chinese Super League","CHN","No","1/1/2020","12/31/2024","Not for Sale","Right","Reasonable","Very Strong","6'1""","171 lbs","364","69",95,131,7,7,9,10,12,9,11,7,8,8,11,14,9,12,10,12,12,12,11,10,9,12,14,13,10,12,12,9,9,10,11,10,13,11,7,10,13,12,16,16,16,10,9,16,8,11,13,12,13,2,3,3,2,2,3,1,1,2,2,3
"9371",23221070,"Zhang Yuning","1/5/1997 (26 years old)","ST (C)","Beijing","Chinese Super League","CHN","No","2/23/2019","12/31/2023","$600K - $5.8M","Right","Fairly Strong","Very Strong","6'0""","176 lbs","147","55",106,129,5,8,8,12,12,8,13,11,5,6,11,12,6,12,14,12,14,12,11,12,12,13,8,12,6,12,9,13,11,12,14,13,12,11,11,13,6,14,11,16,11,13,12,13,5,5,13,17,8,1,1,3,4,1,2,2,3,1,3,2
"9372",1036556,"Zhang Linpeng","5/9/1989 (34 years old)","D (RC), DM","SH Port","Chinese Super League","CHN","No","1/1/2022","12/31/2023","$110K - $1.1M","Right","Weak","Very Strong","6'1""","176 lbs","319","20",102,127,5,8,9,5,9,8,12,10,8,10,8,10,13,7,15,11,15,9,10,10,14,9,12,11,11,13,8,15,12,10,15,14,17,12,13,14,15,11,17,18,10,18,14,13,11,7,12,13,16,1,1,2,1,3,3,2,3,4,3,2
"9373",57138289,"Tudor Băluţă","3/27/1999 (24 years old)","DM, M/AM (C)","Farul Constanţa","Romanian First League","ROU","Yes","7/12/2022","6/30/2024","$1.3M - $2.7M","Right","Reasonable","Very Strong","6'4""","176 lbs","96","9",115,130,6,9,9,11,12,8,14,12,6,12,12,10,12,11,10,14,13,12,13,12,11,10,9,12,12,13,13,13,11,12,12,14,12,11,12,13,13,16,8,15,15,11,6,10,2,5,12,12,11,1,3,2,1,3,2,1,2,2,1,1
"9374",23073174,"Zhang Jiaqi","12/9/1991 (31 years old)","DM, M (C)","Zhejiang","Chinese Super League","CHN","No","1/1/2022","12/31/2023","$30K - $325K","Right Only","Weak","Very Strong","6'4""","176 lbs","151","9",84,125,3,4,8,6,11,6,13,9,6,12,11,7,11,11,11,12,11,12,11,9,8,9,7,7,12,13,11,11,9,7,14,16,13,10,9,13,8,14,14,14,8,7,13,2,12,3,12,9,13,1,1,1,1,1,3,2,1,2,1,1
"9375",28018856,"Nico Yennaris","5/23/1993 (30 years old)","D (R), DM, M (C)","Beijing","Chinese Super League","CHN","Yes","4/1/2023","12/31/2023","Not for Sale","Right","Reasonable","Very Strong","5'9""","154 lbs","214","15",106,125,9,10,12,7,11,9,10,11,11,10,12,5,13,11,12,12,12,13,10,13,14,10,11,11,12,15,11,14,11,11,11,6,13,11,9,10,13,15,14,14,12,14,10,12,7,3,13,10,11,2,2,1,3,2,2,1,2,2,2,1
"9376",53104979,"John Hou Sæter","1/13/1998 (25 years old)","DM, M (C)","Ranheim","Norwegian First Division","CHN","Yes","2/1/2023","12/31/2025","$500 - $5K","Right","Weak","Very Strong","6'0""","163 lbs","92","10",92,122,11,13,13,11,12,14,7,11,8,9,13,12,9,14,7,14,7,14,11,13,15,13,10,13,12,13,14,12,8,10,7,9,10,8,7,5,15,12,11,17,13,15,14,12,6,3,12,11,11,1,2,3,3,1,2,3,1,1,2,1
"9377",23172593,"Wang Shangyuan","6/2/1993 (30 years old)","M (C), AM (RLC), ST (C)","Henan","Chinese Super League","CHN","No","12/21/2020","12/31/2025","$120K","Right","Weak","Very Strong","6'1""","165 lbs","197","21",90,122,10,7,9,9,9,10,9,9,6,7,9,6,8,11,7,9,12,10,8,9,11,12,6,8,8,11,8,13,11,11,11,12,14,12,11,9,15,11,11,10,10,12,7,11,8,4,10,14,12,1,2,2,2,1,2,2,2,3,2,3
"9378",23020214,"Zhang Chengdong","2/9/1989 (34 years old)","M/AM (RL)","Beijing","Chinese Super League","CHN","No","1/1/2022","12/31/2023","Not for Sale","Right","Weak","Very Strong","6'1""","171 lbs","292","24",89,122,7,9,10,10,8,8,12,10,8,8,9,9,12,8,11,11,12,11,11,11,15,11,13,10,8,12,9,12,11,11,12,13,15,12,9,14,15,9,16,17,15,13,10,11,9,6,14,11,13,3,3,2,3,3,3,2,3,1,1,2
"9379",1010568,"Yu Hai","6/4/1987 (36 years old)","D (LC), WB (L), M (LC), AM (L)","SH Port","Chinese Super League","CHN","No","1/1/2021","12/31/2023","$0 - $55K","Left","Very Strong","Weak","6'1""","171 lbs","363","26",85,121,11,10,9,10,10,11,12,10,7,9,10,12,10,10,13,12,10,13,11,11,16,13,8,13,10,11,12,10,10,9,10,13,13,11,7,11,18,12,7,13,12,12,15,17,14,6,13,9,7,3,3,2,1,1,1,2,3,1,2,1
"9380",23053137,"Zhang Xizhe","1/23/1991 (32 years old)","M/AM (LC)","Beijing","Chinese Super League","CHN","No","1/1/2020","12/31/2024","Not for Sale","Right","Reasonable","Very Strong","5'11""","152 lbs","303","52",94,120,12,10,10,8,12,12,6,6,5,5,12,12,6,14,9,11,8,12,12,11,12,13,9,12,7,14,14,12,11,12,11,8,12,11,9,7,14,10,11,13,12,14,7,14,7,8,14,11,7,2,2,2,3,1,1,3,3,2,1,1
"9381",23010867,"Lyu Wenjun","3/11/1989 (34 years old)","M/AM (RL), ST (C)","SH Port","Chinese Super League","CHN","No","1/1/2021","12/31/2025","$8K - $80K","Right","Fairly Strong","Very Strong","6'0""","154 lbs","356","69",90,119,10,9,8,9,8,12,7,9,6,6,10,10,6,10,9,9,13,8,10,10,14,9,7,10,7,13,9,14,11,11,10,11,12,12,11,9,17,7,9,14,12,19,4,10,5,8,13,11,4,1,1,1,2,2,3,3,3,4,3,2
"9382",132219,"Zhao Xuri","12/3/1985 (37 years old)","DM, M (C)","GX PG Hawlaeh","Chinese National First Division","CHN","No","3/31/2023","12/31/2023","$1K - $12K","Right","Reasonable","Very Strong","6'1""","171 lbs","438","33",87,119,10,9,9,11,8,11,12,11,12,11,8,10,13,8,15,11,15,8,9,10,11,5,13,8,9,12,11,9,8,7,13,12,16,8,7,13,9,4,7,8,15,12,3,3,14,8,6,14,13,3,1,3,3,1,2,4,2,3,1,2
"9383",23050267,"Zhao Honglyue","12/4/1989 (33 years old)","D/WB/M (RL)","CZ Mighty Lions","Chinese Super League","CHN","No","2/20/2023","12/31/2023","$16K - $150K","Right","Strong","Very Strong","5'11""","167 lbs","280","10",93,119,9,9,10,6,9,8,8,6,11,8,8,6,11,8,15,12,12,11,10,8,9,14,9,12,9,13,11,14,12,11,10,8,12,12,9,10,11,7,9,10,11,7,8,13,9,12,15,8,13,2,3,2,3,1,3,1,1,1,3,2
"9384",57140672,"Marian Aioani","11/7/1999 (23 years old)","GK","Farul Constanţa","Romanian First League","ROU","Yes","7/1/2021","6/30/2025","$350K - $3.4M","Right","Weak","Very Strong","6'2""","180 lbs","194","-",115,130,2,3,1,3,6,1,3,2,3,1,7,4,2,6,6,10,12,10,12,10,13,8,6,9,12,11,10,9,9,14,9,15,12,9,12,11,10,13,10,12,10,13,5,7,5,5,7,13,10,13,12,15,12,14,14,14,11,13,13,14
"9385",1008505,"Zeng Cheng","1/8/1987 (36 years old)","GK","SH Shenhua","Chinese Super League","CHN","No","4/1/2021","12/31/2023","$28K - $80K","Right","Weak","Very Strong","6'4""","176 lbs","337","-",88,119,4,1,1,1,4,9,3,2,3,2,4,2,3,5,8,10,13,12,12,11,15,9,9,9,13,10,9,10,9,9,11,16,12,8,6,9,10,12,8,10,15,10,7,17,2,7,11,10,15,10,13,11,13,12,7,12,4,13,10,13
"9386",23103722,"Murehmatjan","1/14/1991 (32 years old)","DM, M (C)","SH Port","Chinese Super League","CHN","No","12/31/2019","12/31/2023","$35K - $375K","Left","Very Strong","Weak","6'0""","160 lbs","215","3",93,118,10,9,11,8,10,11,7,9,10,8,10,9,10,10,16,11,16,10,12,11,12,14,10,10,12,11,12,15,12,12,10,10,15,12,9,10,13,10,12,10,11,10,9,10,10,12,14,12,11,3,3,1,2,3,1,2,3,1,1,3
"9387",23008713,"Sun Ke","8/26/1989 (33 years old)","M (R), AM (RC)","Shenzhen","Chinese Super League","CHN","No","7/16/2020","12/31/2023","$16K - $50K","Right","Fairly Strong","Very Strong","5'11""","167 lbs","292","37",82,118,10,9,12,10,12,8,6,7,4,5,9,6,6,11,15,12,13,9,10,11,17,11,6,13,7,12,7,14,11,11,10,8,10,12,7,8,10,10,12,17,15,14,13,13,6,4,11,9,13,1,3,1,2,2,1,3,3,3,3,2
"9388",1007737,"Wang Dalei","1/10/1989 (34 years old)","GK","Shandong","Chinese Super League","CHN","No","6/14/2021","12/31/2024","Not for Sale","Right Only","Weak","Very Strong","6'2""","198 lbs","392","-",106,118,3,3,4,6,4,5,7,2,3,4,8,2,10,5,12,12,14,10,11,10,16,13,15,7,12,12,8,12,11,12,10,14,13,9,9,10,13,6,9,14,17,13,11,16,16,13,15,14,16,15,12,13,16,13,13,11,13,14,12,11
"9389",23109095,"Liu Binbin","6/16/1993 (29 years old)","M/AM (RL)","Shandong","Chinese Super League","CHN","No","1/1/2021","12/31/2026","$50K - $500K","Right","Reasonable","Very Strong","5'8""","158 lbs","219","23",91,117,7,9,13,7,11,9,6,6,6,3,8,10,4,12,13,9,13,10,10,9,13,14,7,10,6,11,10,11,13,14,8,7,12,14,8,8,10,10,13,13,11,14,8,13,9,8,10,11,9,2,1,3,2,2,4,3,1,3,2,3
"9390",23027888,"Piao Cheng","8/21/1989 (33 years old)","DM, M (RC), AM (C)","Beijing","Chinese Super League","CHN","No","6/14/2021","12/31/2023","$10K","Right","Weak","Very Strong","5'9""","154 lbs","296","26",83,117,8,8,14,8,13,10,7,6,2,8,11,11,10,13,14,12,13,12,10,10,13,14,8,11,8,11,8,13,10,12,13,8,13,10,8,9,11,13,12,10,15,13,9,14,5,12,12,9,9,1,2,2,3,3,1,2,2,2,3,1
"9391",23050262,"Lyu Peng","10/28/1989 (33 years old)","DM, M (C)","DL Pro","Chinese Super League","CHN","No","1/1/2023","12/31/2024","Not for Sale","Right","Fairly Strong","Very Strong","6'0""","176 lbs","311","6",83,117,5,6,7,6,9,8,10,9,9,10,9,8,11,9,14,9,14,9,10,10,12,7,13,8,10,12,7,14,10,9,13,10,14,10,11,11,7,14,14,10,13,11,5,12,12,4,11,14,13,2,3,3,3,1,1,4,1,2,2,2
"9392",1007686,"Yan Xiangchuang","9/5/1986 (36 years old)","AM (R), ST (C)","DL Pro","Chinese Super League","CHN","No","1/1/2023","12/31/2023","$3.5K","Right","Fairly Strong","Very Strong","5'9""","145 lbs","433","67",84,117,10,9,10,9,11,10,3,7,4,3,10,12,3,11,9,10,9,12,12,10,13,14,10,13,6,9,10,12,12,12,9,6,5,12,9,7,8,15,10,12,11,11,12,13,8,6,14,12,14,4,2,2,2,3,1,3,1,3,2,4
"9393",1024748,"Zheng Zheng","7/11/1989 (33 years old)","D (LC)","Shandong","Chinese Super League","CHN","No","1/1/2021","12/31/2026","$65K - $650K","Left Only","Very Strong","Weak","6'1""","165 lbs","296","10",93,117,9,11,12,8,12,12,8,10,13,9,9,11,10,12,13,10,13,12,11,10,15,12,11,9,10,13,11,12,12,12,12,12,13,12,11,12,14,15,14,14,11,16,12,10,8,7,13,12,13,3,2,3,3,1,1,1,1,2,2,3
"9394",23090597,"Wang Tong","2/12/1993 (30 years old)","D/WB (R), DM, M (C)","Shandong","Chinese Super League","CHN","No","1/1/2021","12/31/2026","$800K - $1.8M","Right","Weak","Very Strong","6'0""","158 lbs","235","2",91,116,7,9,11,7,11,10,9,7,8,11,10,7,11,10,14,11,14,9,10,10,16,11,12,9,10,10,10,13,12,12,10,10,14,12,10,10,18,10,8,10,12,14,8,10,16,12,12,12,14,3,1,3,3,3,1,1,1,2,3,2
"9395",57077708,"Andrei Burcă","4/15/1993 (30 years old)","D (C)","CFR Cluj","Romanian First League","ROU","Yes","7/1/2019","6/30/2025","$220K - $2.2M","Right","Reasonable","Very Strong","6'2""","180 lbs","289","14",125,130,6,7,10,8,11,8,14,9,10,15,11,10,13,9,13,12,14,12,12,12,15,7,13,10,13,12,10,11,11,10,14,14,12,12,12,16,10,13,10,15,12,9,7,10,11,10,13,15,13,2,3,1,2,3,3,1,1,2,2,2
"9396",1001583,"Zheng Long","4/15/1988 (35 years old)","M/AM (LC)","QD Hainiu","Chinese Super League","CHN","No","1/1/2022","12/31/2023","$2.5K - $24K","Left Only","Very Strong","Very Weak","5'10""","160 lbs","328","47",83,116,11,11,10,13,12,12,5,12,7,5,12,9,5,11,13,12,12,13,13,11,14,15,8,12,7,15,11,12,11,12,12,8,16,11,8,11,12,12,8,15,15,13,5,15,13,8,10,12,16,3,3,2,3,1,2,1,2,3,2,1
"9397",23142144,"Liao Lisheng","4/29/1993 (30 years old)","DM, M (C)","Shandong","Chinese Super League","CHN","No","1/1/2022","12/31/2026","$70K - $700K","Right","Weak","Very Strong","5'10""","149 lbs","176","11",86,116,12,10,10,8,10,13,7,11,5,8,12,12,8,11,13,11,13,12,12,11,15,9,12,12,11,14,11,15,10,10,7,10,14,9,9,8,10,14,9,14,17,12,12,14,8,6,11,12,9,3,3,1,2,2,2,3,3,1,4,2
"9398",23230230,"Gao Zhunyi","8/21/1995 (27 years old)","D (RLC), DM","WH Three Towns","Chinese Super League","CHN","No","1/1/2022","12/31/2023","$180K - $1.8M","Right","Reasonable","Very Strong","6'1""","174 lbs","167","8",94,116,7,9,7,6,10,8,11,8,7,10,8,9,11,9,10,13,14,10,11,9,12,8,6,8,12,11,9,11,11,11,9,13,13,12,11,10,14,11,6,14,8,6,6,5,9,5,11,14,10,1,1,3,2,1,3,1,4,2,3,1
"9399",23010882,"Cai Huikang","10/10/1989 (33 years old)","DM, M (C)","SH Port","Chinese Super League","CHN","No","1/1/2021","12/31/2025","$28K - $275K","Right","Weak","Very Strong","6'0""","187 lbs","342","11",87,116,5,4,6,5,9,7,11,8,5,11,9,9,13,9,12,11,13,12,11,13,10,7,11,7,13,14,8,11,9,7,13,12,16,10,11,15,10,8,10,12,14,9,9,9,10,7,14,7,17,1,2,1,1,2,3,3,1,3,3,3
"9400",1007698,"Zhao Mingjian","11/22/1987 (35 years old)","D/WB/M (R)","SJZ Gongfu","Chinese National First Division","CHN","No","4/1/2023","12/31/2023","$0 - $45K","Right","Reasonable","Very Strong","5'11""","169 lbs","325","11",85,116,9,9,11,7,4,9,6,9,10,9,8,9,11,9,13,11,12,11,7,9,13,12,10,10,7,7,9,10,12,13,12,9,13,13,12,13,16,13,13,12,12,10,8,11,14,7,10,11,13,3,1,3,1,2,2,1,2,2,2,2
"9401",23010858,"Yan Junling","1/28/1991 (32 years old)","GK","SH Port","Chinese Super League","CHN","No","1/1/2021","12/31/2025","Not for Sale","Right Only","Weak","Very Strong","6'4""","189 lbs","341","-",102,116,2,3,2,1,7,6,6,3,1,2,6,2,2,5,9,12,12,11,12,12,11,9,7,5,12,12,7,13,10,12,14,16,15,9,10,10,10,15,11,14,10,18,4,12,3,3,17,10,5,13,9,13,10,10,14,10,7,12,11,12
"9402",2000153212,"Liu-Shao Ziyang","12/11/2003 (19 years old)","GK","Grazer AK 1902","Austrian First Division","CHN","No","12/16/2021","6/30/2025","$20K - $210K","Right Only","Weak","Very Strong","6'3""","169 lbs","21","-",89,116,4,3,1,1,8,8,6,3,2,1,9,1,3,8,6,9,12,10,11,9,14,4,3,2,12,10,8,10,9,12,12,16,12,9,9,12,11,18,17,18,16,12,6,3,13,1,10,14,15,11,14,12,11,12,10,11,7,9,10,13
"9403",5629400,"Feng Xiaoting","10/22/1985 (37 years old)","D (C)","DG Utd.","Chinese National First Division","CHN","No","4/18/2023","12/31/2023","$0 - $20K","Right","Reasonable","Very Strong","6'1""","171 lbs","346","8",89,116,4,5,7,4,8,4,10,4,5,12,7,12,13,9,10,13,8,13,9,13,8,11,14,9,14,14,8,9,8,9,10,12,13,9,9,9,6,10,12,8,13,11,14,9,7,7,8,8,6,1,3,2,1,2,1,3,3,2,3,2
"9404",1034925,"Yu Hanchao","2/25/1987 (36 years old)","M/AM (RL)","SH Shenhua","Chinese Super League","CHN","No","1/1/2021","12/31/2023","$85K - $250K","Right","Reasonable","Very Strong","5'10""","158 lbs","370","77",94,116,11,11,13,9,9,10,7,11,7,4,11,12,7,12,13,12,14,9,10,12,17,12,8,14,10,9,12,14,12,12,11,9,8,12,9,8,12,11,8,13,11,12,12,9,9,3,13,15,8,3,3,1,3,1,4,4,3,3,1,2
"9405",23039600,"Ren Hang","2/23/1989 (34 years old)","D (LC), WB (L)","WH Three Towns","Chinese Super League","CHN","No","2/1/2023","12/31/2024","Not for Sale","Right","Fairly Strong","Very Strong","6'0""","182 lbs","352","13",95,115,4,7,8,6,8,4,13,5,13,10,8,8,13,8,15,12,16,8,12,10,15,8,7,7,10,12,7,13,12,11,12,13,14,12,9,12,8,8,11,14,13,8,8,13,14,11,15,12,12,3,3,4,1,1,1,3,3,3,3,3
"9406",57147838,"Alexandru Măţan","8/29/1999 (23 years old)","AM (RLC)","Columbus","Major League Soccer","ROU","Yes","3/8/2021","6/30/2026","$550K - $5.6M","Right","Weak","Very Strong","5'6""","134 lbs","147","6",115,130,10,10,14,8,13,11,6,9,6,8,12,9,9,14,9,11,9,9,11,11,12,13,9,11,9,10,13,11,15,16,12,2,10,15,11,9,11,16,11,15,12,14,11,10,6,5,9,14,8,3,1,1,1,1,1,1,1,1,3,1
"9407",23111339,"Li Lei","5/30/1992 (31 years old)","D/WB (L), DM, M (LC)","Beijing","Chinese Super League","CHN","No","3/1/2023","12/31/2027","Not for Sale","Left Only","Very Strong","Weak","6'0""","169 lbs","225","10",100,115,11,10,9,7,11,11,9,7,11,9,10,6,12,11,12,11,12,10,13,11,12,12,13,11,10,12,11,14,11,12,11,11,9,12,13,11,12,15,16,15,12,13,12,14,8,4,12,12,6,3,1,3,3,1,1,2,1,2,3,3
"9408",1007638,"Cao Yunding","11/22/1989 (33 years old)","M (L), AM (LC)","SH Shenhua","Chinese Super League","CHN","No","1/1/2023","12/31/2024","$130K - $1.3M","Right","Fairly Strong","Very Strong","5'9""","154 lbs","345","39",93,115,12,11,12,8,13,11,7,10,5,5,12,6,5,14,15,11,12,7,12,12,15,14,11,11,6,11,11,12,12,13,9,5,9,12,8,9,14,6,11,7,7,15,12,13,11,17,11,8,9,2,2,1,2,2,3,2,2,2,1,1
"9409",83174194,"Yan Dinghao","4/6/1998 (25 years old)","DM, M (C)","WH Three Towns","Chinese Super League","CHN","No","2/18/2023","12/31/2025","$160K - $1.6M","Right","Reasonable","Very Strong","5'11""","163 lbs","102","11",85,115,8,8,10,7,10,12,8,10,9,7,12,8,10,12,8,9,10,10,11,10,11,9,7,10,10,13,10,13,11,12,9,8,13,11,10,10,10,15,17,16,6,10,4,8,5,7,11,11,13,2,1,3,2,3,3,2,3,3,3,2
"9410",23117578,"Tang Shi","1/24/1995 (28 years old)","AM (RL), ST (C)","HLJ Ice City","Chinese National First Division","CHN","No","4/3/2023","12/31/2024","$26K - $250K","Left Only","Very Strong","Weak","5'9""","125 lbs","80","14",72,115,9,9,10,8,9,9,6,8,4,5,10,11,5,11,11,10,12,13,10,11,7,15,6,11,9,10,11,10,12,12,6,6,8,12,7,5,15,18,10,14,12,5,5,15,5,5,12,5,15,2,2,1,2,1,1,3,3,1,3,3
"9411",5630052,"Huang Xiyang","6/14/1985 (37 years old)","DM, M/AM (C)","CQ TL Loong","Chinese National Second Division Southern Group","CHN","No","6/9/2022","12/31/2023","$0 - $6K","Right","Strong","Very Strong","5'10""","154 lbs","327","32",77,115,10,6,9,7,9,13,6,13,5,4,12,5,5,11,9,8,7,9,10,10,16,11,7,10,7,10,12,9,8,9,8,7,7,8,8,8,9,15,15,14,10,6,6,7,8,9,15,13,12,2,2,2,3,1,2,1,1,2,2,2
"9412",23109097,"Wu Xinghan","2/24/1993 (30 years old)","M (L), AM (RL), ST (C)","Shandong","Chinese Super League","CHN","No","6/14/2021","12/31/2026","$475K - $1.4M","Right","Reasonable","Very Strong","6'0""","149 lbs","191","29",92,115,6,9,13,10,10,7,8,9,10,4,11,12,4,11,12,10,11,10,8,10,15,14,10,10,6,10,9,10,13,13,8,9,13,13,8,8,14,10,10,7,15,14,10,12,8,9,12,12,12,3,2,3,2,1,2,2,4,2,3,3
"9413",23257106,"Zhang Xiuwei","3/13/1996 (27 years old)","DM, M/AM (C)","Guangzhou","Chinese National First Division","CHN","No","2/7/2019","12/31/2023","$26K - $275K","Right","Fairly Strong","Very Strong","5'8""","143 lbs","108","4",92,115,10,9,11,9,12,10,5,9,6,5,11,10,8,12,14,12,10,12,10,12,12,13,6,12,10,14,11,14,12,14,10,7,11,11,7,7,3,8,10,9,10,8,8,1,3,7,12,13,13,2,1,1,1,3,2,3,2,1,1,3
"9414",23450865,"Zhu Chenjie","8/23/2000 (22 years old)","D (C)","SH Shenhua","Chinese Super League","CHN","No","1/1/2023","12/31/2025","$4.8M - $9.2M","Right","Reasonable","Very Strong","6'1""","167 lbs","98","5",99,115,3,7,7,5,9,5,11,4,6,11,8,3,12,10,13,10,13,14,12,13,15,7,13,7,12,12,9,14,11,10,12,14,13,12,10,12,12,14,12,15,14,16,12,11,9,4,14,12,7,2,1,1,1,2,2,2,3,2,3,2
"9415",23165300,"Du Jia","5/1/1993 (30 years old)","GK","SH Port","Chinese Super League","CHN","No","1/1/2021","12/31/2024","$70K - $700K","Right","Weak","Very Strong","6'1""","171 lbs","96","-",84,114,2,3,3,2,6,4,9,2,2,3,6,1,2,7,12,12,12,13,12,9,11,1,6,3,11,8,5,14,9,10,13,12,15,8,8,12,11,16,10,10,12,11,7,14,10,5,13,12,18,10,12,13,13,10,10,12,4,9,10,10
"9416",23221068,"Cheng Jin","2/18/1995 (28 years old)","M/AM (C)","Zhejiang","Chinese Super League","CHN","No","1/1/2021","12/31/2025","$190K","Right","Weak","Very Strong","5'9""","152 lbs","185","16",86,114,11,7,12,9,11,10,7,9,8,10,10,8,7,11,15,10,9,11,9,11,16,14,12,11,6,12,14,12,12,12,10,10,15,11,9,8,15,13,9,13,13,15,9,13,8,7,14,14,12,3,3,2,3,3,2,2,3,3,1,3
"9417",57024540,"Vlad Chiricheş","11/14/1989 (33 years old)","D (C)","Cremonese","Italian Serie B","ROU","Yes","7/8/2022","6/30/2024","$0","Right","Weak","Very Strong","6'0""","165 lbs","259","8",119,145,4,6,10,7,12,7,14,10,11,14,10,9,14,12,13,13,14,14,11,11,14,10,16,10,12,14,12,12,11,11,14,14,5,11,12,14,11,12,14,16,13,13,18,13,13,3,13,13,14,3,2,2,3,4,3,4,2,3,1,1
"9418",57149755,"Andrei Cordea","6/24/1999 (23 years old)","M/AM (R)","FCSB","Romanian First League","ROU","Yes","6/12/2021","6/30/2026","$140K - $1.4M","Left","Very Strong","Weak","5'11""","165 lbs","127","15",120,130,9,11,12,12,12,10,10,12,6,6,13,12,6,13,10,12,10,13,10,12,14,12,9,12,8,13,12,13,15,15,12,8,12,13,12,11,13,16,16,15,14,12,4,14,9,5,15,17,18,1,2,3,3,2,3,2,1,4,1,1
"9419",23220963,"Liu Yiming","2/28/1995 (28 years old)","D (C)","WH Three Towns","Chinese Super League","CHN","No","1/1/2022","12/31/2024","$130K - $1.3M","Right Only","Weak","Very Strong","6'3""","176 lbs","153","2",92,113,5,5,7,5,8,5,12,5,7,12,8,6,11,8,15,12,13,12,10,9,7,7,11,6,12,13,8,12,11,9,14,16,13,11,10,14,5,11,9,7,8,5,11,10,11,4,8,12,10,1,3,2,1,2,4,2,1,1,3,2
"9420",47064795,"Eljif Elmas","9/24/1999 (23 years old)","M/AM (LC)","Parthenope","Italian Serie A","MKD","No","8/18/2020","6/30/2025","$33M - $41M","Right","Fairly Strong","Very Strong","6'0""","149 lbs","210","23",146,152,10,12,15,13,15,11,12,13,6,8,16,14,10,15,14,13,13,15,11,13,13,14,8,15,11,14,13,15,14,14,14,12,15,13,12,12,16,8,8,13,13,12,7,12,11,8,12,15,13,3,4,2,3,1,2,1,1,1,2,3
"9421",27102027,"Enis Bardhi","7/2/1995 (27 years old)","M/AM (LC)","Trabzonspor","Turkish Super League","MKD","No","8/11/2022","6/30/2025","$350K - $3.5M","Right","Fairly Strong","Very Strong","5'8""","154 lbs","271","55",120,146,14,12,14,12,14,17,7,17,5,7,13,12,7,15,11,13,11,12,13,12,16,15,8,14,8,14,12,12,11,13,11,6,14,12,12,8,13,8,15,14,13,13,8,13,9,7,10,12,15,4,2,3,3,2,1,3,2,3,2,3
"9422",47022611,"Stole Dimitrievski","12/25/1993 (29 years old)","GK","Vallecano","Spanish First Division","MKD","Yes","6/14/2021","6/30/2024","$450K - $4.6M","Right","Fairly Strong","Very Strong","6'2""","196 lbs","358","-",133,142,4,1,1,2,12,8,2,2,2,2,13,2,3,12,13,12,13,12,13,12,15,2,12,3,12,9,11,12,11,12,12,14,10,11,11,13,14,15,12,14,12,12,10,14,5,7,15,12,15,14,11,15,11,13,12,14,5,13,14,13
"9423",98017001,"Ezgjan Alioski","2/12/1992 (31 years old)","D/WB/M/AM (L)","Al-Ahli (KSA)","Saudi Professional League","MKD","Yes","7/29/2021","6/30/2024","$1.9M","Left","Very Strong","Reasonable","5'7""","149 lbs","399","55",125,140,11,14,12,12,13,11,8,12,8,9,13,13,10,14,16,11,16,12,13,11,14,13,10,11,11,13,11,14,13,14,12,7,19,13,14,10,16,6,2,11,17,15,4,12,16,12,8,14,14,3,3,2,2,3,3,2,3,1,3,3
"9424",91178617,"Darko Churlinov","7/11/2000 (22 years old)","M/AM (RL)","Burnley","English Premier Division","MKD","No","8/19/2022","6/30/2026","$11M - $13.5M","Right","Reasonable","Very Strong","5'11""","160 lbs","61","9",120,140,6,11,14,11,12,9,7,10,6,9,12,9,10,13,16,12,12,11,12,9,17,16,4,12,8,11,13,15,14,14,11,8,13,15,12,9,18,9,10,12,13,7,9,13,11,7,12,16,18,3,1,1,1,1,3,3,3,1,1,1
"9425",47100197,"Behar Feta","4/7/2003 (20 years old)","AM (RLC), ST (C)","Voska Sport","North Macedonian First League","MKD","No","9/3/2021","6/14/2024","$190K - $550K","Right","Weak","Very Strong","5'7""","136 lbs","54","38",98,139,9,12,12,11,10,8,8,8,9,9,10,8,7,11,13,12,10,11,10,12,14,12,7,10,9,10,10,10,12,15,10,4,12,12,11,11,11,20,10,12,11,10,12,16,10,1,10,10,20,3,1,3,2,2,3,1,2,3,2,2
"9426",2000038263,"Berat Kalkan","3/2/2003 (20 years old)","D (R), AM (RL)","Kasımpaşa","Turkish Super League","MKD","No","6/1/2022","6/30/2026","$65K - $650K","Right","Weak","Very Strong","5'7""","143 lbs","18","-",105,139,9,11,14,12,11,9,6,10,10,9,11,7,13,12,12,9,9,10,11,9,15,13,8,12,9,13,11,13,14,13,11,5,12,12,11,7,13,12,7,12,8,10,10,6,15,5,13,12,18,4,2,3,1,1,1,2,2,3,2,2
"9427",24004381,"Arijan Ademi","5/29/1991 (32 years old)","DM, M (C)","Beijing","Chinese Super League","MKD","Yes","3/30/2023","3/30/2026","Not for Sale","Right","Reasonable","Very Strong","5'11""","174 lbs","308","26",129,137,5,7,13,11,12,5,12,9,8,12,13,8,13,11,14,14,16,13,15,15,19,10,20,16,11,20,12,16,10,9,14,12,9,12,14,15,14,7,11,17,18,20,15,15,9,8,17,13,7,3,1,3,3,1,1,3,3,3,3,3
"9428",62035683,"Ilija Nestorovski","3/12/1990 (33 years old)","ST (C)","Udinese","Italian Serie A","MKD","No","7/26/2019","6/30/2023","$500 - $4.5K","Left","Very Strong","Reasonable","6'0""","165 lbs","361","135",117,135,6,8,11,14,11,8,13,11,6,7,11,14,8,12,14,14,13,12,12,13,15,13,15,15,6,15,10,15,13,11,13,11,14,13,10,13,10,20,12,16,12,13,4,14,14,12,13,12,15,1,2,4,2,3,3,3,2,1,3,3
"9429",57024538,"Alexandru Maxim","7/8/1990 (32 years old)","AM (C)","Gaziantep FK","Turkish Super League","ROU","Yes","6/1/2022","6/30/2024","$600K - $6M","Right","Strong","Very Strong","5'10""","154 lbs","356","68",130,143,16,14,14,14,15,14,5,16,4,5,14,16,6,16,8,12,7,15,10,13,12,15,5,13,6,12,16,10,13,14,8,8,14,10,10,11,13,8,10,12,10,12,6,12,5,14,13,16,14,1,1,3,3,3,2,2,3,3,3,1
"9430",47076732,"Bojan Miovski","6/24/1999 (23 years old)","ST (C)","Aberdeen","cinch Premiership","MKD","No","6/22/2022","5/31/2026","$650K - $10M","Left","Very Strong","Reasonable","6'2""","165 lbs","131","38",122,135,10,6,14,14,14,11,13,10,6,5,13,15,4,15,11,14,13,8,9,9,13,13,12,15,8,10,12,14,14,14,11,10,15,14,11,10,15,7,11,10,13,10,13,4,12,5,12,12,16,1,4,3,3,1,2,2,3,3,3,3
"9431",47100214,"Bojan Dimoski","11/23/2001 (21 years old)","D (L), DM, M (LC), AM (L)","AP Brera","North Macedonian First League","MKD","No","7/30/2020","6/30/2024","$85K - $850K","Left","Very Strong","Reasonable","5'9""","154 lbs","84","3",96,132,10,13,11,11,15,9,9,7,9,11,14,6,15,10,13,10,10,9,10,10,7,15,9,14,8,10,11,11,12,9,10,5,10,10,7,8,13,19,9,9,10,11,12,7,5,4,17,8,11,1,3,3,3,1,3,1,2,1,3,3
"9432",47038965,"Visar Musliu","11/13/1994 (28 years old)","D (C)","FC Ingolstadt 04","3. Liga","MKD","No","1/18/2022","6/30/2025","$650K - $1.4M","Right","Fairly Strong","Very Strong","6'2""","174 lbs","259","17",116,130,3,6,7,6,10,3,13,6,8,13,11,6,13,9,17,13,14,12,12,12,14,6,14,8,13,12,10,13,11,11,13,14,12,12,12,13,13,8,8,16,10,8,10,13,13,3,13,12,16,3,1,1,1,4,2,4,1,3,2,3
"9433",8408933,"Ivan Trickovski","4/18/1987 (36 years old)","AM (RC), ST (C)","AEK Larnakas","Cypriot First Division","MKD","No","10/15/2021","5/31/2024","$85K - $250K","Right","Reasonable","Very Strong","6'0""","174 lbs","437","167",120,130,10,11,13,15,13,9,11,8,7,3,12,16,4,13,8,15,7,16,13,13,15,12,16,14,6,13,13,7,12,10,14,11,11,11,9,10,12,11,13,13,13,12,7,16,6,5,14,14,14,3,2,1,2,2,1,2,2,1,1,3
"9434",47085786,"Nikola Serafimov","8/11/1999 (23 years old)","D (C)","Fehérvár","Hungarian Division I","MKD","No","7/11/2022","6/30/2025","$150K - $1.5M","Right","Weak","Very Strong","6'4""","176 lbs","107","6",105,130,5,5,6,10,10,4,13,4,7,12,12,6,13,10,13,11,14,11,11,9,12,6,7,8,12,13,8,12,11,12,11,15,11,12,13,14,12,14,11,11,10,11,7,8,10,3,9,12,13,3,1,1,1,2,3,3,3,1,2,3
"9435",93049431,"Erdal Rakip","2/13/1996 (27 years old)","DM, M (C)","Antalyaspor","Turkish Super League","MKD","Yes","1/19/2023","6/30/2025","$140K - $1.4M","Right","Reasonable","Very Strong","5'10""","156 lbs","195","15",115,129,11,10,12,10,13,10,9,10,7,10,13,11,12,13,14,13,13,13,13,12,13,12,11,11,11,13,12,13,12,12,12,8,11,12,13,11,13,10,10,13,13,14,6,12,14,8,13,12,11,3,1,1,3,2,3,2,1,1,1,3
"9436",62092056,"Stefan Ristovski","2/12/1992 (31 years old)","D (RC)","Dinamo","Croatian First League","MKD","No","4/11/2023","6/15/2025","Not for Sale","Right","Weak","Very Strong","5'11""","167 lbs","300","8",128,129,8,13,11,8,12,6,13,12,14,13,13,7,14,11,16,15,17,11,12,12,16,7,16,13,12,15,11,17,12,10,13,12,14,16,14,13,10,6,7,15,11,8,8,14,15,16,13,16,13,2,1,2,4,4,3,4,3,1,1,1
"9437",24021130,"Aleksandar Trajkovski","9/5/1992 (30 years old)","AM (RLC), ST (C)","Al-Fayha","Saudi Professional League","MKD","No","1/31/2022","6/30/2026","$7.2M - $11M","Right","Weak","Very Strong","5'10""","171 lbs","299","42",117,129,13,12,14,10,14,14,8,15,5,4,11,10,4,15,10,11,7,11,12,8,7,16,6,12,6,7,13,11,14,14,13,8,14,14,12,10,15,17,12,10,10,12,4,15,6,8,10,14,10,2,2,2,3,3,1,1,1,2,3,1
"9438",93033202,"Leonard Zuta","8/9/1992 (30 years old)","D (RL)","Vålerenga","Norwegian Premier Division","MKD","Yes","8/1/2021","12/31/2024","$0","Left Only","Very Strong","Weak","6'0""","158 lbs","273","6",106,128,12,12,8,6,12,13,11,9,10,12,12,7,12,10,13,13,13,11,11,12,13,8,8,12,11,14,11,14,11,10,13,12,15,12,14,12,14,9,10,14,13,8,5,11,11,8,12,11,13,1,1,1,2,3,3,1,1,2,3,3
"9439",47085818,"Marko Alcevski","4/16/2002 (21 years old)","GK","AP Brera","North Macedonian First League","MKD","No","8/8/2022","6/14/2025","$180K - $1.8M","Right","Fairly Strong","Very Strong","6'0""","165 lbs","45","-",93,127,3,2,2,3,3,7,1,3,2,1,9,1,3,5,6,8,14,8,6,13,6,1,9,1,9,8,7,7,12,15,8,6,13,12,4,6,12,15,8,11,10,11,8,15,13,8,16,9,14,8,10,13,12,10,13,8,5,12,9,11
"9440",2000094534,"Andrei Borza","11/12/2005 (17 years old)","D/WB (L)","Farul Constanţa","Romanian First League","ROU","Yes","6/13/2022","6/30/2025","$220K - $2.2M","Left","Very Strong","Fairly Strong","6'0""","158 lbs","44","3",102,141,8,11,10,8,11,7,8,12,9,11,11,8,11,11,8,12,13,11,12,11,14,10,6,11,11,13,10,12,13,13,11,10,11,11,11,10,11,14,14,14,13,12,5,10,5,2,12,13,12,1,4,1,2,2,2,2,4,2,2,1
"9441",67085641,"David Babunski","3/1/1994 (29 years old)","M/AM (C)","Mezőkövesd","Hungarian Division I","MKD","Yes","1/26/2023","6/30/2025","$230K - $700K","Right","Reasonable","Very Strong","5'10""","158 lbs","192","12",97,127,12,10,13,8,15,10,7,9,8,6,13,11,9,14,9,10,10,10,11,13,14,13,10,9,7,11,12,9,12,12,12,8,11,11,8,8,10,15,14,13,13,13,10,11,5,5,11,10,12,2,1,2,2,1,1,3,2,1,2,1
"9442",47082833,"Dimitar Todorovski","3/7/2002 (21 years old)","DM, M (C)","Rabotnički","North Macedonian First League","MKD","No","9/1/2021","6/30/2024","$800K - $1.7M","Left","Very Strong","Reasonable","5'10""","154 lbs","105","6",100,127,2,6,7,8,12,2,6,6,6,7,15,5,13,12,12,13,10,10,11,15,15,5,8,10,8,10,13,13,10,15,10,9,11,14,8,7,14,18,12,11,10,11,9,4,11,5,11,10,16,2,1,3,3,2,1,2,3,2,2,3
"9443",2000014287,"Luka Stankovski","9/2/2002 (20 years old)","DM, M (C)","Gorica","Slovenian Second League","MKD","No","1/13/2022","6/30/2026","$110K - $1.1M","Right Only","Weak","Very Strong","6'3""","180 lbs","67","16",95,126,12,12,12,8,13,8,10,12,8,9,13,10,10,13,7,12,9,12,12,12,9,9,8,12,13,12,13,12,9,7,10,13,8,8,13,13,10,9,9,9,9,9,9,11,7,9,8,9,9,2,1,1,2,1,3,2,2,2,4,2
"9444",2000238695,"Feta Fetai","5/11/2005 (18 years old)","M/AM (C)","Rabotnički","North Macedonian First League","MKD","No","7/1/2021","6/30/2025","$18K - $170K","Right","Reasonable","Very Strong","5'8""","132 lbs","13","-",83,126,9,8,11,7,13,6,6,11,5,5,12,9,7,12,13,12,10,10,7,8,15,13,9,10,7,12,11,12,11,13,10,5,16,12,9,6,13,17,11,11,14,9,6,11,13,5,8,10,15,1,2,3,1,2,1,4,4,2,3,2
"9445",8403183,"Martin Bogatinov","4/26/1986 (37 years old)","GK","Achna","Cypriot First Division","MKD","No","6/14/2021","6/30/2024","$500 - $4K","Right","Reasonable","Very Strong","6'2""","178 lbs","324","-",95,125,3,2,3,3,10,5,7,1,2,2,8,3,1,6,12,13,12,12,12,11,12,6,14,3,12,12,4,5,7,10,15,14,11,8,8,12,12,12,13,12,10,12,6,11,7,5,12,14,13,11,9,12,9,10,11,11,5,11,12,11
"9446",24002261,"Daniel Georgievski","2/17/1988 (35 years old)","D/WB (RL)","Inter Lions","Football NSW League One","MKD","No","6/9/2021","9/30/2023","$0","Right","Reasonable","Very Strong","5'10""","165 lbs","272","8",88,125,10,11,7,6,10,8,7,9,12,12,10,7,10,12,14,10,14,8,10,11,15,12,11,10,11,14,10,14,10,10,11,8,10,10,11,10,14,14,10,14,12,12,4,14,14,9,12,14,18,1,2,1,3,1,1,2,2,2,1,2
"9447",47076833,"Jani Atanasov","10/31/1999 (23 years old)","DM, M (C)","Cracovia","PKO Bank Polski Ekstraklasa","MKD","No","1/23/2023","6/30/2026","$700K - $1.5M","Right","Reasonable","Very Strong","6'2""","169 lbs","135","18",108,125,12,13,11,8,12,12,9,12,8,8,12,10,10,12,13,11,8,11,12,11,11,13,10,12,8,11,13,14,13,12,12,13,13,12,13,10,10,10,7,12,11,7,6,9,8,5,10,12,13,1,1,2,4,2,4,1,3,3,2,2
"9448",47091245,"Mario Ilievski","4/24/2002 (21 years old)","ST (C)","Kisvárda","Hungarian Division III - Northeast","MKD","No","7/7/2022","6/30/2025","$700K - $1.5M","Right","Reasonable","Very Strong","6'0""","171 lbs","103","34",99,125,8,8,10,13,10,10,12,11,8,7,10,6,9,10,12,13,9,10,12,11,13,12,11,14,8,11,9,12,11,10,11,13,12,12,9,12,14,16,12,13,11,12,7,13,9,2,13,10,17,3,3,2,1,2,3,1,1,1,3,1
"9449",24057567,"Stefan Jevtoski","9/2/1997 (25 years old)","DM, M (C)","Újpest","Hungarian Division I","MKD","Yes","6/18/2021","6/30/2024","$8K - $85K","Right","Weak","Very Strong","5'11""","160 lbs","130","5",90,125,7,8,9,8,11,10,11,9,10,10,11,10,10,11,15,10,13,9,10,10,14,12,12,11,11,13,11,14,10,10,11,11,5,11,11,11,14,12,13,11,14,10,8,10,8,1,11,10,11,1,2,2,2,1,1,1,3,1,1,2
"9450",67173160,"Dorian Babunski","8/29/1996 (26 years old)","ST (C)","Debrecen","Hungarian Division I","MKD","Yes","1/17/2022","6/30/2024","$0","Right","Reasonable","Very Strong","6'1""","169 lbs","155","36",118,125,8,10,14,14,13,12,13,11,6,5,12,14,9,13,11,13,10,13,12,12,11,13,9,14,8,11,13,10,11,11,11,13,12,12,11,11,14,16,13,15,15,11,8,16,8,7,15,13,11,1,3,3,1,3,3,2,2,1,3,3
"9451",57146735,"Alexandru Cicâldău","7/8/1997 (25 years old)","M/AM (C)","Galatasaray","Turkish Super League","ROU","Yes","7/24/2021","6/30/2026","$400K - $4M","Right","Reasonable","Very Strong","5'10""","167 lbs","221","47",125,140,14,12,12,12,14,13,7,12,6,8,15,13,10,14,10,14,8,14,8,14,12,12,8,13,9,14,14,14,11,13,12,8,14,10,13,10,12,15,9,15,7,11,7,12,8,6,14,13,10,3,1,1,3,3,2,3,2,3,2,3
"9452",47082883,"Jovan Manev","1/25/2001 (22 years old)","D (C)","Bregalnica","North Macedonian First League","MKD","No","6/15/2020","6/30/2025","$50K - $475K","Right","Reasonable","Very Strong","6'2""","178 lbs","108","8",105,125,6,8,10,7,11,7,12,7,7,12,11,6,13,10,10,12,11,11,12,11,13,10,7,8,11,13,9,13,12,13,11,13,9,12,12,11,9,15,14,13,12,10,7,9,9,5,12,9,20,3,1,2,3,1,2,3,2,1,2,2
"9453",8403383,"Dušan Savić","10/1/1985 (37 years old)","M/AM (C), ST (C)","Dubočica","Serbian First League","MKD","No","6/30/2019","6/30/2024","$500 - $6K","Right","Weak","Very Strong","5'10""","167 lbs","449","173",90,124,9,6,12,11,12,10,9,8,6,8,10,8,9,14,14,12,9,12,9,12,12,12,13,12,12,10,11,12,11,8,9,10,13,11,11,10,12,12,13,12,13,12,6,12,7,5,12,14,13,1,2,3,4,3,2,1,2,2,3,2
"9454",62161277,"Aleksa Amanović","10/24/1996 (26 years old)","D (L)","Astana","Kazakhstan Premier League","MKD","No","1/17/2023","12/31/2025","$850K - $1.9M","Left","Very Strong","Weak","6'2""","182 lbs","195","7",117,123,13,13,10,10,13,10,11,10,13,12,12,11,13,11,11,12,10,13,13,13,12,9,11,10,13,13,12,13,13,13,12,13,12,13,12,12,13,12,13,12,11,12,10,7,8,9,13,12,13,1,2,2,2,3,1,3,1,3,1,4
"9455",47100215,"Aleksandar Gjurkovski","2/11/2002 (21 years old)","D (RC), DM","Tikveš","North Macedonian First League","MKD","No","7/19/2022","6/30/2024","$60K - $600K","Right","Reasonable","Very Strong","6'0""","169 lbs","47","-",88,121,7,10,4,2,9,7,12,8,3,8,6,1,14,8,8,10,9,8,10,14,14,5,11,7,11,8,9,9,10,13,8,8,9,12,7,8,11,11,13,11,11,9,8,5,5,3,10,12,19,2,2,3,3,3,1,3,3,1,2,3
"9456",47076702,"Agon Elezi","3/1/2001 (22 years old)","DM, M (C)","Varaždin","Croatian First League","MKD","No","9/19/2022","5/31/2024","$45K - $425K","Right","Reasonable","Very Strong","5'10""","152 lbs","92","7",102,121,8,8,12,12,10,9,7,11,6,10,12,4,13,12,14,13,14,12,8,9,14,11,7,13,9,12,11,14,13,14,10,9,13,12,12,8,20,9,7,11,13,11,8,4,10,7,10,12,8,2,2,1,2,1,3,1,1,1,1,3
"9457",47104826,"Dashmir Elezi","11/21/2004 (18 years old)","AM (C), ST (C)","Shkëndija","North Macedonian First League","MKD","No","6/13/2022","6/30/2024","$150K - $1.5M","Right","Fairly Strong","Very Strong","5'9""","141 lbs","63","10",91,121,7,9,11,11,13,7,8,6,3,5,7,4,4,12,6,6,9,7,8,6,11,15,4,11,6,8,8,12,15,14,12,3,10,15,13,3,10,20,12,10,13,12,13,6,9,2,9,11,12,1,2,1,3,3,2,2,1,4,1,3
"9458",2000312836,"Petar Mitrevski","3/6/2007 (16 years old)","M/AM (RC)","Kamenica Sasa","North Macedonian Second League","MKD","No","7/1/2022","6/30/2026","$0 - $24K","Right","Fairly Strong","Very Strong","5'9""","136 lbs","7","-",55,120,4,7,6,10,12,4,4,6,4,4,10,3,6,8,7,5,6,2,1,8,8,9,7,7,5,6,4,11,10,11,5,3,7,11,10,4,13,17,11,8,10,12,9,13,15,1,9,11,20,2,2,3,4,2,3,2,1,2,1,1
"9459",2000116989,"Martin Gjorgievski","2/28/2005 (18 years old)","DM, M (C)","AP Brera","North Macedonian First League","MKD","No","8/16/2021","6/14/2024","$475K - $1.4M","Right","Fairly Strong","Very Strong","5'10""","156 lbs","27","2",92,120,6,8,6,10,13,8,8,9,4,10,14,5,10,9,15,8,9,8,5,14,11,5,1,8,10,9,14,12,14,14,5,5,11,13,7,7,13,10,10,10,12,11,5,16,5,5,12,11,12,2,2,2,1,3,1,2,2,2,1,3
"9460",2000105369,"Erion Aliji","12/10/2005 (17 years old)","D (R)","SV Ried","Austrian First Division","MKD","No","9/6/2021","6/30/2025","$750K - $1.6M","Right","Strong","Very Strong","5'10""","143 lbs","27","2",75,120,6,11,7,1,10,1,7,3,7,7,9,1,12,9,12,7,9,7,7,8,18,10,11,6,6,8,9,9,12,14,8,11,10,14,8,5,10,15,11,11,11,8,9,9,10,7,7,11,9,1,2,3,1,4,2,1,1,1,3,1
"9461",24057197,"Milan Ristovski","4/8/1998 (25 years old)","AM (RC), ST (C)","Trnava","Slovak First Division","MKD","No","7/17/2021","6/30/2024","$275K - $800K","Right","Reasonable","Very Strong","6'0""","165 lbs","145","30",105,120,7,12,12,14,13,10,11,11,5,10,10,11,5,11,10,10,8,15,11,13,12,8,11,12,10,11,11,9,12,10,9,11,14,12,10,8,11,16,9,9,8,11,12,15,15,3,20,15,13,3,2,2,2,2,1,3,1,4,2,1
"9462",57050464,"Nicolae Stanciu","5/7/1993 (30 years old)","M/AM (RC)","WH Three Towns","Chinese Super League","ROU","Yes","2/15/2022","12/31/2024","$475K - $4.8M","Right","Fairly Strong","Very Strong","5'7""","138 lbs","371","77",137,140,13,13,15,14,15,13,7,15,3,6,16,13,6,15,9,13,10,14,13,16,11,15,11,15,10,11,15,12,12,14,12,7,15,13,11,9,12,15,15,12,8,12,4,10,6,7,12,15,7,2,2,1,3,1,1,4,1,3,2,3
"9463",2000300636,"Stefan Mladenovski","6/28/2007 (15 years old)","ST (C)","Crvena zvezda","Serbian SuperLeague","MKD","No","6/12/2023","6/30/2027","$250K - $2.6M","Right","Reasonable","Very Strong","5'10""","143 lbs","-","-",80,120,7,7,10,11,10,9,8,10,7,7,9,10,8,10,10,10,10,11,11,10,12,9,9,8,10,10,9,11,10,11,10,9,9,11,11,10,8,12,13,12,14,12,12,9,8,4,11,10,14,2,1,3,1,3,1,3,3,3,3,1
"9464",64004588,"Filip Gacevski","8/17/1990 (32 years old)","GK","Vardar","North Macedonian First League","MKD","Yes","12/19/2021","6/14/2024","$65K - $650K","Right Only","Weak","Very Strong","6'3""","180 lbs","301","-",93,120,4,1,2,3,7,6,1,3,3,3,12,3,1,3,14,7,12,9,10,11,14,11,10,1,11,11,9,13,10,12,11,12,12,10,10,10,10,13,15,15,13,14,7,13,8,8,12,14,14,11,9,12,11,9,10,11,13,11,10,13
"9465",69004579,"Darko Tofiloski","1/13/1986 (37 years old)","GK","Pobeda","North Macedonian Second League","MKD","No","1/1/2022","6/30/2024","$0","Right","Reasonable","Very Strong","6'4""","189 lbs","408","-",85,120,4,2,2,3,1,8,1,3,3,3,11,3,2,1,14,12,15,8,11,11,11,1,12,3,12,9,8,8,9,14,9,16,8,9,3,8,12,12,12,9,10,10,8,3,11,2,20,9,10,8,12,11,14,7,10,9,5,10,8,14
"9466",28086369,"Dejan Iliev","2/25/1995 (28 years old)","GK","HJK","Finnish Premier League","MKD","Yes","2/8/2023","11/15/2023","$55K - $170K","Right Only","Very Weak","Very Strong","6'5""","191 lbs","40","-",98,120,4,2,1,3,7,7,5,1,3,3,9,3,3,7,14,11,12,8,9,12,11,1,7,2,10,8,4,8,8,14,12,14,10,9,11,12,14,15,12,13,11,11,12,8,10,4,11,12,9,9,11,16,10,13,12,12,5,8,13,15
"9467",11035404,"Valon Ethemi","10/3/1997 (25 years old)","AM (RL)","İstanbulspor","Turkish Super League","MKD","No","1/6/2021","6/30/2025","$220K - $2.2M","Right","Fairly Strong","Very Strong","5'10""","149 lbs","197","32",115,120,5,10,13,10,12,7,4,10,2,5,12,8,5,13,5,8,7,9,7,10,11,13,5,12,6,10,12,10,16,15,11,9,16,15,11,9,12,12,12,12,11,11,9,10,5,8,12,12,20,1,3,3,2,1,2,4,3,4,3,3
"9468",47036088,"Darko Velkovski","6/21/1995 (27 years old)","D (C), DM","Al-Ettifaq","Saudi Professional League","MKD","No","8/31/2022","6/30/2024","$850K - $10M","Right","Fairly Strong","Very Strong","6'2""","160 lbs","237","13",115,120,8,7,8,5,9,10,14,11,3,11,11,2,12,9,5,13,12,10,12,12,6,7,10,7,12,12,8,12,13,11,13,14,15,12,13,12,12,11,11,7,13,13,13,11,14,6,12,7,11,1,1,1,2,3,1,3,2,3,1,2
"9469",62025619,"Daniel Mojsov","12/25/1987 (35 years old)","D (C)","Bregalnica","North Macedonian First League","MKD","No","6/20/2021","6/30/2024","$6K - $60K","Right","Reasonable","Very Strong","6'3""","176 lbs","327","18",92,119,7,10,9,7,8,6,14,6,6,12,8,7,13,7,13,12,8,11,10,9,12,8,10,7,13,11,9,8,6,9,9,14,13,6,10,11,7,10,12,11,12,13,10,11,9,7,12,14,8,3,3,1,2,2,3,1,2,3,2,3
"9470",62235010,"Nikola Bogdanovski","1/25/1999 (24 years old)","D (R), M (RLC), AM (RL)","Novi Pazar","Serbian SuperLeague","MKD","No","8/9/2022","6/30/2024","$95K - $950K","Right","Reasonable","Very Strong","5'11""","152 lbs","166","8",109,119,12,12,12,9,12,8,8,9,12,7,11,5,7,12,9,10,10,11,11,11,6,12,9,12,9,12,12,11,12,12,11,8,10,12,11,11,15,13,10,12,12,12,6,11,7,2,10,10,19,3,1,3,3,1,4,2,1,3,1,2
"9471",47039844,"Igor Aleksovski","2/24/1995 (28 years old)","GK","Rabotnički","North Macedonian First League","MKD","No","7/1/2022","6/30/2024","$35K - $375K","Left","Very Strong","Reasonable","6'1""","180 lbs","127","-",77,118,4,1,2,3,1,8,1,2,3,2,10,1,3,3,9,9,15,6,9,12,10,3,4,1,12,6,5,6,10,13,6,13,12,12,2,3,8,15,10,12,10,12,5,4,9,1,11,10,16,8,5,13,7,9,13,8,7,5,8,12
"9472",2000307803,"Dejan Siljanovski","2/2/2007 (16 years old)","ST (C)","KV Mechelen","Jupiler Pro League","MKD","Yes","7/1/2022","6/30/2025","$70K - $700K","Right Only","Weak","Very Strong","5'11""","149 lbs","-","-",71,118,6,5,13,13,12,6,9,5,3,2,7,4,1,11,11,12,8,9,7,9,9,11,3,11,4,6,6,7,13,10,7,6,10,10,6,6,8,13,10,12,10,15,12,14,7,2,7,11,12,2,3,3,3,1,2,1,2,2,3,2
"9473",2000098756,"Stelios Andreou","7/24/2002 (20 years old)","D (C)","Charleroi","Jupiler Pro League","CYP","Yes","8/3/2022","6/30/2026","$14M - $21M","Right","Reasonable","Very Strong","6'2""","171 lbs","86","2",114,150,4,7,8,4,11,8,11,8,6,14,10,8,11,9,12,12,13,11,11,13,14,8,11,10,12,13,8,12,12,13,12,13,15,13,14,13,6,13,14,11,12,12,4,7,8,4,15,13,19,3,2,2,3,2,2,3,1,1,2,2
"9474",2000198985,"Evangelos Andreou","9/24/2002 (20 years old)","M/AM (L)","AEL","Cypriot First Division","CYP","Yes","6/13/2022","6/30/2026","$750K - $1.7M","Left Only","Very Strong","Weak","5'8""","149 lbs","26","3",100,129,10,13,13,11,15,9,9,7,9,9,11,5,10,15,14,9,3,11,8,11,13,13,6,14,8,10,9,13,14,10,13,7,17,13,9,5,15,12,13,11,12,12,12,1,7,4,10,15,18,2,2,3,2,1,2,1,1,3,2,1
"9475",2000245635,"Eslyn Correa","6/29/2005 (17 years old)","DM, M (C)","Municipal","Peruvian First Division","PER","No","1/3/2023","12/31/2025","$20K - $210K","Left Only","Very Strong","Weak","5'6""","134 lbs","4","1",83,129,7,8,10,10,15,5,8,11,6,8,14,2,14,14,7,9,9,10,8,15,6,5,4,8,7,9,6,13,13,12,7,5,5,10,9,2,11,17,11,11,13,12,10,12,7,5,7,13,14,2,2,1,4,2,2,3,3,2,3,1
"9476",211232,"Djéné Dakonam","12/31/1991 (31 years old)","D (C), DM","Getafe","Spanish First Division","TOG","No","6/14/2021","6/30/2025","Not for Sale","Right","Reasonable","Very Strong","5'10""","156 lbs","291","2",139,150,8,9,9,5,11,7,9,8,12,15,9,8,15,10,16,14,17,14,14,14,13,8,9,11,14,16,10,17,16,14,13,10,16,14,16,15,15,11,9,16,12,15,7,4,13,7,16,14,12,2,3,1,1,3,2,4,4,2,3,2
"9477",34001871,"Floyd Ayité","12/15/1988 (34 years old)","AM (RLC), ST (C)","VAFC","Ligue 2 BKT","TOG","Yes","8/4/2021","6/30/2024","$5K - $50K","Right","Reasonable","Very Strong","5'9""","149 lbs","348","50",107,140,10,11,12,12,11,11,7,10,6,4,11,10,7,14,9,11,11,12,12,9,11,11,6,13,7,10,11,12,12,13,12,7,13,12,12,10,12,14,14,12,10,13,12,11,9,8,11,11,14,2,3,2,3,3,3,2,3,3,1,3
"9478",91132870,"Ihlas Bebou","4/23/1994 (29 years old)","WB/M/AM (R), ST (C)","TSG Hoffenheim","Bundesliga","TOG","Yes","12/17/2021","6/30/2026","$8M - $12M","Right","Reasonable","Very Strong","6'1""","176 lbs","241","55",134,140,6,10,14,12,12,6,12,9,13,8,11,13,11,13,13,13,13,11,10,10,12,15,6,13,8,12,10,13,16,14,11,12,12,16,13,11,16,10,12,13,12,12,13,11,7,8,11,14,10,2,1,1,3,1,1,3,3,2,3,2
"9479",916439,"Alaixys Romao","1/18/1984 (39 years old)","D (C), DM, M (C)","Ionikos","Greek Super League 2 South","TOG","Yes","7/1/2021","6/30/2024","$8K - $75K","Right","Weak","Very Strong","5'11""","163 lbs","556","17",110,135,6,8,7,7,10,8,12,8,7,13,11,7,11,11,16,13,17,12,11,11,16,8,13,8,15,16,9,16,10,10,12,10,16,10,12,13,12,7,6,15,15,14,5,14,16,10,12,15,12,2,1,2,1,3,1,3,2,2,3,3
"9480",34003025,"Gilles Sunu","3/30/1991 (32 years old)","AM (RL), ST (C)","Châteauroux","French National","TOG","Yes","1/9/2020","6/30/2024","$110K - $325K","Right","Reasonable","Very Strong","6'0""","176 lbs","272","20",101,130,5,13,13,7,12,10,9,11,5,5,12,11,3,13,5,10,10,9,13,9,13,13,10,11,8,12,10,8,12,12,13,11,13,12,12,13,10,14,14,12,13,16,10,13,5,7,11,14,13,4,3,3,2,3,4,1,2,2,1,1
"9481",49040822,"Kévin Denkey","11/30/2000 (22 years old)","ST (C)","Cercle Brugge","Jupiler Pro League","TOG","Yes","11/5/2022","6/30/2026","$400K - $4.1M","Right","Weak","Very Strong","5'11""","178 lbs","118","24",116,130,6,10,12,13,12,8,10,10,5,10,13,11,9,13,12,10,14,12,14,13,10,12,5,13,9,11,11,12,12,13,12,10,15,14,15,15,8,11,8,11,9,9,7,11,8,8,11,12,10,3,3,3,1,2,1,4,4,2,2,4
"9482",13189534,"Kodjo Laba","1/27/1992 (31 years old)","ST (C)","Al-Ain","UAE Professional League","TOG","No","1/16/2023","5/31/2026","Not for Sale","Right","Reasonable","Very Strong","6'0""","180 lbs","179","131",130,130,6,7,13,15,12,8,13,10,6,6,12,16,7,13,11,13,13,13,12,12,13,13,12,15,8,12,12,12,13,13,14,12,15,14,14,14,9,15,13,14,13,12,8,12,8,1,13,12,13,4,2,2,1,3,2,1,1,1,2,1
"9483",91108283,"Khaled Narey","7/23/1994 (28 years old)","M (R), AM (RL)","PAOK","Greek Super League 1","TOG","Yes","7/17/2022","6/30/2026","$210K - $2.1M","Right","Fairly Strong","Very Strong","5'11""","165 lbs","290","46",125,130,10,12,13,11,9,7,8,12,13,9,9,8,9,10,15,9,14,9,10,9,15,14,10,14,9,12,10,16,15,13,14,10,16,16,13,13,15,10,13,12,9,8,4,11,12,8,14,15,13,2,1,3,3,1,2,3,2,2,1,2
"9484",34003999,"Matthieu Dossevi","2/12/1988 (35 years old)","M/AM (R)","FC Versailles 78","French National","TOG","Yes","10/10/2022","6/30/2024","$1K - $8K","Right","Weak","Very Strong","5'9""","158 lbs","356","31",92,130,10,12,13,8,12,8,6,11,5,6,12,10,5,12,7,11,10,10,12,12,13,12,11,12,6,12,10,12,11,12,10,6,13,11,11,9,10,16,14,14,12,12,12,11,6,8,10,14,10,1,3,2,1,2,2,1,2,2,1,1
"9485",2000289960,"Leontios Zacharia","9/19/2005 (17 years old)","M/AM (C)","AEL","Cypriot First Division","CYP","Yes","6/13/2022","5/31/2024","$130K - $1.3M","Right Only","Weak","Very Strong","5'9""","143 lbs","7","-",85,128,7,3,10,10,15,8,8,10,1,10,12,5,8,10,12,8,7,7,8,13,11,8,10,10,5,14,15,10,10,11,9,6,12,9,9,5,10,11,11,13,10,12,8,7,6,4,17,12,16,3,2,1,3,3,3,2,2,1,3,2
"9486",12095293,"Enock Assigno","8/28/2004 (18 years old)","AM (RL)","AC Barracuda","Togolese First Division","TOG","No","6/12/2023","6/30/2025","$8K - $24K","Right Only","Weak","Very Strong","5'9""","147 lbs","-","-",83,128,8,13,14,12,14,7,5,8,7,5,14,5,8,10,9,9,8,6,8,14,15,9,9,12,7,8,7,9,13,9,8,5,11,12,8,5,8,17,9,13,9,12,5,15,8,2,16,9,11,1,1,1,1,3,2,3,1,2,2,2
"9487",91012819,"Peniel Mlapa","2/20/1991 (32 years old)","AM (RC), ST (C)","Al-Nasr (UAE)","UAE Professional League","TOG","Yes","1/18/2023","6/30/2025","$400K - $4.1M","Right","Fairly Strong","Very Strong","6'5""","205 lbs","342","87",120,125,7,11,12,13,12,7,11,12,8,6,11,9,7,11,13,10,11,10,9,8,8,12,6,10,7,13,9,11,13,12,12,16,13,16,12,16,14,11,9,12,8,12,5,9,13,13,9,14,10,3,1,1,3,1,3,1,1,4,3,1
"9488",49061661,"Steven Nador","6/23/2002 (20 years old)","D (C), DM","SPAL","Italian Serie C/B","TOG","Yes","8/12/2021","6/30/2025","$110K - $325K","Right Only","Very Weak","Very Strong","6'4""","189 lbs","31","-",88,124,4,5,7,5,10,4,12,6,8,12,10,5,10,9,10,11,13,10,8,9,11,5,10,7,12,10,7,12,11,11,12,15,14,12,13,12,8,20,9,10,10,9,15,12,6,6,11,10,15,1,2,4,1,3,3,2,3,1,3,3
"9489",16199801,"Kennedy Boateng","11/29/1996 (26 years old)","D (C)","Santa Clara","Portuguese Second League","TOG","No","7/1/2021","6/30/2025","$475K - $1.4M","Right","Reasonable","Very Strong","6'3""","171 lbs","186","7",112,122,6,6,9,6,12,6,12,7,10,13,10,7,13,8,14,10,13,9,13,10,13,8,8,6,9,14,10,13,11,11,14,17,14,13,13,16,8,11,13,13,10,12,8,11,6,8,12,11,12,1,2,1,1,1,2,2,3,1,3,2
"9490",2000069757,"Pierre Nadjombe","5/10/2003 (20 years old)","D (RL), WB/M (R)","1. FC Köln","Bundesliga","TOG","Yes","7/1/2022","6/30/2024","$350K - $1M","Right Only","Weak","Very Strong","6'0""","167 lbs","29","1",86,122,7,7,12,7,10,6,4,3,6,9,11,12,14,8,8,8,9,7,11,7,13,11,6,7,8,12,9,12,14,14,8,11,11,14,14,7,11,13,13,13,13,13,11,9,7,7,8,13,7,2,2,2,1,4,3,1,1,1,3,1
"9491",12095082,"Djibril Bastou","10/26/2006 (16 years old)","M (C)","Unisport (TOG)","Togolese First Division","TOG","No","1/1/2022","6/30/2026","$0 - $12K","Right","Reasonable","Very Strong","5'8""","134 lbs","-","-",79,122,4,7,4,6,13,6,5,8,7,9,13,4,11,12,7,6,8,10,7,12,12,5,1,5,5,8,14,13,13,10,8,5,13,8,13,6,12,15,9,11,11,11,7,13,8,6,18,10,14,2,1,1,3,2,1,1,1,3,3,4
"9492",13215218,"Thibaut Klidjé","7/10/2001 (21 years old)","ST (C)","Luzern","Swiss Promotion League","TOG","No","8/31/2022","6/30/2026","$90K - $900K","Right","Weak","Very Strong","5'7""","143 lbs","19","-",96,121,8,8,13,12,12,9,7,12,5,6,11,9,6,12,8,12,11,10,12,11,15,13,7,13,7,11,12,12,13,13,13,8,13,13,12,8,14,17,13,11,10,12,7,11,8,4,12,13,11,1,1,1,3,3,1,3,2,4,2,2
"9493",48044742,"Malcolm Barcola","5/14/1999 (24 years old)","GK","Tuzla City","Bosnian Premier League","TOG","Yes","7/1/2022","6/30/2025","$80K - $800K","Right","Weak","Very Strong","6'6""","182 lbs","8","-",104,120,3,3,3,1,10,6,8,1,2,1,10,2,3,10,9,12,13,11,11,11,14,3,10,3,11,10,6,10,10,9,12,18,14,10,10,12,11,19,12,14,11,14,8,2,9,8,12,12,19,11,12,14,8,14,10,10,5,9,11,16
"9494",91150290,"Etienne Amenyido","3/1/1998 (25 years old)","AM (RL), ST (C)","St. Pauli","Bundesliga 2","TOG","Yes","7/1/2021","6/30/2024","$75K - $750K","Right","Fairly Strong","Very Strong","5'11""","176 lbs","96","11",110,120,9,7,13,11,11,11,9,8,6,7,11,11,8,12,13,11,13,10,9,9,10,12,6,13,7,12,11,12,15,12,12,9,11,15,12,12,12,12,12,7,8,10,13,12,6,13,10,11,5,3,3,3,2,4,1,2,2,1,1,4
"9495",18075182,"Samuel Asamoah","3/23/1994 (29 years old)","M (C)","FC U Craiova","Romanian First League","TOG","Yes","5/19/2022","6/30/2024","$90K - $900K","Right","Weak","Very Strong","5'5""","132 lbs","295","20",103,119,9,9,11,8,12,10,8,10,8,8,13,7,10,12,12,12,14,13,13,11,15,13,11,12,12,9,13,12,13,14,5,4,12,13,11,10,10,10,12,8,10,14,1,12,13,4,11,14,8,1,3,1,2,1,2,3,3,2,1,1
"9496",28085586,"Nikolas Ioannou","11/10/1995 (27 years old)","D/WB/M (L)","Como","Italian Serie B","CYP","Yes","7/22/2022","6/30/2025","$300K - $3.1M","Left","Very Strong","Weak","6'0""","165 lbs","151","10",122,128,9,12,11,10,12,4,14,7,10,12,10,7,13,11,15,12,14,12,12,12,14,8,10,11,12,13,10,13,13,12,12,14,12,13,15,14,10,11,13,13,12,11,13,11,13,4,15,14,13,1,2,3,3,4,3,2,2,3,3,2
"9497",2000067913,"Karim Dermane","12/26/2003 (19 years old)","DM, M (C)","Feyenoord","Eredivisie","TOG","No","2/1/2022","6/30/2025","$0","Right","Weak","Very Strong","5'10""","156 lbs","1","-",101,119,7,9,13,12,12,10,10,10,7,12,16,8,9,11,12,9,12,11,11,12,12,11,6,11,8,12,9,14,13,13,13,9,11,13,14,8,12,16,9,13,9,12,5,5,10,3,12,11,14,2,1,3,2,1,2,4,2,2,3,4
"9498",8431043,"Razak Boukari","4/25/1987 (36 years old)","AM (RL), ST (C)","FC Déols","French Regional 1 - Centre Val de Loire","TOG","Yes","7/1/2022","-","$0","Right","Weak","Very Strong","6'2""","185 lbs","302","37",97,119,8,10,12,10,12,11,13,12,5,4,9,12,3,12,8,10,12,10,8,8,12,14,6,13,6,7,10,8,12,12,14,13,12,13,9,13,10,14,14,10,10,13,14,13,8,7,10,12,7,3,1,3,2,1,3,2,2,1,1,4
"9499",84102962,"Emmanuel Hackman","5/14/1995 (28 years old)","D (RC)","Mladost GAT","Serbian First League","TOG","No","2/2/2023","6/30/2024","$70K - $700K","Right Only","Weak","Very Strong","5'11""","158 lbs","148","3",109,118,5,9,8,6,8,6,15,6,14,13,9,8,10,7,15,16,16,9,14,6,14,7,8,13,12,13,6,15,14,14,11,11,14,14,15,11,15,14,14,16,15,11,4,9,8,11,13,13,15,3,4,2,3,2,2,2,2,1,3,2
"9500",49061694,"Kévin Boma","11/20/2002 (20 years old)","D (C)","Rodez AF","French Regional 1 - Occitanie - Group C","TOG","Yes","8/9/2022","6/30/2025","$140K - $1.4M","Right","Weak","Very Strong","6'4""","160 lbs","6","-",92,118,8,7,8,8,11,5,12,8,8,13,8,7,13,8,14,12,12,10,7,10,11,6,10,9,7,9,10,11,12,12,10,16,14,13,7,9,7,15,9,11,11,12,7,2,12,4,11,11,16,2,3,2,1,3,1,3,1,1,1,2
"9501",53024914,"Komlan Amewou","12/15/1983 (39 years old)","DM","SO Cholet","French National","TOG","No","6/30/2022","-","$0","Left Only","Very Strong","Weak","5'9""","156 lbs","114","2",82,118,8,11,11,7,11,12,8,11,6,9,12,10,11,11,11,12,12,12,11,10,14,9,8,9,11,11,11,11,11,11,11,8,12,11,12,11,10,14,14,13,11,9,7,13,11,7,10,16,12,1,3,3,3,2,1,2,3,2,4,3
"9502",12095317,"Caleb Bodza","12/26/2003 (19 years old)","M (C)","AS Binah","Togolese First Division","TOG","No","1/1/2022","6/30/2024","$6K - $18K","Right","Fairly Strong","Very Strong","6'4""","182 lbs","-","-",82,118,6,7,8,7,14,3,6,10,1,10,14,3,8,11,5,9,7,7,7,9,17,5,8,13,10,8,12,12,9,12,7,13,9,11,8,6,9,20,11,14,14,11,8,5,5,7,9,12,8,2,1,1,1,4,3,2,4,2,1,3
"9503",2000033281,"Jean-Marie Nadjombe","9/6/2001 (21 years old)","D (RL)","Fortuna Köln","German Regional Division West","TOG","Yes","6/13/2022","6/30/2025","$0","Right Only","Weak","Very Strong","6'3""","176 lbs","68","-",90,118,7,13,7,1,10,3,8,8,8,10,8,1,14,10,14,9,10,7,6,14,18,5,13,7,10,9,7,9,14,10,9,16,12,11,14,7,15,11,12,12,11,13,11,14,9,3,11,8,12,1,1,4,2,3,1,3,2,2,2,2
"9504",13102220,"Dové Womé","6/8/1991 (32 years old)","AM (RC)","ASKO de Kara","Togolese First Division","TOG","No","7/5/2022","6/30/2024","$0 - $40K","Right","Weak","Very Strong","5'9""","149 lbs","190","36",104,117,12,12,13,9,12,11,9,9,7,8,12,11,8,12,8,11,3,9,11,9,12,12,8,13,11,11,13,12,13,11,11,8,12,13,13,11,11,19,11,9,11,13,11,10,7,7,11,11,7,2,1,1,1,1,2,1,3,3,2,1
"9505",91189194,"Nikell Touglo","11/20/2001 (21 years old)","D (C)","Viktoria 1889","German Regional Division Northeast","TOG","Yes","7/1/2022","6/30/2023","$0 - $7K","Right","Reasonable","Very Strong","6'1""","182 lbs","58","1",89,117,1,1,2,2,8,1,12,7,3,13,9,3,14,5,5,9,9,7,9,14,4,5,7,7,14,5,7,9,9,12,8,13,12,13,9,9,15,18,11,9,10,12,5,8,13,1,12,10,19,2,2,3,2,1,3,2,2,2,1,1
"9506",13186044,"Komlan Agbégniadan","3/26/1991 (32 years old)","M (R), AM (RLC)","Kirrlach","German Lower Division","TOG","Yes","7/1/2022","6/30/2023","$0","Right Only","Weak","Very Strong","5'5""","143 lbs","94","29",75,117,9,8,11,10,10,7,8,10,5,7,10,4,6,12,12,10,11,10,9,10,9,13,9,10,7,10,10,10,11,12,9,6,12,11,9,7,13,18,13,11,11,12,7,12,11,4,12,10,17,3,1,3,3,2,3,1,3,2,1,2
"9507",2000073767,"Loizos Loizou","7/18/2003 (19 years old)","M (R), AM (RL)","Omonoia","Cypriot First Division","CYP","Yes","8/28/2022","5/31/2026","$95K - $950K","Left Only","Very Strong","Weak","5'6""","138 lbs","91","11",100,128,7,11,12,11,8,3,3,4,3,4,10,3,5,12,8,10,10,10,11,10,13,15,4,9,4,6,10,8,16,16,4,5,15,15,14,5,9,9,12,11,12,13,5,7,4,4,12,13,17,3,2,2,2,3,2,3,2,4,1,2
"9508",18056184,"David Henen","4/19/1996 (27 years old)","ST (C)","KV Kortrijk","Jupiler Pro League","TOG","Yes","1/31/2022","6/30/2024","$60K - $600K","Right","Fairly Strong","Very Strong","6'1""","160 lbs","116","6",103,117,9,10,12,11,11,11,8,10,4,5,10,12,5,13,7,11,12,11,11,11,18,12,9,13,7,11,8,10,14,13,12,11,14,13,12,9,8,13,13,5,8,9,7,10,7,11,12,16,10,1,4,1,1,1,2,3,3,3,3,1
"9509",91139871,"Fredéric Ananou","9/20/1997 (25 years old)","D (RC), WB (R)","Hansa Rostock","Bundesliga 2","TOG","Yes","7/3/2022","6/30/2025","$60K - $600K","Right","Weak","Very Strong","6'0""","178 lbs","103","1",113,116,3,10,10,6,11,5,11,6,14,12,10,5,13,11,13,11,15,9,10,9,14,8,6,11,12,12,9,12,15,12,12,12,12,17,13,14,15,10,13,13,10,8,12,12,12,5,12,15,12,1,3,4,3,3,2,2,3,1,3,3
"9510",2000075883,"Samsondin Ouro","3/2/2000 (23 years old)","DM, M (C)","Mura","Slovenian First League","TOG","Yes","1/1/2021","6/30/2026","$28K - $275K","Right","Weak","Very Strong","6'0""","165 lbs","53","4",105,115,9,5,11,9,12,10,10,13,6,13,11,4,12,11,12,12,10,12,12,12,14,11,14,11,13,12,12,13,12,11,12,13,15,11,12,12,15,12,11,11,12,12,6,12,15,5,7,11,11,3,1,3,3,3,3,2,1,1,2,3
"9511",12095154,"Bernard Achiangbon","8/6/2006 (16 years old)","ST (C)","Anges de Notsé","Togolese Second Division","TOG","No","1/1/2022","6/30/2026","$0 - $10K","Right","Fairly Strong","Very Strong","5'5""","119 lbs","-","-",74,115,6,6,12,13,13,5,13,6,2,4,7,6,3,13,11,13,4,12,6,12,8,13,9,13,4,6,2,7,13,12,7,2,12,12,6,4,9,12,10,9,12,10,5,8,7,1,18,9,16,1,2,2,3,1,2,1,3,3,2,2
"9512",12012413,"Lalawelé Atakora","11/9/1990 (32 years old)","M/AM (RC)","FC Ouest Tourangeau 37","French National 3 - Group C","TOG","No","7/1/2022","6/30/2024","$12K - $35K","Right Only","Weak","Very Strong","5'6""","136 lbs","243","32",74,115,10,11,10,10,10,11,5,11,5,3,11,8,7,10,14,11,8,10,10,9,9,12,6,11,10,10,10,10,11,9,12,6,12,11,11,12,9,9,9,10,11,7,7,5,8,8,11,9,12,2,2,2,1,4,1,1,1,3,2,1
"9513",13101828,"Vincent Bossou","2/7/1986 (37 years old)","D (C)","Pattani","Thai League Three Southern Region","TOG","No","10/1/2019","6/30/2024","$0 - $45K","Right Only","Very Weak","Very Strong","6'4""","189 lbs","78","1",95,115,9,5,7,9,9,7,15,3,7,14,7,4,16,8,14,13,15,7,8,9,7,12,6,11,4,10,7,13,10,8,16,15,12,12,12,16,16,17,14,14,12,10,12,16,8,4,11,11,12,2,1,3,3,1,1,3,2,3,3,2
"9514",2000028593,"Idjessi Metsoko","3/14/2002 (21 years old)","ST (C)","AJ Auxerre","French National 2 - D","TOG","Yes","6/13/2022","6/30/2027","$0","Right Only","Weak","Very Strong","6'3""","158 lbs","-","-",88,115,6,7,12,13,13,6,6,7,1,5,9,7,1,9,8,11,8,13,3,13,11,9,10,13,6,7,7,11,13,12,13,15,11,12,13,6,11,11,11,12,12,12,5,9,10,5,13,12,16,1,1,1,3,3,1,1,4,1,1,1
"9515",13157071,"Hakim Ouro-Sama","12/28/1997 (25 years old)","D (C)","LOSC","Ligue 1 Uber Eats","TOG","No","7/4/2018","6/30/2027","$7K - $75K","Right Only","Weak","Very Strong","6'1""","163 lbs","11","-",95,115,6,6,1,1,8,1,14,8,4,13,9,1,13,7,5,12,10,9,10,14,10,8,10,8,10,8,6,8,13,12,12,12,15,10,13,12,8,17,12,13,8,11,11,18,5,6,10,11,20,1,3,2,2,3,3,3,1,1,2,2
"9516",2000068129,"Yékini Maman-Zougou","12/28/2001 (21 years old)","ST (C)","AC Sèmassi","Togolese First Division","TOG","No","1/1/2021","6/30/2024","$6K - $18K","Right","Reasonable","Very Strong","6'2""","171 lbs","-","-",82,114,6,3,11,13,13,6,11,7,1,4,7,3,2,11,10,6,7,9,6,12,9,11,7,13,7,6,7,7,13,11,7,10,12,12,6,7,13,15,10,10,8,10,6,6,12,3,14,12,15,3,1,2,3,2,2,2,2,2,3,1
"9517",890820,"Moustapha Salifou","6/1/1983 (40 years old)","M/AM (C)","Türkspor Augsburg","German Div. Bavaria South","TOG","Yes","6/12/2023","6/30/2024","$0","Right Only","Weak","Very Strong","5'11""","154 lbs","263","16",62,114,9,8,8,7,9,6,9,7,6,7,13,4,9,11,10,9,10,12,11,9,10,5,8,7,11,11,8,11,10,9,12,8,10,8,10,11,6,18,12,13,10,12,10,9,6,3,9,10,12,3,3,4,3,3,3,1,1,3,1,1
"9518",2000312553,"Argyris Christodoulou","3/1/2007 (16 years old)","M/AM (C)","Pafos","Cypriot First Division","CYP","Yes","6/13/2022","6/30/2026","$16K - $50K","Right","Reasonable","Very Strong","5'11""","149 lbs","-","-",65,127,6,8,8,9,14,6,4,8,2,5,14,4,8,9,12,6,3,6,3,13,13,8,7,8,5,7,11,8,8,9,7,7,9,11,6,6,9,13,12,11,12,9,11,4,5,6,5,11,9,1,2,1,3,2,3,3,2,2,2,1
"9519",48037005,"Loïc Bessilé","2/19/1999 (24 years old)","D (LC)","Eupen","Jupiler Pro League","TOG","Yes","4/3/2023","6/30/2025","$350K - $1.1M","Left","Very Strong","Weak","6'0""","171 lbs","26","1",104,113,8,8,10,8,11,8,12,9,9,13,10,9,14,11,14,9,14,12,12,12,4,11,11,12,8,13,6,13,12,10,12,13,13,11,14,14,13,14,12,12,12,11,14,11,13,7,12,13,20,2,2,4,2,1,3,3,2,1,3,2
"9520",120951401,"Ouzéroudine Kpérédja","12/12/2005 (17 years old)","AM (RL)","Entente II","Togolese First Division","TOG","No","1/1/2023","6/30/2024","$1.5K - $5K","Right","Strong","Very Strong","5'11""","145 lbs","-","-",71,113,6,9,13,8,12,5,5,7,5,5,9,1,4,9,12,6,6,6,6,5,11,10,5,7,3,5,7,9,13,13,6,9,13,12,7,3,9,16,13,12,11,9,5,15,6,7,19,10,16,3,3,4,2,2,3,2,2,3,1,3
"9521",85075762,"Camaldine Abraw","8/15/1990 (32 years old)","ST (C)","FC Ouest Tourangeau 37","French National 3 - Group C","TOG","No","7/11/2022","6/30/2023","$0","Right Only","Weak","Very Strong","6'0""","174 lbs","173","43",84,112,4,4,8,10,12,6,13,9,5,4,8,10,4,11,9,12,13,8,12,12,12,11,5,12,6,11,8,12,11,12,13,12,13,11,12,13,7,14,14,11,7,5,7,10,9,6,7,10,7,4,4,3,1,2,3,3,1,1,3,1
"9522",12095107,"Israël Fagla","6/25/2006 (16 years old)","GK","Dyto FC","Togolese First Division","TOG","No","1/1/2022","6/30/2026","$500 - $3.5K","Right","Fairly Strong","Very Strong","6'5""","174 lbs","-","-",79,112,2,2,3,1,2,5,1,1,3,1,8,2,2,3,11,5,14,4,4,12,12,1,10,2,8,7,6,6,10,14,7,16,10,9,5,6,7,16,9,11,9,13,6,5,6,1,18,10,10,7,14,13,10,10,12,13,5,5,10,12
"9523",2000065396,"Steven Mensah","3/22/2003 (20 years old)","GK","HSV","Bundesliga 2","TOG","Yes","11/16/2021","6/30/2024","$60K - $600K","Left Only","Very Strong","Very Weak","6'0""","163 lbs","7","-",79,112,3,1,3,1,1,5,1,3,3,3,7,1,3,2,9,5,14,6,10,12,10,1,11,3,8,6,5,5,11,14,4,9,14,10,2,5,11,17,13,9,11,12,13,10,15,2,11,12,11,5,11,12,7,6,11,12,9,8,9,8
"9524",12095315,"Akim Koura","8/12/2005 (17 years old)","D (C)","Kakadl FC","Togolese First Division","TOG","No","1/1/2022","6/30/2024","$500 - $4.5K","Right Only","Weak","Very Strong","6'0""","160 lbs","-","-",79,111,6,2,1,1,7,5,14,2,2,14,5,3,13,4,12,5,9,6,8,14,11,5,10,4,14,6,2,8,10,13,6,10,13,14,7,8,14,15,11,11,10,14,14,14,12,6,9,12,7,2,1,3,2,3,1,1,1,2,4,3
"9525",2000068406,"Dikeni Salifou","6/8/2003 (20 years old)","DM, M (C)","SV Werder","Bundesliga","TOG","Yes","7/1/2022","6/30/2025","$55K - $550K","Right","Weak","Very Strong","6'2""","178 lbs","14","3",99,111,3,6,12,6,12,4,13,8,7,12,12,5,13,12,13,11,12,12,12,10,14,11,8,9,12,11,12,12,12,11,12,12,11,12,13,12,10,11,12,12,8,10,12,5,6,6,13,14,7,3,2,3,1,2,3,1,3,3,3,2
"9526",85014068,"Serge Nyuiadzi","9/17/1991 (31 years old)","AM (RL)","Ratchaburi","Thai League","TOG","Yes","12/31/2022","6/30/2026","Not for Sale","Right","Reasonable","Very Strong","5'11""","154 lbs","223","50",105,110,5,12,13,8,12,5,5,8,5,5,10,10,5,13,8,10,10,10,10,10,13,12,5,10,5,10,10,10,15,13,12,10,14,14,11,8,10,15,15,15,12,14,8,10,8,6,12,12,16,2,1,3,1,3,3,2,2,3,1,1
"9527",12094739,"Moushérifi Tchakeï","12/31/2002 (20 years old)","M/AM (C)","ASKO de Kara","Togolese First Division","TOG","No","1/1/2021","6/30/2025","$1.5K - $12K","Right","Reasonable","Very Strong","5'9""","147 lbs","-","-",88,110,8,8,8,13,14,8,8,9,3,8,12,5,10,15,7,6,8,11,7,13,10,13,11,10,10,9,9,12,9,14,8,10,16,14,7,6,16,13,11,12,12,10,11,7,6,5,16,11,20,1,1,2,1,3,1,2,3,1,1,1
"9528",12094759,"Sylvain Karango","7/1/2002 (20 years old)","AM (R), ST (C)","AS OTR","Togolese First Division","TOG","No","10/20/2022","6/30/2025","$1.5K - $16K","Right","Reasonable","Very Strong","5'11""","154 lbs","16","8",90,110,6,8,13,13,13,7,12,7,3,7,10,5,4,13,12,8,7,7,8,11,18,13,4,12,5,8,8,9,13,13,8,5,8,13,11,6,11,11,11,13,11,10,5,13,5,8,11,10,15,1,2,1,1,3,3,1,2,2,1,2
"9529",43461635,"Andreas Chrysostomou","1/14/2001 (22 years old)","M/AM (C)","Anorthosi","Cypriot First Division","CYP","Yes","1/14/2022","5/31/2025","$45K - $450K","Right Only","Weak","Very Strong","5'11""","165 lbs","30","3",95,127,5,5,9,11,15,8,9,7,8,11,15,9,12,15,13,13,8,12,9,15,9,13,10,11,11,10,15,9,10,6,12,9,11,7,13,5,15,12,9,11,10,10,7,10,8,7,10,12,19,2,3,2,3,2,3,2,3,1,3,1
"9530",13196499,"Bilali Akoro","12/14/1999 (23 years old)","M (C), AM (LC)","ASC Kara","Togolese First Division","TOG","No","1/1/2022","6/30/2025","$1.5K - $16K","Right Only","Weak","Very Strong","5'10""","152 lbs","2","-",91,109,6,10,13,10,9,8,8,10,3,7,12,5,9,14,13,13,7,8,6,14,6,13,12,13,9,9,8,13,14,14,9,5,16,14,10,6,12,11,11,11,12,10,7,3,8,7,11,12,13,2,3,3,3,3,2,3,3,2,4,1
"9531",19000714,"Marcelo Moreno","6/18/1987 (35 years old)","ST (C)","Independiente del Valle","Ecuadorian Serie A","BOL","No","3/27/2023","12/31/2023","$16K - $170K","Right","Strong","Very Strong","6'2""","194 lbs","351","123",117,149,5,10,10,14,11,13,16,12,2,5,10,14,8,12,9,12,14,14,12,11,11,14,6,15,7,13,12,11,9,10,14,15,15,11,8,14,8,16,10,14,11,10,11,13,10,14,12,7,13,1,1,1,1,1,3,2,3,2,2,2
"9532",86007697,"Alejandro Chumacero","4/22/1991 (32 years old)","M (RC), AM (R)","Jorge Wilstermann","Bolivian Premier Division","BOL","No","1/1/2023","12/31/2024","Not for Sale","Right","Fairly Strong","Very Strong","5'5""","132 lbs","414","61",113,145,13,12,12,11,12,13,10,13,10,10,13,12,10,13,13,12,11,13,11,13,14,12,13,13,11,13,13,10,11,10,15,13,8,11,11,9,7,13,12,11,11,14,14,12,9,11,9,13,11,2,3,2,2,3,3,2,2,3,2,3
"9533",86065231,"Franz Gonzáles","6/26/2000 (22 years old)","DM, M (RLC)","Platense","Argentine Premier Division","BOL","No","12/28/2021","12/31/2024","$250K - $2.6M","Right","Fairly Strong","Very Strong","5'11""","178 lbs","123","7",116,139,8,12,12,12,13,11,9,11,14,9,11,10,9,12,11,12,13,12,12,13,8,5,11,14,11,12,13,13,12,11,11,10,12,11,13,11,12,13,13,11,11,12,6,16,8,3,14,11,15,3,2,1,3,3,1,1,2,3,3,2
"9534",2000088460,"Miguel Terceros","4/24/2004 (19 years old)","AM (RC)","SAN","Brazilian National First Division","BOL","No","7/20/2022","4/24/2027","$120K - $1.2M","Left Only","Very Strong","Weak","5'10""","154 lbs","4","-",90,136,11,11,13,12,12,11,7,12,8,8,13,10,7,13,11,12,9,11,10,10,12,14,10,12,8,11,12,8,13,13,12,7,12,12,12,5,10,10,9,13,12,14,8,12,5,7,12,13,17,3,1,1,1,2,1,3,1,2,1,3
"9535",2000232775,"Yeferson Mamani","5/10/2005 (18 years old)","AM (RLC)","Girona B","Spanish Federation Third Group 5","BOL","No","2/1/2021","1/31/2024","$4.5K - $45K","Right","Reasonable","Very Strong","5'5""","123 lbs","2","-",85,135,8,10,12,13,15,8,8,10,6,6,14,5,10,15,8,10,4,9,8,14,14,13,10,10,7,9,14,12,10,11,9,1,8,11,7,1,16,10,11,12,9,9,7,5,10,7,13,8,7,2,2,3,2,4,3,1,3,1,2,3
"9536",86056908,"Luis Haquín","11/15/1997 (25 years old)","D (C)","Bolívar","Bolivian Premier Division","BOL","No","2/5/2022","12/31/2025","$90K - $900K","Right","Reasonable","Very Strong","6'2""","182 lbs","125","5",115,135,5,7,9,6,11,3,13,7,10,12,11,5,13,11,13,12,13,11,12,12,12,6,12,6,13,12,8,12,11,11,13,12,11,12,14,13,6,11,12,12,13,11,12,11,10,7,13,12,13,3,2,2,2,3,2,3,1,3,4,2
"9537",2000118803,"Javier Uzeda","7/31/2002 (20 years old)","M (C), AM (LC)","Bolívar","Bolivian Premier Division","BOL","No","2/2/2022","12/31/2025","$75K - $750K","Left","Very Strong","Reasonable","5'9""","154 lbs","48","5",103,133,10,9,12,14,11,10,9,10,7,6,11,5,9,12,5,11,10,11,12,12,14,9,9,10,11,10,11,12,12,10,11,9,7,12,12,11,13,17,8,10,11,10,12,14,15,8,16,11,17,1,2,2,1,4,2,2,2,1,3,3
"9538",19026640,"Carlos Lampe","3/17/1987 (36 years old)","GK","Bolívar","Bolivian Premier Division","BOL","No","12/10/2022","12/31/2023","$20K - $200K","Right Only","Weak","Very Strong","6'4""","187 lbs","433","1",129,132,6,2,1,3,8,9,6,1,1,2,11,3,3,8,12,12,14,14,15,14,14,5,15,8,14,14,9,8,5,10,12,15,14,4,9,14,13,12,7,17,11,12,8,15,11,11,12,14,13,11,13,16,10,14,12,15,10,16,14,15
"9539",2000120338,"Yomar Rocha","6/21/2003 (19 years old)","D/WB/M (R)","Bolívar","Bolivian Premier Division","BOL","No","1/1/2022","12/31/2025","$200K - $2M","Right","Reasonable","Very Strong","5'10""","156 lbs","31","2",95,131,9,10,11,6,11,9,9,9,3,10,11,6,11,12,13,11,10,9,11,12,5,5,6,11,10,11,6,12,12,11,10,10,6,12,15,8,13,14,11,10,10,12,8,17,9,6,11,10,9,2,2,4,1,2,1,1,3,2,2,3
"9540",26028233,"Pieros Sotiriou","1/13/1993 (30 years old)","ST (C)","Hiroshima","J1 League","CYP","Yes","8/15/2022","1/31/2025","$2.7M - $5.6M","Right","Reasonable","Very Strong","6'0""","178 lbs","279","102",112,126,6,7,11,12,10,4,11,5,5,6,10,19,8,11,16,12,16,11,10,9,16,9,9,11,8,15,9,17,11,12,13,13,16,11,15,13,8,7,13,13,12,16,7,13,7,3,14,13,16,2,1,2,3,1,1,1,3,2,2,3
"9541",43390594,"Jaume Cuéllar","8/23/2001 (21 years old)","AM (RLC), ST (C)","Lugo","Spanish Federation First Division A","BOL","Yes","8/5/2021","6/30/2024","$110K - $1.1M","Right","Strong","Very Strong","6'0""","165 lbs","74","4",110,130,10,11,14,11,13,10,7,9,4,5,11,9,6,13,11,9,9,10,9,9,14,14,7,12,5,9,11,11,12,13,13,9,14,12,10,10,16,14,12,14,12,10,6,12,8,8,14,12,18,1,1,3,1,3,2,1,1,2,1,3
"9542",5240390,"Juan Carlos Arce","4/10/1985 (38 years old)","AM (RL), ST (C)","Blooming","Bolivian Premier Division","BOL","No","2/28/2023","12/31/2023","$0 - $110K","Right","Reasonable","Very Strong","5'9""","143 lbs","485","122",117,130,6,12,13,14,12,8,14,13,5,9,13,14,7,13,9,13,15,14,12,13,18,12,11,15,12,12,13,15,11,12,13,10,14,12,10,9,14,13,14,15,16,15,12,14,8,7,13,14,16,1,2,2,1,1,2,3,3,3,1,2
"9543",89067926,"Jairo Quinteros","2/7/2001 (22 years old)","D (C)","Zaragoza","Spanish Second Division","BOL","Yes","8/16/2022","6/30/2026","$0 - $90K","Right Only","Weak","Very Strong","6'0""","167 lbs","49","2",105,130,3,4,5,3,7,4,11,4,9,12,9,6,11,8,7,11,11,10,11,10,8,8,10,7,15,9,6,10,12,12,10,11,15,11,13,14,11,18,10,11,12,11,6,14,14,3,17,11,8,1,4,2,1,2,3,3,3,3,1,1
"9544",86053429,"Rubén Cordano","10/16/1998 (24 years old)","GK","Bolívar","Bolivian Premier Division","BOL","No","1/1/2022","12/31/2025","$275K - $800K","Right","Weak","Very Strong","6'1""","163 lbs","150","-",112,130,2,3,1,3,9,1,7,3,1,1,10,1,1,9,11,8,12,10,12,11,12,6,10,6,12,10,9,10,12,11,14,13,15,10,16,15,1,17,12,11,10,11,7,12,9,1,11,12,16,11,10,14,11,13,11,12,5,11,12,14
"9545",86070929,"Roberto Fernández","7/12/1999 (23 years old)","D/WB/M (L)","Bolívar","Bolivian Premier Division","BOL","No","1/1/2020","12/31/2025","$475K - $1.4M","Left","Very Strong","Reasonable","5'10""","156 lbs","177","20",113,130,9,14,12,12,12,10,9,13,10,9,12,10,11,13,11,11,11,10,12,11,13,12,9,12,11,11,11,12,13,10,11,9,15,13,14,11,13,18,10,10,11,12,8,9,8,2,11,11,11,3,1,2,4,2,3,2,3,1,2,2
"9546",75038829,"Bruno Miranda","2/10/1998 (25 years old)","ST (C)","Guabirá","Bolivian Premier Division","BOL","No","1/25/2021","12/31/2024","$450K - $1.3M","Right","Fairly Strong","Very Strong","5'11""","145 lbs","128","33",120,129,10,7,11,12,11,8,11,10,5,10,9,11,5,12,8,13,12,12,13,12,11,12,10,13,10,14,13,13,14,11,12,11,14,15,13,11,8,18,11,10,10,12,7,10,7,7,9,9,12,2,3,3,2,2,3,1,4,2,2,2
"9547",75049629,"Daniel Rojas","2/22/2000 (23 years old)","DM, M (C)","Oriente Petrolero","Bolivian Premier Division","BOL","No","7/1/2022","12/31/2024","$300K - $850K","Right","Reasonable","Very Strong","5'7""","154 lbs","73","1",106,129,8,5,8,10,15,9,9,11,5,12,13,5,15,15,11,12,9,12,12,11,9,5,3,10,11,13,12,11,11,12,10,8,12,11,11,11,14,16,9,9,10,12,7,11,5,5,11,11,14,2,2,3,4,3,3,1,1,3,1,4
"9548",86038892,"Moisés Villarroel","9/7/1998 (24 years old)","M/AM (C)","Bolívar","Bolivian Premier Division","BOL","No","6/28/2022","12/31/2025","$160K - $1.6M","Left","Very Strong","Reasonable","5'10""","165 lbs","179","15",118,128,11,10,12,11,13,8,8,12,8,11,12,14,10,13,13,13,11,12,12,12,12,13,11,13,12,14,12,13,12,13,12,9,14,12,13,10,14,18,11,11,11,13,7,11,10,11,13,9,10,2,3,2,2,3,2,1,3,1,3,2
"9549",86041292,"Carmelo Algarañaz","1/27/1996 (27 years old)","AM (L), ST (C)","Bolívar","Bolivian Premier Division","BOL","No","1/1/2023","12/31/2025","$130K - $1.3M","Left","Very Strong","Fairly Strong","5'10""","180 lbs","174","58",120,128,11,9,13,14,10,12,10,11,7,4,11,13,3,12,6,12,11,11,12,12,13,9,7,12,12,11,12,11,14,12,15,11,14,12,16,13,12,10,11,9,10,11,13,1,6,3,12,12,17,1,4,2,3,2,3,1,1,3,1,1
"9550",2000086753,"Diego Medina","1/13/2002 (21 years old)","D (RLC), WB (R)","Always Ready","Bolivian Premier Division","BOL","No","7/1/2022","12/31/2024","$475K - $1.4M","Right","Reasonable","Very Strong","5'9""","143 lbs","52","2",102,128,7,14,9,9,10,3,10,5,10,11,10,6,11,12,10,11,9,10,9,11,8,5,11,10,12,11,7,11,12,14,10,9,11,12,11,10,13,19,12,10,13,10,8,7,8,8,11,14,7,1,2,3,3,1,1,3,4,3,1,3
"9551",2000117518,"Christoforos Frantzis","2/25/2001 (22 years old)","D/WB (R), DM","AEL","Cypriot First Division","CYP","Yes","6/15/2020","6/30/2026","$180K - $1.8M","Right Only","Weak","Very Strong","6'0""","154 lbs","58","2",100,125,9,11,9,5,11,9,9,7,6,12,11,7,15,10,11,12,10,11,11,12,3,5,5,9,14,11,8,12,11,13,11,11,6,14,10,5,15,11,10,12,11,10,11,3,10,5,12,11,15,3,1,3,2,1,4,2,1,1,1,3
"9552",2000154953,"Enrique Taborga","4/3/2002 (21 years old)","D (LC), WB (L), DM","Always Ready","Bolivian Premier Division","BOL","No","2/26/2022","12/31/2023","$425K - $1.3M","Left","Very Strong","Reasonable","5'10""","149 lbs","30","-",103,128,10,12,10,7,11,10,12,10,7,11,11,4,10,12,8,10,11,9,11,11,7,5,7,10,15,11,12,12,12,11,11,10,13,12,10,9,13,11,11,11,13,13,7,8,10,3,13,10,8,3,1,1,2,3,1,2,2,2,1,3
"9553",2000060681,"Leonardo Zabala","5/23/2002 (21 years old)","D (C)","SAN","Brazilian National First Division","BOL","No","9/23/2021","12/31/2025","$100K - $300K","Right","Reasonable","Very Strong","6'2""","180 lbs","-","-",82,127,4,4,3,1,9,1,10,4,1,11,7,4,13,9,11,10,9,7,8,13,10,5,14,3,12,6,4,7,10,9,10,14,11,9,4,10,14,19,12,10,11,11,13,16,8,4,20,11,20,2,2,2,1,2,2,2,3,2,3,1
"9554",2000195390,"Christian Osinaga","1/21/2004 (19 years old)","D (C)","Bolívar","Bolivian Premier Division","BOL","No","1/1/2022","12/31/2025","$95K - $950K","Right","Reasonable","Very Strong","6'3""","187 lbs","1","-",91,126,6,5,7,6,9,1,11,8,1,15,10,4,11,9,13,11,11,8,11,11,10,5,3,6,10,9,7,10,10,11,10,13,11,10,12,11,14,17,10,9,9,9,5,2,10,7,17,10,20,3,4,4,1,3,3,1,1,1,1,2
"9555",86075508,"Gabriel Villamil","6/28/2001 (21 years old)","DM, M (RC)","Bolívar","Bolivian Premier Division","BOL","No","2/1/2023","12/31/2025","$140K - $1.4M","Right","Reasonable","Very Strong","5'10""","160 lbs","78","7",103,126,9,10,11,9,11,9,9,11,2,11,15,4,15,11,8,12,13,11,10,10,13,5,13,10,11,10,11,12,11,11,10,10,15,11,12,12,11,20,11,10,10,11,9,2,6,6,20,11,10,1,3,2,1,3,1,2,1,1,3,2
"9556",2000241496,"Moisés Paniagua","8/16/2007 (15 years old)","ST (C)","Always Ready","Bolivian Premier Division","BOL","No","1/1/2022","12/31/2026","$75K - $750K","Right","Weak","Very Strong","5'7""","132 lbs","4","1",70,125,7,6,11,13,14,7,14,8,1,2,8,6,1,11,11,13,6,13,6,10,5,8,10,14,7,7,7,8,12,10,6,2,14,9,9,4,10,18,13,10,10,9,8,17,15,6,7,10,15,3,1,2,2,2,2,4,2,1,3,1
"9557",86075500,"Jean Cartagena","5/5/1999 (24 years old)","D (C)","Real Oruro","Bolivian Second Division","BOL","No","4/14/2023","12/31/2023","$0 - $35K","Right","Strong","Very Strong","6'2""","154 lbs","37","-",100,125,7,8,8,7,9,2,12,6,6,12,10,2,12,7,9,11,10,9,10,10,11,5,10,9,15,12,8,13,13,13,10,9,8,11,12,12,13,10,10,11,11,12,10,14,10,8,10,12,12,2,1,3,3,3,4,3,3,3,2,1
"9558",86081146,"Jeyson Chura","2/3/2002 (21 years old)","AM (L), ST (C)","The Strongest","Bolivian Premier Division","BOL","No","1/1/2022","12/31/2025","$120K - $1.2M","Left","Very Strong","Weak","5'8""","156 lbs","56","13",100,125,7,9,11,12,10,13,12,15,6,5,10,14,6,10,15,12,7,9,9,14,9,14,14,15,10,9,11,11,12,13,9,8,15,13,15,8,12,15,10,9,10,12,6,15,7,1,11,10,20,3,1,1,3,2,2,2,3,2,3,2
"9559",86036695,"Erwin Saavedra","2/22/1996 (27 years old)","M (RC)","Sundowns","South African Premier Soccer League","BOL","No","1/18/2022","6/30/2024","$16K - $150K","Right","Weak","Very Strong","5'9""","147 lbs","264","47",115,125,13,11,13,12,14,13,9,15,7,9,13,15,11,13,13,14,11,8,13,13,13,13,11,13,11,14,9,14,14,10,12,10,14,12,16,10,14,20,12,11,11,12,9,11,12,5,11,11,13,2,1,3,1,1,1,2,1,2,3,1
"9560",86044400,"Jordy Candía","4/20/1996 (27 years old)","D (RC), WB (R)","Universitario de Vinto","Bolivian Premier Division","BOL","No","1/1/2023","12/31/2024","$40K - $400K","Right","Reasonable","Very Strong","6'0""","176 lbs","112","6",115,125,10,13,10,10,12,6,15,14,3,15,12,6,14,9,12,11,10,11,12,12,12,5,12,12,11,10,8,11,13,12,11,10,13,13,11,12,14,14,10,9,10,11,10,7,12,2,14,12,16,2,3,4,1,2,1,1,1,4,2,3
"9561",86074909,"Marcelo Suárez","12/20/2001 (21 years old)","D (LC)","Jorge Wilstermann","Bolivian Premier Division","BOL","No","1/1/2019","12/31/2025","$110K - $350K","Left","Very Strong","Reasonable","6'4""","182 lbs","64","-",88,125,5,7,6,2,10,2,15,7,6,14,9,4,15,8,8,13,9,9,10,10,13,5,13,8,8,8,2,9,11,6,9,17,11,11,8,9,15,20,10,9,9,12,8,6,11,3,20,12,8,2,1,1,3,1,1,3,2,1,1,4
"9562",26038782,"Michalis Ioannou","6/30/2000 (22 years old)","DM, M (LC)","Anorthosi","Cypriot First Division","CYP","Yes","9/21/2022","5/31/2025","$120K - $1.2M","Right Only","Weak","Very Strong","5'11""","149 lbs","90","-",100,123,7,8,10,9,12,7,8,7,6,12,11,8,13,11,8,11,12,12,10,11,14,8,4,7,12,13,10,13,12,13,13,11,13,13,15,12,10,10,12,11,14,13,7,7,5,4,10,13,8,1,2,2,2,4,1,3,3,2,1,3
"9563",86010922,"Rodrigo Ramallo","10/19/1990 (32 years old)","AM (RL), ST (C)","Aurora","Bolivian Premier Division","BOL","No","1/1/2023","12/31/2023","$40K - $375K","Right","Fairly Strong","Very Strong","5'10""","154 lbs","381","104",117,125,6,10,13,14,12,8,14,12,8,5,11,14,6,13,7,11,12,11,12,13,13,12,9,14,12,14,13,13,11,11,13,11,12,11,13,12,14,14,11,9,10,11,7,12,11,10,12,12,11,1,3,1,2,4,1,2,3,3,3,1
"9564",86076300,"Santiago Arce","5/30/2000 (23 years old)","D (C), DM, M (C)","Always Ready","Bolivian Premier Division","BOL","No","11/13/2022","12/31/2024","$45K - $450K","Right","Reasonable","Very Strong","6'0""","171 lbs","79","-",93,125,10,10,5,9,10,10,11,12,6,11,15,8,11,12,5,12,9,12,11,10,9,5,9,9,11,11,11,12,11,9,10,11,12,12,11,10,18,17,11,10,10,12,14,9,13,2,11,12,13,2,1,2,1,2,2,3,1,3,3,2
"9565",86041322,"Paul Arano","2/23/1995 (28 years old)","DM, M (C)","The Strongest","Bolivian Premier Division","BOL","No","1/1/2023","12/31/2023","$85K - $850K","Right","Fairly Strong","Very Strong","6'0""","169 lbs","193","32",121,124,9,5,12,13,15,10,13,14,5,11,15,5,13,12,5,12,13,11,12,13,13,7,7,12,13,12,11,12,11,12,12,13,13,12,13,12,12,14,10,11,12,13,7,9,11,3,12,13,11,3,3,2,3,2,1,4,4,2,1,4
"9566",86056924,"Ramiro Vaca","7/1/1999 (23 years old)","M (C), AM (LC)","Bolívar","Bolivian Premier Division","BOL","No","12/28/2022","12/31/2024","$110K - $1.1M","Right","Weak","Very Strong","5'10""","158 lbs","132","13",112,124,15,13,12,11,14,13,8,11,7,8,14,11,9,13,11,9,9,11,11,11,13,14,6,11,9,13,14,11,11,12,13,11,14,13,14,11,14,20,10,12,11,12,7,11,10,7,12,11,16,2,2,1,3,2,1,3,4,1,1,3
"9567",86010924,"Diego Bejarano","8/24/1991 (31 years old)","D/WB (R)","Bolívar","Bolivian Premier Division","BOL","No","1/1/2023","12/31/2023","$50K - $500K","Right","Reasonable","Very Strong","5'9""","154 lbs","323","46",120,124,7,13,12,10,11,7,12,8,13,14,12,8,13,11,14,10,11,13,12,13,13,10,16,13,12,15,12,15,14,11,15,9,12,11,13,11,15,6,7,12,10,14,9,11,11,8,12,12,10,2,2,2,3,3,1,3,2,2,2,1
"9568",86012889,"Alejandro Meleán","6/16/1987 (35 years old)","D (C), DM, M (C)","Guabirá","Bolivian Premier Division","BOL","No","1/1/2022","12/31/2023","$18K - $55K","Right","Weak","Very Strong","6'0""","171 lbs","368","36",114,123,10,9,7,12,16,11,15,11,6,13,16,6,11,13,8,12,11,12,12,12,13,5,10,10,13,11,16,11,12,10,11,13,13,11,10,14,11,11,11,11,10,12,10,20,5,3,11,13,7,3,3,1,2,1,2,3,2,3,1,3
"9569",2000188259,"César Flores","1/7/2006 (17 years old)","ST (C)","Temperley","Argentine Second Division","BOL","No","1/1/2022","12/31/2025","$35K - $325K","Right","Fairly Strong","Very Strong","6'0""","163 lbs","-","-",80,123,6,4,13,13,13,6,13,5,1,6,7,5,4,11,8,8,8,10,6,13,7,11,9,13,5,6,5,7,11,9,7,10,6,9,9,8,11,10,11,11,12,11,5,13,13,7,18,11,11,2,1,3,1,1,2,2,1,1,1,2
"9570",2000011134,"Fernando Rodríguez","1/11/2000 (23 years old)","M (C)","Blooming","Bolivian Premier Division","BOL","No","12/31/2022","12/31/2025","$35K - $350K","Right","Reasonable","Very Strong","5'7""","132 lbs","57","3",100,123,10,10,8,11,10,10,10,15,6,16,12,9,13,15,5,11,9,10,10,11,12,7,9,10,10,9,11,9,12,11,11,8,11,13,11,4,12,12,12,10,10,11,12,9,13,2,11,12,15,3,2,3,2,1,2,3,2,3,3,3
"9571",86065236,"Josué Mamani","8/20/2000 (22 years old)","DM, M (C)","Jorge Wilstermann","Bolivian Premier Division","BOL","No","1/1/2022","12/31/2024","$70K - $700K","Right","Reasonable","Very Strong","5'9""","158 lbs","46","1",90,122,4,4,7,9,14,5,8,10,1,10,14,5,14,10,13,8,9,7,11,11,11,5,6,10,11,9,14,12,11,11,9,5,15,11,12,13,14,11,9,11,10,13,5,11,7,7,12,11,9,3,2,1,4,3,3,1,3,1,1,2
"9572",86068278,"Walter Antelo","10/9/2000 (22 years old)","D (C), DM","Real Santa Cruz","Bolivian Premier Division","BOL","No","1/1/2023","12/31/2024","$120K - $1.2M","Right","Reasonable","Very Strong","6'0""","198 lbs","57","-",97,122,9,9,3,6,11,14,15,7,7,11,11,3,11,9,12,12,11,10,11,11,11,5,12,9,11,10,9,12,11,12,11,8,14,11,12,12,17,19,10,9,9,12,7,14,7,8,13,12,19,2,1,3,1,1,3,1,3,1,1,3
"9573",2000291420,"Nikolas Perdios","11/26/2004 (18 years old)","M/AM (R)","Achna","Cypriot First Division","CYP","Yes","6/13/2022","5/31/2024","$100K - $1M","Right Only","Weak","Very Strong","5'9""","143 lbs","1","-",85,122,6,11,13,9,14,2,5,8,7,7,12,2,6,9,5,9,8,9,6,9,12,8,9,9,6,8,9,8,14,14,14,9,11,14,10,4,15,14,14,12,9,12,7,16,5,4,10,11,16,1,3,2,2,3,3,2,3,2,2,1
"9574",19026645,"Didí Torrico","5/18/1988 (35 years old)","D/WB/M/AM (R)","Aurora","Bolivian Premier Division","BOL","No","1/1/2023","12/31/2023","$18K - $55K","Right","Reasonable","Very Strong","5'10""","163 lbs","586","29",114,122,9,15,12,7,11,11,6,18,8,6,11,11,11,13,13,11,12,15,12,12,13,10,17,9,7,11,12,14,11,12,15,11,12,11,10,9,12,15,9,10,11,12,12,12,8,7,14,11,13,4,2,3,3,2,1,1,1,2,2,2
"9575",86006499,"Leonel Justiniano","7/2/1992 (30 years old)","DM, M (C)","Bolívar","Bolivian Premier Division","BOL","No","1/1/2021","12/31/2024","$60K - $600K","Right","Fairly Strong","Very Strong","5'8""","171 lbs","336","28",119,122,10,5,10,9,13,10,7,12,4,10,15,11,10,14,11,14,12,13,14,15,11,12,10,15,16,12,14,11,9,10,8,7,12,11,13,9,10,15,11,13,11,12,8,13,9,1,13,13,12,3,4,1,2,3,1,1,3,3,2,1
"9576",42009530,"Rudy Cardozo","2/14/1990 (33 years old)","M (RL), AM (RLC)","Jorge Wilstermann","Bolivian Premier Division","BOL","No","1/1/2023","12/31/2024","Not for Sale","Left","Very Strong","Reasonable","5'7""","149 lbs","413","67",117,122,12,15,13,12,13,10,7,11,9,6,12,10,5,12,9,12,13,12,12,12,13,9,12,13,11,13,12,15,13,11,13,7,15,13,12,11,13,16,10,11,11,12,7,9,13,7,10,13,13,3,1,3,1,1,3,3,2,3,3,2
"9577",2000281347,"Diego Arroyo","4/29/2005 (18 years old)","D (C)","Bolívar","Bolivian Premier Division","BOL","No","3/17/2023","1/31/2024","$0","Either","Very Strong","Very Strong","5'11""","163 lbs","-","-",79,122,2,3,2,1,7,1,13,3,5,13,7,3,13,5,7,8,9,7,6,13,6,7,7,6,13,6,2,7,8,9,7,10,12,8,4,9,8,12,11,9,10,11,14,14,9,1,11,14,11,2,1,1,3,2,3,4,1,1,4,2
"9578",2000245926,"Paulino Paz","2/15/2005 (18 years old)","M (C)","Bolívar","Bolivian Premier Division","BOL","No","1/1/2021","12/31/2023","$50K - $500K","Right","Reasonable","Very Strong","5'10""","147 lbs","-","-",80,122,2,6,8,8,9,6,7,11,2,5,14,4,8,12,10,9,12,6,8,12,10,11,6,8,8,8,11,10,14,14,6,7,14,14,6,5,14,12,14,11,11,14,11,4,10,5,11,10,10,1,2,3,3,3,2,2,3,1,1,2
"9579",86006481,"Vladimir Castellón","8/12/1989 (33 years old)","AM (RL), ST (C)","Jorge Wilstermann","Bolivian Premier Division","BOL","No","7/1/2022","12/31/2024","Not for Sale","Right","Reasonable","Very Strong","5'10""","158 lbs","356","107",116,122,10,15,10,13,15,10,15,5,9,10,14,8,5,13,6,15,10,12,12,12,13,11,14,12,10,10,10,12,12,13,11,8,15,13,11,11,14,14,11,9,10,10,7,3,7,6,18,13,15,1,3,4,2,4,4,1,2,3,2,2
"9580",86041320,"José Sagredo","3/10/1994 (29 years old)","D (LC)","Bolívar","Bolivian Premier Division","BOL","No","12/31/2021","12/31/2024","$120K - $1.2M","Left","Very Strong","Fairly Strong","5'11""","154 lbs","179","17",114,122,8,13,11,8,11,7,12,8,13,10,12,7,14,12,12,12,13,11,13,11,12,11,9,12,11,14,9,13,13,12,13,12,14,12,13,12,16,18,9,10,10,11,8,9,12,5,10,13,20,1,3,1,1,1,1,3,3,1,1,3
"9581",86041321,"Leonardo Vaca","11/24/1995 (27 years old)","AM (R), ST (C)","Žalgiris","Lithuanian A League","BOL","No","2/15/2023","12/31/2023","$180K - $550K","Right Only","Weak","Very Strong","5'9""","154 lbs","226","31",105,122,10,12,12,13,11,10,11,11,6,2,13,11,5,11,8,11,10,12,12,12,12,8,14,12,10,12,12,11,13,14,15,7,15,12,15,8,10,16,10,11,10,11,5,10,7,5,11,12,20,3,3,4,3,3,2,2,3,2,3,2
"9582",86031210,"Raúl Castro","8/19/1989 (33 years old)","DM, M (C)","Universitario de Vinto","Bolivian Premier Division","BOL","No","1/1/2023","12/31/2024","Not for Sale","Right","Reasonable","Very Strong","5'11""","158 lbs","336","11",120,122,9,10,15,6,12,7,12,16,6,10,14,9,12,11,12,14,11,12,12,12,13,5,11,16,10,12,12,15,13,12,14,9,13,12,14,9,12,12,11,10,10,11,10,6,13,4,12,10,8,1,2,1,3,1,3,1,1,3,2,3
"9583",19155917,"Guillermo Viscarra","2/7/1993 (30 years old)","GK","The Strongest","Bolivian Premier Division","BOL","No","1/1/2022","12/31/2023","$190K - $550K","Right","Weak","Very Strong","6'3""","176 lbs","161","-",115,121,2,3,1,2,10,2,5,3,3,2,9,2,1,10,6,11,13,7,13,11,13,6,9,8,14,12,8,12,10,11,11,13,12,10,10,14,2,17,10,10,11,12,4,10,5,8,12,12,9,10,11,13,12,14,14,13,12,11,14,12
"9584",2000282000,"Lysandros Papastylianou","11/29/2005 (17 years old)","M/AM (L), ST (C)","Pafos","Cypriot First Division","CYP","Yes","6/13/2022","5/31/2024","$80K - $800K","Right Only","Weak","Very Strong","6'2""","149 lbs","2","-",83,135,6,9,13,9,11,7,9,10,6,7,13,4,7,13,10,7,4,9,6,14,14,15,10,12,6,8,9,13,13,11,14,10,15,12,10,4,11,16,13,11,12,12,5,11,6,6,18,15,14,4,1,3,2,1,3,1,1,1,1,3
"9585",2000082627,"Strahinja Kerkez","12/13/2002 (20 years old)","D (C)","Trencin","Slovak First Division","CYP","Yes","6/30/2022","6/30/2024","$50K - $500K","Right","Weak","Very Strong","6'1""","182 lbs","20","-",98,122,5,8,3,5,9,3,9,6,1,14,9,5,11,8,8,14,10,7,9,14,10,5,6,4,13,4,7,8,11,9,12,13,12,13,11,13,15,14,10,12,11,9,12,6,8,1,9,11,18,3,4,2,2,4,1,1,2,2,2,3
"9586",86007109,"Fernando Saucedo","3/15/1990 (33 years old)","DM, M/AM (C)","Bolívar","Bolivian Premier Division","BOL","No","1/1/2023","12/31/2023","$50K - $150K","Right","Reasonable","Very Strong","5'8""","156 lbs","417","32",119,121,10,11,11,16,14,11,11,13,7,10,13,12,8,12,10,12,12,11,12,13,12,11,8,11,12,12,15,9,14,13,15,4,15,12,13,12,18,15,11,9,10,11,7,6,5,2,13,11,18,1,2,2,1,1,3,3,1,3,2,3
"9587",2000292795,"Keyliane Abdallah","4/5/2006 (17 years old)","ST (C)","OM","Ligue 1 Uber Eats","MAY","Yes","7/1/2021","6/30/2025","$200K - $2M","Right","Reasonable","Very Strong","6'1""","163 lbs","-","-",80,149,2,4,13,13,13,6,13,7,1,6,5,8,5,13,5,8,8,8,5,13,8,13,4,13,4,6,5,7,13,13,7,9,13,12,8,8,10,15,11,12,13,9,8,4,10,2,8,11,8,1,2,2,1,1,1,1,2,1,3,1
"9588",50071937,"El Anziz Houmadi","5/26/1999 (24 years old)","DM, M (C)","ES Dol","French Regional 1 - Bretagne - Group C","MAY","Yes","7/1/2022","-","$0","Left Only","Very Strong","Weak","5'11""","160 lbs","50","3",70,93,6,6,5,5,11,6,6,8,2,7,10,1,12,13,10,10,4,8,8,9,4,5,5,8,8,7,8,11,13,13,7,10,12,13,13,8,10,19,12,12,10,12,12,6,10,4,11,14,15,2,1,2,3,1,1,2,4,2,2,1
"9589",2000049903,"Houssame Boinali","7/16/1996 (26 years old)","D (R)","GFA Rumilly-Vallières","French National 3 - Group J","MAY","Yes","7/1/2019","6/30/2025","$5K - $55K","Right","Strong","Very Strong","6'2""","174 lbs","60","1",84,89,6,12,5,4,11,4,7,5,7,8,9,2,9,8,14,7,5,7,10,10,6,5,10,7,8,8,5,8,14,14,8,12,14,14,10,10,9,19,10,12,12,10,6,15,9,3,11,11,13,1,1,2,1,1,2,2,3,2,2,2
"9590",50073819,"Dhouli Abdou-Mari","5/18/1992 (31 years old)","M (RLC)","Plouzané AC","French Regional Divisions","MAY","Yes","7/1/2022","-","$0","Right Only","Weak","Very Strong","5'10""","154 lbs","37","4",73,78,8,11,8,8,14,8,8,10,7,9,14,3,10,12,12,10,7,8,8,15,12,5,10,9,6,10,10,8,13,10,10,8,14,10,6,6,12,16,10,11,12,12,13,13,8,5,11,15,13,1,3,3,1,1,1,3,1,3,1,1
"9591",2000088607,"Ansar Ahamada Combo","3/19/1995 (28 years old)","DM, M (C)","Avoine Chinon","French National 2 - B","MAY","No","7/1/2018","6/30/2024","$2K - $22K","Right Only","Weak","Very Strong","5'6""","152 lbs","99","1",73,78,7,5,3,7,14,7,7,6,2,10,11,4,14,11,5,8,5,7,7,12,5,5,6,8,10,8,9,13,14,14,7,4,10,14,12,4,13,13,11,8,12,13,9,1,12,8,9,11,17,2,3,1,3,2,2,1,2,1,2,3
"9592",28127217,"Zidane Iqbal","4/27/2003 (20 years old)","DM, M/AM (C)","Man UFC","English Premier Division","IRQ","No","7/1/2019","6/30/2027","$4M - $7.8M","Right","Fairly Strong","Very Strong","5'11""","156 lbs","-","-",118,149,12,7,13,10,14,7,3,10,2,7,14,10,8,15,12,12,8,14,11,12,9,12,5,12,10,14,13,13,13,14,12,9,12,13,14,8,8,20,12,9,11,13,11,10,8,3,12,14,15,3,2,1,2,2,1,2,3,2,1,2
"9593",2000206753,"Jaafar Shanishel","9/16/2003 (19 years old)","GK","Al-Mina'a","Iraqi First Division Group B","IRQ","No","7/1/2022","6/30/2025","$12K - $35K","Right Only","Weak","Very Strong","6'2""","182 lbs","-","-",60,144,3,3,1,1,5,3,6,1,2,1,9,3,2,6,11,7,12,8,9,10,10,1,7,3,8,9,8,8,9,11,9,11,13,7,6,11,8,4,11,10,9,4,6,7,11,2,11,13,5,6,10,9,14,8,9,9,4,9,9,9
"9594",23017158,"Ala'a Abdul Zahra","12/22/1987 (35 years old)","AM (RC), ST (C)","Al-Shorta","Iraqi Premier League","IRQ","No","8/16/2022","7/31/2023","$0 - $8K","Right Only","Weak","Very Strong","5'10""","154 lbs","137","46",118,135,9,9,13,13,12,12,13,14,6,4,9,12,4,13,14,14,15,11,8,13,10,13,9,13,5,12,9,9,13,14,14,11,13,14,12,12,5,19,10,10,11,12,8,13,6,3,12,12,16,3,2,3,2,2,1,1,1,2,2,1
"9595",23320660,"Bashar Resan","12/22/1996 (26 years old)","AM (RLC)","Qatar SC","Qatar Stars League","IRQ","No","12/31/2020","5/31/2024","$325K - $7.4M","Right","Reasonable","Very Strong","5'10""","154 lbs","113","25",115,135,13,12,13,11,14,13,8,11,6,7,13,10,7,14,11,12,9,12,10,12,12,14,9,13,8,11,14,11,13,13,12,9,11,12,12,9,12,10,9,13,11,11,8,14,5,7,20,13,9,3,3,3,2,1,3,3,2,3,3,1
"9596",2000288394,"Andreas Kapsis","9/21/2005 (17 years old)","D (C)","AEK Larnakas","Cypriot First Division","CYP","Yes","6/13/2022","5/31/2024","$130K - $1.3M","Right Only","Weak","Very Strong","5'10""","147 lbs","-","-",85,121,9,5,4,5,6,8,12,3,9,11,11,9,17,7,7,11,11,10,12,11,17,5,13,9,7,10,4,11,12,12,11,7,14,12,9,7,13,12,12,8,12,13,11,9,11,4,10,11,9,2,2,1,1,3,1,3,3,1,1,1
"9597",93083206,"Kevin Yakob","10/10/2000 (22 years old)","M (C), AM (LC)","AGF","3F Superliga","IRQ","Yes","8/26/2022","6/30/2027","$275K - $2.8M","Right","Reasonable","Very Strong","6'0""","163 lbs","74","13",112,135,10,12,14,11,14,8,8,11,5,7,13,10,8,14,10,12,9,12,11,11,13,13,8,12,8,10,13,12,13,12,11,10,10,13,11,10,11,10,12,12,12,12,13,13,7,6,11,13,13,1,1,1,3,1,2,2,1,1,2,1
"9598",23036028,"Karrar Jassim","6/11/1987 (36 years old)","M/AM (LC)","Naft Al-Wasat","Iraqi Premier League","IRQ","No","8/18/2022","7/31/2023","$0 - $6K","Left","Very Strong","Reasonable","5'10""","149 lbs","259","50",103,131,11,12,13,10,13,13,5,11,9,3,10,13,9,10,7,13,10,13,10,12,3,9,12,14,2,15,11,11,10,12,13,4,15,9,12,7,14,18,12,10,8,11,5,20,7,4,10,10,9,2,2,3,3,1,1,3,1,3,1,1
"9599",37041917,"Rewan Amin","1/8/1996 (27 years old)","DM, M (C)","Duhok","Iraqi Premier League","IRQ","Yes","2/2/2023","7/31/2023","$6K - $20K","Right","Fairly Strong","Very Strong","5'10""","165 lbs","103","1",85,130,12,12,11,8,11,11,7,10,5,9,12,8,11,11,12,11,11,11,11,11,10,12,10,10,11,11,12,11,9,9,11,8,12,9,9,10,7,9,11,12,11,9,14,8,9,7,10,9,14,2,3,2,4,2,1,3,3,2,1,1
"9600",70087636,"Ali Adnan","12/19/1993 (29 years old)","D (LC), WB/M (L)","Rubin","Russian Premier League","IRQ","No","8/11/2022","6/30/2025","$500K - $5.2M","Left","Very Strong","Reasonable","6'1""","171 lbs","168","7",115,130,12,12,12,10,12,13,11,14,12,7,12,12,12,13,13,10,12,12,8,11,14,13,13,13,7,11,8,13,13,13,15,12,14,13,13,11,12,13,12,12,13,13,3,10,10,4,13,12,14,1,1,3,1,2,2,1,3,3,3,3
"9601",2000085968,"Montader Madjed","4/24/2005 (18 years old)","M (RL), AM (RLC)","Hammarby IF","Swedish Premier Division","IRQ","Yes","8/10/2022","7/14/2025","$140K - $1.4M","Left","Very Strong","Weak","6'0""","163 lbs","23","5",96,130,8,11,13,9,12,9,6,9,6,6,10,9,7,13,12,10,12,12,11,10,14,14,5,12,8,9,11,9,13,12,10,10,10,13,12,8,9,9,9,12,13,10,6,8,9,10,12,13,18,1,3,3,2,2,2,3,1,3,1,3
"9602",37001840,"Osama Rashid","1/13/1992 (31 years old)","DM, M/AM (C)","VIZ","Portuguese Premier League","IRQ","Yes","6/1/2023","6/30/2024","$40K - $375K","Right","Fairly Strong","Very Strong","5'10""","169 lbs","219","28",110,130,13,13,11,11,13,14,7,13,5,7,14,14,7,13,13,12,11,13,10,12,13,12,13,10,12,11,14,10,11,12,13,8,13,10,10,12,11,10,13,15,13,15,7,14,8,5,13,12,14,3,2,1,2,3,1,2,1,2,1,2
"9603",93057528,"Mohanad Jeahze","4/10/1997 (26 years old)","D/WB/M (L)","D.C. United","Major League Soccer","IRQ","Yes","12/7/2022","12/31/2025","$275K - $2.8M","Left Only","Very Strong","Weak","5'10""","169 lbs","164","8",120,128,12,13,12,9,13,13,8,12,8,9,13,7,10,13,17,13,15,13,13,12,15,13,7,14,10,14,13,14,13,13,11,10,12,13,15,11,12,7,7,5,14,5,7,10,15,17,11,13,16,3,4,3,4,3,1,3,3,1,1,2
"9604",93085927,"Danilo Al-Saed","2/24/1999 (24 years old)","M (RL), AM (RLC), ST (C)","Sandefjord","Norwegian Premier Division","IRQ","Yes","1/1/2023","12/31/2025","$120K - $1.2M","Right","Reasonable","Very Strong","5'10""","147 lbs","147","41",114,127,8,9,16,11,15,9,6,10,6,5,10,10,5,15,10,10,8,13,10,10,11,17,6,13,5,6,11,8,13,15,9,9,10,12,12,6,8,10,10,10,11,9,8,12,7,8,11,10,16,2,3,4,4,2,3,1,3,3,1,1
"9605",93142568,"Alai Ghasem","2/16/2003 (20 years old)","D (RL), WB (R), M (C)","IFK Göteborg","Swedish Premier Division","IRQ","Yes","5/14/2022","12/31/2024","$0 - $95K","Right Only","Weak","Very Strong","5'9""","147 lbs","8","-",85,127,8,8,8,6,10,9,7,6,7,10,11,1,11,10,13,9,12,10,10,10,12,5,7,10,10,12,7,13,13,11,10,6,14,12,11,9,10,12,12,12,12,12,12,12,11,5,9,12,14,2,2,1,1,3,2,3,1,2,1,1
"9606",93053622,"Amir Al-Ammari","7/27/1997 (25 years old)","DM, M (C)","IFK Göteborg","Swedish Premier Division","IRQ","Yes","1/14/2022","11/30/2024","$0","Left","Very Strong","Reasonable","5'11""","154 lbs","166","29",107,126,12,11,11,10,13,12,9,11,6,9,12,11,11,13,13,12,12,12,11,11,13,12,9,12,11,12,12,12,12,11,10,11,9,12,13,9,13,8,9,12,11,10,7,12,14,9,10,12,14,2,2,1,4,1,1,3,2,2,1,3
"9607",2000073768,"Andronikos Kakoullis","5/3/2001 (22 years old)","AM (R), ST (C)","Omonoia","Cypriot First Division","CYP","Yes","11/14/2022","5/31/2026","$140K - $1.4M","Right Only","Weak","Very Strong","5'11""","160 lbs","86","17",105,121,7,10,11,13,7,5,9,6,5,5,9,7,6,11,8,12,11,8,12,11,16,13,3,16,7,12,7,11,16,16,8,9,15,15,15,5,7,11,12,11,12,12,9,9,5,4,10,15,20,2,1,2,2,3,2,3,2,2,1,3
"9608",147102,"Noor Sabri","6/18/1984 (38 years old)","GK","Samarra","Iraqi First Division Group A","IRQ","No","1/9/2022","6/30/2024","$0 - $14K","Right","Reasonable","Very Strong","5'9""","165 lbs","18","-",88,125,4,3,1,3,5,6,1,3,1,2,11,4,3,7,14,11,12,8,8,14,6,1,12,2,7,8,7,4,7,12,6,4,12,7,6,7,13,18,11,10,11,11,11,8,8,2,12,10,19,10,9,7,9,12,14,12,5,8,16,18
"9609",23433998,"Ibrahim Bayesh","5/1/2000 (23 years old)","M/AM (L)","Al-Quwa Al-Jawiya","Iraqi Premier League","IRQ","No","6/12/2023","7/31/2024","$28K - $275K","Left","Very Strong","Fairly Strong","5'10""","147 lbs","-","-",105,125,8,13,14,13,12,8,8,8,7,8,12,1,9,14,9,12,6,6,9,14,17,13,8,14,8,9,8,12,14,14,9,6,14,14,7,6,14,10,9,10,10,10,9,8,6,2,10,13,18,2,1,1,1,2,2,3,2,3,2,3
"9610",23252221,"Saad Natiq","3/19/1994 (29 years old)","D (C), DM","Abha","Saudi Professional League","IRQ","No","8/24/2022","6/30/2024","$4M - $7.8M","Right","Fairly Strong","Very Strong","6'2""","169 lbs","109","16",120,125,4,8,5,6,10,8,14,9,2,14,10,2,9,9,5,13,11,8,13,14,5,5,11,7,14,9,9,11,14,14,10,13,11,14,7,14,15,20,11,10,10,10,9,18,9,3,17,12,10,1,1,2,3,1,3,2,1,3,3,1
"9611",93081202,"André Alsanati","1/6/2000 (23 years old)","M/AM (R)","IK Sirius","Swedish Premier Division","IRQ","Yes","11/14/2022","12/31/2027","$90K - $900K","Left","Very Strong","Reasonable","5'5""","141 lbs","95","13",101,125,11,10,13,11,13,11,5,12,5,6,11,11,7,13,7,11,12,11,10,10,13,15,5,12,9,9,12,8,13,13,8,3,12,13,12,7,10,11,11,12,12,9,5,8,6,6,12,12,14,3,3,2,1,3,3,2,1,3,2,1
"9612",93122988,"Hussein Ali","3/1/2002 (21 years old)","D/WB (R)","sc Heerenveen","Eredivisie","IRQ","Yes","7/19/2022","6/30/2025","$500K - $4.9M","Right","Weak","Very Strong","5'11""","149 lbs","62","-",105,125,7,11,10,7,12,7,9,10,8,11,10,7,12,11,13,11,12,12,12,10,15,7,10,13,12,13,12,14,13,12,12,10,14,14,13,9,10,11,12,12,14,9,5,8,9,6,10,14,12,3,2,3,2,2,3,2,1,2,1,2
"9613",29194803,"Mohammed Dawood","11/22/2000 (22 years old)","AM (RL), ST (C)","Al-Shorta","Iraqi Premier League","IRQ","No","2/11/2021","6/30/2024","$12K - $130K","Left","Very Strong","Strong","5'11""","163 lbs","82","13",102,125,10,12,13,13,14,14,9,5,4,3,10,6,4,12,9,9,9,7,8,11,17,11,10,12,5,9,7,10,13,10,12,9,11,13,14,10,11,16,13,4,9,5,12,14,12,8,15,15,10,2,3,3,1,1,2,2,1,3,2,2
"9614",8115850,"Jiloan Hamad","11/6/1990 (32 years old)","M/AM (RLC)","Al-Kholood","Saudi First Division League","IRQ","Yes","2/1/2023","6/30/2024","$0","Right","Reasonable","Very Strong","5'8""","158 lbs","334","60",102,125,12,11,12,9,12,10,5,11,4,6,13,15,5,13,10,12,8,11,9,10,10,13,11,11,8,8,13,10,12,13,7,6,12,12,12,7,14,10,12,11,12,6,10,12,8,12,11,10,7,1,1,1,2,1,1,2,2,3,3,3
"9615",2000134390,"Abbas Kareem","11/15/2003 (19 years old)","GK","Al-Shorta","Iraqi Premier League","IRQ","No","7/1/2019","6/30/2024","$30K - $300K","Right","Weak","Very Strong","5'10""","156 lbs","-","-",83,124,2,1,1,1,5,3,1,3,3,3,13,3,2,6,5,7,11,7,9,14,7,1,3,1,9,8,7,7,11,12,3,9,12,10,2,7,10,18,12,11,9,13,9,14,15,7,20,12,14,6,7,14,8,14,12,14,5,10,7,7
"9616",2000210539,"Ali Hayder","10/19/2005 (17 years old)","M/AM (L)","Stoke","Sky Bet Championship","IRQ","No","7/1/2022","6/30/2024","$35K - $350K","Left","Very Strong","Reasonable","5'6""","127 lbs","-","-",65,124,1,12,15,1,12,1,1,3,1,2,1,1,1,7,11,10,11,8,5,6,16,13,11,9,6,7,9,12,12,18,13,1,11,10,9,1,13,12,11,11,12,12,5,13,14,3,9,15,15,2,2,1,3,1,2,2,1,3,3,2
"9617",29218499,"Ali Al-Hamadi","3/1/2002 (21 years old)","AM (RL), ST (C)","AFC Wimbledon","Sky Bet League Two","IRQ","No","1/12/2023","6/30/2025","$40K - $400K","Right","Fairly Strong","Very Strong","6'3""","180 lbs","37","13",95,123,5,6,9,12,8,5,9,6,2,6,7,8,6,13,11,9,11,11,8,7,15,11,8,13,4,13,8,13,14,10,11,13,15,15,9,11,10,8,9,9,8,8,13,12,11,11,12,17,14,3,3,3,2,2,3,1,1,2,1,2
"9618",2000074257,"Kyriakos Antoniou","3/5/2001 (22 years old)","D (C)","AEZ","Cypriot First Division","CYP","Yes","8/18/2022","5/31/2024","$220K - $650K","Right Only","Weak","Very Strong","6'2""","176 lbs","65","2",85,121,5,4,6,4,11,6,11,5,7,13,7,5,12,7,10,11,11,11,9,10,12,5,4,3,10,13,5,12,12,12,12,12,12,13,12,10,4,14,13,13,14,14,6,8,6,3,8,11,12,3,1,1,2,2,1,3,1,4,3,2
"9619",23252216,"Dhurgham Ismail","5/23/1994 (29 years old)","D/WB/M (L)","Al-Talaba","Iraqi Premier League","IRQ","No","7/12/2022","7/31/2023","$0","Left","Very Strong","Weak","5'10""","149 lbs","77","2",122,123,13,12,13,11,13,10,9,13,9,13,10,11,15,11,14,11,15,12,13,14,12,10,5,13,12,16,11,16,14,14,9,9,13,14,15,8,10,12,9,10,9,12,8,13,7,7,15,12,9,3,1,1,4,1,1,2,2,1,2,2
"9620",54200612,"Mustafa Mohammad","1/14/1998 (25 years old)","D/WB (L)","Al-Zawra'a","Iraqi Premier League","IRQ","No","7/11/2022","7/31/2023","$0 - $24K","Left","Very Strong","Reasonable","5'7""","138 lbs","-","-",110,121,6,14,10,9,10,4,10,9,8,12,9,5,10,12,5,12,11,12,13,15,12,5,10,11,12,6,9,11,15,11,11,3,13,13,15,4,12,10,12,12,12,10,10,9,5,7,10,9,18,2,3,2,2,4,4,3,1,2,3,3
"9621",23320669,"Hussein Ali","11/29/1996 (26 years old)","M (C), AM (RLC)","CS Sfax","Ligue Professionnelle 1","IRQ","No","8/21/2021","6/30/2025","$800K - $1.7M","Right","Reasonable","Very Strong","5'4""","132 lbs","60","8",107,121,8,9,13,9,14,12,4,10,4,5,13,10,8,14,7,11,6,14,10,11,9,15,8,12,7,12,14,8,13,16,14,5,12,11,11,6,15,10,11,8,11,11,9,12,6,5,11,12,12,1,1,2,3,3,2,3,3,3,3,3
"9622",54200648,"Safaa Hadi","7/10/1998 (24 years old)","DM, M (C)","Tractor","Persian Gulf Premier League","IRQ","No","4/9/2023","6/30/2024","$150K - $1.5M","Right","Reasonable","Very Strong","5'10""","165 lbs","37","1",112,121,9,10,4,8,14,9,8,8,9,11,9,8,14,12,12,10,10,11,9,12,10,5,10,10,14,10,9,13,14,14,10,7,12,14,11,13,12,20,13,13,13,12,11,2,8,1,13,12,20,3,3,2,2,3,3,2,3,1,3,2
"9623",54200628,"Maytham Jabbar","11/10/2000 (22 years old)","D (C)","Al-Zawra'a","Iraqi Premier League","IRQ","No","7/11/2022","7/31/2024","$30K - $300K","Right","Fairly Strong","Very Strong","6'0""","167 lbs","-","-",105,120,6,3,1,2,8,1,14,5,2,14,7,2,14,8,8,13,10,9,7,13,8,5,4,8,14,8,1,9,14,14,9,7,5,14,8,7,16,15,13,11,10,9,5,10,10,3,15,12,7,3,1,3,3,3,1,1,2,3,1,2
"9624",72023357,"Justin Meram","12/4/1988 (34 years old)","WB (L), AM (RL)","Charlotte FC","Major League Soccer","IRQ","No","4/24/2023","12/31/2023","$650K - $1.4M","Right","Reasonable","Very Strong","6'1""","165 lbs","341","53",112,120,13,13,15,12,13,12,11,14,5,8,13,12,9,13,14,11,10,11,13,11,11,15,10,13,11,10,13,12,11,12,13,11,12,11,10,11,16,7,9,11,12,8,12,12,10,11,12,14,11,3,2,3,2,2,1,1,1,1,3,3
"9625",68016292,"Ahmed Yasin","4/22/1991 (32 years old)","M (R), AM (RLC)","Al-Kholood","Saudi First Division League","IRQ","Yes","1/1/2023","6/30/2024","$230K - $2.3M","Right","Weak","Very Strong","6'1""","174 lbs","318","44",105,120,10,12,11,11,13,11,7,11,6,8,12,11,8,13,13,11,8,11,10,12,11,15,2,12,9,11,11,10,12,12,12,12,16,13,12,12,14,9,9,12,12,8,13,11,11,10,10,11,14,4,4,3,3,3,1,3,2,1,3,1
"9626",54202390,"Mohammed Ridha Jalil","2/17/2000 (23 years old)","M (C)","Sanat Naft","Persian Gulf Premier League","IRQ","No","1/1/2023","6/30/2026","$70K - $700K","Right","Fairly Strong","Very Strong","5'5""","141 lbs","11","-",97,120,8,6,6,8,14,8,8,6,5,13,14,3,9,10,15,11,5,12,9,14,8,11,1,11,9,9,13,13,13,12,8,5,13,10,8,1,14,13,9,13,10,11,13,13,9,6,12,9,13,2,1,3,2,3,3,1,1,1,4,1
"9627",23325135,"Ayman Hussein","3/22/1996 (27 years old)","ST (C)","Al-Jazira (UAE)","UAE Professional League","IRQ","No","2/7/2023","5/31/2024","$0","Right","Reasonable","Very Strong","6'2""","171 lbs","46","16",105,120,9,5,12,15,15,8,15,9,3,9,10,9,3,11,10,11,12,12,9,11,10,11,1,13,8,9,7,10,10,9,12,14,10,11,8,14,11,16,11,12,11,12,6,4,13,2,13,8,12,1,1,1,2,1,1,2,2,3,1,2
"9628",23433907,"Ahmed Jalal","3/17/1998 (25 years old)","M (C)","Naft Al-Basra","Iraqi Premier League","IRQ","No","8/5/2022","6/30/2024","$0","Right","Fairly Strong","Very Strong","6'1""","171 lbs","7","-",98,120,8,7,4,8,14,8,6,7,1,14,14,6,10,13,14,10,7,8,8,13,18,5,9,10,8,9,13,13,13,13,9,9,12,12,13,9,14,13,13,11,9,9,12,15,12,4,12,11,18,3,4,1,3,4,2,2,2,1,1,1
"9629",26034519,"Ioannis Pittas","7/10/1996 (26 years old)","AM (L), ST (C)","Apol. Limassol","Cypriot First Division","CYP","Yes","6/15/2020","6/30/2025","$85K - $850K","Right","Weak","Very Strong","5'11""","160 lbs","166","54",116,120,10,9,12,13,12,9,12,11,6,5,10,13,7,13,15,12,12,12,13,12,15,12,9,13,6,13,10,13,14,13,12,9,12,14,13,12,10,8,12,13,12,15,8,12,11,5,13,14,12,3,1,2,1,2,2,1,2,3,1,1
"9630",2000209969,"Samal Saeed","12/1/1987 (35 years old)","D (RC)","Al-Diwaniya","Iraqi Premier League","IRQ","No","9/5/2022","7/31/2023","$1.5K - $4.5K","Right","Reasonable","Very Strong","6'0""","160 lbs","21","1",85,120,7,12,6,2,10,2,13,4,6,11,9,6,10,7,7,8,10,8,9,15,16,5,14,8,15,9,7,9,10,8,9,8,15,8,11,7,15,10,14,11,11,12,8,9,9,4,10,12,17,1,3,3,2,1,1,2,4,2,1,3
"9631",54200063,"Mohanad Ali","6/20/2000 (22 years old)","ST (C)","Al-Sailiya","Qatar League","IRQ","No","7/3/2022","5/31/2024","$0","Right Only","Weak","Very Strong","6'0""","171 lbs","136","54",100,120,11,11,8,13,10,10,13,7,8,6,10,8,11,13,15,12,13,10,13,8,8,13,15,11,12,13,8,13,13,8,13,12,12,14,11,14,6,11,10,10,14,10,9,7,5,7,14,9,7,3,3,1,2,1,4,2,1,1,3,1
"9632",23320658,"Hammadi Ahmed","10/18/1989 (33 years old)","AM (R), ST (C)","Al-Quwa Al-Jawiya","Iraqi Premier League","IRQ","No","7/2/2022","7/31/2023","$0 - $20K","Right","Reasonable","Very Strong","5'8""","152 lbs","-","-",116,119,9,13,13,15,15,7,15,6,7,10,15,9,5,13,10,11,7,14,11,15,16,11,5,15,11,10,9,12,13,13,5,3,11,12,8,8,14,13,11,10,11,12,7,5,8,8,14,12,11,3,2,1,2,1,3,3,1,3,3,3
"9633",54201422,"Mujtaba Mohammed","3/20/2002 (21 years old)","GK","Al-Mina'a","Iraqi First Division Group B","IRQ","No","7/4/2020","6/30/2024","$10K - $110K","Right","Reasonable","Very Strong","6'1""","163 lbs","-","-",74,119,2,1,1,3,2,5,1,2,1,1,7,2,1,1,12,7,14,6,8,11,11,1,9,2,8,6,5,5,9,14,6,12,15,10,4,3,11,16,9,10,11,13,7,17,5,8,17,11,15,6,6,12,5,7,9,12,13,6,10,10
"9634",23320707,"Mazen Fayad","4/2/1997 (26 years old)","M/AM (R)","Al-Najaf","Iraqi Premier League","IRQ","No","2/4/2023","7/31/2023","$500 - $7K","Right","Fairly Strong","Very Strong","5'3""","123 lbs","-","-",109,119,9,13,14,6,14,8,7,7,4,8,14,4,7,14,5,10,9,8,9,11,4,13,11,12,8,9,8,10,13,14,9,2,9,14,12,2,15,14,12,13,10,12,9,10,12,5,7,13,7,3,3,1,1,2,1,2,3,3,3,2
"9635",2000019461,"Merchas Doski","12/7/1999 (23 years old)","D/WB/M (L)","Slovácko","Czech First Division","IRQ","Yes","7/1/2022","6/30/2025","$325K - $950K","Left","Very Strong","Weak","5'8""","147 lbs","121","6",102,118,10,12,16,4,8,10,10,6,10,15,12,9,14,11,15,9,10,12,9,13,9,5,14,11,12,15,5,14,16,12,6,4,10,12,9,6,15,11,12,10,10,9,14,1,8,8,9,11,9,3,1,1,1,1,2,1,1,3,3,3
"9636",54201912,"Hassan Raed","9/23/2000 (22 years old)","D (L)","Al-Quwa Al-Jawiya","Iraqi Premier League","IRQ","No","7/3/2022","7/31/2023","$0 - $120K","Left","Very Strong","Reasonable","6'0""","160 lbs","-","-",91,118,6,13,5,8,13,3,9,8,6,10,9,1,12,9,14,6,10,9,9,12,4,9,3,6,11,9,6,9,9,14,9,6,17,14,14,7,13,15,9,12,13,9,9,4,5,6,20,10,16,1,2,2,1,2,1,3,3,3,1,1
"9637",8110263,"Brwa Nouri","1/23/1987 (36 years old)","DM, M (C)","Bali United","Indonesian League One","IRQ","Yes","7/31/2018","5/31/2024","$500 - $6K","Right","Weak","Very Strong","5'10""","158 lbs","386","62",90,118,12,11,11,8,12,12,6,11,3,6,12,15,8,12,10,12,10,11,11,11,9,12,13,10,11,11,11,11,12,11,8,9,12,12,13,8,9,8,8,8,12,8,10,12,8,15,14,8,11,1,1,1,2,2,1,3,3,1,3,1
"9638",54203088,"Basil Asaad","4/8/2000 (23 years old)","DM, M (RC)","Al-Bahri","Iraqi First Division Group A","IRQ","No","7/1/2021","6/30/2024","$12K - $120K","Right","Fairly Strong","Very Strong","6'0""","165 lbs","-","-",81,117,7,7,9,7,10,7,7,8,7,9,12,7,10,8,13,10,7,9,8,14,7,5,4,9,8,8,11,13,12,11,7,9,15,10,9,7,10,13,13,10,9,12,12,14,12,6,13,10,15,3,1,1,2,3,2,3,1,2,2,1
"9639",2000134399,"Haider Ali Hussein","7/9/2003 (19 years old)","ST (C)","Al-Shorta","Iraqi Premier League","IRQ","No","7/1/2019","6/30/2024","$8K - $85K","Right","Fairly Strong","Very Strong","6'0""","167 lbs","-","-",75,117,6,3,9,14,14,4,11,4,4,6,8,6,7,11,5,8,6,8,8,7,8,10,5,13,8,7,8,8,14,10,8,6,14,10,7,8,11,17,12,9,12,9,15,8,5,7,19,11,16,1,1,2,2,3,1,2,2,3,2,2
"9640",2000119425,"Nikolas Panagiotou","5/12/2000 (23 years old)","D (LC), DM","Omonoia","Cypriot First Division","CYP","Yes","10/15/2021","5/31/2025","$230K - $700K","Left Only","Very Strong","Weak","6'0""","169 lbs","43","1",95,120,4,6,7,8,8,4,10,5,8,12,10,6,11,10,8,10,11,10,11,11,13,5,11,4,11,13,10,12,12,13,14,12,11,13,13,10,12,15,13,13,15,12,5,8,5,3,12,15,18,1,2,3,3,1,2,2,1,2,3,2
"9641",23384187,"Ala'a Mhawi","6/3/1996 (27 years old)","D/WB (R)","Al-Quwa Al-Jawiya","Iraqi Premier League","IRQ","No","7/13/2022","6/30/2024","$10K - $110K","Right","Reasonable","Very Strong","5'10""","160 lbs","9","-",111,116,8,13,15,7,11,4,11,4,9,12,14,3,14,11,15,10,11,10,14,12,7,5,9,9,13,10,10,10,12,10,10,7,11,12,14,8,12,15,12,9,12,11,8,1,10,4,10,10,15,2,2,1,3,1,1,2,2,3,3,1
"9642",93033236,"Rebin Asaad","10/31/1994 (28 years old)","M/AM (C)","Österlen FF","Swedish Second Division South Götaland","IRQ","Yes","12/31/2021","11/30/2023","$0 - $16K","Right","Reasonable","Very Strong","5'9""","145 lbs","236","24",78,115,9,11,10,8,11,10,7,8,6,8,11,9,7,11,9,11,11,10,10,10,8,11,6,9,11,10,11,10,11,11,8,8,12,11,10,8,9,13,12,11,11,8,5,8,7,4,11,7,14,4,2,1,3,3,3,2,2,1,3,1
"9643",23433993,"Ala'a Abbas","7/27/1997 (25 years old)","ST (C)","Al-Zawra'a","Iraqi Premier League","IRQ","No","8/1/2022","6/30/2024","$120K - $350K","Right","Fairly Strong","Very Strong","5'11""","163 lbs","22","9",104,115,5,8,10,14,12,8,13,12,7,2,8,11,4,11,11,12,11,13,7,8,13,9,8,12,3,7,8,8,13,12,11,12,14,14,11,11,10,12,8,6,14,13,5,8,5,14,11,13,9,2,2,1,4,1,2,3,3,3,3,3
"9644",2000019066,"Muntadher Mohammed","6/5/2001 (22 years old)","D (L), DM, M/AM (C)","Al-Naft","Iraqi Premier League","IRQ","No","1/1/2023","6/30/2025","$26K - $250K","Left","Very Strong","Fairly Strong","5'9""","154 lbs","15","3",95,115,5,9,3,8,10,8,8,8,2,9,12,5,12,8,10,11,9,8,10,14,7,11,10,10,14,9,14,10,14,12,9,6,11,11,8,7,15,19,10,13,11,9,13,8,8,8,15,11,10,3,2,2,2,3,2,3,2,3,3,3
"9645",54201432,"Ahmed Farhan","8/3/2000 (22 years old)","M (C), AM (LC)","Al-Shorta","Iraqi Premier League","IRQ","No","7/28/2022","7/31/2023","$28K - $275K","Right","Reasonable","Very Strong","5'6""","130 lbs","73","11",95,115,12,10,12,8,12,7,6,12,6,9,13,3,4,13,5,10,7,4,9,14,14,10,1,11,9,9,14,10,14,12,4,1,14,11,9,7,16,18,8,12,12,11,6,10,6,4,18,10,14,4,1,4,1,1,2,1,1,2,3,3
"9646",23434153,"Bassam Shaker","5/17/2000 (23 years old)","M/AM (L), ST (C)","Al-Shorta","Iraqi Premier League","IRQ","No","8/6/2021","6/30/2025","$70K - $210K","Left","Very Strong","Fairly Strong","5'7""","134 lbs","59","8",89,115,8,11,13,11,13,7,9,8,2,6,10,4,6,14,9,9,7,10,8,12,5,13,4,11,5,6,9,9,13,10,8,3,15,11,10,1,10,20,11,10,11,11,12,6,5,2,10,10,9,1,3,2,2,3,2,1,2,4,2,2
"9647",523101,"Roman Eremenko","3/19/1987 (36 years old)","M (RC), AM (C)","FC Honka","Finnish Premier League","FIN","Yes","5/4/2023","11/15/2023","$10K - $28K","Right","Fairly Strong","Very Strong","6'1""","176 lbs","313","49",108,148,11,10,12,11,14,13,7,12,11,7,15,11,7,14,12,12,11,14,13,14,18,13,6,13,10,12,16,11,7,8,9,11,10,8,5,10,15,16,13,13,11,13,16,11,2,5,15,12,16,4,2,1,3,2,2,1,3,3,1,1
"9648",93123164,"Robin Tihi","3/16/2002 (21 years old)","D (RC)","AIK","Swedish Premier Division","FIN","Yes","6/13/2022","12/31/2023","$375K - $3.8M","Right","Reasonable","Very Strong","6'1""","147 lbs","86","3",110,145,7,12,8,7,11,7,11,7,9,12,12,7,12,12,12,12,12,12,12,12,14,8,9,9,12,12,12,12,12,11,12,12,12,13,12,12,7,12,10,12,14,14,5,5,8,5,12,13,14,1,2,1,3,1,3,2,1,2,3,3
"9649",8507078,"Teemu Pukki","3/29/1990 (33 years old)","ST (C)","Norwich","Sky Bet Championship","FIN","Yes","6/14/2021","6/30/2025","Not for Sale","Right","Reasonable","Very Strong","5'11""","171 lbs","479","176",127,144,7,12,13,15,14,9,10,12,5,5,12,17,6,12,14,15,9,14,13,13,15,8,8,15,6,16,14,17,13,13,13,9,15,12,13,13,7,18,19,16,13,15,3,14,4,3,14,13,16,4,3,2,2,1,1,3,3,2,2,1
"9650",33001438,"Lukás Hrádecký","11/24/1989 (33 years old)","GK","Bayer 04","Bundesliga","FIN","Yes","8/30/2022","6/30/2026","Not for Sale","Right Only","Weak","Very Strong","6'4""","189 lbs","412","-",138,144,1,2,3,1,8,1,7,1,3,3,10,7,3,8,15,12,15,12,14,12,16,6,15,3,13,12,8,13,9,14,12,17,16,11,11,13,1,10,12,14,14,14,5,16,6,8,13,15,17,16,12,16,9,16,11,14,8,14,14,15
"9651",2000119428,"Charalabos Charalabous","4/4/2002 (21 years old)","M/AM (C)","Omonoia","Cypriot First Division","CYP","Yes","11/14/2022","5/31/2026","$120K - $1.2M","Right Only","Weak","Very Strong","5'10""","154 lbs","47","-",95,120,5,7,13,15,11,7,8,9,1,10,12,10,11,12,15,7,4,11,8,14,14,9,12,12,7,14,12,13,15,11,15,7,9,12,11,7,11,13,15,13,14,16,7,11,7,3,11,14,14,2,1,3,2,1,4,3,4,3,1,2
"9652",28124568,"Lucas Bergström","9/5/2002 (20 years old)","GK","Chelsea","English Premier Division","FIN","Yes","1/24/2021","6/30/2024","$18.5M - $28M","Right","Weak","Very Strong","6'8""","185 lbs","23","-",120,143,2,3,1,3,8,7,10,1,1,1,6,3,2,8,11,8,11,11,12,10,13,2,9,3,8,9,11,10,10,13,12,20,13,10,7,10,11,10,13,13,12,10,12,4,10,5,9,12,12,13,8,15,7,13,14,11,2,19,10,19
"9653",2000112371,"Juho Talvitie","3/25/2005 (18 years old)","AM (RC), ST (C)","Lommel SK","Belgian Challenger Pro League","FIN","Yes","7/2/2021","6/30/2024","$100K - $1M","Left Only","Very Strong","Weak","5'10""","145 lbs","23","-",89,139,9,11,13,8,13,7,5,6,6,8,11,5,5,13,8,12,14,12,10,7,17,12,4,9,6,11,10,12,15,12,4,7,9,15,5,3,12,19,10,10,12,11,12,8,9,7,8,11,20,3,1,2,3,3,3,2,2,1,1,1
"9654",2000201806,"Juho Lähteenmäki","6/15/2006 (16 years old)","AM (R)","FC Nordsjælland","3F Superliga","FIN","Yes","6/30/2022","6/30/2025","$220K - $2.2M","Right Only","Weak","Very Strong","5'9""","147 lbs","-","-",80,139,10,11,13,12,13,9,9,10,5,4,13,11,5,13,9,12,10,8,6,4,8,14,11,12,5,12,11,12,13,12,8,11,14,13,5,5,15,13,12,14,10,11,11,8,9,4,18,12,16,3,3,1,2,3,2,3,2,1,3,3
"9655",2000101281,"Tomas Galvez","1/28/2005 (18 years old)","D/WB (L)","Man City","English Premier Division","FIN","Yes","7/1/2022","6/30/2025","$700K - $1.5M","Left Only","Very Strong","Weak","5'7""","130 lbs","-","-",80,139,5,9,8,5,10,2,7,8,8,10,10,2,12,13,15,7,10,7,10,6,4,5,2,7,10,14,12,13,15,14,10,5,9,12,9,4,14,18,10,12,12,11,5,20,7,8,18,11,10,2,2,4,1,2,2,2,1,4,2,3
"9656",2000134692,"Jaaso Jantunen","1/31/2005 (18 years old)","GK","SC Freiburg","Bundesliga","FIN","Yes","7/1/2022","6/30/2026","$300K - $3.1M","Right","Reasonable","Very Strong","6'5""","182 lbs","1","-",88,139,1,3,2,1,1,6,1,3,2,2,12,3,2,6,12,9,13,7,10,13,18,3,10,2,9,7,4,6,8,15,7,15,12,7,1,6,9,14,11,11,12,9,6,9,11,3,10,13,7,6,12,13,15,11,9,13,5,7,7,11
"9657",518969,"Niklas Moisander","9/29/1985 (37 years old)","D (C)","Malmö FF","Swedish Premier Division","FIN","Yes","11/30/2022","12/31/2023","$35K - $110K","Left","Very Strong","Weak","6'0""","169 lbs","444","15",119,138,7,11,10,7,11,7,14,10,14,14,13,9,14,11,12,14,12,15,13,14,14,8,14,10,14,14,12,13,9,9,13,11,16,9,12,13,10,10,16,17,15,15,17,15,7,5,14,5,14,3,1,2,3,1,1,1,3,2,2,2
"9658",2000083680,"Otso Liimatta","7/10/2004 (18 years old)","M/AM (C)","AC Oulu","Finnish Premier League","FIN","Yes","1/1/2022","11/30/2025","$0","Right","Fairly Strong","Very Strong","5'7""","132 lbs","69","12",108,138,7,10,12,8,13,9,5,7,10,5,13,13,8,13,10,12,10,11,12,11,14,12,9,12,9,12,14,11,14,12,8,9,14,12,12,8,12,16,15,14,14,14,6,8,6,4,12,14,14,3,3,3,3,1,1,3,2,1,1,1
"9659",33075882,"Naatan Skyttä","5/7/2002 (21 years old)","M/AM (C)","OB","3F Superliga","FIN","Yes","1/31/2021","6/30/2025","$230K - $2.3M","Left","Very Strong","Fairly Strong","5'7""","152 lbs","57","5",113,138,10,9,11,11,12,13,8,10,5,5,13,10,5,13,13,13,11,13,12,12,14,16,7,12,10,12,13,13,14,13,8,6,12,14,10,8,12,12,12,15,11,12,8,10,4,7,12,14,12,3,2,2,2,3,3,1,1,3,2,3
"9660",8505627,"Përparim Hetemaj","12/12/1986 (36 years old)","DM, M (C)","HJK","Finnish Premier League","FIN","Yes","4/20/2022","11/15/2023","$2K - $22K","Right","Reasonable","Very Strong","5'10""","167 lbs","468","19",115,137,9,8,12,7,14,10,7,10,7,12,12,9,15,12,18,14,17,11,14,12,18,12,14,10,13,15,13,16,9,9,14,9,14,10,10,14,13,10,12,18,12,14,11,12,15,8,15,16,13,3,1,3,3,2,2,3,3,3,2,2
"9661",2000018180,"Jimi Tauriainen","3/8/2004 (19 years old)","DM, M/AM (C)","Chelsea","English Premier Division","FIN","Yes","3/9/2021","6/30/2024","$150K - $1.5M","Left","Very Strong","Reasonable","6'1""","167 lbs","-","-",90,135,10,9,9,10,9,12,5,12,8,6,8,8,8,11,13,11,10,10,9,8,6,10,6,8,7,8,9,10,14,9,10,12,12,14,11,8,13,19,13,11,11,14,12,15,5,4,5,11,20,1,2,1,2,2,1,3,1,3,3,2
"9662",43500536,"Giorgos Naoum","2/21/2001 (22 years old)","M (C), AM (RC)","AEK Larnakas","Cypriot First Division","CYP","Yes","5/26/2021","5/31/2024","$110K - $1.1M","Left","Very Strong","Reasonable","5'10""","147 lbs","38","-",95,120,12,13,14,7,14,11,5,9,3,5,12,9,6,14,7,11,5,12,6,13,8,14,5,11,8,8,12,6,12,14,10,7,8,11,12,5,13,11,13,12,8,7,9,6,5,5,7,16,7,3,1,4,1,2,2,3,3,2,2,1
"9663",33058650,"Leo Väisänen","7/23/1997 (25 years old)","D (C)","Austin FC","Major League Soccer","FIN","Yes","1/4/2023","12/31/2026","$425K - $4.2M","Right","Weak","Very Strong","6'1""","176 lbs","198","14",119,135,5,11,7,6,10,7,14,7,9,14,12,8,14,11,8,13,12,14,14,13,14,5,13,8,14,12,12,11,11,8,12,14,12,12,12,13,9,15,16,15,14,11,10,12,3,6,15,14,15,1,1,1,1,3,2,2,1,2,1,1
"9664",33079161,"Niklas Pyyhtiä","9/25/2003 (19 years old)","DM, M (C)","Bologna","Italian Serie A","FIN","Yes","8/30/2021","6/30/2024","$210K - $650K","Left","Very Strong","Reasonable","6'1""","176 lbs","41","3",104,135,8,11,11,8,12,9,8,12,7,6,13,10,9,13,10,10,9,11,12,12,9,11,9,11,8,12,12,10,13,12,14,10,14,13,13,13,12,12,14,14,10,14,7,7,7,3,12,10,12,2,3,1,3,1,2,1,3,3,2,2
"9665",28084932,"Glen Kamara","10/28/1995 (27 years old)","DM, M (C)","Rangers","cinch Premiership","FIN","Yes","9/22/2021","5/31/2025","$5.2M - $7.8M","Right","Weak","Very Strong","5'11""","171 lbs","181","6",125,134,5,13,14,6,15,7,9,7,8,13,14,12,11,16,7,14,4,14,8,11,10,14,5,14,12,12,15,11,15,13,15,11,17,15,14,9,11,14,13,9,15,7,6,12,6,6,10,11,13,2,3,1,3,1,1,3,3,3,3,2
"9666",28106531,"Marcus Forss","6/18/1999 (23 years old)","AM (R), ST (C)","Middlesbrough","Sky Bet Championship","FIN","Yes","7/28/2022","6/30/2026","$5.4M - $6.8M","Right","Reasonable","Very Strong","6'0""","169 lbs","121","30",123,133,7,11,13,15,13,8,12,11,7,7,12,14,6,13,13,13,11,14,11,12,14,13,6,13,10,13,11,13,13,12,12,11,13,14,11,11,13,15,12,13,11,12,5,13,6,5,12,13,13,2,1,1,1,2,1,2,3,3,2,2
"9667",33070662,"Jaakko Oksanen","11/7/2000 (22 years old)","DM, M (C)","KuPS","Finnish Premier League","FIN","Yes","6/30/2022","11/15/2023","$90K - $900K","Right","Reasonable","Very Strong","6'0""","176 lbs","79","4",98,132,13,7,10,8,12,12,7,7,2,8,11,5,10,11,13,11,13,12,11,11,15,10,6,9,12,12,11,13,10,11,11,7,12,9,12,11,12,14,12,12,12,10,6,12,5,8,12,14,12,1,2,3,3,3,2,3,2,2,3,2
"9668",33020908,"Jesse Joronen","3/21/1993 (30 years old)","GK","Venezia","Italian Serie B","FIN","Yes","7/1/2022","6/30/2025","$325K - $3.3M","Left Only","Very Strong","Weak","6'6""","196 lbs","254","2",123,132,3,2,2,1,5,5,4,3,1,1,6,4,2,6,13,12,14,10,12,11,14,1,9,3,14,8,6,6,10,14,12,17,9,9,12,13,10,14,14,16,11,10,10,13,15,2,13,17,15,13,13,15,7,15,13,12,8,13,15,16
"9669",33071592,"Onni Valakari","8/18/1999 (23 years old)","M/AM (C)","Pafos","Cypriot First Division","FIN","Yes","11/25/2022","5/31/2026","$240K - $2.4M","Left","Very Strong","Weak","6'2""","182 lbs","184","60",120,132,11,11,12,13,14,12,10,15,3,6,12,13,7,13,11,14,11,13,15,12,16,14,8,14,8,11,13,13,13,14,11,13,11,12,14,10,12,15,14,14,12,7,5,13,9,6,12,12,16,1,1,3,2,4,3,2,4,1,3,2
"9670",33027508,"Joel Pohjanpalo","9/13/1994 (28 years old)","ST (C)","Venezia","Italian Serie B","FIN","Yes","8/19/2022","6/30/2025","$100K - $7M","Right","Fairly Strong","Very Strong","6'1""","189 lbs","276","124",130,131,6,7,11,15,13,10,14,11,4,4,13,13,6,12,11,15,14,15,15,13,15,10,12,16,5,12,11,14,10,11,15,13,11,12,12,15,10,13,13,11,16,12,14,12,6,12,15,14,14,4,1,2,3,4,1,4,1,1,2,3
"9671",33082937,"Leo Walta","6/24/2003 (19 years old)","M/AM (C)","HB Køge","NordicBet Liga","FIN","Yes","7/14/2021","6/30/2025","$700K - $1.5M","Right","Fairly Strong","Very Strong","5'8""","136 lbs","39","3",109,131,11,10,13,8,13,11,6,13,7,8,13,11,8,14,10,13,10,13,10,11,13,12,10,13,8,13,13,13,12,13,9,7,13,12,12,6,9,14,13,14,7,11,7,9,9,6,9,13,11,3,2,2,3,2,1,3,3,2,1,2
"9672",167261,"Jere Uronen","7/13/1994 (28 years old)","D/WB (L)","Schalke 04","Bundesliga 2","FIN","Yes","7/20/2021","6/30/2025","$650K - $1.4M","Left","Very Strong","Reasonable","5'10""","163 lbs","273","10",122,130,13,12,11,6,12,13,8,8,15,13,12,7,13,12,12,11,14,10,13,12,14,10,7,12,13,15,11,14,12,12,13,8,14,13,15,13,12,14,13,14,11,12,10,14,7,8,12,12,15,1,3,1,1,4,2,2,1,1,3,1
"9673",2000185987,"Konstantinos Chrysostomou","1/7/2003 (20 years old)","GK","Aris Limassol","Cypriot First Division","CYP","Yes","8/19/2022","6/30/2025","$35K - $325K","Right Only","Weak","Very Strong","5'10""","158 lbs","-","-",90,120,3,3,1,3,4,5,1,3,2,2,7,2,3,1,5,12,11,8,10,13,9,2,12,1,11,8,7,7,9,14,5,7,15,9,3,8,11,11,12,10,14,10,5,13,11,4,20,12,17,6,12,13,5,10,11,11,6,12,13,10
"9674",33029449,"Robin Lod","4/17/1993 (30 years old)","M/AM (RLC), ST (C)","Minnesota","Major League Soccer","FIN","Yes","7/29/2022","12/31/2024","$3.6M - $7M","Left","Very Strong","Fairly Strong","5'11""","169 lbs","292","73",129,130,10,11,12,13,11,9,10,13,6,10,13,12,9,14,12,13,13,13,12,13,15,12,9,14,10,15,12,14,11,11,14,10,12,11,10,13,16,17,16,17,14,15,8,13,6,4,14,16,13,2,2,2,2,2,3,3,3,2,2,1
"9675",33076314,"Oliver Antman","8/15/2001 (21 years old)","M (C), AM (RC)","FC Groningen","Keuken Kampioen Divisie","FIN","Yes","9/6/2022","6/30/2025","$300K - $3M","Right","Reasonable","Very Strong","5'9""","143 lbs","94","12",115,130,11,13,13,12,14,13,4,13,3,6,14,12,6,14,11,14,12,13,13,13,16,12,8,14,6,13,13,15,12,13,8,6,14,12,12,11,10,12,13,13,7,11,7,8,7,9,11,17,14,3,1,1,2,3,2,3,1,2,2,1
"9676",33057521,"Kaan Kairinen","12/22/1998 (24 years old)","DM, M/AM (C)","Sparta Prague","Czech First Division","FIN","Yes","1/1/2023","6/30/2026","$2.3M - $4.8M","Left","Very Strong","Weak","6'1""","185 lbs","154","9",119,130,13,12,11,9,13,13,8,12,9,10,14,11,11,14,13,8,11,13,13,12,12,14,8,13,13,14,13,14,12,11,12,12,12,11,14,13,12,10,12,12,10,11,9,10,11,11,13,15,8,1,2,2,1,2,1,1,4,1,3,3
"9677",33082940,"Matti Peltola","7/3/2002 (20 years old)","D (RC), DM, M (C)","HJK","Finnish Premier League","FIN","Yes","8/23/2022","11/15/2023","$150K - $1.5M","Right","Reasonable","Very Strong","6'1""","176 lbs","64","2",109,130,6,7,8,6,10,6,10,8,6,10,11,10,8,10,11,13,16,9,13,12,14,9,13,12,12,13,8,15,12,12,11,10,14,12,14,11,14,10,12,12,13,11,12,13,8,2,12,15,18,3,1,2,3,1,3,2,1,2,3,1
"9678",33058051,"Saku Ylätupa","8/4/1999 (23 years old)","M (RL), AM (RLC)","Kalmar FF","Swedish Premier Division","FIN","Yes","1/16/2023","12/31/2025","$30K - $300K","Left","Very Strong","Weak","5'7""","147 lbs","111","27",99,130,7,10,12,11,12,8,6,11,6,8,11,12,6,12,6,12,11,12,11,11,12,14,7,12,10,11,12,11,13,12,8,7,12,13,11,7,10,14,14,12,12,7,6,11,6,6,10,12,13,2,2,1,3,1,1,1,2,3,4,3
"9679",91177223,"Anssi Suhonen","1/14/2001 (22 years old)","M/AM (C)","HSV","Bundesliga 2","FIN","Yes","4/7/2022","6/30/2026","$120K - $1.2M","Right","Fairly Strong","Very Strong","5'7""","154 lbs","39","5",110,128,12,11,13,8,13,13,6,11,4,8,13,12,11,13,12,11,12,11,11,10,12,16,4,12,10,12,13,13,12,14,10,6,10,12,12,8,10,11,12,14,13,15,13,8,9,4,12,13,15,2,3,1,1,3,3,1,2,2,2,3
"9680",2000282596,"Daniel Riihilahti","3/9/2006 (17 years old)","M (C)","HJK","Finnish Premier League","FIN","Yes","1/1/2022","11/30/2024","$0","Right Only","Weak","Very Strong","6'2""","167 lbs","-","-",76,128,7,6,10,6,14,7,7,9,1,9,14,4,12,14,14,7,7,9,5,13,13,6,10,9,5,13,5,13,14,11,7,13,12,11,10,7,14,20,9,10,11,13,12,20,11,4,7,11,20,2,1,3,1,1,2,2,2,2,4,3
"9681",33045787,"Sauli Väisänen","6/5/1994 (29 years old)","D (C)","Cosenza","Italian Serie B","FIN","Yes","8/16/2021","6/30/2025","$55K - $550K","Right","Fairly Strong","Very Strong","6'2""","165 lbs","204","12",114,128,3,9,7,5,11,8,12,7,5,14,12,6,12,12,14,11,13,14,12,12,14,6,11,12,14,12,11,12,11,9,12,14,12,11,12,13,10,14,16,14,15,12,12,13,7,3,12,12,14,2,1,3,1,2,3,2,1,3,2,3
"9682",33055789,"Lassi Lappalainen","8/24/1998 (24 years old)","WB (L), AM (RL)","CF Montréal","Major League Soccer","FIN","Yes","12/3/2021","12/31/2024","$1.8M - $3.7M","Right","Fairly Strong","Very Strong","6'0""","176 lbs","174","37",112,128,9,12,12,14,11,7,6,9,2,8,10,10,5,12,9,10,8,12,10,11,14,12,8,9,6,12,11,14,15,12,10,10,12,14,10,8,12,14,14,12,14,12,14,12,5,7,13,13,13,1,2,1,2,2,2,3,3,2,1,4
"9683",28101609,"Niko Hämäläinen","3/5/1997 (26 years old)","D/WB (L)","QPR","Sky Bet Championship","FIN","Yes","6/15/2020","6/30/2025","$28K - $85K","Left Only","Very Strong","Weak","6'2""","163 lbs","77","-",97,128,7,9,12,6,12,8,9,8,7,12,9,8,11,12,7,12,8,13,8,11,7,10,7,10,11,12,12,11,13,12,12,13,15,13,12,9,17,13,10,7,6,11,7,8,7,8,12,10,10,2,1,2,1,3,1,1,1,1,2,2
"9684",29122251,"Andreas Karo","9/9/1996 (26 years old)","D (RC)","OFI","Greek Super League 1","CYP","Yes","6/9/2023","6/30/2025","$80K - $800K","Right Only","Weak","Very Strong","6'3""","169 lbs","141","11",105,120,5,8,10,7,7,9,14,7,7,12,9,4,11,10,10,13,12,12,9,12,4,5,4,6,12,13,8,15,12,12,13,14,11,13,13,13,9,11,12,9,8,12,9,6,9,10,10,8,5,1,2,1,3,3,2,1,2,4,4,2
"9685",33049957,"Fredrik Jensen","9/9/1997 (25 years old)","M (C), AM (RLC)","Augsburg","Bundesliga","FIN","Yes","1/20/2023","6/30/2025","$2.2M - $4.6M","Right","Reasonable","Very Strong","6'0""","176 lbs","123","14",121,128,10,10,12,10,12,10,8,12,15,9,12,10,10,13,8,12,11,12,12,12,13,12,8,14,10,16,12,16,12,12,12,10,11,14,14,12,18,18,15,13,12,13,12,12,4,5,12,12,14,2,1,2,1,3,4,1,3,1,2,1
"9686",91005031,"Alexander Ring","4/9/1991 (32 years old)","D (C), DM, M (C)","Austin FC","Major League Soccer","FIN","Yes","1/3/2022","12/31/2023","$180K - $1.8M","Right","Fairly Strong","Very Strong","5'9""","163 lbs","356","39",123,127,9,11,13,9,12,8,10,11,7,10,13,10,14,12,17,11,14,11,11,11,15,12,15,13,13,15,13,15,14,13,11,7,13,12,14,10,17,14,11,15,11,9,10,13,11,6,12,15,14,2,3,2,4,3,1,3,2,1,1,3
"9687",33064466,"Pyry Hannola","10/21/2001 (21 years old)","DM, M (C)","SJK","Finnish Premier League","FIN","Yes","4/5/2022","11/15/2024","$110K - $1.1M","Left","Very Strong","Weak","6'0""","174 lbs","56","-",93,126,11,9,11,7,14,9,7,11,4,9,13,9,7,15,8,10,10,8,12,11,12,8,4,12,7,12,12,12,13,13,13,8,13,11,13,9,10,16,12,12,12,10,4,7,5,4,11,11,14,1,3,1,2,2,4,2,3,3,1,1
"9688",33054655,"Benjamin Källman","6/17/1998 (24 years old)","AM (R), ST (C)","Cracovia","PKO Bank Polski Ekstraklasa","FIN","Yes","7/2/2022","6/30/2025","$60K - $600K","Right","Reasonable","Very Strong","5'11""","165 lbs","256","69",111,125,7,11,11,13,11,7,11,7,4,5,11,12,9,11,13,11,14,13,12,12,14,10,11,12,7,13,11,14,13,11,14,10,13,12,14,14,12,12,12,12,10,12,7,12,9,12,12,11,12,2,2,3,1,3,2,3,3,2,1,2
"9689",33003224,"Rasmus Schüller","6/18/1991 (31 years old)","DM, M (C)","Djurgårdens IF","Swedish Premier Division","FIN","Yes","1/8/2022","12/31/2025","Not for Sale","Left","Very Strong","Reasonable","5'10""","154 lbs","306","22",121,125,10,9,11,7,12,11,8,8,3,13,13,7,15,10,16,14,18,12,11,13,14,8,12,13,15,14,12,15,10,11,9,9,15,12,15,13,11,17,16,15,14,13,11,11,12,6,14,13,12,1,3,3,1,1,1,1,1,2,3,1
"9690",33080849,"Ville Koski","1/27/2002 (21 years old)","D (C), DM, M (C)","FC Honka","Finnish Premier League","FIN","Yes","12/31/2018","11/15/2023","$400K - $1.2M","Right","Reasonable","Very Strong","6'1""","189 lbs","82","4",98,125,9,9,9,6,10,7,12,7,1,11,11,8,11,10,11,12,13,10,12,10,12,8,9,9,11,13,10,12,12,11,11,12,12,12,12,8,15,10,12,12,10,12,7,14,7,1,15,13,14,1,2,1,4,3,1,1,3,3,3,2
"9691",33058652,"Aapo Halme","5/22/1998 (25 years old)","D (C), DM","HJK","Finnish Premier League","FIN","Yes","7/25/2022","11/15/2024","$100K - $1M","Right","Weak","Very Strong","6'5""","171 lbs","106","7",104,125,5,6,8,8,9,6,14,6,10,12,11,5,13,11,12,12,13,11,12,10,12,4,12,8,12,13,11,13,8,9,12,17,12,10,13,13,12,13,13,13,11,9,16,10,9,4,12,12,12,1,1,1,3,1,2,3,4,3,2,3
"9692",33004450,"Petteri Forsell","10/16/1990 (32 years old)","M (L), AM (LC)","FC Inter","Finnish Premier League","FIN","Yes","2/21/2022","11/15/2023","$35K - $375K","Either","Very Strong","Very Strong","5'7""","174 lbs","338","88",106,125,12,13,12,9,13,14,4,14,4,3,14,12,6,14,10,13,9,12,10,12,12,18,11,11,6,7,13,7,8,10,14,7,6,9,11,12,11,12,6,7,16,18,8,12,8,14,11,10,9,3,3,1,3,1,1,3,2,2,1,2
"9693",33027501,"Daniel O'Shaughnessy","9/14/1994 (28 years old)","D (LC)","Karlsruhe","Bundesliga 2","FIN","Yes","1/1/2022","6/30/2024","$210K - $600K","Left Only","Very Strong","Weak","6'3""","185 lbs","156","11",108,125,3,9,9,7,9,6,13,10,18,13,12,8,12,9,11,12,13,11,12,11,16,7,12,8,13,13,10,13,10,9,13,14,8,12,11,14,12,12,12,12,9,11,14,10,11,7,12,16,11,2,1,1,3,2,3,2,4,3,3,1
"9694",33076565,"Daniel Håkans","10/26/2000 (22 years old)","AM (RL)","Vålerenga","Norwegian Premier Division","FIN","Yes","2/4/2023","12/31/2026","$1M - $2.1M","Right Only","Weak","Very Strong","5'10""","154 lbs","93","5",108,125,4,11,13,8,11,7,6,11,2,3,11,7,3,12,9,10,11,9,9,8,14,16,4,9,7,11,7,15,17,15,11,7,10,16,11,7,15,15,15,15,12,14,10,16,5,2,13,12,12,2,3,1,3,1,2,1,3,3,3,2
"9695",26030142,"Grigoris Kastanos","1/30/1998 (25 years old)","WB (R), M/AM (RC)","Salernitana","Italian Serie A","CYP","Yes","8/2/2022","6/30/2026","$12K - $5.6M","Left","Very Strong","Reasonable","5'10""","156 lbs","153","8",127,135,11,11,13,11,14,13,5,13,7,5,13,10,13,14,13,10,11,10,10,10,16,14,10,13,12,12,14,14,13,14,13,6,15,13,15,10,18,18,17,8,8,14,7,13,9,2,13,16,14,1,3,2,3,3,3,1,3,1,3,2
"9696",5123419,"Jason Demetriou","11/18/1987 (35 years old)","D/WB (R)","Southend","Vanarama National League","CYP","Yes","7/15/2021","6/30/2023","$0","Right","Weak","Very Strong","5'11""","149 lbs","500","38",69,120,7,9,10,7,11,6,5,9,3,9,11,13,10,10,11,12,13,12,11,10,15,10,7,10,11,14,10,14,7,10,11,6,10,7,9,9,14,5,5,5,8,12,14,11,9,12,12,15,12,2,4,2,3,3,1,1,1,3,2,1
"9697",523099,"Joona Toivio","3/10/1988 (35 years old)","D (C)","HJK","Finnish Premier League","FIN","Yes","12/31/2021","11/15/2024","Not for Sale","Right","Reasonable","Very Strong","6'1""","187 lbs","399","32",108,125,10,9,5,8,11,14,14,12,12,14,13,10,13,10,11,12,12,11,10,12,14,5,13,10,14,12,11,12,8,6,13,13,11,9,12,13,6,15,14,16,14,17,4,12,8,5,13,11,14,1,2,2,3,1,1,2,3,3,1,2
"9698",33078324,"Santeri Väänänen","1/1/2002 (21 years old)","DM, M (C)","Rosenborg","Norwegian Third Division Group 5","FIN","Yes","1/1/2023","12/31/2026","$150K - $1.5M","Right","Reasonable","Very Strong","5'10""","158 lbs","65","2",100,125,5,7,8,6,12,6,9,7,6,6,13,9,10,12,12,11,14,10,12,12,12,12,10,14,10,12,12,12,12,12,9,10,10,13,13,10,11,10,12,12,10,12,14,14,9,4,13,14,12,4,3,2,1,1,3,3,3,3,1,1
"9699",33047772,"Thomas Mäkinen","1/30/1997 (26 years old)","D (R), M (C)","IFK Mariehamn","Finnish Premier League","FIN","Yes","6/15/2020","11/30/2024","$35K - $350K","Right","Reasonable","Very Strong","6'1""","165 lbs","76","4",90,123,7,11,9,6,11,8,14,9,4,9,12,7,8,11,8,9,8,11,11,11,16,9,6,9,12,12,12,12,10,12,6,15,13,10,15,6,10,12,16,14,13,12,5,10,5,4,10,14,13,2,1,2,1,3,3,3,2,2,1,3
"9700",33056673,"Rasmus Karjalainen","4/4/1996 (27 years old)","AM (R), ST (C)","AC Oulu","Finnish Premier League","FIN","Yes","6/23/2022","11/15/2023","$90K - $275K","Right","Fairly Strong","Very Strong","6'1""","180 lbs","206","63",97,123,9,8,10,12,9,10,11,10,5,7,10,13,7,11,9,11,12,11,11,11,13,8,14,12,7,13,9,13,10,10,13,12,12,11,12,12,12,14,14,15,13,10,4,12,6,6,13,12,12,1,2,1,1,3,2,2,3,1,1,1
"9701",8504307,"Berat Sadik","9/14/1986 (36 years old)","ST (C)","Doxa Katokopias","Cypriot First Division","FIN","Yes","7/18/2020","5/31/2024","$3K - $30K","Right","Fairly Strong","Very Strong","6'4""","182 lbs","469","166",105,123,6,9,8,13,13,7,13,12,10,6,11,12,7,11,8,13,14,12,12,13,13,15,6,12,8,10,8,13,9,9,10,15,13,10,13,13,6,15,8,13,9,4,8,11,10,14,13,16,11,3,1,3,3,3,4,1,1,1,1,2
"9702",33028111,"Robert Taylor","10/21/1994 (28 years old)","M/AM (RL)","Inter Miami","Major League Soccer","FIN","Yes","2/11/2022","12/31/2023","$190K - $1.9M","Right","Fairly Strong","Very Strong","6'0""","171 lbs","273","55",123,123,12,12,14,11,12,13,5,13,4,8,14,11,8,13,10,12,10,14,12,10,12,13,8,13,10,12,13,14,13,14,12,10,12,13,13,10,15,12,9,13,13,13,5,12,6,4,12,13,13,3,3,2,3,1,2,2,4,1,1,1
"9703",83190945,"Ali Al Musrati","4/6/1996 (27 years old)","DM, M (C)","BRG","Portuguese Premier League","LBY","No","10/11/2022","6/30/2026","$28M - $33M","Right","Fairly Strong","Very Strong","6'4""","180 lbs","143","8",146,148,7,10,11,11,14,7,12,13,8,13,16,9,14,14,13,15,13,17,16,15,14,5,11,8,16,15,16,12,10,11,15,14,14,12,14,16,12,11,13,18,17,14,8,14,10,6,18,12,6,1,2,3,3,1,2,1,2,3,2,1
"9704",84125494,"Hamdou Elhouni","2/12/1994 (29 years old)","M (L), AM (RL)","ES Tunis","Ligue Professionnelle 1","LBY","No","6/15/2020","6/30/2025","$375K - $3.8M","Right","Fairly Strong","Very Strong","5'9""","143 lbs","132","21",123,135,10,12,16,8,14,9,7,12,6,5,13,11,6,15,9,12,4,13,11,10,13,17,7,12,6,11,12,12,13,16,11,8,12,14,12,8,12,12,8,12,9,10,12,14,5,6,11,12,15,3,1,4,2,1,3,3,3,3,2,2
"9705",28027672,"Ahmad Benali","2/7/1992 (31 years old)","M/AM (C)","Bari","Italian Serie B","LBY","No","1/31/2023","6/30/2024","$160K - $1.6M","Right","Reasonable","Very Strong","5'8""","145 lbs","292","44",116,130,12,12,13,11,13,12,9,12,5,8,13,12,11,13,13,12,13,12,13,11,15,13,12,13,10,12,12,12,13,12,13,10,11,13,12,12,14,10,14,14,13,17,13,14,7,9,14,14,18,3,2,1,3,2,1,3,3,1,2,1
"9706",2000103624,"Noureddine Al Gleib","3/22/2001 (22 years old)","M/AM (C)","Al-Ahli Tripoli","Libyan First Division","LBY","No","8/29/2021","6/30/2024","$30K - $325K","Right","Reasonable","Very Strong","5'5""","136 lbs","17","3",110,130,6,9,10,12,15,5,10,15,7,12,15,5,9,14,7,15,7,11,9,13,2,12,8,13,12,14,10,9,14,12,8,4,12,13,8,1,17,16,7,9,8,9,6,17,9,4,15,9,17,3,2,3,1,3,2,2,4,2,3,2
"9707",2000289954,"Michalis Kolias","8/2/2004 (18 years old)","M (L), AM (RL)","AEL","Cypriot First Division","CYP","Yes","6/13/2022","5/31/2025","$130K - $1.3M","Right Only","Weak","Very Strong","6'0""","158 lbs","14","-",85,120,8,13,11,10,14,3,8,12,5,4,13,4,6,15,5,7,3,9,7,9,13,13,12,11,7,9,7,13,12,13,12,11,12,12,8,5,14,18,10,10,13,10,7,7,5,4,10,9,19,1,2,1,1,2,3,2,1,3,2,2
"9708",2000115295,"Daniel Elfadli","4/6/1997 (26 years old)","D (C), DM, M (C)","Magdeburg","Bundesliga 2","LBY","Yes","1/23/2023","6/30/2025","$170K - $1.7M","Right","Reasonable","Very Strong","6'2""","171 lbs","165","12",120,125,2,6,11,8,12,2,13,7,6,12,13,6,15,12,15,14,16,12,12,11,17,8,8,8,14,16,11,16,13,11,12,13,12,13,15,13,14,10,10,12,12,9,8,12,13,6,16,16,12,3,1,2,2,2,1,3,3,3,1,2
"9709",2000103628,"Asiyil Almiqasbi","8/2/2000 (22 years old)","GK","Al-Nassr Benghazi","Libyan First Division","LBY","No","6/15/2020","6/30/2024","$0 - $120K","Right","Reasonable","Very Strong","6'2""","174 lbs","-","-",70,125,3,1,3,2,1,4,1,3,3,3,13,1,2,4,8,5,9,8,9,14,16,1,12,1,12,8,7,7,10,6,3,11,9,12,5,7,12,17,10,9,8,12,13,16,11,3,10,11,8,6,13,14,8,6,11,12,5,8,13,6
"9710",2000156467,"Abdulmuyasser Bousheiba","2/2/2004 (19 years old)","ST (C)","Elettihad Almisraty","Libyan First Division","LBY","No","7/1/2019","6/30/2024","$4K - $40K","Right","Fairly Strong","Very Strong","6'4""","165 lbs","-","-",66,125,4,2,12,12,11,4,12,5,1,3,5,2,1,6,5,10,6,7,5,9,15,14,5,12,5,4,1,6,12,11,5,11,14,12,11,4,8,16,7,9,13,14,10,12,9,2,7,11,17,2,1,3,1,1,2,3,2,3,2,2
"9711",12036688,"Abdulaziz Belraysh","7/12/1990 (32 years old)","D (RC), WB (R)","Al-Shat","Libyan First Division","LBY","No","10/14/2021","6/30/2024","$26K - $250K","Right Only","Weak","Very Strong","5'10""","169 lbs","-","-",85,124,5,11,8,4,10,2,10,7,7,13,10,1,15,9,7,9,10,5,9,12,11,5,8,7,12,9,9,9,10,8,9,7,5,9,12,10,11,20,8,12,10,10,10,15,7,1,5,10,14,3,2,3,2,2,2,1,2,1,2,2
"9712",2000034711,"Anas Chebli","8/31/2002 (20 years old)","AM (LC)","CS Sfax","Ligue Professionnelle 1","LBY","No","1/27/2021","6/30/2025","$0","Right","Weak","Very Strong","5'10""","143 lbs","5","-",84,123,5,10,12,8,13,8,5,13,4,5,12,8,4,13,6,11,7,10,9,8,14,13,6,9,6,9,13,10,13,13,9,7,12,11,8,5,13,19,10,12,11,10,13,8,10,7,12,14,15,2,3,2,2,3,2,2,3,3,2,1
"9713",12011239,"Mohammad Zaabia","3/20/1989 (34 years old)","ST (C)","Al-Ittihad Tripoli","Libyan First Division","LBY","No","6/14/2021","6/30/2024","$2K - $18K","Right","Reasonable","Very Strong","6'2""","165 lbs","110","38",90,123,11,12,13,10,12,9,12,6,7,6,10,7,6,14,14,11,9,8,8,7,12,12,8,11,8,8,11,8,12,7,10,12,9,12,10,9,11,4,4,3,7,13,8,12,14,13,7,13,9,3,3,3,1,1,2,1,2,2,1,3
"9714",12064804,"Faisal Al Badri","6/4/1990 (33 years old)","M/AM (C)","Al-Hilal Benghazi","Libyan First Division","LBY","No","7/1/2020","6/30/2024","$0 - $40K","Right","Weak","Very Strong","5'8""","149 lbs","-","-",90,122,6,5,8,10,14,8,8,10,4,10,12,7,4,14,13,7,5,10,9,14,11,11,13,11,10,13,13,10,12,12,9,2,12,12,6,9,13,19,8,11,10,12,8,5,7,6,13,11,19,3,1,4,3,3,2,2,3,2,3,2
"9715",12063485,"Marwan Al Suwaee","12/15/1989 (33 years old)","DM, M (C)","Elettihad Almisraty","Libyan First Division","LBY","No","1/23/2021","6/30/2024","$40K - $120K","Right Only","Weak","Very Strong","6'0""","169 lbs","-","-",70,122,7,7,5,8,7,7,7,12,1,12,14,5,14,9,13,7,8,9,9,14,9,5,8,8,8,8,14,12,12,10,8,10,11,9,7,7,12,20,8,11,14,11,7,5,9,4,9,11,8,2,2,1,2,2,2,2,1,3,2,2
"9716",2000103374,"Abdulati Al Abbasi","10/23/1994 (28 years old)","M (C), AM (RLC)","Al-Ittihad Tripoli","Libyan First Division","LBY","No","7/1/2020","6/30/2024","$85K - $850K","Right","Fairly Strong","Very Strong","5'5""","143 lbs","11","1",110,120,6,10,13,11,14,8,9,11,9,9,14,9,9,10,13,12,7,13,10,12,4,11,9,14,9,10,14,11,14,12,10,2,14,13,14,5,14,11,6,9,13,10,6,10,8,6,14,10,12,1,2,2,2,3,2,3,1,3,3,1
"9717",2000103369,"Omar Al Khoja","3/1/2000 (23 years old)","M (C), AM (RC)","Al-Ittihad Tripoli","Libyan First Division","LBY","No","7/1/2018","6/30/2025","$50K - $150K","Right","Strong","Very Strong","5'11""","154 lbs","16","3",110,120,8,11,12,11,14,9,6,12,3,10,12,6,11,14,9,10,10,9,7,13,17,15,14,14,10,10,11,13,12,11,14,7,13,11,11,5,11,10,10,11,13,13,5,4,5,6,10,12,10,3,1,4,2,1,3,3,2,2,3,3
"9718",23226014,"Christos Sielis","2/2/2000 (23 years old)","D (RC)","Volos","Greek Super League 1","CYP","Yes","1/8/2022","6/30/2024","$160K - $1.6M","Right","Reasonable","Very Strong","6'0""","165 lbs","75","-",105,120,3,7,8,6,11,8,12,4,4,13,10,5,11,7,15,12,12,13,12,12,15,4,7,6,12,12,7,13,12,12,10,13,12,12,14,13,8,12,10,13,12,10,3,13,8,5,12,12,13,1,1,4,1,1,1,2,3,2,2,2
"9719",13232344,"Mouad Issa","5/8/1999 (24 years old)","AM (RL), ST (C)","Al-Ittihad Tripoli","Libyan First Division","LBY","No","6/15/2020","6/30/2024","$12K - $120K","Left","Very Strong","Strong","6'2""","165 lbs","15","2",110,120,9,11,11,14,14,9,13,10,9,5,11,6,5,14,11,10,4,13,8,14,15,13,12,14,5,10,2,11,13,10,10,14,18,11,6,5,11,18,5,8,12,10,12,14,13,6,6,12,13,1,2,2,2,1,2,3,2,2,1,3
"9720",2000083421,"Salah Fakroun","2/8/1999 (24 years old)","D (C)","Al-Nassr Benghazi","Libyan First Division","LBY","No","6/15/2020","6/30/2024","$35K - $110K","Right","Fairly Strong","Very Strong","6'1""","167 lbs","-","-",95,120,4,7,5,3,8,6,13,5,1,13,6,2,13,6,14,9,10,8,7,13,11,6,4,7,10,7,4,8,13,12,8,13,17,13,11,8,12,14,9,11,10,11,6,8,8,1,12,12,11,3,3,2,2,1,2,3,3,1,2,2
"9721",2000103151,"Ali Youssef","9/7/2001 (21 years old)","D (C)","Al-Ahly Benghazi","Libyan First Division","LBY","No","7/1/2020","6/30/2024","$5K - $50K","Right","Fairly Strong","Very Strong","6'2""","180 lbs","-","-",85,120,3,1,2,1,8,6,14,1,2,13,6,2,13,4,7,10,9,7,8,14,3,5,2,5,14,7,6,8,12,13,8,8,12,9,8,10,12,10,3,13,11,10,6,13,5,7,10,12,9,1,2,4,2,3,2,2,1,2,3,2
"9722",2000124231,"Osama Baleid","11/28/1998 (24 years old)","M/AM (L)","Al-Hilal Benghazi","Libyan First Division","LBY","No","7/1/2019","6/30/2024","$3.5K - $35K","Right","Reasonable","Very Strong","5'9""","134 lbs","-","-",95,120,9,13,12,10,13,8,8,6,7,7,10,2,7,14,7,10,9,8,6,10,19,13,12,14,8,6,9,11,14,14,10,4,14,14,10,4,15,15,6,12,10,12,12,15,12,1,10,10,15,3,3,2,3,2,2,2,2,2,2,3
"9723",13178141,"Sanad Al Werfalli","5/17/1992 (31 years old)","D (C)","Al-Ittihad Tripoli","Libyan First Division","LBY","No","9/9/2021","6/30/2024","$0","Left","Very Strong","Reasonable","6'0""","171 lbs","45","1",115,120,7,5,11,5,12,2,11,7,11,12,13,8,12,10,9,12,12,12,15,12,7,5,15,11,14,11,9,12,14,13,12,10,5,13,16,10,10,20,3,10,10,10,8,1,15,3,15,9,16,3,3,3,3,1,4,3,2,3,2,3
"9724",64046255,"Mohammed Soulah","7/29/1993 (29 years old)","M/AM (RL)","Qadsia","Kuwaiti Premier League","LBY","No","6/12/2023","6/30/2024","$130K - $1.3M","Left","Very Strong","Reasonable","6'0""","169 lbs","62","28",115,120,10,10,15,9,13,9,7,10,8,6,12,7,5,14,12,14,9,13,11,9,11,16,8,12,7,10,10,13,14,15,12,8,11,13,11,9,14,11,9,10,11,9,7,13,7,5,10,9,10,2,1,2,2,3,3,3,3,3,3,4
"9725",13167437,"Muaid Al-Laafi","3/7/1996 (27 years old)","AM (RLC)","Wydad Casablanca","Botola Pro 1","LBY","No","10/25/2020","6/30/2023","$20K - $65K","Right","Reasonable","Very Strong","5'7""","143 lbs","93","17",107,119,12,12,12,15,13,13,6,11,5,6,10,10,6,15,9,15,6,13,6,9,8,13,10,14,9,11,7,14,13,14,11,5,14,13,9,4,17,10,13,10,10,12,5,16,8,7,12,10,18,3,3,3,3,1,3,1,3,1,1,1
"9726",13183906,"Anis Saltou","4/1/1992 (31 years old)","ST (C)","Al-Ahli Tripoli","Libyan First Division","LBY","No","1/18/2022","6/30/2023","$0 - $9K","Right","Reasonable","Very Strong","6'4""","194 lbs","34","3",110,118,6,8,11,12,12,6,14,8,5,5,10,11,3,11,13,15,11,11,11,11,13,11,8,12,10,13,10,8,12,12,13,16,13,12,12,13,10,17,10,12,10,13,12,11,6,7,14,12,12,2,3,2,1,3,1,3,4,1,1,3
"9727",2000290359,"Sobhi Dawwi","6/8/2004 (19 years old)","D (L)","Al-Ittihad Tripoli","Libyan First Division","LBY","No","1/1/2023","6/30/2024","$4.5K - $45K","Left","Very Strong","Reasonable","6'5""","185 lbs","-","-",75,117,7,10,8,1,8,3,9,5,8,7,7,5,10,9,8,10,10,6,10,15,15,5,6,6,7,14,9,14,10,9,12,17,13,9,12,7,10,19,10,10,10,10,8,7,9,5,11,10,19,1,2,1,2,3,4,1,1,2,2,1
"9728",13202629,"Mohammed Al Tarhouni","7/10/1991 (31 years old)","D/WB/AM (L)","Al-Ahly Benghazi","Libyan First Division","LBY","No","9/28/2022","6/30/2024","$24K - $70K","Left","Very Strong","Fairly Strong","5'11""","160 lbs","29","1",100,117,6,10,9,10,10,8,8,6,8,10,13,6,13,14,6,12,9,10,6,14,4,13,11,12,9,13,7,12,14,13,11,10,8,10,7,4,15,16,9,10,14,10,6,9,5,2,14,12,19,2,2,2,3,4,4,3,1,2,1,3
"9729",28106880,"Jack Roles","2/26/1999 (24 years old)","M/AM (C)","Crawley","Sky Bet League Two","CYP","Yes","1/31/2023","6/30/2024","$22K - $220K","Right","Reasonable","Very Strong","5'9""","145 lbs","57","7",82,120,9,8,11,10,10,9,8,11,4,8,11,9,8,12,8,10,9,12,9,10,11,12,7,11,9,12,10,11,11,11,9,6,14,10,11,10,9,19,11,14,12,12,11,5,6,6,11,6,15,3,4,3,1,3,3,3,1,3,4,4
"9730",13202623,"Mohammed Nashnosh","6/14/1988 (34 years old)","GK","Al-Ahli Tripoli","Libyan First Division","LBY","No","6/14/2021","6/30/2024","$6K - $60K","Right","Reasonable","Very Strong","5'10""","163 lbs","16","-",102,117,3,1,1,1,2,8,1,2,2,1,12,2,3,7,12,10,14,8,13,12,12,1,11,1,12,6,3,8,10,11,9,9,6,11,8,7,11,19,9,10,11,10,14,8,5,2,19,14,10,9,6,11,10,7,12,14,5,10,14,11
"9731",13167438,"Ahmed El Trbi","6/6/1992 (31 years old)","D (RC)","Al-Ahli Tripoli","Libyan First Division","LBY","No","10/13/2021","6/30/2024","$0 - $100K","Right Only","Weak","Very Strong","5'11""","163 lbs","19","2",100,116,7,14,6,8,12,4,14,10,6,12,11,7,13,7,13,10,11,11,12,11,10,5,10,6,16,10,6,11,8,11,9,13,14,10,8,10,14,20,3,12,10,9,8,12,5,3,15,10,9,2,4,3,4,4,3,1,2,3,2,1
"9732",12036738,"Ali Salama","9/18/1987 (35 years old)","D (C)","Al-Nassr Benghazi","Libyan First Division","LBY","No","1/2/2021","6/30/2024","$0 - $10K","Left Only","Very Strong","Weak","5'9""","160 lbs","15","-",85,115,3,3,5,1,8,1,14,6,1,13,8,7,14,3,15,14,9,8,10,12,7,5,8,5,14,7,5,8,6,10,8,6,9,9,8,10,13,13,4,9,11,11,11,11,7,6,10,11,8,2,3,3,2,3,2,3,2,2,2,1
"9733",62096268,"Mohammed Al Munir","4/8/1992 (31 years old)","D/WB/M/AM (L)","Al-Ahli Tripoli","Libyan First Division","LBY","No","8/27/2021","7/31/2023","$0 - $28K","Left","Very Strong","Weak","5'9""","154 lbs","129","4",104,115,6,11,10,6,11,4,7,6,4,11,11,5,12,10,12,12,10,10,10,12,13,9,9,11,12,11,11,11,13,12,10,9,10,13,12,12,7,10,10,9,11,10,7,9,10,10,12,12,13,2,2,2,1,3,1,2,2,1,2,2
"9734",13202639,"Muftah Taktak","5/5/1996 (27 years old)","M (L), AM (LC)","Al-Nassr Benghazi","Libyan First Division","LBY","No","5/9/2021","7/31/2023","$0","Right","Reasonable","Very Strong","6'1""","167 lbs","41","4",103,114,8,12,13,8,13,7,6,8,7,7,9,5,7,13,14,9,9,13,3,13,13,13,4,13,7,8,7,12,13,13,12,8,8,13,10,5,10,12,12,11,9,11,6,8,7,8,13,10,10,4,1,1,3,2,1,1,1,3,2,2
"9735",12036705,"Osama Eshtiba","9/27/1988 (34 years old)","D (C)","Al-Olympic","Libyan First Division","LBY","No","1/27/2022","6/30/2024","$6K - $16K","Right","Strong","Very Strong","5'10""","165 lbs","16","-",95,114,5,7,1,7,10,2,15,4,7,15,9,4,15,6,8,11,10,10,13,10,15,5,10,8,14,9,5,10,11,11,10,6,12,10,11,10,15,10,3,12,10,11,6,10,14,5,12,10,11,1,3,1,3,4,1,1,4,2,1,3
"9736",12063508,"Ahmed Al-Saghir","12/18/1987 (35 years old)","D/WB (R)","Shabaab Al-Jabal","Libyan Second Division","LBY","No","10/22/2021","6/30/2024","$0 - $8K","Right Only","Weak","Very Strong","5'10""","163 lbs","-","-",89,114,8,15,6,6,12,6,11,10,10,12,12,7,11,12,13,12,10,10,12,10,6,5,15,10,13,11,10,11,13,8,11,9,14,11,13,13,17,12,2,10,11,10,10,15,5,2,12,11,8,3,1,1,2,1,3,1,2,3,3,3
"9737",2000289817,"Abdoulmalik Alandoulsi","8/12/2003 (19 years old)","M/AM (L)","Al-Ahli Tripoli","Libyan First Division","LBY","No","7/1/2022","6/30/2024","$45K - $130K","Left","Very Strong","Reasonable","6'4""","180 lbs","8","-",80,112,8,12,13,10,10,7,5,8,7,5,9,4,6,14,5,7,8,7,9,8,18,13,1,6,7,8,8,9,14,11,8,14,12,12,8,6,10,20,6,14,10,10,14,15,12,1,17,10,19,3,3,2,3,1,2,4,1,3,1,2
"9738",2000290347,"Fadel Salama","2/21/2002 (21 years old)","D/WB (R), DM, M (RC), AM (R)","Al-Ahly Benghazi","Libyan First Division","LBY","No","1/1/2020","6/30/2024","$4.5K - $45K","Right Only","Weak","Very Strong","5'10""","145 lbs","-","-",90,112,8,12,9,9,12,7,7,5,6,8,13,7,9,8,15,9,9,9,4,9,6,9,8,12,9,8,5,12,13,12,13,8,7,13,7,5,18,10,11,12,11,11,8,5,6,8,11,13,17,3,2,2,3,3,2,2,3,3,1,1
"9739",23384159,"Abdelsalam El-Fitouri","7/22/1993 (29 years old)","ST (C)","Asswehly","Libyan First Division","LBY","No","1/19/2023","6/30/2024","$0","Right","Fairly Strong","Very Strong","5'11""","169 lbs","-","-",86,112,5,3,12,12,12,5,12,6,2,4,6,4,1,9,9,9,7,11,6,11,10,10,1,12,5,5,4,7,12,12,6,6,14,12,12,12,11,14,3,12,12,10,6,3,8,7,8,12,9,1,1,1,1,2,3,2,1,3,1,2
"9740",2000039666,"Paris Polykarpou","9/23/2000 (22 years old)","DM, M (C)","APOEL","Cypriot First Division","CYP","Yes","5/30/2022","5/31/2024","$90K - $900K","Left Only","Very Strong","Weak","6'0""","176 lbs","57","-",95,118,10,10,7,7,11,10,11,10,3,11,10,7,10,10,15,10,10,10,9,16,6,5,15,5,11,12,10,15,8,7,11,12,10,9,12,12,14,16,11,11,11,13,5,9,9,5,17,13,7,2,1,2,1,4,3,2,2,2,3,2
"9741",2000103185,"Aymen Al Tihar","4/27/2002 (21 years old)","GK","Al-Ahli Tripoli","Libyan First Division","LBY","No","7/1/2020","6/30/2024","$40K - $130K","Right","Reasonable","Very Strong","6'4""","185 lbs","-","-",80,111,3,2,1,1,2,7,1,2,1,3,8,2,1,3,9,11,13,3,6,13,5,3,9,2,10,7,6,6,10,16,7,15,9,6,4,6,11,19,6,9,12,12,12,5,9,3,11,12,15,10,12,13,10,9,13,8,5,6,9,10
"9742",2000125147,"Taha Al-Shalui","2/21/1997 (26 years old)","M/AM (RL)","Al-Sadaqa","Libyan First Division","LBY","No","11/14/2021","6/30/2025","$0","Right","Fairly Strong","Very Strong","5'8""","143 lbs","-","-",100,110,8,9,9,11,13,8,8,13,6,6,11,5,5,8,8,9,5,7,9,10,7,10,7,10,6,9,6,8,14,14,14,7,12,14,13,4,15,10,4,11,11,11,8,13,7,2,10,12,18,2,3,1,2,2,2,3,2,1,2,2
"9743",2000101475,"Mohamed Journi","5/7/2000 (23 years old)","M (LC), AM (C)","CS Sfax","Ligue Professionnelle 1","LBY","No","9/1/2020","6/30/2026","$1K - $10K","Right Only","Weak","Very Strong","5'9""","152 lbs","30","-",87,110,11,11,13,7,14,10,7,11,6,6,12,7,8,14,10,13,8,12,9,10,18,14,14,11,7,10,13,10,11,11,12,8,12,11,9,6,11,13,10,12,14,11,6,6,5,1,10,9,13,2,3,1,3,3,2,3,3,3,1,2
"9744",13232390,"Haitham Dana","4/13/1991 (32 years old)","D (C)","Abu Salim","Libyan First Division","LBY","No","8/15/2021","6/30/2024","$0 - $55K","Right","Reasonable","Very Strong","6'1""","178 lbs","7","-",90,110,7,3,1,5,9,5,14,2,5,13,9,2,14,5,15,13,10,9,8,14,10,5,14,6,13,8,7,9,8,9,9,12,12,9,6,11,13,18,7,12,12,12,7,14,12,5,10,10,16,1,1,3,2,3,3,3,3,3,3,1
"9745",13232347,"Saad Ejbara","7/18/1996 (26 years old)","D (C)","Al-Ahly Benghazi","Libyan First Division","LBY","No","10/25/2019","6/30/2024","$2.5K - $26K","Left Only","Very Strong","Weak","6'4""","185 lbs","3","-",90,110,4,1,3,4,8,2,13,7,6,13,8,1,13,5,6,9,10,8,10,10,16,5,12,7,13,7,2,8,13,12,8,11,12,13,12,9,14,14,6,10,12,9,12,12,10,5,12,10,9,3,3,1,1,2,2,1,2,3,3,2
"9746",2000171531,"Ezzeddine Al-Mariami","8/22/1998 (24 years old)","AM (RC), ST (C)","Abu Salim","Libyan First Division","LBY","No","7/1/2021","6/30/2024","$0","Right","Fairly Strong","Very Strong","5'11""","154 lbs","-","-",90,110,7,10,10,13,14,5,10,6,6,8,10,9,9,10,13,11,7,10,7,8,15,11,14,14,9,9,7,10,12,9,10,9,13,11,8,5,14,11,4,10,10,10,6,14,5,2,12,11,11,2,1,1,3,3,3,3,1,1,1,3
"9747",13167434,"Mohammed Al Tubal","6/23/1993 (29 years old)","M/AM (R)","Al-Ahli Tripoli","Libyan First Division","LBY","No","8/1/2022","6/30/2024","$0","Right","Fairly Strong","Very Strong","5'10""","154 lbs","29","8",92,110,7,12,12,13,13,7,3,8,7,7,12,4,8,10,15,11,7,6,5,13,4,10,10,11,4,8,7,10,13,13,8,3,13,13,13,6,11,18,5,12,12,11,7,7,5,7,9,13,17,1,3,2,3,1,2,3,3,2,2,1
"9748",13202627,"Bader Hasan","10/1/1987 (35 years old)","D (C), DM, M (C)","Al-Ahly Benghazi","Libyan First Division","LBY","No","9/27/2022","6/30/2024","$0","Right","Fairly Strong","Very Strong","6'2""","182 lbs","14","-",90,110,6,8,6,7,12,4,9,9,2,12,10,5,12,10,13,14,9,10,8,14,16,5,4,9,14,9,9,13,10,10,4,9,9,8,10,10,14,13,1,12,12,11,12,11,7,1,14,12,14,3,1,1,3,2,3,3,2,2,3,3
"9749",13202632,"Abdulmuen Khumaj","10/4/1988 (34 years old)","D (C)","Abe Al-Ashhar","Libyan Second Division Group 5","LBY","No","2/14/2022","6/30/2024","$0 - $5K","Right","Fairly Strong","Very Strong","6'0""","169 lbs","-","-",90,110,4,2,2,2,9,1,14,6,7,14,8,4,13,8,15,7,10,8,7,14,18,5,9,7,14,8,6,9,8,11,9,7,12,9,9,7,12,16,6,11,12,11,9,6,9,2,18,13,18,2,2,3,1,1,3,1,1,1,1,1
"9750",13161822,"Moataz Al Mahdi","8/9/1990 (32 years old)","AM (C), ST (C)","Al-Ahly Benghazi","Libyan First Division","LBY","No","8/22/2022","6/30/2024","$0","Right","Reasonable","Very Strong","5'9""","158 lbs","-","-",90,110,8,5,13,14,11,8,13,10,5,8,11,8,7,8,6,10,9,10,8,11,11,8,11,14,9,8,7,10,13,11,6,6,6,11,13,7,11,10,9,11,12,10,5,12,15,6,18,11,13,1,3,1,1,2,3,1,1,1,2,2
"9751",19144095,"Anderson Correia","5/6/1991 (32 years old)","D/WB/M (L)","Anorthosi","Cypriot First Division","CYP","Yes","12/30/2022","5/31/2026","Not for Sale","Left","Very Strong","Reasonable","5'10""","160 lbs","246","6",110,118,11,13,12,8,11,10,8,8,12,12,11,11,13,12,13,12,12,12,11,12,14,14,5,7,12,12,9,12,13,12,10,7,12,14,13,10,12,10,7,11,9,12,14,11,10,7,12,10,12,2,3,2,1,2,2,2,2,1,2,2
"9752",2000103166,"Muayid Jaddour","2/14/2001 (22 years old)","D/WB/M (R)","Al-Ahli Tripoli","Libyan First Division","LBY","No","7/1/2020","6/30/2024","$12K - $120K","Right","Fairly Strong","Very Strong","6'0""","165 lbs","18","1",90,110,9,11,10,4,11,7,8,9,9,11,10,7,10,9,9,11,10,11,12,15,10,5,11,10,11,14,8,12,13,11,9,8,11,11,8,6,15,16,8,13,12,13,7,13,13,2,14,12,10,3,3,3,1,1,3,2,3,3,1,1
"9753",13161820,"Mohammed Al Shebli","6/22/1990 (32 years old)","DM","Al-Olympic","Libyan First Division","LBY","No","9/1/2022","6/30/2024","$0 - $35K","Left","Very Strong","Weak","6'2""","176 lbs","6","-",90,110,9,9,5,10,13,9,9,12,9,13,12,7,15,11,6,10,9,10,10,15,11,5,7,8,12,9,9,13,9,7,10,9,10,8,8,9,18,16,11,10,10,10,5,6,9,2,13,11,9,3,3,3,2,2,2,1,2,2,3,2
"9754",2000248331,"Abdulsalam Diga","1/1/2000 (23 years old)","AM (RC)","Al-Hilal Benghazi","Libyan First Division","LBY","No","1/23/2023","6/30/2024","$2K - $22K","Right","Weak","Very Strong","6'0""","163 lbs","-","-",71,110,4,9,13,7,13,7,7,8,3,6,10,3,8,13,12,11,6,10,7,10,2,14,13,14,8,8,9,9,13,10,8,7,10,11,6,5,12,20,4,10,11,10,6,7,8,2,18,11,20,1,2,1,3,2,1,1,1,1,2,2
"9755",13232380,"Mourad Al Wuhayshi","2/28/1997 (26 years old)","GK","Al-Ahly Benghazi","Libyan First Division","LBY","No","7/1/2020","6/30/2024","$0 - $45K","Right","Fairly Strong","Very Strong","6'2""","174 lbs","-","-",92,110,5,3,2,2,4,7,1,2,2,2,11,2,1,1,12,10,14,7,10,13,10,3,5,3,10,8,7,7,9,7,8,10,12,10,4,6,13,19,6,12,12,11,5,12,6,2,11,11,18,10,12,13,6,6,13,12,5,9,13,13
"9756",2000170915,"Mohammed Al-Shaawani","10/19/2000 (22 years old)","GK","Al-Nassr Benghazi","Libyan First Division","LBY","No","10/3/2021","7/31/2026","$3.5K - $35K","Right","Reasonable","Very Strong","6'3""","174 lbs","-","-",75,110,5,3,2,3,2,6,1,1,2,2,12,3,3,4,6,5,14,6,8,12,14,2,13,1,6,6,5,5,10,12,6,14,10,11,3,4,10,15,11,12,14,10,14,13,6,7,8,12,16,7,10,12,12,6,10,12,5,6,9,11
"9757",13232393,"Ibrahim Boudabbous","8/3/1996 (26 years old)","ST (C)","Al-Ahly Benghazi","Libyan First Division","LBY","No","8/18/2022","6/30/2024","$40K - $120K","Right","Reasonable","Very Strong","5'11""","163 lbs","12","-",98,110,7,4,13,13,14,8,12,9,6,7,9,10,6,10,11,14,2,14,9,13,8,9,9,10,8,8,6,9,13,14,9,6,12,14,9,8,10,14,6,11,10,11,6,11,14,6,10,9,15,2,2,2,3,1,1,1,1,4,1,3
"9758",29158694,"Shandon Baptiste","4/8/1998 (25 years old)","DM, M/AM (C)","Brentford","English Premier Division","GRN","No","1/31/2020","6/30/2024","$10.5M - $16M","Right","Reasonable","Very Strong","5'9""","160 lbs","105","2",130,148,8,10,13,11,14,9,11,11,5,10,13,11,12,13,12,13,13,14,12,13,15,12,12,14,12,13,14,13,13,13,14,9,14,13,14,12,13,12,12,15,14,10,12,12,9,6,14,14,13,2,1,1,3,2,3,2,3,3,1,2
"9759",5006313,"Cameron Jerome","8/14/1986 (36 years old)","ST (C)","Bolton","Sky Bet League One","GRN","No","1/27/2023","6/30/2024","$14K - $45K","Right","Reasonable","Very Strong","6'1""","187 lbs","625","137",105,135,5,8,12,12,11,5,14,11,7,7,12,11,7,11,13,12,15,12,12,12,16,10,7,14,11,14,12,14,9,12,15,13,15,9,8,14,8,12,12,12,9,8,6,12,12,9,13,17,8,3,2,3,1,1,3,3,2,2,3,3
"9760",29054709,"Ollie Norburn","10/26/1992 (30 years old)","DM, M (C)","Peterborough","Sky Bet League One","GRN","No","8/10/2021","6/30/2025","$450K - $1.3M","Right","Reasonable","Very Strong","6'1""","178 lbs","309","31",114,125,11,11,11,10,12,12,11,10,6,12,13,13,13,12,18,12,14,13,12,11,18,8,17,12,13,14,11,14,11,10,11,11,14,10,14,12,9,10,10,12,11,10,12,12,12,15,12,13,10,1,3,4,2,1,3,4,2,2,3,3
"9761",28043216,"Aaron Pierre","2/17/1993 (30 years old)","D (C)","AFC Wimbledon","Sky Bet League Two","GRN","No","1/31/2023","6/30/2024","$0 - $110K","Left","Very Strong","Weak","6'1""","196 lbs","284","23",87,120,5,4,9,7,10,4,12,8,5,11,10,5,12,11,13,11,14,11,12,10,12,10,15,9,11,11,7,11,9,9,12,12,6,9,10,12,8,11,13,14,14,12,14,14,11,6,10,12,11,2,2,1,1,2,2,2,1,1,3,2
"9762",2000141778,"Panagiotis Karagiorgis","1/7/2005 (18 years old)","D (C)","SPAL","Italian Serie C/B","CYP","Yes","9/25/2021","6/30/2024","$0","Left","Very Strong","Reasonable","6'1""","169 lbs","-","-",60,118,1,1,1,1,5,1,8,3,1,12,5,1,12,3,12,10,7,5,5,12,12,5,1,2,10,4,3,5,12,12,5,12,9,12,3,8,9,13,13,8,14,9,9,12,10,1,8,10,7,1,1,2,1,1,3,3,2,1,1,2
"9763",29060068,"Omar Beckles","10/25/1991 (31 years old)","D (C)","Leyton Orient","Sky Bet League One","GRN","No","7/1/2021","6/30/2024","$20K - $210K","Right Only","Weak","Very Strong","6'3""","171 lbs","446","25",96,120,3,7,8,6,11,4,12,4,9,11,11,5,12,11,9,11,10,14,10,9,16,12,15,8,13,12,10,11,12,12,12,13,15,11,12,14,13,18,17,18,9,17,5,13,7,4,12,13,7,1,3,4,3,4,2,1,1,1,2,3
"9764",28100544,"Reiss Greenidge","8/10/1996 (26 years old)","D (C)","Maidstone","Vanarama National League South","GRN","No","5/9/2023","6/30/2024","$0 - $26K","Left","Very Strong","Reasonable","6'6""","231 lbs","90","5",69,115,4,6,5,5,7,5,13,5,4,7,8,4,10,7,12,10,14,10,7,8,7,8,10,7,9,9,8,12,8,4,8,18,10,8,12,14,7,17,10,13,11,10,13,9,8,6,8,12,11,1,1,3,2,3,3,3,3,3,2,1
"9765",29174556,"Jacob Bedeau","12/24/1999 (23 years old)","D (LC)","Morecambe","Sky Bet League Two","GRN","No","8/9/2022","6/30/2024","$70K - $700K","Left","Very Strong","Weak","6'0""","176 lbs","113","2",97,113,2,3,7,5,10,3,12,3,7,11,11,6,13,10,15,11,11,12,11,9,16,4,9,10,10,13,8,12,14,13,12,14,13,13,11,13,11,8,13,14,11,12,9,11,9,7,9,11,14,3,2,3,3,4,1,3,1,1,2,3
"9766",29120248,"Regan Charles-Cook","2/14/1997 (26 years old)","AM (RL)","Eupen","Jupiler Pro League","GRN","No","7/1/2022","6/30/2025","$220K - $2.2M","Right","Reasonable","Very Strong","5'9""","152 lbs","176","33",110,111,11,10,12,14,13,8,9,7,6,8,13,7,9,13,9,11,10,12,10,10,13,11,8,11,9,12,12,13,12,13,9,8,15,13,14,12,12,10,11,12,11,9,11,9,7,5,9,11,9,1,2,4,1,2,2,2,2,2,1,1
"9767",2000130364,"Benjamin Ettienne","3/13/2003 (20 years old)","D/WB (R)","Charleston","USSL Championship Eastern Conference","GRN","No","2/4/2022","11/30/2023","$55K - $550K","Right Only","Weak","Very Strong","6'0""","176 lbs","5","-",78,107,5,9,1,2,7,1,7,1,6,9,9,1,13,8,12,6,9,7,10,12,10,5,1,7,7,12,7,13,13,12,12,11,14,12,9,12,11,13,12,12,12,9,11,1,5,4,10,10,12,2,2,4,3,2,2,1,3,3,1,3
"9768",29091120,"Myles Hippolyte","11/9/1994 (28 years old)","WB (L), M (LC)","Stockport","Sky Bet League Two","GRN","No","6/7/2022","6/30/2024","$12K - $120K","Left","Very Strong","Weak","6'0""","182 lbs","298","38",94,107,9,10,12,10,10,8,9,10,12,8,10,10,10,11,9,11,10,10,9,10,13,12,6,11,9,11,9,13,12,11,11,11,13,13,12,12,16,8,7,15,12,5,8,11,9,12,10,15,14,2,3,3,1,1,1,3,1,3,2,3
"9769",28018779,"Antonio German","12/26/1991 (31 years old)","AM (R), ST (C)","Leatherhead","English Isthmian League South Central Division","GRN","No","1/14/2022","-","$0","Right Only","Weak","Very Strong","6'1""","171 lbs","138","20",53,105,7,8,8,8,6,5,9,6,4,4,8,9,5,7,9,9,9,9,8,7,16,10,6,10,4,7,7,11,11,8,12,10,5,11,6,10,10,9,10,9,14,7,7,8,9,8,11,12,11,2,1,1,3,1,1,1,3,3,4,2
"9770",72051138,"A.J. Paterson","1/31/1996 (27 years old)","D (LC), WB (L), DM","Charleston","USSL Championship Eastern Conference","GRN","No","11/21/2022","11/30/2024","$130K - $1.3M","Left","Very Strong","Weak","6'2""","182 lbs","93","7",98,103,9,10,9,6,10,10,11,7,10,11,10,6,12,10,9,11,13,12,9,10,10,7,11,10,11,10,9,10,11,10,10,12,10,11,14,13,13,10,11,11,11,12,11,1,15,6,12,11,12,1,2,2,3,3,4,3,1,1,2,1
"9771",28095475,"Jacob Berkeley-Agyepong","3/29/1997 (26 years old)","WB (L), M (LC), AM (RL)","Gloucester","Vanarama National League North","GRN","No","5/31/2022","6/30/2024","$3.5K - $35K","Left Only","Very Strong","Weak","6'0""","152 lbs","128","14",74,103,8,9,12,7,8,9,4,6,3,6,8,1,4,9,2,6,5,7,5,5,12,12,8,11,6,11,6,9,13,12,11,9,13,11,11,7,11,14,13,12,11,11,13,5,6,4,7,11,14,2,1,2,2,3,1,3,1,1,1,2
"9772",29047107,"Kithson Bain","5/26/1982 (41 years old)","ST (C)","Alpha Utd","Guyanese Regional Member Associations","GRN","No","6/14/2021","6/30/2024","$0","Right","Weak","Very Strong","5'10""","176 lbs","34","14",57,100,4,9,8,10,8,5,7,6,4,5,8,6,6,10,11,8,12,7,11,8,14,13,7,11,5,9,7,9,10,7,13,7,11,14,10,10,9,11,12,13,9,10,9,15,12,2,18,14,7,3,2,2,2,3,3,3,2,1,3,1
"9773",2000039660,"Giannis Satsias","12/28/2002 (20 years old)","M/AM (C)","APOEL","Cypriot First Division","CYP","Yes","9/14/2022","5/31/2026","$120K - $1.2M","Right","Weak","Very Strong","5'11""","160 lbs","55","6",95,117,6,7,8,7,10,6,7,9,7,11,10,10,12,10,11,11,12,10,10,11,14,7,7,11,10,12,11,13,12,14,11,8,11,13,14,11,8,10,12,12,11,17,8,9,7,4,12,15,14,1,1,1,2,1,1,3,3,2,1,3
"9774",82087608,"Tervin Samuel","4/27/1998 (25 years old)","D (RC)","St. John's Sports","Grenadian Premier Division","GRN","No","6/15/2020","12/31/2024","$0","Right","Reasonable","Very Strong","6'0""","167 lbs","15","-",61,98,3,9,5,3,8,1,7,5,2,9,7,5,10,5,8,11,8,7,7,14,3,5,12,6,12,6,6,7,12,10,7,8,11,8,5,8,11,11,12,11,12,12,12,10,10,5,11,11,19,4,1,3,1,2,1,2,1,1,3,2
"9775",28059219,"Reice Charles-Cook","4/8/1994 (29 years old)","GK","Bromley","Vanarama National League","GRN","No","8/5/2022","6/30/2023","$0 - $2K","Left Only","Very Strong","Very Weak","6'1""","176 lbs","147","-",83,95,2,2,2,1,6,5,3,1,3,3,8,3,1,7,10,11,11,11,7,10,10,5,10,2,10,10,6,8,10,12,10,11,7,8,12,11,8,7,12,14,7,9,8,3,6,7,9,7,15,11,11,12,9,12,9,12,6,11,10,11
"9776",72044261,"Kharlton Belmar","12/1/1992 (30 years old)","AM (RL), ST (C)","Richmond","United States Soccer Leagues Division One","GRN","No","2/9/2023","11/30/2023","$130K - $375K","Right","Reasonable","Very Strong","5'11""","160 lbs","234","50",94,95,7,9,11,12,9,11,10,11,5,7,9,11,6,9,12,9,10,9,8,9,15,11,7,9,5,11,8,10,13,11,12,9,12,14,10,13,7,16,11,11,9,9,5,10,10,5,11,11,18,2,2,2,1,2,3,2,1,3,2,4
"9777",29159633,"Ricardo German","1/13/1999 (24 years old)","AM (R), ST (C)","Chesham","English Southern League Premier South","GRN","No","6/30/2022","6/30/2024","$14K - $40K","Right Only","Weak","Very Strong","5'11""","174 lbs","100","36",66,95,3,6,10,12,10,4,9,7,4,5,9,9,4,9,10,8,11,12,10,8,9,7,4,11,4,10,6,9,11,10,9,10,12,11,10,12,5,7,10,7,10,12,3,9,5,5,12,9,7,4,2,1,3,3,1,4,3,2,1,3
"9778",29154407,"Ashley Charles","5/15/1999 (24 years old)","DM, M (C)","Wealdstone","Vanarama National League","GRN","No","6/5/2023","5/31/2024","$1.5K - $16K","Right Only","Weak","Very Strong","5'6""","143 lbs","112","2",72,94,8,7,7,6,11,10,5,7,8,10,12,7,12,10,13,9,10,9,9,9,14,8,8,11,10,13,10,12,11,10,10,8,17,10,11,10,7,8,7,12,10,10,11,7,13,1,9,14,9,3,2,3,2,3,2,3,3,3,2,1
"9779",2000130383,"Joshua Isaac","1/28/2000 (23 years old)","ST (C)","Paradise (GRN)","Grenadian Premier Division","GRN","No","6/15/2020","12/31/2025","$0 - $1.5K","Right","Fairly Strong","Very Strong","6'2""","171 lbs","13","9",69,92,5,5,8,13,13,5,13,5,1,4,6,5,3,12,8,9,5,7,6,9,12,12,6,13,6,3,6,6,13,10,6,9,13,11,7,7,9,17,8,12,11,11,5,9,8,4,15,14,16,3,2,2,2,1,4,2,2,4,3,2
"9780",82000174,"Kennedy Hinkson","2/21/1986 (37 years old)","D/WB (R), DM, M (RC), AM (R)","TLH Rangers","TT Premier Football League Tier 1","GRN","No","7/1/2019","6/30/2024","$0","Right","Reasonable","Very Strong","5'6""","134 lbs","24","4",76,90,2,6,8,11,12,7,7,7,4,9,10,4,14,9,11,7,8,7,9,14,17,10,9,9,13,8,10,9,6,8,8,3,15,8,8,1,11,11,10,11,12,13,7,10,12,5,14,12,15,3,3,1,2,4,3,3,3,1,2,2
"9781",30001159,"Shavon John-Brown","4/13/1995 (28 years old)","M (L), AM (LC), ST (C)","NY Pancyprian Freedoms","Lower Leagues","GRN","No","4/14/2023","12/31/2023","$28K - $275K","Right","Weak","Very Strong","5'8""","171 lbs","56","10",89,90,8,9,11,10,8,7,9,8,8,7,10,7,8,9,11,11,10,12,10,8,19,12,6,16,10,10,9,12,13,10,14,7,9,12,12,11,15,13,13,11,11,12,8,5,5,8,8,11,14,1,3,3,2,2,2,1,2,3,3,3
"9782",28100208,"Kairo Mitchell","10/21/1997 (25 years old)","AM (L), ST (C)","Notts Co","Sky Bet League Two","GRN","No","8/3/2021","6/30/2024","$0 - $45K","Right","Reasonable","Very Strong","6'1""","152 lbs","162","37",81,90,5,6,11,9,9,5,9,9,1,5,7,7,7,11,10,9,11,8,6,9,7,10,7,10,6,10,7,11,13,11,11,12,11,13,12,13,11,8,9,10,8,6,3,7,8,6,5,8,11,2,2,2,3,3,1,1,3,4,2,1
"9783",82084495,"Saydrel Lewis","11/27/1997 (25 years old)","AM (RC), ST (C)","Real Juventud","Liga de Ascenso de Honduras","GRN","No","1/20/2022","6/30/2024","$5K - $50K","Right","Reasonable","Very Strong","5'10""","156 lbs","10","4",85,90,7,10,12,15,13,4,14,7,4,8,9,6,7,11,15,12,8,10,6,13,3,10,9,10,7,9,7,10,10,11,9,9,13,11,10,8,15,12,12,13,11,11,14,11,11,3,12,12,17,1,1,2,1,1,2,1,3,2,1,2
"9784",2000185780,"Fotis Kotsonis","2/10/2003 (20 years old)","D (R), DM, M (C)","Paralimni","Cypriot Second Division","CYP","Yes","7/24/2021","6/30/2024","$26K - $275K","Right Only","Weak","Very Strong","5'10""","158 lbs","68","1",90,116,10,10,8,7,9,7,10,11,7,13,15,4,10,12,15,9,10,8,10,12,6,5,2,5,16,15,10,15,10,7,12,10,13,8,12,9,11,16,11,12,12,12,11,10,5,1,13,12,7,1,2,3,1,2,4,1,1,3,1,4
"9785",2000203875,"Christian James","1/24/2001 (22 years old)","D (C), DM","FC Camerhogne","Grenadian Premier Division","GRN","No","1/2/2020","12/31/2024","$0 - $2K","Right","Reasonable","Very Strong","6'1""","160 lbs","27","1",72,90,6,8,4,7,9,8,10,7,3,11,10,5,10,10,14,8,10,9,11,15,18,5,1,8,9,9,10,14,10,9,9,12,15,10,12,6,12,16,9,13,10,10,15,12,7,5,12,12,18,2,2,2,1,3,3,2,2,4,1,1
"9786",2000144100,"Roman Charles-Cook","12/22/2003 (19 years old)","D/WB (R)","Harrow","English Southern League Premier South","GRN","No","7/1/2021","6/30/2026","$0 - $12K","Right","Weak","Very Strong","5'10""","160 lbs","20","-",55,90,7,9,5,6,9,2,11,4,7,9,8,4,9,9,8,9,10,8,8,13,9,10,2,8,6,8,6,11,7,9,10,11,5,9,6,11,7,16,13,13,11,12,7,1,7,6,9,11,11,2,1,2,2,2,3,1,3,1,3,3
"9787",82087612,"Steffon Abraham","12/29/1999 (23 years old)","D/WB (R), DM, M (RC), AM (R)","Paradise (GRN)","Grenadian Premier Division","GRN","No","6/15/2020","12/31/2024","$0 - $8K","Right","Reasonable","Very Strong","6'1""","154 lbs","29","12",75,89,6,9,8,9,6,2,6,8,1,7,13,3,8,8,6,7,8,8,8,12,13,9,1,9,8,7,7,8,13,11,6,13,15,11,11,5,10,16,12,10,10,9,10,8,12,7,12,10,11,3,2,2,3,2,3,1,2,3,4,1
"9788",2000081257,"Kayden Harrack","11/5/2003 (19 years old)","D (RC), WB (R), DM","QPR","Sky Bet Championship","GRN","No","6/1/2023","6/30/2024","$20K - $60K","Right","Weak","Very Strong","6'1""","165 lbs","-","-",50,89,6,9,6,6,5,8,10,8,8,10,8,2,10,8,9,10,9,6,5,8,7,5,1,5,10,9,9,5,6,10,9,11,15,10,7,5,7,18,10,10,12,13,8,3,8,4,8,12,18,2,3,2,1,1,2,2,2,3,1,3
"9789",82087554,"Neil Rennie","11/13/1997 (25 years old)","M/AM (L), ST (C)","Paradise (GRN)","Grenadian Premier Division","GRN","No","6/15/2020","12/31/2024","$0","Left","Very Strong","Strong","6'2""","171 lbs","15","-",64,88,5,6,11,11,7,5,7,3,1,4,6,6,4,5,8,7,2,7,5,7,13,8,11,8,5,6,2,7,13,10,6,9,12,13,12,5,12,19,13,11,8,8,5,5,9,3,7,12,7,1,1,3,3,1,2,1,2,2,3,3
"9790",82090190,"Ronaldo Joseph","3/28/2002 (21 years old)","M/AM (RL), ST (C)","Fontenoy Utd","Grenadian Central Conference","GRN","No","1/1/2021","-","$0","Right","Reasonable","Very Strong","5'11""","149 lbs","2","-",68,87,6,7,9,8,11,3,7,5,4,6,11,5,7,8,11,4,6,10,7,9,12,8,11,14,6,7,8,8,13,11,7,10,14,12,4,4,9,12,11,10,10,12,13,16,5,5,11,15,17,3,1,2,3,2,3,1,2,1,2,4
"9791",2000025232,"Jose McIntosh","11/16/1997 (25 years old)","M/AM (C), ST (C)","Super Strikers","Grenadian North West Conference","GRN","No","6/15/2020","-","$0","Right","Weak","Very Strong","5'9""","149 lbs","21","21",68,86,3,6,9,13,5,6,8,3,1,3,12,9,4,8,9,12,5,10,11,14,5,7,7,9,6,7,8,12,14,12,10,6,7,12,12,4,10,15,9,10,10,9,5,9,7,3,9,12,17,1,2,1,4,3,3,2,1,3,2,1
"9792",2000288179,"Rayel Alexander","8/30/2002 (20 years old)","D (C), DM, M (C)","Hurricanes","Grenadian Premier Division","GRN","No","8/30/2020","-","$0","Right Only","Weak","Very Strong","6'2""","180 lbs","-","-",67,85,4,6,4,5,7,1,7,7,2,9,8,1,9,8,8,7,13,11,8,14,16,10,10,7,14,8,9,12,8,8,12,10,18,8,7,12,13,16,9,11,13,10,5,3,5,2,10,12,10,2,1,1,3,3,1,2,4,3,3,4
"9793",30001170,"Cassim Langaigne","2/27/1980 (43 years old)","D/WB/M/AM (R)","Hurricanes","Grenadian Premier Division","GRN","No","6/14/2021","12/31/2024","$0","Right","Reasonable","Very Strong","5'11""","158 lbs","17","2",60,85,9,13,7,13,10,9,9,7,6,10,12,4,9,11,14,12,8,10,11,11,15,8,15,12,9,10,10,11,7,7,7,9,17,7,7,7,12,20,10,14,9,14,9,13,11,1,11,13,9,2,2,2,4,1,1,1,1,2,1,1
"9794",30001173,"Shemel Louison","8/9/1990 (32 years old)","GK","GBSS","Grenadian Southern Conference","GRN","No","8/1/2018","12/31/2023","$0","Right","Fairly Strong","Very Strong","6'2""","176 lbs","36","-",80,85,3,1,2,3,1,3,2,1,1,1,10,4,3,5,14,9,11,8,5,15,13,1,7,2,12,6,6,7,5,12,6,10,7,6,2,7,11,18,10,9,12,12,5,7,12,3,8,12,7,6,8,14,8,7,9,11,5,10,8,13
"9795",26040414,"Ioakeim Toubas","2/19/1999 (24 years old)","GK","AEK Larnakas","Cypriot First Division","CYP","Yes","12/29/2022","5/31/2025","$35K - $325K","Right","Reasonable","Very Strong","6'3""","160 lbs","27","-",100,116,3,3,1,2,10,1,5,2,2,3,11,1,3,10,8,10,9,11,6,10,12,6,7,3,11,11,9,12,12,14,10,13,13,13,10,9,1,12,13,14,7,14,8,11,5,4,12,11,16,10,13,14,12,14,13,13,13,5,14,13
"9796",30001127,"Jason Belfon","7/3/1990 (32 years old)","GK","Paradise (GRN)","Grenadian Premier Division","GRN","No","11/1/2020","12/31/2024","Not for Sale","Right","Reasonable","Very Strong","5'9""","149 lbs","1","-",72,85,4,1,1,3,1,7,1,2,2,3,11,3,2,1,7,9,15,5,10,10,6,3,9,1,11,8,7,7,11,8,5,9,14,7,3,9,9,12,8,12,10,13,12,13,13,2,20,9,19,10,10,12,5,11,8,10,5,10,8,8
"9797",82073526,"Shamari Mark","7/18/1997 (25 years old)","M/AM (R)","UWI Blackbirds","BFA Digicel Premier League","GRN","No","6/15/2020","12/31/2024","$0","Right","Reasonable","Very Strong","5'9""","147 lbs","16","5",62,85,6,9,6,11,11,5,3,2,5,4,6,5,3,6,14,5,4,6,6,13,10,13,5,11,3,7,5,11,12,13,4,3,10,12,12,3,13,15,7,11,9,11,12,8,7,7,18,13,17,3,3,3,1,1,2,3,3,2,2,1
"9798",2000065937,"Keanu Hagley","2/17/1998 (25 years old)","DM, M (C)","Gießen","German Div. Hessia","GRN","Yes","4/29/2023","6/30/2025","$20K - $55K","Right Only","Weak","Very Strong","6'1""","167 lbs","102","2",70,82,5,2,3,5,10,2,6,7,1,11,11,6,13,7,6,12,8,6,5,11,8,6,7,7,11,7,12,12,13,13,4,7,13,13,10,6,14,12,12,14,9,10,12,9,7,8,20,10,18,1,3,3,2,3,3,3,3,3,2,1
"9799",82087631,"O'Neal Hoston","11/9/1998 (24 years old)","D (C), ST (C)","Paradise (GRN)","Grenadian Premier Division","GRN","No","6/15/2020","12/31/2025","$0","Right","Reasonable","Very Strong","6'0""","158 lbs","15","1",60,80,1,3,6,10,7,3,7,4,1,6,5,7,6,6,10,5,7,7,5,12,9,7,9,7,6,4,5,6,12,12,5,8,14,12,11,4,10,12,11,10,10,10,11,2,11,5,20,11,18,1,1,1,1,2,2,2,1,3,1,2
"9800",82065490,"Garth Thomas","10/27/1992 (30 years old)","D/WB (RL)","Hurricanes","Grenadian Premier Division","GRN","No","1/1/2020","12/31/2024","$0 - $5K","Right","Reasonable","Very Strong","6'2""","169 lbs","45","2",74,80,8,13,6,4,9,3,8,4,5,8,8,2,6,8,6,7,9,8,7,11,12,5,12,7,9,8,4,8,14,10,5,11,12,14,8,6,13,18,11,12,9,12,9,10,11,8,11,12,16,2,1,1,3,3,3,3,2,4,3,1
"9801",82073582,"Kwazim Theodore","1/12/1996 (27 years old)","M/AM (RLC)","All Saints Utd","Antigua and Barbuda Premier Division","GRN","No","7/1/2022","6/30/2025","$0 - $7K","Right","Fairly Strong","Very Strong","5'6""","134 lbs","27","6",76,80,6,9,9,11,13,6,5,7,1,5,11,5,8,13,9,10,4,10,7,8,12,13,8,9,7,7,5,12,13,10,7,1,13,12,10,4,12,19,13,13,10,9,8,1,8,7,19,10,13,2,1,3,3,3,1,1,2,1,1,2
"9802",30001141,"Denron Frederick","3/14/1989 (34 years old)","ST (C)","Shamrock (GRN)","Grenadian North West Conference","GRN","No","6/14/2021","-","$0","Right","Reasonable","Very Strong","5'10""","171 lbs","-","-",62,80,6,3,5,13,13,6,14,5,2,6,6,8,2,12,13,12,5,9,6,13,2,11,10,14,7,6,4,7,9,9,7,5,12,7,11,5,11,12,13,10,12,12,14,11,11,1,9,12,16,3,1,1,3,3,2,3,3,2,3,3
"9803",2000288181,"Ethan Telesford","11/13/2003 (19 years old)","M/AM (C)","GBSS","Grenadian Southern Conference","GRN","No","1/1/2020","-","$0","Right","Reasonable","Very Strong","5'8""","145 lbs","-","-",64,80,6,2,8,9,9,6,1,8,2,5,10,2,4,8,6,7,5,8,4,11,5,11,8,8,5,7,13,10,14,13,6,6,9,13,6,5,8,18,13,12,11,11,12,6,12,4,7,11,13,2,4,1,2,3,2,3,4,1,2,1
"9804",82087567,"Romar Frank","9/28/1996 (26 years old)","M (L), AM (RL)","FC Camerhogne","Grenadian Premier Division","GRN","No","1/1/2021","12/31/2023","$0 - $1.5K","Right","Reasonable","Very Strong","5'4""","119 lbs","23","11",79,80,7,12,11,7,8,6,6,5,4,6,11,6,4,10,7,11,7,9,7,10,10,10,9,9,5,7,6,12,13,13,7,1,15,13,12,1,15,11,11,12,12,10,9,14,12,4,13,12,15,3,4,2,3,1,3,3,2,1,3,2
"9805",82073557,"Chad Mark","12/7/1995 (27 years old)","M/AM (C)","Hard Rock (GRN)","Grenadian Premier Division","GRN","No","7/1/2018","12/31/2024","$2K - $6K","Right","Reasonable","Very Strong","5'10""","154 lbs","15","4",72,80,6,6,6,10,13,6,1,13,1,6,7,5,6,10,10,8,8,6,5,13,15,10,4,8,7,7,13,12,13,13,7,5,14,13,9,6,14,16,11,8,11,11,13,7,11,4,16,11,7,3,3,1,1,1,3,3,3,3,2,1
"9806",2000117792,"Stavros Georgiou","10/19/2004 (18 years old)","AM (L), ST (C)","APOEL","Cypriot First Division","CYP","Yes","6/10/2021","5/31/2024","$18K - $180K","Right Only","Weak","Very Strong","6'0""","163 lbs","9","1",85,135,7,12,11,8,13,7,13,9,2,7,14,3,4,9,5,8,4,5,8,10,9,13,9,12,7,8,11,9,14,13,9,6,6,13,8,5,8,14,13,13,10,10,8,13,9,6,17,13,10,2,2,2,2,2,3,1,2,2,3,2
"9807",2000118958,"Andreas Karamanolis","9/2/2001 (21 years old)","D (C), DM","Doxa Katokopias","Cypriot First Division","CYP","Yes","8/17/2021","5/31/2024","$0 - $120K","Right Only","Weak","Very Strong","6'0""","174 lbs","94","3",80,116,7,9,6,9,11,9,13,6,7,11,10,9,16,8,14,11,10,9,9,11,5,5,11,9,6,9,7,11,11,9,10,8,12,12,9,11,13,18,12,12,12,10,12,4,5,7,12,11,16,1,1,1,1,2,3,1,3,1,2,1
"9808",82087622,"Jeremy Richardson","3/3/1998 (25 years old)","GK","Paradise (GRN)","Grenadian Premier Division","GRN","No","6/15/2020","12/31/2024","$0","Right","Reasonable","Very Strong","6'0""","163 lbs","16","-",70,80,3,3,2,3,5,5,1,1,1,2,8,3,2,4,10,12,13,7,9,6,15,3,12,1,11,7,5,6,11,12,7,10,12,12,4,5,11,15,10,12,11,11,14,9,14,8,10,13,8,10,8,13,10,9,7,13,5,9,6,13
"9809",2000288166,"Joe-Max Wildman","10/1/2002 (20 years old)","GK","Hard Rock (GRN)","Grenadian Premier Division","GRN","No","10/1/2020","-","$0","Right","Reasonable","Very Strong","6'0""","163 lbs","-","-",65,80,2,3,1,1,1,4,1,1,1,1,5,3,3,3,5,6,15,7,12,8,15,2,13,2,9,7,6,6,10,6,6,6,17,6,6,6,10,15,10,11,12,10,13,14,8,8,10,10,9,9,5,14,13,11,6,8,5,8,12,12
"9810",2000288178,"Ryhim Griffith","5/12/2001 (22 years old)","D/WB (L)","FC Camerhogne","Grenadian Premier Division","GRN","No","8/1/2020","12/31/2024","$0","Left","Very Strong","Reasonable","5'9""","147 lbs","-","-",65,80,5,11,4,4,12,2,7,7,2,9,7,1,11,9,10,12,7,9,11,12,13,5,11,8,9,8,7,9,15,10,8,10,15,12,7,5,12,18,13,12,12,11,8,5,7,2,8,10,8,4,3,1,3,3,3,2,3,2,3,3
"9811",2000288176,"Jamil Rocastle","11/7/2002 (20 years old)","D/WB/M/AM (R)","Hard Rock (GRN)","Grenadian Premier Division","GRN","No","11/7/2020","-","$0","Right","Reasonable","Very Strong","5'10""","154 lbs","-","-",65,79,7,12,8,8,7,6,7,5,6,7,13,2,8,10,5,6,7,5,5,10,2,10,13,6,8,8,5,8,13,9,7,4,10,11,7,4,11,20,13,11,12,8,8,7,7,1,11,10,10,3,2,2,2,3,2,2,3,1,1,3
"9812",2000288173,"Sawan Mark","4/11/2002 (21 years old)","D (RC), DM","Sunsetters","Grenadian Premier Division","GRN","No","4/11/2019","-","$0","Right","Weak","Very Strong","5'10""","167 lbs","-","-",65,78,6,9,8,5,9,8,7,5,1,8,8,6,8,9,12,13,5,10,7,6,15,5,10,8,9,8,6,11,11,9,11,10,8,9,16,10,15,17,12,11,10,9,8,3,5,2,11,11,11,2,2,1,2,3,1,1,2,1,2,3
"9813",45021458,"Shane Rennie","12/14/1986 (36 years old)","M/AM (C), ST (C)","Paradise (GRN)","Grenadian Premier Division","GRN","No","1/1/2021","12/31/2023","$0","Right","Reasonable","Very Strong","5'8""","145 lbs","-","-",60,78,6,3,5,8,11,7,9,8,4,7,10,2,8,10,15,7,5,9,8,15,7,8,10,12,8,8,15,9,6,9,8,3,14,10,6,6,12,19,9,10,10,13,11,13,7,2,16,11,10,2,1,2,1,1,3,2,2,3,3,4
"9814",2000079847,"José Córdoba","3/6/2001 (22 years old)","D (LC)","Levski","Bulgarian First League","PAN","No","7/1/2022","6/30/2025","$230K - $2.3M","Left","Very Strong","Weak","6'2""","176 lbs","78","-",120,148,8,9,10,7,10,9,12,10,13,11,12,11,15,11,14,13,15,11,11,10,15,6,11,8,12,16,10,13,12,10,13,15,17,15,14,16,11,13,11,13,13,12,7,13,8,7,12,13,13,1,1,1,2,1,3,1,1,2,1,1
"9815",80027502,"Yoel Bárcenas","10/23/1993 (29 years old)","WB (R), AM (RLC)","Mazatlán","Mexican First Division","PAN","No","6/15/2020","6/30/2025","$275K - $2.6M","Right","Fairly Strong","Very Strong","5'9""","165 lbs","312","47",120,135,12,12,11,11,12,14,8,14,7,8,12,10,8,13,9,12,9,9,11,12,17,12,8,14,12,12,13,14,12,13,10,8,12,12,13,10,14,3,7,11,12,11,6,12,5,5,9,12,15,2,2,1,2,1,1,2,1,1,1,4
"9816",80030203,"Andres Andrade","10/16/1998 (24 years old)","D (LC), WB (L)","Arminia Bielefeld","3. Liga","PAN","No","6/30/2022","6/30/2025","$0","Left","Very Strong","Weak","6'2""","171 lbs","143","5",120,132,10,9,11,6,11,8,12,7,15,13,11,6,15,11,14,12,15,10,11,11,16,8,7,12,13,13,10,13,14,12,12,12,13,14,13,13,9,10,9,11,10,10,6,10,7,10,11,13,12,1,2,1,3,2,1,1,1,3,3,2
"9817",80033240,"Adalberto Carrasquilla","11/28/1998 (24 years old)","DM, M/AM (C)","Houston","Major League Soccer","PAN","No","5/10/2022","12/31/2024","$550K - $5.4M","Right","Reasonable","Very Strong","5'7""","141 lbs","192","10",122,130,8,12,15,9,13,10,7,7,3,8,13,11,11,14,14,11,10,10,11,12,12,15,11,12,13,10,13,15,15,14,12,10,12,14,15,10,11,14,2,12,10,12,9,14,11,11,12,11,17,3,3,2,3,2,2,3,1,1,2,3
"9818",43325922,"Panagiotis Louka","9/8/2000 (22 years old)","ST (C)","AEL","Cypriot First Division","CYP","Yes","7/9/2022","5/31/2025","$14K - $130K","Left","Very Strong","Weak","6'4""","196 lbs","77","17",90,115,4,8,10,12,12,6,15,7,3,3,10,12,4,10,13,11,13,9,9,9,12,9,9,12,5,12,9,10,11,8,12,16,12,12,9,12,10,8,7,10,12,11,4,12,12,5,14,13,14,3,1,2,1,3,3,2,4,2,2,2
"9819",80033775,"Romeesh Ivey","7/14/1994 (28 years old)","AM (RL)","Spartak Varna","Bulgarian Second League","PAN","No","6/6/2022","6/30/2025","$28K - $275K","Right","Reasonable","Very Strong","5'6""","125 lbs","239","34",103,130,12,11,12,10,10,11,7,11,12,6,11,10,7,13,12,9,9,10,10,8,13,13,7,12,8,9,11,12,14,14,11,6,12,13,11,7,11,3,10,11,11,11,13,12,8,6,12,11,10,3,2,2,1,2,3,2,1,1,1,1
"9820",80028885,"Amir Murillo","2/11/1996 (27 years old)","D/WB (R)","RSC Anderlecht","Jupiler Pro League","PAN","No","12/4/2020","6/30/2025","$2.7M - $5.4M","Right","Weak","Very Strong","6'0""","165 lbs","213","17",120,128,8,13,10,11,13,8,13,10,13,11,13,8,13,11,11,10,15,11,9,11,10,13,8,13,11,9,12,13,14,13,12,13,14,14,14,12,9,7,9,6,8,7,14,13,8,6,8,14,14,4,3,3,3,3,2,3,1,1,3,3
"9821",18102670,"José Luis Rodríguez","6/19/1998 (24 years old)","M/AM (RL)","Famalicão","Portuguese Premier League","PAN","No","8/15/2022","6/30/2026","$240K - $2.4M","Left","Very Strong","Reasonable","5'11""","169 lbs","101","12",119,128,10,13,14,11,13,7,11,7,7,7,12,11,7,13,16,12,12,10,11,9,12,14,8,10,5,10,14,9,15,12,10,11,12,15,12,11,11,12,11,12,11,12,12,10,14,6,12,11,12,2,2,1,3,1,2,3,2,1,1,2
"9822",84125463,"Ismael Díaz","5/12/1997 (26 years old)","AM (L), ST (C)","U. Católica (Quito)","Ecuadorian Serie A","PAN","No","11/5/2022","12/31/2025","$170K - $1.7M","Right","Weak","Very Strong","6'0""","158 lbs","172","55",126,127,6,9,13,14,13,8,11,12,4,5,13,11,6,14,11,15,11,11,13,14,13,13,7,14,9,14,13,11,12,14,15,12,15,15,14,15,10,19,13,14,11,11,13,11,8,5,13,9,18,3,1,2,2,2,3,1,1,1,1,2
"9823",83152912,"Fidel Escobar","1/9/1995 (28 years old)","D (C), DM","Saprissa","Primera División de Costa Rica","PAN","No","7/1/2022","6/30/2025","$100K - $1M","Right","Reasonable","Very Strong","6'0""","165 lbs","202","8",106,125,5,7,7,6,9,6,12,6,8,13,12,5,12,10,13,12,12,9,11,10,12,5,12,9,12,12,8,12,12,12,8,13,13,13,13,13,10,8,11,7,10,5,4,18,14,16,13,10,8,3,2,1,1,2,1,1,1,4,1,4
"9824",80031700,"José Fajardo","8/18/1993 (29 years old)","ST (C)","Cusco FC","Peruvian First Division","PAN","No","12/12/2021","1/31/2024","$0","Right","Reasonable","Very Strong","5'11""","147 lbs","166","80",119,125,7,9,12,14,11,8,15,9,6,7,11,14,8,11,17,14,13,12,9,9,12,11,9,13,8,13,9,14,12,13,14,12,14,13,13,16,9,11,12,11,10,11,7,12,15,6,12,13,14,3,1,2,2,2,3,1,3,2,3,2
"9825",78023215,"Luis Mejía","3/16/1991 (32 years old)","GK","U. Española","Chilean First Division","PAN","No","1/15/2022","12/31/2024","Not for Sale","Left","Very Strong","Reasonable","6'3""","176 lbs","182","-",121,125,3,2,2,1,9,4,3,12,2,2,9,3,3,9,7,12,13,12,12,10,14,7,8,3,10,12,11,8,15,15,15,15,14,14,13,14,1,7,7,8,10,9,7,13,7,16,14,10,8,10,13,15,12,15,13,9,10,9,12,13
"9826",80032958,"Jovani Welch","12/7/1999 (23 years old)","DM, M (C)","Ac. Viseu","Portuguese Second League","PAN","No","6/15/2020","6/30/2024","$14K - $150K","Right","Weak","Very Strong","6'1""","176 lbs","110","4",105,125,8,8,9,6,10,8,12,6,4,10,10,5,11,11,11,13,11,12,13,12,12,5,11,8,12,13,10,15,11,11,12,12,16,13,16,13,8,1,12,12,11,8,6,4,6,5,14,10,11,2,4,1,3,3,4,3,2,1,1,1
"9827",2000103148,"Omar Alba","3/26/2004 (19 years old)","D/WB (L)","Real Monarchs","MLS Next Pro Western Conference","PAN","No","8/6/2022","12/31/2025","$150K - $1.5M","Left Only","Very Strong","Weak","5'8""","141 lbs","1","-",98,124,9,11,3,5,9,7,10,5,9,7,11,7,12,9,8,5,11,10,10,15,12,5,5,8,5,14,6,10,14,15,15,6,10,11,14,6,14,6,8,13,10,13,9,8,11,4,18,9,16,1,2,2,2,1,1,4,2,4,3,2
"9828",80012044,"Roderick Miller","4/3/1992 (31 years old)","D (LC)","Turan","Azeri Premier League","PAN","No","1/2/2023","6/30/2025","Not for Sale","Left","Very Strong","Reasonable","6'2""","182 lbs","146","7",96,122,6,5,9,3,7,2,12,9,5,11,7,6,11,8,8,12,14,11,12,12,11,6,12,8,11,10,10,11,10,7,12,15,10,11,13,14,15,7,10,10,6,12,11,1,7,7,11,13,12,1,4,3,2,2,1,3,2,1,3,1
"9829",2000117783,"Stylianos Vrontis","11/5/2004 (18 years old)","D (R), M/AM (C)","APOEL","Cypriot First Division","CYP","Yes","6/3/2021","5/31/2024","$22K - $230K","Right Only","Weak","Very Strong","5'10""","143 lbs","30","6",75,115,8,8,9,10,10,8,8,10,6,10,11,2,9,12,8,8,9,8,10,14,8,10,8,10,5,10,11,10,10,12,12,9,13,10,9,5,13,10,12,13,10,10,9,5,8,4,14,10,9,1,3,2,1,2,1,2,2,4,2,2
"9830",67099292,"Alberto Quintero","12/18/1987 (35 years old)","AM (R)","Cienciano","Peruvian First Division","PAN","No","11/15/2022","12/31/2023","$0 - $45K","Right","Reasonable","Very Strong","5'6""","145 lbs","349","51",120,122,10,12,15,10,12,7,6,8,5,8,12,8,6,13,7,8,8,10,11,11,10,11,6,9,9,10,12,13,16,13,9,6,9,17,12,3,7,5,6,11,12,10,11,11,7,8,11,13,8,3,3,1,2,3,1,1,3,3,3,1
"9831",20049244,"Carlos Harvey","2/3/2000 (23 years old)","DM, M (C)","Phoenix","USSL Championship Western Conference","PAN","No","2/7/2023","11/30/2024","$160K - $1.6M","Right","Reasonable","Very Strong","6'1""","182 lbs","68","6",92,121,7,8,11,8,9,6,10,8,7,10,12,9,10,10,15,10,12,9,10,9,16,6,14,9,10,15,11,13,12,12,14,12,6,11,13,13,11,7,8,9,10,11,11,2,8,8,11,11,12,2,1,1,2,4,1,3,2,3,3,2
"9832",80030343,"Cesar Blackman","4/2/1998 (25 years old)","D/WB/AM (R)","Dun. Streda","Slovak First Division","PAN","No","6/15/2020","6/30/2025","$35K - $375K","Right Only","Weak","Very Strong","5'9""","156 lbs","151","4",110,120,11,13,14,6,10,6,6,5,11,9,13,7,8,12,14,12,10,9,11,9,4,9,1,9,7,10,12,14,16,11,8,7,11,14,15,6,13,15,11,13,12,9,12,16,8,3,12,12,7,1,3,3,2,2,2,2,2,4,4,1
"9833",80028806,"Valentín Pimentel","5/30/1991 (32 years old)","AM (C), ST (C)","Sporting San Miguelito","Liga Panameña de Futbol","PAN","No","7/1/2021","6/30/2024","$0 - $110K","Right","Reasonable","Very Strong","6'1""","169 lbs","162","29",110,120,11,9,10,11,12,11,13,10,5,11,10,14,12,11,11,12,12,11,12,12,12,11,5,13,8,13,12,11,11,11,12,13,6,12,13,12,10,10,4,12,12,11,10,10,12,5,7,10,11,2,2,4,1,3,2,2,2,3,2,4
"9834",86006958,"José Calderón","8/14/1985 (37 years old)","GK","Xelajú","Liga Nacional de Guatemala","PAN","No","5/31/2022","6/30/2024","$0 - $55K","Right","Reasonable","Very Strong","6'2""","185 lbs","415","-",117,120,2,1,3,1,7,7,1,2,2,3,9,3,2,6,10,15,16,12,11,11,11,3,10,1,13,12,11,11,13,13,10,15,12,11,10,10,10,5,13,12,12,12,5,4,6,2,10,12,12,14,11,12,13,11,12,12,5,11,12,12
"9835",80032975,"Eduardo Guerrero","2/21/2000 (23 years old)","AM (RLC), ST (C)","Zoria","Ukrainian Premier League","PAN","No","7/19/2021","5/31/2024","$65K - $650K","Right","Fairly Strong","Very Strong","5'10""","160 lbs","126","22",110,120,12,10,12,12,12,6,8,9,8,5,12,6,8,11,12,9,11,8,7,9,10,10,6,12,6,10,10,11,14,13,10,11,14,13,11,11,12,7,7,6,11,6,5,12,13,12,6,9,13,2,4,4,1,1,4,2,2,2,1,3
"9836",80024854,"Ricardo Clarke","9/27/1992 (30 years old)","M/AM (RL), ST (C)","Plaza Amador","Liga Panameña de Futbol","PAN","No","12/31/2021","6/30/2024","$0 - $100K","Right","Reasonable","Very Strong","5'11""","165 lbs","265","74",111,120,8,10,12,11,11,7,11,10,5,5,8,13,4,12,13,12,10,11,12,12,9,8,10,12,6,12,11,13,13,11,12,10,13,13,12,12,13,9,9,9,13,12,5,6,5,7,8,13,12,1,1,3,3,3,1,1,2,3,1,2
"9837",76058682,"Alejandro Rodríguez","1/12/2001 (22 years old)","GK","Deportivo Cali","Colombian First Division","PAN","No","6/15/2020","6/30/2024","$95K - $950K","Right","Weak","Very Strong","5'11""","154 lbs","30","-",100,120,3,2,1,2,8,6,1,1,1,1,16,3,3,7,14,11,12,11,11,11,11,3,1,1,10,11,10,10,12,12,11,12,12,12,11,12,10,17,11,11,10,10,9,2,6,7,10,10,11,12,8,11,8,10,11,12,7,10,11,12
"9838",86008026,"Harold Cummings","3/1/1992 (31 years old)","D (C)","Monagas S.C.","Venezuelan Premier Division","PAN","No","1/11/2023","12/31/2024","Not for Sale","Left","Very Strong","Reasonable","6'0""","207 lbs","203","2",113,120,8,7,8,8,11,7,14,6,6,13,6,6,14,12,15,13,12,10,11,13,13,6,10,12,10,11,11,11,12,12,11,14,9,11,12,14,6,10,13,12,11,10,12,6,6,9,6,12,12,2,1,1,2,1,4,2,5,5,5,5
"9839",76015146,"Alfredo Phillips","10/30/1988 (34 years old)","DM, M (C)","Atlético Nacional (PAN)","Lower Leagues","PAN","No","6/14/2021","6/30/2024","$0","Right","Fairly Strong","Very Strong","5'5""","143 lbs","91","7",95,120,8,8,9,4,13,8,6,13,8,13,9,6,14,12,7,13,9,8,10,14,5,5,13,9,12,9,12,13,11,10,9,2,12,11,11,1,14,4,10,11,13,11,11,1,9,8,19,12,17,1,1,2,2,2,3,4,1,2,2,1
"9840",2000119736,"Alexandros Michail","1/28/2000 (23 years old)","D (LC)","Pafos","Cypriot First Division","CYP","Yes","11/23/2022","5/31/2024","$45K - $425K","Left Only","Very Strong","Weak","6'4""","185 lbs","58","1",90,115,5,10,9,6,11,6,11,8,4,11,12,5,15,7,7,10,11,14,9,11,3,6,14,9,12,7,6,11,12,10,11,15,12,10,7,9,10,14,14,11,9,9,7,14,6,1,12,12,7,3,3,3,1,3,2,3,3,2,3,1
"9841",78044572,"Cecilio Waterman","4/13/1991 (32 years old)","ST (C)","U. de Concepción","Chilean First Division B","PAN","No","6/14/2021","12/31/2023","$130K - $1.3M","Right","Reasonable","Very Strong","5'11""","160 lbs","286","79",119,119,5,10,11,12,10,7,13,11,9,6,10,15,8,11,12,13,12,13,11,11,11,13,11,13,11,12,8,14,14,12,13,12,15,13,13,14,11,7,9,7,11,7,7,11,6,15,13,10,10,1,1,2,3,1,2,1,3,3,3,1
"9842",80024923,"Omar Browne","5/3/1994 (29 years old)","AM (R), ST (C)","Tauro","Liga Panameña de Futbol","PAN","No","12/31/2022","6/30/2024","$4K - $40K","Left Only","Very Strong","Weak","5'6""","138 lbs","130","23",105,119,10,11,13,12,13,10,6,12,10,5,11,7,6,14,12,11,4,7,10,8,10,16,5,11,8,6,13,7,15,14,13,4,11,14,11,7,11,8,9,7,8,9,7,3,7,13,8,12,9,1,1,2,2,3,1,1,3,2,3,2
"9843",80030105,"Freddy Gondola","9/18/1995 (27 years old)","M/AM (RL), ST (C)","Alajuelense","Primera División de Costa Rica","PAN","No","12/31/2021","6/30/2024","$650K - $1.4M","Left","Very Strong","Reasonable","5'9""","154 lbs","197","42",114,118,11,11,13,10,12,8,12,12,4,6,9,10,6,13,13,13,12,11,11,11,2,13,8,12,7,12,10,11,15,12,13,8,14,13,13,12,8,6,6,11,11,11,8,3,6,1,12,8,14,1,1,2,3,2,3,4,2,4,3,1
"9844",2000056931,"Ricardo Phillips","5/6/2001 (22 years old)","AM (RLC), ST (C)","Potros del Este","Liga Panameña de Futbol","PAN","No","12/31/2022","6/30/2024","$4K - $40K","Left","Very Strong","Reasonable","5'7""","154 lbs","58","6",98,118,8,13,11,13,10,7,6,7,8,8,13,6,6,14,7,14,9,8,4,14,7,13,7,8,8,9,6,10,14,14,5,4,12,13,9,2,13,3,8,11,11,10,6,1,11,6,10,13,9,3,1,2,1,4,2,2,1,3,3,2
"9845",2000206251,"Omar Valencia","6/8/2004 (19 years old)","D/WB (L)","New York II","MLS Next Pro Eastern Conference","PAN","No","7/1/2021","6/30/2025","$3K - $30K","Left Only","Very Strong","Weak","5'11""","149 lbs","11","-",79,118,6,10,9,5,10,3,6,8,5,10,10,3,8,10,12,5,9,9,6,13,16,8,6,6,5,14,10,13,15,14,7,10,12,12,8,5,12,7,2,9,10,11,5,8,11,3,8,11,18,2,3,1,3,1,1,4,1,2,1,3
"9846",76007021,"Armando Cooper","11/26/1987 (35 years old)","DM, M (RLC)","Árabe Unido","Liga Panameña de Futbol","PAN","No","7/1/2021","6/30/2024","$4K - $12K","Right","Reasonable","Very Strong","5'8""","156 lbs","231","23",105,118,10,11,11,11,11,9,10,10,8,11,11,11,12,12,14,12,13,13,10,11,10,12,9,12,11,12,11,11,12,13,13,10,14,12,12,12,12,12,14,10,8,10,3,12,8,12,12,10,15,2,2,1,1,2,3,3,4,1,3,1
"9847",86008024,"Eric Davis","3/31/1991 (32 years old)","D/WB/M (L)","Dun. Streda","Slovak First Division","PAN","No","6/14/2021","6/30/2024","$50K - $475K","Left","Very Strong","Reasonable","5'10""","171 lbs","270","25",110,118,10,14,15,12,9,11,14,11,11,9,15,5,9,12,11,14,11,10,10,11,12,13,11,12,10,12,14,8,12,11,12,10,12,11,10,10,14,6,10,12,9,8,6,10,13,6,11,13,11,2,1,3,3,1,3,1,3,3,4,1
"9848",80033018,"Abdiel Ayarza","9/12/1992 (30 years old)","DM, M (C)","Cusco FC","Peruvian First Division","PAN","No","12/12/2021","12/31/2023","$0 - $45K","Right Only","Weak","Very Strong","6'1""","138 lbs","141","33",114,116,7,13,8,7,12,6,15,12,12,15,12,8,16,11,15,12,12,9,10,9,13,6,9,8,13,15,9,14,13,14,13,14,13,12,15,12,12,16,7,13,11,12,7,12,13,1,13,12,18,2,3,4,3,3,2,1,2,3,3,3
"9849",2000015836,"Martin Moran","8/30/2001 (21 years old)","M/AM (C)","CA Independiente","Liga Panameña de Futbol","PAN","No","7/1/2020","6/30/2024","$0 - $100K","Right Only","Weak","Very Strong","5'10""","145 lbs","68","4",84,116,9,7,8,8,11,6,9,12,5,8,10,6,12,9,12,10,15,9,8,9,13,8,10,8,10,14,10,15,13,10,12,13,13,11,10,12,13,5,9,9,11,11,13,7,5,7,5,11,7,3,4,1,1,2,2,2,3,1,2,1
"9850",86008047,"Eric Hughes","11/7/1986 (36 years old)","GK","Tauro","Liga Panameña de Futbol","PAN","No","12/31/2020","6/30/2024","$0 - $2.5K","Right","Weak","Very Strong","6'3""","182 lbs","276","-",105,115,2,2,3,2,8,5,9,1,3,2,11,2,1,10,10,12,13,11,12,12,8,2,12,1,12,11,10,10,12,12,12,13,11,12,10,14,13,6,4,13,13,12,5,13,6,8,13,10,18,11,12,10,10,12,10,10,11,8,11,12
"9851",2000290393,"Christodoulos Georgiou","3/15/2004 (19 years old)","D (RC)","Pafos","Cypriot First Division","CYP","Yes","7/1/2019","5/31/2024","$0","Right Only","Weak","Very Strong","5'10""","156 lbs","-","-",85,115,6,10,10,10,12,2,12,5,4,9,12,5,15,7,15,11,10,12,10,12,11,5,11,10,11,10,3,11,12,12,11,9,13,12,12,7,13,11,10,10,11,11,6,8,11,3,9,10,13,4,3,2,2,2,3,1,1,2,3,3
"9852",80030296,"Joseph Cox","6/25/1994 (28 years old)","ST (C)","9 de Octubre","Ecuadorian Serie B","PAN","No","1/8/2023","12/31/2023","$90K - $900K","Right","Weak","Very Strong","6'4""","171 lbs","236","72",107,115,5,7,10,13,10,7,14,11,4,5,8,13,5,10,13,12,11,14,12,12,13,8,9,12,6,10,9,12,12,10,15,15,9,13,10,16,8,11,10,11,11,13,5,11,14,3,10,10,11,3,1,2,3,3,3,3,3,1,3,2
"9853",80027505,"Abdiel Arroyo","12/13/1993 (29 years old)","AM (L), ST (C)","Monagas S.C.","Venezuelan Premier Division","PAN","No","1/5/2023","12/31/2023","$110K - $325K","Right","Reasonable","Very Strong","6'1""","176 lbs","276","52",96,115,7,8,11,11,10,7,10,9,4,7,9,12,6,11,11,11,10,9,11,11,10,12,6,11,5,10,11,11,12,11,11,13,15,14,12,12,10,12,10,13,8,12,10,10,8,7,9,12,8,1,3,2,1,4,1,3,3,1,3,1
"9854",2000190674,"Kahiser Lenis","7/23/2000 (22 years old)","D/WB/M/AM (L)","Jaguares F.C.","Colombian First Division","PAN","No","1/2/2023","5/31/2025","$14K - $140K","Left","Very Strong","Weak","5'11""","154 lbs","49","2",100,115,9,13,9,10,13,9,9,6,9,10,13,4,11,13,15,10,9,4,11,11,8,11,13,15,10,9,8,14,13,13,15,10,13,11,12,5,13,14,7,14,10,12,5,9,5,3,13,11,14,2,2,3,1,1,3,1,4,2,3,3
"9855",76007114,"Ricardo Buitrago","3/10/1985 (38 years old)","AM (RLC)","Plaza Amador","Liga Panameña de Futbol","PAN","No","12/31/2019","6/30/2024","$0 - $12K","Right","Strong","Very Strong","5'10""","178 lbs","321","61",112,115,15,12,12,5,13,14,9,13,8,7,14,14,8,13,8,10,9,10,11,12,11,13,7,12,8,9,13,8,12,13,11,8,8,12,11,11,14,9,10,11,8,14,8,11,8,9,12,12,10,3,1,3,3,3,1,1,2,1,1,1
"9856",80031711,"Jiovany Ramos","1/26/1997 (26 years old)","D (C)","Deportivo Táchira","Venezuelan Premier Division","PAN","No","1/1/2023","12/31/2024","$30K - $300K","Right Only","Weak","Very Strong","6'0""","165 lbs","151","5",110,115,9,5,8,7,10,4,13,10,11,12,10,6,13,11,13,12,13,11,13,12,4,7,8,7,12,12,10,11,12,11,11,13,14,13,12,12,7,12,1,13,8,11,8,13,15,7,20,11,18,3,2,3,2,2,3,2,3,1,3,3
"9857",80027611,"José Murillo","2/24/1995 (28 years old)","D/WB/M/AM (L)","Plaza Amador","Liga Panameña de Futbol","PAN","No","1/1/2020","6/30/2025","$0","Left","Very Strong","Weak","5'9""","143 lbs","234","27",103,115,6,12,13,13,9,7,8,6,7,8,13,4,9,10,9,8,9,9,10,13,5,9,11,13,9,9,9,9,13,13,8,8,12,16,7,5,17,14,13,13,11,13,8,2,6,5,12,12,18,3,1,2,3,2,2,2,2,2,1,1
"9858",14023180,"Aníbal Godoy","2/10/1990 (33 years old)","DM, M (C)","Nashville","Major League Soccer","PAN","No","12/10/2021","12/31/2023","$100K - $1M","Left","Very Strong","Reasonable","5'11""","160 lbs","273","14",113,115,10,9,10,10,14,9,13,12,4,13,15,7,13,13,14,14,13,10,13,9,15,7,14,11,13,12,12,13,11,12,11,12,12,11,10,14,7,7,12,11,8,12,13,12,11,10,16,9,14,1,1,1,1,1,9,1,6,1,1,3
"9859",80026345,"José Del Carmen González","5/5/1991 (32 years old)","M/AM (RC)","Árabe Unido","Liga Panameña de Futbol","PAN","No","6/14/2021","6/30/2024","$20K - $60K","Right","Reasonable","Very Strong","5'9""","152 lbs","189","29",102,115,10,15,11,14,12,8,8,6,10,10,12,7,8,12,7,13,3,12,11,12,11,12,13,11,11,11,11,14,11,10,11,9,13,11,10,9,16,11,8,9,12,12,10,5,5,10,12,9,10,1,2,2,2,3,2,2,3,2,1,4
"9860",80027534,"Jan Carlos Vargas","3/13/1995 (28 years old)","D (C)","Tauro","Liga Panameña de Futbol","PAN","No","7/1/2019","6/30/2024","$0 - $130K","Right","Weak","Very Strong","6'0""","182 lbs","242","7",103,115,7,7,9,8,9,6,12,8,9,13,9,7,12,10,11,12,13,11,12,11,8,7,11,9,13,14,9,13,11,9,9,12,10,13,13,12,7,11,5,11,12,10,6,8,10,3,13,12,15,3,2,1,1,1,2,2,2,1,2,2
"9861",77016605,"Julio Segundo","9/26/1993 (29 years old)","AM (RLC)","Sport West","Lower Leagues","PAN","No","6/15/2020","6/30/2024","$35K - $100K","Left Only","Very Strong","Weak","5'8""","154 lbs","59","1",85,115,7,9,11,13,11,7,6,8,5,7,14,9,9,12,7,6,5,14,9,14,11,10,8,12,8,8,11,9,13,13,7,6,10,12,9,6,11,1,6,12,12,11,5,3,7,5,5,12,12,2,2,2,1,2,2,4,1,1,1,1
"9862",28106679,"Kostas Pileas","12/11/1998 (24 years old)","D (LC), WB/M/AM (L)","Aris Limassol","Cypriot First Division","CYP","Yes","6/1/2022","6/30/2025","$0","Left Only","Very Strong","Weak","5'11""","154 lbs","73","-",110,115,11,12,9,6,10,7,8,10,13,12,10,7,12,9,14,11,11,11,12,11,10,6,8,3,12,12,9,13,13,13,12,11,12,14,13,13,9,14,13,13,12,9,10,5,6,8,8,13,16,1,1,4,4,1,1,2,3,1,1,3
"9863",80029264,"Christian Martínez","2/6/1997 (26 years old)","M (RC)","Plaza Amador","Liga Panameña de Futbol","PAN","No","6/12/2023","6/30/2024","$12K - $110K","Right","Fairly Strong","Very Strong","5'7""","174 lbs","172","8",104,114,6,10,11,11,12,8,9,9,6,8,11,9,9,12,12,12,13,11,11,11,6,10,10,10,10,11,12,11,12,13,12,7,11,12,12,13,9,9,10,8,8,12,8,9,10,12,8,13,10,3,3,2,2,3,3,1,1,1,1,1
"9864",20049302,"Juan Tejada","1/14/1997 (26 years old)","AM (RL), ST (C)","Indy Eleven","USSL Championship Eastern Conference","PAN","No","7/21/2022","12/31/2023","$0","Right Only","Weak","Very Strong","5'7""","149 lbs","117","26",91,114,8,7,10,10,14,5,6,9,6,8,9,6,5,10,5,11,8,9,8,14,7,10,11,14,8,9,7,15,12,10,11,6,13,11,13,8,11,5,11,10,11,11,14,17,5,2,20,10,11,1,3,3,1,4,3,2,1,3,1,1
"9865",2000087048,"Janpol Morales","6/22/1998 (24 years old)","AM (RL), ST (C)","Macará","Ecuadorian Serie B","PAN","No","6/13/2022","6/30/2025","$140K - $1.4M","Right","Weak","Very Strong","5'10""","149 lbs","94","12",106,114,10,12,14,10,11,7,9,10,8,5,12,11,8,12,10,7,7,10,8,10,10,14,6,11,5,9,8,11,15,13,8,9,15,14,12,7,14,8,10,10,11,10,8,9,7,5,11,13,13,1,3,3,3,2,1,3,2,1,2,3
"9866",62199942,"Ricardo Ávila","1/4/1997 (26 years old)","DM, M (C)","CD Universitario (Panama)","Liga Panameña de Futbol","PAN","No","12/31/2022","12/31/2023","$0 - $55K","Left","Very Strong","Reasonable","6'0""","165 lbs","84","9",102,114,10,10,10,9,12,13,8,13,4,8,14,9,11,13,15,10,12,9,10,10,6,11,7,8,11,9,13,10,14,12,13,11,12,12,12,10,14,7,7,13,10,11,13,15,15,6,8,12,6,3,2,1,2,3,2,2,2,3,1,2
"9867",2000130260,"John Jairo Alvarado","11/7/2001 (21 years old)","M/AM (R)","Alianza FC (PAN)","Liga Panameña de Futbol","PAN","No","7/1/2021","6/30/2025","$0","Right","Reasonable","Very Strong","5'9""","141 lbs","50","3",71,112,5,8,10,9,12,4,5,3,5,4,10,3,4,12,12,8,4,6,3,11,11,14,4,10,5,6,5,11,12,12,6,6,11,12,12,3,13,10,6,11,11,9,6,12,8,1,6,11,14,1,2,2,1,3,3,3,3,4,3,2
"9868",2000188451,"Javier Betegón","2/12/2003 (20 years old)","AM (RL)","CA Independiente","Liga Panameña de Futbol","PAN","No","7/1/2021","6/30/2025","$2K - $18K","Right Only","Weak","Very Strong","5'11""","156 lbs","16","1",68,112,8,12,13,10,11,6,3,7,6,6,8,1,6,10,5,9,6,8,8,7,11,9,3,10,6,7,7,6,13,12,4,10,12,12,8,4,14,8,1,11,9,9,10,2,11,7,20,11,20,2,2,1,4,3,2,3,3,2,1,1
"9869",2000219858,"Murad Al-Faluji","12/23/2003 (19 years old)","GK","Wehdat","Jordanian Professional League","JOR","No","1/1/2021","6/30/2025","$30K - $300K","Right Only","Weak","Very Strong","6'0""","167 lbs","-","-",75,148,4,1,3,2,4,8,1,3,3,3,5,3,3,6,10,11,15,7,8,13,15,3,4,1,11,6,6,6,10,9,7,7,15,5,1,6,12,7,13,12,8,10,5,14,10,8,12,16,10,8,7,13,13,11,13,13,5,9,8,11
"9870",64048679,"Amin Al-Shanaineh","4/7/2003 (20 years old)","M (L), AM (RL)","Al-Faisaly","Jordanian Professional League","JOR","No","7/29/2021","6/30/2025","$10K - $95K","Right Only","Weak","Very Strong","5'11""","163 lbs","-","-",80,136,6,11,8,11,12,4,6,4,6,6,10,3,5,10,15,11,7,5,7,11,18,10,2,12,5,7,7,12,13,11,7,5,9,13,8,7,11,8,10,11,13,14,12,12,5,10,9,18,7,2,1,2,2,2,3,2,2,3,1,2
"9871",23176283,"Anas Bani Yaseen","11/29/1988 (34 years old)","D (C)","Al-Faisaly","Jordanian Professional League","JOR","No","1/11/2023","12/31/2023","$500 - $5K","Right","Fairly Strong","Very Strong","6'1""","178 lbs","153","11",103,131,2,4,3,1,10,4,15,8,5,15,8,7,13,7,13,14,10,8,12,15,16,5,6,9,12,9,4,10,9,10,10,11,12,9,12,10,12,17,12,14,13,13,5,6,7,3,20,11,15,3,1,3,1,2,2,3,1,1,2,2
"9872",18039452,"Abdallah Deeb","3/10/1987 (36 years old)","M (C), AM (RLC), ST (C)","Salt","Jordanian Professional League","JOR","No","1/1/2020","6/30/2024","$0 - $28K","Right","Reasonable","Very Strong","6'0""","160 lbs","176","56",111,131,10,11,10,14,9,10,14,12,7,10,12,7,10,14,9,11,11,8,8,8,13,14,13,15,7,10,11,10,13,12,6,7,10,13,14,7,10,13,8,9,13,14,13,10,10,3,19,11,8,3,3,3,3,1,3,2,4,3,2,1
"9873",26040474,"Marinos Tzionis","7/16/2001 (21 years old)","AM (RLC)","Sporting KC","Major League Soccer","CYP","Yes","1/24/2022","12/31/2024","$475K - $4.7M","Right","Reasonable","Very Strong","5'4""","125 lbs","114","15",107,114,8,10,13,12,10,5,5,6,4,3,10,9,4,13,12,11,10,10,10,12,13,12,3,13,5,11,9,9,14,15,11,5,14,13,14,10,12,13,11,12,14,14,12,10,8,4,14,16,20,3,3,2,1,3,1,1,4,3,2,3
"9874",64049016,"Ahmad Juaidi","4/9/2001 (22 years old)","GK","Shabab Ordon","Jordanian Professional League","JOR","No","6/15/2020","6/30/2024","$26K - $250K","Right","Fairly Strong","Very Strong","5'11""","171 lbs","-","-",81,130,5,2,2,2,7,8,1,3,2,2,7,1,2,7,9,11,13,8,8,14,11,1,6,2,10,8,7,7,13,6,8,11,15,9,4,7,13,18,10,12,13,12,6,11,6,1,11,11,14,11,11,14,12,9,10,14,5,10,5,14
"9875",26038808,"Musa Al-Tamari","6/10/1997 (26 years old)","M (R), AM (RL)","OH Leuven","Jupiler Pro League","JOR","No","10/5/2020","6/30/2025","$900K - $10.5M","Left","Very Strong","Weak","5'9""","165 lbs","172","29",124,130,6,9,15,12,13,6,7,12,6,6,10,6,5,13,7,12,10,11,11,10,12,13,5,12,6,14,12,14,16,15,9,7,12,15,15,8,12,12,12,14,14,12,5,12,5,10,12,15,15,3,3,3,3,2,3,2,3,3,1,3
"9876",23233072,"Sharara","12/30/1997 (25 years old)","M (R), AM (RC)","ES Tunis","Ligue Professionnelle 1","JOR","No","8/15/2022","6/30/2025","$16K - $170K","Left Only","Very Strong","Weak","5'7""","147 lbs","29","8",108,130,10,11,14,11,13,11,5,14,4,5,12,12,6,14,11,12,7,12,12,10,11,16,6,11,6,9,11,11,15,15,12,7,10,14,9,5,11,9,14,12,10,12,15,14,11,4,11,15,12,1,2,3,1,1,3,2,2,2,3,3
"9877",2000268099,"Omar Salah","4/18/2003 (20 years old)","M/AM (C)","Wehdat","Jordanian Professional League","JOR","No","1/1/2020","6/30/2024","$14K - $140K","Right","Reasonable","Very Strong","5'8""","143 lbs","-","-",85,126,2,6,8,10,12,6,6,8,2,8,10,3,5,13,10,8,6,8,5,8,13,13,1,8,8,7,13,8,13,13,7,1,13,13,10,5,14,17,11,12,13,10,7,8,5,4,17,11,11,2,4,2,2,2,1,4,3,2,2,1
"9878",23233266,"Oday Zahran","1/29/1991 (32 years old)","M/AM (R)","Sahab","Jordanian Professional League","JOR","No","8/3/2022","6/30/2024","$0 - $100K","Right","Reasonable","Very Strong","5'7""","143 lbs","111","12",90,126,9,13,6,13,14,5,8,9,8,7,9,4,7,14,7,11,8,9,10,14,7,13,10,13,8,9,10,10,13,9,9,4,7,12,13,2,15,16,13,9,10,12,6,10,8,7,11,11,14,3,1,1,1,3,3,1,1,2,2,1
"9879",64049018,"Ali Olwan","3/26/2000 (23 years old)","ST (C)","Al-Shamal","Qatar Stars League","JOR","No","12/21/2021","6/30/2026","$600K - $6M","Right Only","Weak","Very Strong","6'0""","171 lbs","30","5",100,125,9,7,15,15,11,9,15,6,5,9,10,8,5,10,11,11,12,11,5,13,4,8,2,12,10,9,9,10,11,10,10,11,14,11,13,12,13,12,12,11,10,11,6,10,9,1,14,12,18,2,3,2,2,2,2,2,2,3,1,3
"9880",64049020,"Mohammed Aburiziq","2/1/1999 (24 years old)","ST (C)","Wehdat","Jordanian Professional League","JOR","No","1/1/2023","6/30/2024","$14K - $130K","Right","Reasonable","Very Strong","5'7""","165 lbs","-","-",85,125,7,4,10,14,10,4,6,8,1,7,8,5,6,12,5,8,5,9,8,10,16,11,7,14,8,7,8,9,14,14,8,4,14,14,14,4,12,16,11,9,10,10,10,15,13,7,11,11,16,2,1,2,3,1,1,3,2,2,2,1
"9881",2000084524,"Adham Al-Rifae","2/4/2004 (19 years old)","AM (R)","Al-Faisaly","Jordanian Professional League","JOR","No","4/20/2023","12/31/2027","$20K - $200K","Right","Reasonable","Very Strong","6'0""","163 lbs","-","-",64,124,8,12,9,14,6,6,6,7,5,6,11,5,7,6,15,9,7,7,4,10,13,5,9,10,5,8,7,12,12,9,7,11,10,11,10,4,9,18,10,12,10,9,8,12,6,4,3,11,20,1,1,2,3,1,3,1,1,1,1,1
"9882",64042348,"Abdallah Al-Fakhouri","1/22/2000 (23 years old)","GK","Al-Ain FC","Saudi First Division League","JOR","No","6/15/2020","6/30/2025","$20K - $190K","Right","Fairly Strong","Very Strong","6'2""","165 lbs","15","-",85,121,3,1,3,3,4,7,1,3,2,2,7,1,1,5,11,6,14,5,8,12,18,1,8,2,11,1,5,5,12,14,6,13,13,9,4,4,8,18,9,14,13,11,12,7,5,3,9,12,12,7,10,12,5,8,9,10,5,9,9,12
"9883",23189634,"Mohammed Al-Basha","2/5/1988 (35 years old)","D (C)","Shabab Alsamu","Palestinian West Bank Premier League","JOR","No","12/8/2022","6/30/2024","$0 - $6K","Right","Reasonable","Very Strong","6'2""","180 lbs","98","3",94,120,8,5,1,7,8,8,13,5,1,14,9,5,11,5,14,13,10,8,10,14,8,5,10,6,10,8,8,9,6,10,9,14,13,8,10,10,14,18,11,11,9,8,11,14,11,2,12,9,20,2,2,3,1,1,3,3,1,1,2,2
"9884",36062516,"Alex Gogić","4/13/1994 (29 years old)","D (C), DM, M (C)","St Mirren","cinch Premiership","CYP","Yes","8/19/2022","5/31/2024","$160K - $1.6M","Right","Reasonable","Very Strong","6'1""","182 lbs","156","5",111,114,5,6,10,8,8,8,14,10,12,13,7,8,11,10,17,11,15,10,12,13,13,10,12,11,11,9,13,15,9,12,11,12,10,10,11,16,10,13,12,10,14,14,7,15,4,8,12,12,12,3,2,1,3,2,2,4,1,4,2,2
"9885",2000085578,"Ahmed Aymen","2/14/2004 (19 years old)","DM","Shabab Ordon","Jordanian Professional League","JOR","No","1/1/2020","6/30/2024","$24K - $250K","Right","Reasonable","Very Strong","5'11""","167 lbs","-","-",63,120,6,6,5,6,14,6,6,8,2,7,14,5,11,12,11,8,7,8,7,12,11,5,7,5,9,7,12,12,12,9,2,6,5,9,10,6,11,16,11,10,10,11,5,8,7,3,11,13,8,3,1,3,3,1,3,1,3,3,3,1
"9886",23189731,"Ra'ed Al-Nawateer","5/5/1988 (35 years old)","M/AM (RL)","Al-Ahli","Jordanian Professional League","JOR","No","6/14/2021","6/30/2024","$1K - $8K","Left","Very Strong","Reasonable","5'8""","149 lbs","67","16",82,119,9,13,8,14,14,7,2,8,7,7,12,5,8,14,7,11,5,10,8,14,11,13,10,14,7,6,8,11,10,9,8,5,8,9,9,5,14,14,12,10,14,11,13,10,12,7,20,10,16,3,2,2,2,3,2,4,1,3,1,3
"9887",2000193365,"Hashem Al-Khalidi","1/25/2002 (21 years old)","ST (C)","Ramtha","Jordanian Professional League","JOR","No","1/1/2021","6/30/2024","$80K - $240K","Right","Reasonable","Very Strong","5'7""","132 lbs","-","-",83,117,7,6,7,14,10,6,10,8,6,6,8,5,3,11,9,13,6,13,8,14,14,13,11,14,8,7,8,8,14,14,8,2,12,14,6,1,12,15,10,9,9,11,11,7,8,1,19,11,11,3,2,2,3,1,2,2,1,1,3,2
"9888",64049697,"Ali Thiabat","11/21/2003 (19 years old)","D/WB/AM (R)","Ramtha","Jordanian Professional League","JOR","No","6/13/2022","6/30/2024","$75K - $220K","Right","Fairly Strong","Very Strong","5'8""","145 lbs","-","-",69,116,8,10,5,13,10,5,5,2,1,4,13,5,7,8,13,8,7,3,7,13,13,8,1,7,6,6,7,4,13,13,6,1,5,13,9,3,13,18,12,13,11,14,5,18,5,3,10,10,18,3,1,2,2,1,2,2,2,1,2,1
"9889",2000084649,"Zaid Abu Rayya","4/13/2001 (22 years old)","AM (C)","Baqa'a","Jordanian First Division","JOR","No","7/1/2018","6/30/2024","$28K - $85K","Right","Reasonable","Very Strong","5'10""","154 lbs","-","-",72,116,4,4,8,9,8,6,6,13,1,6,12,4,5,13,13,10,8,4,5,9,15,13,9,8,6,7,13,12,13,11,6,7,12,11,9,5,12,10,14,13,10,13,14,4,5,7,20,11,17,1,3,1,1,1,3,2,1,2,3,4
"9890",64049019,"Nizar Mahmoud","3/23/1999 (24 years old)","DM, M (C)","Newroz","Iraqi Premier League","JOR","No","1/11/2023","12/31/2023","$4K - $40K","Right","Fairly Strong","Very Strong","5'10""","167 lbs","-","-",89,115,8,6,8,9,13,8,8,9,3,10,13,5,10,15,7,9,9,11,10,14,11,9,10,13,8,14,11,10,10,10,8,7,15,10,5,10,10,11,11,13,12,12,8,8,15,1,17,13,17,2,2,2,4,1,3,3,1,3,2,3
"9891",64048678,"Khalid Zakaria","6/26/2000 (22 years old)","DM, M (C)","Al-Faisaly","Jordanian Professional League","JOR","No","1/1/2020","6/30/2024","$26K - $275K","Right","Fairly Strong","Very Strong","6'0""","167 lbs","-","-",88,115,8,8,4,5,13,7,8,7,3,9,15,5,15,10,6,6,8,10,7,15,3,5,9,9,11,9,9,11,13,10,9,8,17,8,10,8,11,16,9,11,12,13,10,12,14,2,17,12,10,2,3,2,2,3,3,3,3,2,1,3
"9892",64049022,"Yazan Al-Naimat","6/4/1999 (24 years old)","ST (C)","Al-Ahli","Qatar Stars League","JOR","No","12/28/2021","6/30/2024","$250K - $2.6M","Right Only","Weak","Very Strong","6'0""","169 lbs","35","14",100,115,5,4,11,14,11,4,14,6,7,6,10,6,5,12,11,10,9,13,9,14,11,12,6,11,8,8,10,12,13,12,11,11,13,13,12,9,12,14,12,10,12,9,7,12,5,6,15,11,9,2,3,3,3,1,3,1,3,2,3,1
"9893",23233245,"Baha' Abdel Rahman","1/5/1987 (36 years old)","M (C)","Al-Faisaly","Jordanian Professional League","JOR","No","2/6/2023","12/31/2023","$4K - $12K","Right","Reasonable","Very Strong","5'10""","163 lbs","141","16",100,115,8,9,5,10,15,9,9,9,5,13,15,7,7,15,14,10,7,10,10,15,12,5,5,12,10,10,12,13,10,9,7,9,7,10,9,8,12,13,13,12,13,8,12,2,9,1,11,12,9,1,2,1,1,2,2,1,1,3,1,3
"9894",23233241,"Alaa' Al-Shaqran","4/21/1987 (36 years old)","DM, M (C)","Torra","Jordanian First Division","JOR","No","8/1/2021","6/30/2024","$6K - $18K","Right","Reasonable","Very Strong","5'8""","152 lbs","117","4",89,115,8,8,5,7,15,8,8,11,1,11,15,2,15,11,13,13,9,10,10,10,5,7,13,10,11,9,11,14,9,9,9,8,14,8,10,8,14,13,12,11,10,9,12,13,13,2,6,11,19,2,3,3,1,4,3,1,1,3,1,3
"9895",62143076,"Matija Špoljarić","4/2/1997 (26 years old)","M/AM (C)","Aris Limassol","Cypriot First Division","CYP","Yes","8/8/2022","5/31/2025","$160K - $1.6M","Right Only","Weak","Very Strong","5'10""","152 lbs","133","19",110,113,13,12,11,11,12,14,13,12,5,10,12,13,9,13,7,12,7,13,13,14,14,12,12,10,9,15,14,13,11,11,14,13,14,12,13,8,6,15,18,14,17,13,7,11,5,4,11,16,14,3,1,1,2,3,4,3,2,1,3,2
"9896",2000065159,"Fadel Haikel","2/14/2000 (23 years old)","DM, M (C)","Al-Diwaniya","Iraqi Premier League","JOR","No","2/6/2023","7/31/2023","$4K - $40K","Right","Reasonable","Very Strong","6'3""","176 lbs","-","-",90,115,8,8,6,6,14,8,8,11,3,12,12,4,8,14,14,14,9,10,10,14,12,6,13,9,10,9,12,13,13,11,9,11,10,13,12,7,13,17,11,10,9,11,5,8,10,8,11,13,17,4,1,2,1,2,3,2,2,4,4,2
"9897",23189740,"Saeed Murjan","2/10/1990 (33 years old)","M/AM (C)","Sahab","Jordanian Professional League","JOR","No","6/1/2023","12/31/2023","$0 - $40K","Right","Reasonable","Very Strong","6'0""","167 lbs","79","27",114,114,7,7,6,13,15,10,8,12,15,12,14,7,11,13,6,10,9,12,11,15,9,11,6,14,9,14,15,16,11,9,11,8,13,11,10,8,16,19,10,10,11,10,8,15,6,7,16,12,18,1,1,1,1,3,1,1,2,3,2,2
"9898",2000209157,"Ibrahim Sabreh","9/12/2006 (16 years old)","ST (C)","Wehdat","Jordanian Professional League","JOR","No","5/24/2023","6/30/2026","$75K - $220K","Right","Reasonable","Very Strong","5'10""","145 lbs","-","-",73,114,6,5,10,13,13,6,11,7,4,5,7,2,6,9,5,9,6,9,6,11,12,11,6,13,5,6,6,8,8,11,3,6,12,12,12,9,10,18,10,12,10,11,5,7,14,6,16,12,9,1,3,1,3,4,1,1,3,2,3,1
"9899",64042347,"Hamza Al-Dardour","5/12/1991 (32 years old)","AM (C), ST (C)","Hussein","Jordanian Professional League","JOR","No","1/19/2023","6/30/2024","$6K - $60K","Right","Reasonable","Very Strong","5'7""","143 lbs","127","57",109,114,8,10,11,15,12,8,13,9,5,7,11,8,7,13,6,14,6,14,10,13,11,11,11,10,10,9,11,11,14,14,10,3,15,14,14,7,12,15,11,10,10,10,9,12,12,1,12,10,19,1,2,3,2,2,3,3,3,3,3,3
"9900",2000085580,"Muhannad Abu Awwad","10/6/2002 (20 years old)","ST (C)","Shabab Ordon","Jordanian Professional League","JOR","No","6/13/2022","6/30/2024","$18K - $170K","Right","Fairly Strong","Very Strong","5'9""","154 lbs","-","-",75,114,5,4,9,12,11,5,12,6,1,3,2,3,2,10,14,6,7,10,6,9,6,12,11,11,2,5,4,7,12,12,6,5,13,12,12,9,11,17,11,12,12,10,6,14,9,5,10,11,9,1,1,1,3,1,2,1,1,3,2,4
"9901",5637521,"Alaa' Matalqa","10/7/1982 (40 years old)","D (LC)","Shabab Hussein","Jordanian Second Division Group A","JOR","No","6/14/2021","6/30/2024","$3K - $9K","Right","Reasonable","Very Strong","5'8""","149 lbs","72","4",63,114,5,11,2,3,7,2,9,2,6,12,9,15,11,8,8,9,9,8,7,13,14,5,7,6,12,8,7,8,6,6,6,8,13,6,6,6,11,13,11,10,12,12,12,8,11,2,11,12,12,1,1,3,2,3,2,3,1,3,2,2
"9902",64042085,"Noor Al-Rawabdeh","2/24/1997 (26 years old)","M (C)","Selangor","Malaysian Super League","JOR","No","1/12/2023","11/30/2024","$160K - $475K","Right","Reasonable","Very Strong","6'0""","160 lbs","15","1",100,114,8,7,14,7,12,6,10,8,6,9,13,5,11,13,7,10,9,10,9,12,6,5,13,8,12,9,13,13,14,10,9,10,9,14,10,13,17,20,12,10,12,11,13,13,9,1,12,12,11,2,3,2,3,3,1,2,1,1,2,2
"9903",64048202,"Wassim Ryalat","8/16/2001 (21 years old)","M (LC)","Shabab Ordon","Jordanian Professional League","JOR","No","6/13/2022","6/30/2024","$0 - $35K","Left","Very Strong","Reasonable","5'7""","134 lbs","-","-",86,113,7,8,9,6,9,7,7,6,6,8,14,6,7,10,10,10,7,10,8,10,6,8,12,9,7,8,9,13,14,14,8,4,13,14,8,2,18,20,12,14,10,12,14,10,10,5,6,10,8,1,3,1,3,2,1,1,3,2,1,1
"9904",91177091,"Alaa Bakir","1/15/2001 (22 years old)","M (RL), AM (RLC), ST (C)","MSV Duisburg","3. Liga","JOR","Yes","7/1/2021","6/30/2024","$14K - $130K","Right","Weak","Very Strong","5'10""","152 lbs","85","8",97,113,8,10,13,8,11,8,7,9,5,5,11,9,6,13,11,10,8,10,8,10,12,13,7,10,4,8,13,9,13,14,8,8,11,12,9,5,15,11,7,12,13,11,10,14,6,10,11,14,8,3,1,1,3,1,3,3,2,3,1,1
"9905",64046341,"Daniel Afaneh","3/24/2001 (22 years old)","D (C)","Wehdat","Jordanian Professional League","JOR","No","8/4/2019","12/31/2024","$70K - $210K","Right Only","Weak","Very Strong","5'10""","163 lbs","-","-",74,113,3,1,2,5,8,1,13,5,1,14,6,1,11,4,11,13,9,7,5,14,8,5,1,7,14,7,5,6,11,12,8,5,15,14,11,9,12,14,8,8,10,10,13,17,10,3,14,11,7,1,1,3,2,1,3,2,3,1,3,1
"9906",2000112005,"Konstantinos Evripidou","4/26/2005 (18 years old)","M/AM (C)","PSV","Eredivisie","CYP","Yes","7/31/2021","6/30/2024","$170K - $500K","Left","Very Strong","Reasonable","5'9""","138 lbs","-","-",90,112,4,6,9,11,13,7,8,10,2,7,11,6,9,10,6,12,7,7,10,14,12,11,9,10,6,9,14,15,14,11,11,5,14,13,8,6,14,11,13,14,9,9,5,19,10,3,20,11,18,1,2,3,4,4,2,3,1,3,3,1
"9907",2000085003,"Moataz Alyan","7/28/2003 (19 years old)","GK","Jazeera","Jordanian First Division","JOR","No","1/1/2020","6/30/2024","$5K - $50K","Right","Reasonable","Very Strong","6'4""","178 lbs","-","-",72,113,3,3,3,2,1,7,1,1,1,2,10,3,2,3,13,6,15,7,5,10,14,3,4,1,9,7,6,6,11,10,7,13,8,10,6,5,8,11,11,13,12,15,8,7,7,4,9,13,20,10,5,13,10,9,9,13,5,8,7,13
"9908",64039255,"Ahmad Ersan","9/28/1995 (27 years old)","M (RL), AM (RLC)","Al-Sarhan","Jordanian First Division","JOR","No","7/12/2018","12/31/2024","$5K - $50K","Left","Very Strong","Fairly Strong","5'8""","149 lbs","59","14",105,113,7,8,11,12,14,5,8,8,8,8,12,9,7,12,13,12,9,11,9,11,7,11,11,13,7,9,12,11,14,13,9,2,12,11,14,7,12,20,8,12,10,10,11,14,10,2,12,13,19,2,1,2,1,3,1,2,1,3,2,2
"9909",23189626,"Mohammed Mustafa","10/29/1989 (33 years old)","D (C), DM","Salt","Jordanian Professional League","JOR","No","2/1/2020","6/30/2024","$0 - $55K","Right","Reasonable","Very Strong","5'8""","163 lbs","82","2",90,113,7,4,1,5,9,8,11,9,6,14,8,8,14,7,7,12,10,8,12,14,19,5,9,8,14,8,8,10,7,9,9,2,13,9,6,9,14,18,9,9,12,12,10,13,6,3,10,9,16,1,3,2,3,3,2,3,2,1,2,1
"9910",64049021,"Ibrahim Sa'deh","4/27/2000 (23 years old)","M (C)","Hussein","Jordanian Professional League","JOR","No","1/17/2022","6/30/2025","$0","Right","Fairly Strong","Very Strong","5'10""","169 lbs","-","-",88,113,5,6,4,8,14,7,1,8,3,12,14,2,8,12,11,8,6,6,8,8,4,5,7,8,10,8,10,12,10,14,8,4,16,14,8,7,13,13,9,11,11,11,5,12,7,7,10,12,7,3,1,2,2,3,2,1,3,2,3,3
"9911",64048684,"Oudeh Al-Khzaleh","6/25/1993 (29 years old)","AM (C)","Al-Faisaly","Jordanian Professional League","JOR","No","6/15/2020","6/30/2024","$0 - $80K","Right","Reasonable","Very Strong","5'6""","130 lbs","-","-",107,112,6,8,14,12,13,7,8,10,3,8,11,3,7,14,7,11,5,8,7,14,15,13,3,13,9,9,14,12,14,14,9,1,15,14,7,1,10,13,11,11,9,11,7,12,11,3,18,11,19,2,3,2,4,2,1,1,4,3,2,1
"9912",23234961,"Mussab Al-Laham","5/20/1991 (32 years old)","AM (LC), ST (C)","Hussein","Jordanian Professional League","JOR","No","1/14/2022","12/31/2023","$26K - $80K","Left","Very Strong","Reasonable","5'4""","125 lbs","76","33",100,112,6,10,14,14,13,9,11,11,3,9,10,9,8,13,9,11,7,11,9,11,3,13,10,14,9,10,10,11,12,13,10,3,10,11,9,1,12,11,9,11,9,8,10,3,8,3,14,13,7,3,2,3,2,3,1,1,3,3,3,1
"9913",23237408,"Omar Manasrah","2/15/1994 (29 years old)","D/WB (RL)","Wehdat","Jordanian Professional League","JOR","No","1/4/2022","6/30/2024","$0 - $95K","Left","Very Strong","Reasonable","6'1""","169 lbs","21","-",81,112,5,10,9,7,11,1,6,5,7,8,7,1,10,7,10,9,8,9,9,10,4,7,10,8,8,9,6,9,14,14,9,11,11,14,11,6,13,20,12,11,8,13,6,2,7,4,15,10,17,3,1,3,2,2,1,2,3,3,1,3
"9914",64049783,"Waleed Essam","2/16/1999 (24 years old)","GK","Sahab","Jordanian Professional League","JOR","No","4/6/2023","6/30/2025","$4.5K - $45K","Right","Reasonable","Very Strong","6'5""","180 lbs","-","-",81,112,5,3,3,1,1,8,1,2,3,1,13,1,3,3,11,11,10,3,10,13,6,2,6,1,8,6,6,6,12,12,7,14,13,13,6,6,11,13,12,12,11,10,7,12,7,4,12,13,13,9,6,13,8,9,13,11,5,9,8,13
"9915",64048014,"Rizk Bani-Hani","11/22/2002 (20 years old)","ST (C)","Shabab Ordon","Jordanian Professional League","JOR","No","11/19/2019","6/30/2024","$22K - $220K","Right","Fairly Strong","Very Strong","5'10""","154 lbs","-","-",78,111,1,3,13,13,13,5,13,7,1,6,7,7,3,10,5,10,8,8,6,12,4,11,9,11,2,6,7,7,13,11,7,4,12,13,7,7,10,14,10,12,12,10,10,10,13,8,20,11,14,4,3,4,2,1,2,1,2,1,3,2
"9916",23189713,"Ibrahim Al-Zawahreh","1/17/1989 (34 years old)","D (C)","Al-Faisaly","Jordanian Professional League","JOR","No","7/1/2019","6/30/2024","$7K - $22K","Right","Reasonable","Very Strong","6'4""","189 lbs","96","11",93,111,6,2,4,5,10,7,15,4,1,13,7,6,15,6,6,9,11,10,9,15,13,5,10,7,12,9,5,10,7,7,10,16,10,7,7,9,15,19,13,14,11,8,11,11,10,7,9,11,20,1,2,2,1,3,2,1,2,3,2,3
"9917",28051267,"Konstantinos Laifis","5/19/1993 (30 years old)","D (C)","Standard","Jupiler Pro League","CYP","Yes","6/14/2021","6/30/2024","$180K - $1.8M","Left","Very Strong","Weak","6'1""","180 lbs","284","19",122,133,6,7,10,6,11,8,13,11,9,15,12,8,13,11,9,13,13,13,13,13,15,7,12,10,14,14,8,11,13,11,12,12,13,12,14,14,15,10,14,11,12,11,7,13,8,3,14,16,12,3,2,4,2,4,3,2,1,1,4,3
"9918",26038929,"Andreas Keravnos","5/5/1999 (24 years old)","GK","Anorthosi","Cypriot First Division","CYP","Yes","8/22/2022","5/31/2025","$75K - $230K","Right","Weak","Very Strong","6'3""","187 lbs","28","-",95,111,1,1,3,3,8,4,6,1,2,2,7,3,3,5,6,11,12,10,11,12,13,3,4,3,11,12,7,4,9,13,13,12,8,10,12,11,12,12,14,11,12,14,4,6,4,4,7,12,12,11,8,13,6,10,11,12,3,10,10,11
"9919",5637109,"Hamad Al-Asmar","1/13/1987 (36 years old)","GK","Shabab Aqaba","Jordanian Professional League","JOR","No","4/20/2023","12/31/2023","$2.5K - $7K","Right","Reasonable","Very Strong","5'8""","138 lbs","79","4",77,111,5,3,1,3,2,6,1,1,1,3,7,2,1,1,8,10,10,7,11,14,11,2,11,1,8,8,7,7,9,9,8,7,9,9,7,7,8,14,11,11,13,11,6,1,9,4,12,10,8,13,5,9,9,10,14,14,5,7,9,11
"9920",77029444,"Renato Tapia","7/28/1995 (27 years old)","D (C), DM, M (C)","Vigo","Spanish First Division","PER","No","7/21/2020","6/30/2024","$500K - $8.4M","Right","Reasonable","Very Strong","6'1""","176 lbs","203","10",130,150,9,7,11,8,13,8,13,10,10,14,12,12,15,13,16,14,15,13,12,12,14,12,13,11,15,14,11,16,13,13,13,14,15,12,15,14,14,14,12,15,13,12,9,15,12,7,11,15,9,2,2,1,2,1,1,4,2,1,2,3
"9921",5290748,"Paolo Guerrero","1/1/1984 (39 years old)","ST (C)","Racing Club","Argentine Premier Division","PER","No","1/24/2023","12/31/2024","$70K - $700K","Right","Fairly Strong","Very Strong","6'0""","189 lbs","431","152",119,149,7,8,10,16,15,14,15,13,7,5,13,15,6,15,14,14,16,14,10,13,14,13,15,16,7,11,13,10,8,8,13,13,10,9,8,13,5,15,9,11,13,9,13,17,14,16,13,15,15,4,3,3,2,3,1,3,2,2,2,3
"9922",8826416,"Luis Ramírez","11/10/1984 (38 years old)","M/AM (C)","Cantolao","Peruvian First Division","PER","No","1/2/2023","12/31/2023","$0 - $28K","Right","Fairly Strong","Very Strong","5'11""","171 lbs","488","56",107,148,15,11,15,8,13,12,7,13,12,6,14,14,6,15,8,11,8,11,11,12,12,15,9,13,7,11,15,12,9,10,8,8,10,10,10,12,7,13,13,14,12,11,7,13,4,4,11,13,12,3,1,4,2,1,3,3,3,3,2,1
"9923",77012758,"Raúl Ruidíaz","7/25/1990 (32 years old)","AM (R), ST (C)","Seattle","Major League Soccer","PER","Yes","2/4/2022","12/31/2024","Not for Sale","Right Only","Weak","Very Strong","5'7""","145 lbs","419","196",132,146,12,13,15,15,15,7,6,13,11,7,13,15,7,14,8,15,8,11,14,14,14,16,8,15,7,14,12,15,15,15,9,7,11,15,12,9,13,12,13,14,13,9,17,12,11,12,12,11,14,1,3,2,3,3,4,1,1,2,3,3
"9924",77063750,"Piero Quispe","8/14/2001 (21 years old)","M/AM (C)","Universitario","Peruvian First Division","PER","No","8/7/2019","12/31/2025","$140K - $1.4M","Right","Weak","Very Strong","5'6""","141 lbs","49","5",118,141,10,12,16,8,15,8,7,12,9,12,15,8,12,14,9,13,9,9,12,13,9,15,7,13,10,12,14,12,14,12,10,8,9,13,11,8,8,10,8,12,10,13,7,13,7,6,14,12,13,3,1,3,2,3,3,2,2,2,2,1
"9925",77005949,"Christian Cueva","11/23/1991 (31 years old)","AM (RLC)","Alianza","Peruvian First Division","PER","No","6/22/2022","6/30/2025","$11.5M - $14M","Right","Fairly Strong","Very Strong","5'6""","143 lbs","359","61",125,140,13,12,12,12,13,13,7,8,12,9,14,15,8,13,8,13,11,12,12,12,9,16,7,14,7,13,15,13,15,15,12,5,13,14,12,6,11,8,9,10,8,8,7,12,7,6,11,12,11,3,3,2,3,2,3,2,2,2,1,1
"9926",77017791,"Miguel Trauco","8/25/1992 (30 years old)","D/WB (L)","San Jose","Major League Soccer","PER","No","9/2/2022","12/31/2023","$130K - $1.3M","Left","Very Strong","Weak","5'9""","136 lbs","342","8",124,140,14,15,13,7,15,13,9,14,14,10,14,14,12,15,11,10,10,12,13,12,12,15,6,13,10,13,12,13,14,13,10,9,14,14,13,8,15,11,12,13,12,12,7,13,7,6,12,12,12,3,1,2,2,2,1,2,2,2,1,1
"9927",77032094,"Pedro Aquino","4/13/1995 (28 years old)","DM, M (C)","América","Mexican First Division","PER","No","12/25/2020","6/30/2023","$60K - $600K","Right","Reasonable","Very Strong","5'9""","147 lbs","238","8",128,140,9,8,10,9,14,9,11,10,14,15,15,15,14,12,13,14,12,11,12,13,8,12,15,14,14,14,13,13,12,13,11,9,10,12,13,11,12,11,9,10,9,12,13,11,12,8,12,12,12,2,1,3,3,3,1,2,3,2,4,3
"9928",77004183,"Paolo Hurtado","7/27/1990 (32 years old)","AM (RLC)","Cienciano","Peruvian First Division","PER","No","12/20/2022","12/31/2023","$6K - $55K","Right","Reasonable","Very Strong","5'9""","147 lbs","295","49",112,140,15,13,14,12,14,13,10,13,6,6,15,13,7,15,9,11,9,12,10,12,9,15,7,14,7,11,14,9,12,12,11,7,5,13,8,8,12,9,9,13,8,13,20,13,7,5,11,12,13,2,1,3,1,3,1,1,4,2,1,1
"9929",89061572,"Hector Kyprianou","5/27/2001 (22 years old)","DM, M (C)","Peterborough","Sky Bet League One","CYP","Yes","6/22/2022","6/30/2025","$375K - $3.8M","Right","Fairly Strong","Very Strong","6'3""","189 lbs","123","3",110,133,8,9,10,11,13,8,12,10,8,12,13,5,12,12,10,11,12,13,10,11,14,13,12,10,12,15,9,14,11,10,13,13,12,11,13,13,12,15,14,14,14,12,14,7,4,5,12,10,13,3,2,1,2,4,2,3,3,2,2,2
"9930",77051575,"Marcos López","11/20/1999 (23 years old)","D/WB/M (L)","Feyenoord","Eredivisie","PER","No","8/8/2022","6/30/2026","$425K - $4.3M","Left Only","Very Strong","Weak","5'10""","152 lbs","113","9",127,140,14,13,15,7,10,15,12,9,15,11,15,9,11,13,12,13,10,10,11,11,12,8,7,13,11,11,9,12,16,11,10,11,11,15,13,11,15,13,11,12,10,10,7,7,6,5,8,13,7,2,3,1,3,3,3,2,3,2,2,3
"9931",2000132854,"Juan Pablo Goicochea","1/12/2005 (18 years old)","ST (C)","Alianza","Peruvian First Division","PER","No","2/8/2022","12/31/2024","$85K - $850K","Right","Reasonable","Very Strong","6'1""","176 lbs","4","-",89,139,6,8,13,11,13,6,13,7,6,6,6,6,1,11,5,9,5,9,2,12,10,13,1,7,5,6,5,8,14,11,11,10,12,14,13,12,12,15,8,10,12,12,12,14,5,5,10,10,7,2,1,1,1,1,1,3,1,2,2,1
"9932",77059267,"Kluiverth Aguilar","5/5/2003 (20 years old)","D/WB (R)","Lommel SK","Belgian Challenger Pro League","PER","No","7/1/2022","6/30/2026","$160K - $1.6M","Right","Weak","Very Strong","5'11""","163 lbs","40","2",95,139,7,7,12,7,8,7,12,7,13,13,12,7,12,13,11,11,10,10,9,9,10,8,8,10,12,13,8,13,14,11,8,13,7,14,11,8,13,11,10,11,9,15,6,10,7,5,12,13,13,1,2,3,1,2,1,3,3,3,1,3
"9933",43020298,"Gianluca Lapadula","2/7/1990 (33 years old)","ST (C)","Cagliari","Italian Serie A","PER","Yes","7/26/2022","6/30/2025","Not for Sale","Left","Very Strong","Reasonable","5'10""","152 lbs","366","150",130,139,8,9,12,15,12,10,13,10,9,9,11,15,10,11,14,14,18,14,14,13,18,14,12,16,9,13,10,18,12,14,14,10,15,12,13,12,9,14,16,11,13,10,14,16,8,1,14,18,13,1,3,3,4,1,3,3,1,3,2,1
"9934",77060016,"Jhilmar Lora","10/24/2000 (22 years old)","D (RL), WB (R)","Cristal","Peruvian First Division","PER","No","1/30/2021","12/31/2023","$120K - $1.2M","Right","Fairly Strong","Very Strong","5'10""","158 lbs","59","-",112,138,14,13,12,6,13,13,9,9,13,13,14,9,12,14,9,12,9,12,10,13,10,8,6,8,11,12,13,9,13,11,8,9,12,13,12,8,13,8,9,12,11,13,7,13,7,5,14,13,13,1,1,3,2,1,4,3,2,4,1,3
"9935",77059268,"Joao Grimaldo","2/20/2003 (20 years old)","M (R), AM (RL)","Cristal","Peruvian First Division","PER","No","6/13/2022","12/31/2024","$130K - $1.3M","Right","Weak","Very Strong","5'9""","160 lbs","46","4",111,138,8,8,15,9,14,9,14,9,7,8,15,10,8,15,8,9,9,9,8,9,9,14,8,8,8,8,9,8,16,13,8,11,9,16,9,8,9,8,9,12,8,8,5,9,6,7,12,12,12,1,1,4,2,3,1,4,2,2,3,3
"9936",77004608,"Pedro Gallese","2/23/1990 (33 years old)","GK","Orlando City","Major League Soccer","PER","No","12/27/2022","12/31/2024","Not for Sale","Left","Very Strong","Reasonable","6'2""","174 lbs","301","2",130,137,6,8,7,5,13,11,12,12,2,9,13,1,12,13,10,13,12,12,13,14,13,2,14,6,12,12,12,12,11,13,14,14,14,10,11,14,13,12,8,14,12,12,9,13,10,7,14,15,13,10,11,16,9,12,15,15,7,11,11,14
"9937",77015994,"Carlos Ascues","6/19/1992 (30 years old)","D (C), DM, M (RC)","César Vallejo","Peruvian First Division","PER","No","12/8/2021","12/31/2024","$75K - $750K","Right","Weak","Very Strong","6'2""","180 lbs","218","18",114,135,6,13,13,7,12,8,13,9,10,13,15,11,12,15,12,12,12,9,10,9,12,11,10,12,12,8,10,13,13,12,13,13,8,13,10,13,15,12,11,9,9,13,10,13,8,10,11,13,11,3,1,3,3,4,3,1,2,1,4,1
"9938",77012583,"André Carrillo","6/14/1991 (31 years old)","M (C), AM (RL)","Al-Hilal (KSA)","Saudi Professional League","PER","No","7/23/2019","6/30/2025","Not for Sale","Right","Reasonable","Very Strong","5'11""","160 lbs","307","39",130,135,11,13,16,11,14,10,8,10,10,7,14,13,7,15,8,11,12,14,10,12,11,16,6,13,9,10,13,12,14,14,12,8,12,14,12,12,12,10,11,13,12,5,7,11,5,7,12,16,13,2,2,2,3,1,1,2,3,3,4,3
"9939",77000887,"Christian Ramos","11/4/1988 (34 years old)","D (C)","Sport Boys","Peruvian First Division","PER","No","12/20/2022","12/31/2023","$1.5K - $12K","Right Only","Weak","Very Strong","6'1""","176 lbs","437","17",115,135,6,9,7,6,10,7,14,7,12,13,10,13,13,10,13,13,12,12,12,12,12,8,11,12,13,13,8,12,12,13,13,14,13,12,13,13,9,12,12,15,13,12,6,12,8,6,14,12,14,3,3,2,2,1,2,2,1,3,2,2
"9940",2000057844,"Antonio Foti","11/3/2003 (19 years old)","M (C), AM (RLC)","Eintracht Frankfurt","Bundesliga","CYP","Yes","6/16/2022","6/30/2025","$350K - $3.4M","Right","Reasonable","Very Strong","5'11""","163 lbs","25","7",105,132,11,11,12,11,13,11,9,12,6,8,13,13,9,14,12,11,9,12,9,9,12,14,10,12,8,12,13,10,12,12,10,8,14,14,11,8,15,12,12,10,9,9,5,12,5,6,12,12,10,2,2,2,2,3,2,4,2,3,1,3
"9941",77000913,"Carlos Zambrano","7/10/1989 (33 years old)","D (C)","Alianza","Peruvian First Division","PER","No","1/7/2023","12/31/2024","Not for Sale","Right","Weak","Very Strong","6'1""","180 lbs","243","6",125,135,4,9,10,6,11,6,15,10,12,16,11,7,15,11,17,13,17,12,10,12,18,7,13,8,14,10,6,12,11,12,14,12,14,13,12,12,14,8,4,10,15,7,13,12,18,16,12,12,13,3,1,3,1,1,2,3,3,2,1,3
"9942",77018477,"Edison Flores","5/14/1994 (29 years old)","M (L), AM (RLC)","Universitario","Peruvian First Division","PER","No","6/23/2022","12/31/2025","$1.2M - $2.6M","Left","Very Strong","Fairly Strong","5'7""","158 lbs","331","38",123,135,14,13,14,12,14,11,13,14,13,6,14,13,9,15,6,10,6,13,12,9,9,14,5,11,9,11,14,10,13,13,12,7,10,13,11,8,14,14,13,10,12,8,11,9,6,8,12,13,6,1,1,3,3,1,3,2,2,2,3,3
"9943",77062603,"Jesús Castillo","6/11/2001 (22 years old)","DM, M (C)","Cristal","Peruvian First Division","PER","No","6/13/2022","1/31/2025","$70K - $700K","Right Only","Weak","Very Strong","6'1""","176 lbs","95","3",112,135,10,13,9,7,13,8,13,9,9,13,15,11,13,14,13,12,13,10,9,12,10,8,8,9,13,13,12,13,12,13,13,13,10,13,12,12,12,11,12,13,11,12,7,12,8,3,13,12,12,3,2,1,1,3,3,4,1,3,3,1
"9944",77062597,"Rafael Lutiger","7/3/2001 (21 years old)","D (LC)","Cristal","Peruvian First Division","PER","Yes","11/15/2022","12/31/2025","$325K - $950K","Left Only","Very Strong","Weak","6'2""","176 lbs","49","4",99,135,7,9,6,7,12,8,14,8,13,14,13,9,13,13,12,13,10,9,8,8,9,7,9,8,10,12,8,9,12,12,9,14,9,12,12,12,13,10,11,13,10,13,7,11,8,6,12,14,14,3,3,4,3,3,2,2,3,1,3,3
"9945",77003539,"Joel Sánchez","6/11/1989 (34 years old)","M (R), AM (RLC)","UTC","Peruvian First Division","PER","No","11/29/2022","12/31/2023","$2K - $20K","Right","Strong","Very Strong","5'7""","156 lbs","399","42",109,135,13,12,15,8,12,6,7,10,12,7,12,12,5,12,9,12,8,10,8,7,12,13,6,12,8,15,12,15,13,12,9,8,12,12,11,10,14,8,9,13,11,13,12,9,8,5,13,12,12,2,1,1,1,1,2,2,1,1,1,1
"9946",5290503,"Rinaldo Cruzado","9/21/1984 (38 years old)","M (LC), AM (C)","Universidad San Martín","Peruvian Second Division","PER","No","2/10/2023","12/31/2023","$500 - $7K","Left","Very Strong","Weak","5'11""","180 lbs","447","38",103,135,15,13,10,8,15,15,9,15,8,8,16,15,7,16,9,8,8,10,8,13,9,14,13,9,9,11,16,7,9,9,9,9,9,9,9,10,8,9,10,10,8,10,7,12,10,7,9,12,14,2,3,3,2,3,4,2,2,3,1,2
"9947",2000045681,"Catriel Cabellos","8/18/2004 (18 years old)","D/WB (R), M/AM (RC)","Racing Club","Argentine Premier Division","PER","No","8/24/2022","12/31/2026","$4.5M - $8.6M","Right","Fairly Strong","Very Strong","5'8""","156 lbs","6","-",103,135,9,10,13,10,11,7,6,10,9,10,13,13,11,12,14,8,9,8,9,10,11,9,11,12,10,9,12,10,13,12,9,7,9,12,10,6,16,13,8,10,12,12,6,15,7,2,8,11,13,3,1,3,1,1,4,4,1,4,3,1
"9948",77056310,"Yuriel Celi","2/20/2002 (21 years old)","M (C), AM (LC)","Universitario","Peruvian First Division","PER","No","1/31/2023","6/30/2025","$425K - $9M","Left Only","Very Strong","Weak","5'10""","171 lbs","109","14",108,133,14,15,12,8,13,13,12,13,7,9,16,16,8,15,13,7,13,12,8,10,11,13,12,10,8,10,13,10,13,13,13,11,9,13,9,11,9,14,9,7,9,13,6,12,8,6,11,10,9,2,2,1,3,2,3,2,1,3,2,2
"9949",2000055858,"Fabrizio Roca","3/20/2002 (21 years old)","ST (C)","Sport Boys","Peruvian First Division","PER","No","7/27/2022","12/31/2024","$100K - $1M","Right Only","Weak","Very Strong","6'0""","176 lbs","9","3",108,133,8,10,12,14,11,10,13,11,4,8,13,14,7,11,12,12,13,9,11,12,9,8,9,8,8,12,8,12,13,13,11,12,13,13,13,13,12,12,11,14,12,10,6,11,5,7,12,13,13,1,1,3,1,2,3,1,1,3,1,2
"9950",77029495,"Luis Abram","2/27/1996 (27 years old)","D (C)","Atlanta United","Major League Soccer","PER","Yes","2/2/2023","12/31/2026","$1M - $6M","Left","Very Strong","Weak","5'11""","169 lbs","239","10",129,133,8,6,11,6,11,9,15,5,11,14,13,9,13,11,12,14,13,13,14,13,12,7,9,9,13,13,13,13,13,12,14,12,12,14,15,13,12,9,10,14,12,12,8,12,8,2,12,15,14,3,4,1,2,1,3,1,2,1,3,1
"9951",43460201,"Rafail Mamas","3/4/2001 (22 years old)","DM, M (C)","AEK Larnakas","Cypriot First Division","CYP","Yes","8/24/2021","5/31/2024","$550K - $1.6M","Right","Reasonable","Very Strong","6'1""","171 lbs","46","1",100,132,9,8,11,7,11,8,8,10,8,14,12,5,15,11,12,10,13,10,10,8,14,11,8,8,11,14,11,13,13,12,11,10,13,12,13,10,12,10,7,13,12,11,6,10,12,5,11,15,12,2,3,2,2,3,4,2,3,4,1,2
"9952",77012161,"Luis Advíncula","3/2/1990 (33 years old)","D/WB/M/AM (R)","Boca","Argentine Premier Division","PER","No","7/31/2021","12/31/2024","Not for Sale","Right","Fairly Strong","Very Strong","5'10""","165 lbs","424","19",133,133,8,13,10,5,10,7,8,13,14,10,12,8,13,12,15,9,15,11,11,9,15,8,11,13,9,12,8,15,15,12,14,11,15,16,15,15,15,8,10,13,13,10,8,14,13,11,13,14,9,3,2,1,3,2,1,2,1,3,2,1
"9953",77029292,"Sergio Peña","9/28/1995 (27 years old)","DM, M (C)","Malmö FF","Swedish Premier Division","PER","Yes","8/4/2021","12/31/2024","$275K - $2.8M","Right","Fairly Strong","Very Strong","5'10""","154 lbs","229","21",124,132,14,13,13,9,15,13,7,11,10,8,15,13,12,15,12,14,12,14,10,13,13,14,12,12,10,10,15,10,12,12,12,8,12,10,11,11,10,7,7,8,12,6,13,12,10,16,13,11,11,1,3,3,1,2,2,3,1,3,3,3
"9954",77047795,"Gianfranco Chávez","8/10/1998 (24 years old)","D (RC)","Cristal","Peruvian First Division","PER","No","1/29/2021","12/31/2023","$16K - $150K","Right Only","Weak","Very Strong","5'10""","163 lbs","96","5",116,132,7,7,7,5,12,6,13,7,12,15,13,11,15,12,13,15,12,11,11,12,12,7,7,8,12,12,8,12,14,13,8,13,11,14,13,9,14,14,10,13,12,14,7,12,9,7,14,14,13,3,2,3,1,3,3,1,3,3,1,2
"9955",77000899,"Josepmir Ballón","3/21/1988 (35 years old)","D (C), DM, M (C)","Alianza","Peruvian First Division","PER","No","12/26/2019","12/31/2023","$1.5K - $14K","Right","Reasonable","Very Strong","5'11""","167 lbs","523","27",118,132,8,10,8,4,10,8,12,8,13,12,15,7,12,12,12,13,13,13,12,11,12,8,14,12,13,15,8,14,12,14,13,12,13,12,14,14,16,13,12,15,12,12,11,13,12,6,11,13,14,1,3,1,2,2,1,1,2,2,3,3
"9956",2000048829,"Alessandro Burlamaqui","2/18/2002 (21 years old)","M/AM (C)","Intercity","Spanish Federation First Division B","PER","Yes","6/30/2021","6/30/2024","$0","Right","Weak","Very Strong","5'11""","154 lbs","49","-",100,132,8,8,10,14,14,8,8,10,7,10,14,4,11,14,10,11,5,7,10,8,15,13,2,10,10,10,13,13,14,10,10,7,10,14,14,6,13,12,9,11,10,12,12,5,13,7,20,13,18,2,3,1,3,1,3,1,2,1,2,3
"9957",67011210,"Cristian Benavente","5/19/1994 (29 years old)","AM (RLC)","Alianza","Peruvian First Division","PER","Yes","2/4/2022","12/31/2023","$40K - $375K","Right","Fairly Strong","Very Strong","5'9""","149 lbs","190","38",117,132,12,12,15,12,15,13,8,13,6,5,14,12,6,16,6,10,11,12,9,12,10,15,7,9,6,8,14,8,15,13,12,6,12,13,9,8,12,12,12,15,12,13,11,13,8,2,9,15,12,3,1,4,3,2,2,3,3,3,1,2
"9958",77047989,"Alec Deneumostier","5/5/1999 (24 years old)","D (C)","Melgar","Peruvian First Division","PER","Yes","6/15/2020","12/31/2025","$250K - $750K","Right Only","Weak","Very Strong","6'1""","167 lbs","86","1",115,131,8,12,8,6,12,8,15,7,14,15,14,9,15,14,12,11,12,9,12,9,9,8,11,9,12,13,8,13,13,12,10,15,8,13,12,11,9,11,10,13,11,12,10,12,6,9,13,12,13,3,2,2,3,3,1,3,2,4,1,2
"9959",77062131,"Diego Romero","8/17/2001 (21 years old)","GK","Universitario","Peruvian First Division","PER","No","1/1/2019","12/31/2024","$30K - $300K","Right Only","Weak","Very Strong","6'3""","182 lbs","19","-",106,131,3,1,3,2,2,6,1,1,1,1,14,2,1,7,15,12,15,8,8,15,15,3,8,2,13,10,7,7,11,12,10,17,14,13,2,8,13,19,11,13,12,10,5,10,5,3,10,11,18,12,8,12,10,12,13,13,6,9,10,13
"9960",77014733,"Andy Polo","9/29/1994 (28 years old)","WB/M (R), AM (RL)","Universitario","Peruvian First Division","PER","No","3/8/2022","12/31/2023","$180K - $550K","Right","Fairly Strong","Very Strong","5'8""","156 lbs","287","25",121,130,7,12,11,10,11,7,7,9,8,11,13,8,10,12,6,13,8,9,12,12,11,12,5,10,9,12,7,13,15,11,8,7,9,16,10,9,12,7,9,5,10,9,6,9,6,14,13,13,12,1,3,2,2,3,1,1,3,1,1,3
"9961",77012995,"Alexander Callens","5/4/1992 (31 years old)","D (LC)","Girona","Spanish First Division","PER","Yes","1/23/2023","6/30/2025","$70K - $700K","Left Only","Very Strong","Weak","6'1""","180 lbs","326","20",125,130,5,8,8,6,10,4,14,6,10,14,12,12,14,10,15,14,14,11,10,11,13,9,13,7,13,13,8,14,14,13,12,14,13,14,15,15,13,13,13,15,12,12,8,12,12,7,12,15,15,2,1,2,1,3,1,3,1,3,2,3
"9962",5103200,"Giorgos Efraim","7/5/1989 (33 years old)","M (R), AM (RL)","APOEL","Cypriot First Division","CYP","Yes","6/14/2021","6/30/2024","$18K - $170K","Right","Fairly Strong","Very Strong","5'7""","143 lbs","317","62",105,130,9,11,12,10,12,11,6,11,5,6,11,11,7,13,6,11,8,12,11,12,12,15,9,10,5,12,12,10,13,14,8,6,12,12,12,7,10,8,12,15,9,10,12,15,3,3,12,15,14,2,3,2,1,1,4,2,1,3,3,3
"9963",77000619,"Ronald Quinteros","6/28/1985 (37 years old)","WB (R), M (C)","César Vallejo","Peruvian First Division","PER","No","6/14/2021","12/31/2023","$1K - $9K","Right Only","Weak","Very Strong","5'10""","158 lbs","504","55",108,130,16,8,13,8,10,14,8,13,13,8,13,15,8,13,10,9,10,12,13,12,12,13,8,13,9,15,14,13,13,12,11,9,12,13,15,12,13,8,9,13,13,10,9,13,9,6,14,13,11,3,3,3,2,3,1,2,3,3,2,3
"9964",77064327,"Alex Valera","5/16/1996 (27 years old)","ST (C)","Universitario","Peruvian First Division","PER","No","1/11/2023","12/31/2024","$45K - $450K","Left Only","Very Strong","Weak","6'0""","180 lbs","78","37",123,130,7,12,14,14,13,9,13,13,7,11,14,13,9,14,14,15,13,13,14,15,9,13,8,9,10,14,8,13,14,13,13,13,13,13,12,13,11,10,8,13,12,12,7,13,9,4,15,12,12,3,2,1,3,2,2,2,1,3,1,3
"9965",8825633,"Junior Viza","4/3/1985 (38 years old)","AM (RLC)","Universidad San Martín","Peruvian Second Division","PER","No","1/15/2023","12/31/2023","$7K - $22K","Right","Fairly Strong","Very Strong","5'8""","163 lbs","517","61",102,130,11,9,14,7,11,7,4,6,3,4,14,8,7,12,10,12,10,10,8,11,8,15,10,11,7,11,13,11,11,16,11,8,13,10,10,8,6,8,8,8,9,10,7,14,8,5,12,9,12,1,1,1,1,2,2,1,1,1,4,3
"9966",77018490,"Miguel Araujo","10/24/1994 (28 years old)","D (C)","FC Emmen","Keuken Kampioen Divisie","PER","No","7/1/2019","6/30/2025","$0","Right Only","Weak","Very Strong","5'11""","156 lbs","295","17",124,130,9,8,9,7,8,14,13,9,12,14,11,12,15,12,17,12,14,11,13,12,12,8,9,10,13,13,9,14,12,12,11,15,10,12,13,15,13,13,11,13,13,14,8,14,8,7,13,13,9,2,1,3,1,1,2,1,4,1,2,2
"9967",77016553,"Anderson Santamaría","1/10/1992 (31 years old)","D (C)","Atlas","Mexican First Division","PER","No","11/12/2021","6/30/2025","Not for Sale","Right Only","Weak","Very Strong","6'0""","180 lbs","343","27",124,130,12,12,11,10,12,9,14,12,13,14,14,12,14,13,13,12,12,12,12,12,12,10,11,9,12,14,12,15,14,13,12,13,12,14,13,12,12,10,12,12,9,10,8,12,13,6,14,10,12,1,3,1,2,1,2,3,3,2,3,1
"9968",77063200,"Jhamir D'Arrigo","11/15/1999 (23 years old)","WB (L), AM (RL)","Melgar","Peruvian First Division","PER","No","12/1/2022","12/31/2023","$65K - $650K","Left Only","Very Strong","Weak","5'6""","138 lbs","74","8",119,130,10,12,15,9,14,9,9,8,8,8,14,8,7,14,8,12,10,11,11,11,11,14,7,8,7,12,11,12,17,12,7,5,8,17,9,7,13,13,11,11,14,12,7,12,6,6,13,11,16,2,2,2,3,3,3,4,3,3,3,1
"9969",77029252,"Angelo Campos","4/27/1993 (30 years old)","GK","Alianza","Peruvian First Division","PER","No","3/23/2021","12/31/2024","$90K - $900K","Left Only","Very Strong","Weak","6'1""","180 lbs","165","-",126,130,5,2,1,1,4,7,3,3,1,3,16,1,2,7,6,14,14,9,13,16,6,1,12,1,13,12,9,11,16,8,12,15,13,14,10,9,13,12,11,11,11,11,8,3,13,4,13,10,16,8,11,15,12,13,12,13,8,12,13,13
"9970",2000097222,"Lisandro Vásquez","1/30/2003 (20 years old)","M/AM (R)","Melgar","Peruvian First Division","PER","No","12/1/2022","12/31/2023","$65K - $650K","Right Only","Weak","Very Strong","5'7""","143 lbs","38","4",89,130,8,11,13,12,13,6,6,8,6,6,13,6,7,13,7,7,3,12,7,9,4,13,11,6,5,7,11,11,12,13,7,5,9,13,13,2,15,12,9,10,11,11,15,10,9,7,10,10,20,3,3,1,3,3,1,2,1,1,1,2
"9971",78047041,"Gabriel Costa","4/2/1990 (33 years old)","AM (RLC)","Alianza","Peruvian First Division","PER","No","12/1/2022","12/31/2024","Not for Sale","Right","Reasonable","Very Strong","5'7""","152 lbs","330","92",122,129,14,14,15,10,14,12,8,11,7,5,14,12,5,14,10,14,9,10,10,13,8,14,9,13,7,14,14,10,14,14,12,6,12,12,12,8,11,13,12,11,12,6,7,11,9,8,7,13,14,1,3,4,3,3,4,3,3,3,3,2
"9972",77055658,"Alejandro Ramos","9/13/1998 (24 years old)","D/WB (R)","Melgar","Peruvian First Division","PER","No","12/29/2020","12/31/2024","$90K - $900K","Right Only","Weak","Very Strong","5'10""","165 lbs","167","7",117,129,12,12,12,5,12,7,11,7,14,15,15,10,15,13,13,13,13,12,12,13,9,8,10,12,13,13,14,13,13,12,10,7,9,13,12,12,12,11,11,13,13,12,6,13,11,8,12,13,13,3,2,1,2,1,2,3,2,2,3,1
